transaction_date,value_date,description,reference,debit,credit,balance
2013-08-21,2013-08-21,Business materials,REF75754841,458.39,0.0,4907.53
2013-08-22,2013-08-22,Business materials,REF35909705,575.62,0.0,4331.91
2013-08-24,2013-08-24,Tools expense,REF92960326,44.35,0.0,4287.56
2013-08-26,2013-08-26,Fuel purchase,REF21285656,391.36,0.0,3896.2
2013-08-27,2013-08-27,Fuel purchase,REF72307184,293.22,0.0,3602.98
2013-08-27,2013-08-27,Business materials,REF45972421,1216.21,0.0,2386.77
2013-08-30,2013-08-30,"Service payment - Nelson, Parks and Campbell",REF14618213,0.0,1460.33,3847.1
2013-08-30,2013-08-30,Payment from Porter Inc,REF36079756,0.0,804.17,4651.27
2013-08-30,2013-08-30,"Service payment - Mullins, Buckley and Hahn",REF94738811,0.0,1293.05,5944.32
2013-08-30,2013-08-30,Service payment - Abbott-Gomez,REF46714141,0.0,1683.35,7627.67
2013-08-30,2013-08-30,Payment from Roman-Gonzalez,REF94704854,0.0,1293.79,8921.46
2013-08-30,2013-08-30,Permits Licenses expense,REF18873397,21.37,0.0,8900.09
2013-09-02,2013-09-02,Subcontractors expense,REF44870133,1430.71,0.0,7469.38
2013-09-06,2013-09-06,Vehicle Maintenance expense,REF89734565,183.28,0.0,7286.1
2013-09-06,2013-09-06,Business materials,REF41883543,1006.33,0.0,6279.77
2013-09-10,2013-09-10,Fuel purchase,REF58017600,339.74,0.0,5940.03
2013-09-13,2013-09-13,Business materials,REF75946575,1259.82,0.0,4680.21
2013-09-14,2013-09-14,Business materials,REF20695087,692.23,0.0,3987.98
2013-09-15,2013-09-15,Project payment - Porter Inc,REF96357424,0.0,793.42,4781.4
2013-09-15,2013-09-15,"Project payment - Nelson, Parks and Campbell",REF42561241,0.0,1214.78,5996.18
2013-09-15,2013-09-15,Business insurance premium,REF44528651,225.84,0.0,5770.34
2013-09-15,2013-09-15,Payment from Roman-Gonzalez,REF83986822,0.0,807.12,6577.46
2013-09-17,2013-09-17,Business materials,REF98111460,1065.84,0.0,5511.62
2013-09-18,2013-09-18,Safety Equipment expense,REF48555927,109.09,0.0,5402.53
2013-09-19,2013-09-19,Tools expense,REF56473213,133.53,0.0,5269.0
2013-09-28,2013-09-28,Business materials,REF51951102,940.4,0.0,4328.6
2013-09-28,2013-09-28,Equipment Rental expense,REF91167464,417.24,0.0,3911.36
2013-09-30,2013-09-30,Invoice payment - Porter Inc,REF14293923,0.0,963.79,4875.15
2013-09-30,2013-09-30,"Invoice payment - Nelson, Parks and Campbell",REF99879445,0.0,1237.17,6112.32
2013-09-30,2013-09-30,Service payment - Roman-Gonzalez,REF24540440,0.0,945.93,7058.25
2013-09-30,2013-09-30,"Payment from Mullins, Buckley and Hahn",REF43604712,0.0,943.0,8001.25
2013-09-30,2013-09-30,Project payment - Abbott-Gomez,REF30713771,0.0,951.07,8952.32
2013-10-14,2013-10-14,Business materials,REF83030355,1306.56,0.0,7645.76
2013-10-15,2013-10-15,Project payment - Porter Inc,REF32187686,0.0,628.0,8273.76
2013-10-15,2013-10-15,Business insurance premium,REF63243334,212.25,0.0,8061.51
2013-10-15,2013-10-15,"Service payment - Mullins, Buckley and Hahn",REF38847889,0.0,946.95,9008.46
2013-10-15,2013-10-15,Service payment - Roman-Gonzalez,REF71777698,0.0,1143.53,10151.99
2013-10-15,2013-10-15,"Service payment - Nelson, Parks and Campbell",REF16040748,0.0,1339.23,11491.22
2013-10-21,2013-10-21,Business materials,REF11766247,569.02,0.0,10922.2
2013-10-21,2013-10-21,Vehicle Maintenance expense,REF42540178,190.22,0.0,10731.98
2013-10-22,2013-10-22,Safety Equipment expense,REF56445139,75.13,0.0,10656.85
2013-10-22,2013-10-22,Fuel purchase,REF25237547,336.71,0.0,10320.14
2013-10-23,2013-10-23,Business materials,REF27108099,787.82,0.0,9532.32
2013-10-25,2013-10-25,Tools expense,REF99067467,153.69,0.0,9378.63
2013-10-27,2013-10-27,Vehicle Maintenance expense,REF81635047,191.98,0.0,9186.65
2013-10-28,2013-10-28,Tools expense,REF94062096,95.64,0.0,9091.01
2013-10-30,2013-10-30,Invoice payment - Abbott-Gomez,REF47781620,0.0,1145.71,10236.72
2013-10-30,2013-10-30,Service payment - Porter Inc,REF59603218,0.0,595.36,10832.08
2013-10-30,2013-10-30,Payment from Roman-Gonzalez,REF78070380,0.0,933.49,11765.57
2013-10-30,2013-10-30,"Service payment - Mullins, Buckley and Hahn",REF97731193,0.0,786.82,12552.39
2013-10-30,2013-10-30,"Invoice payment - Nelson, Parks and Campbell",REF50670732,0.0,941.59,13493.98
2013-11-04,2013-11-04,Fuel purchase,REF48399252,212.1,0.0,13281.88
2013-11-12,2013-11-12,Tools expense,REF30195887,104.56,0.0,13177.32
2013-11-15,2013-11-15,Payment from Abbott-Gomez,REF28201515,0.0,946.16,14123.48
2013-11-15,2013-11-15,Business insurance premium,REF48182430,161.76,0.0,13961.72
2013-11-15,2013-11-15,Invoice payment - Porter Inc,REF16615328,0.0,684.16,14645.88
2013-11-15,2013-11-15,Payment from Roman-Gonzalez,REF19958431,0.0,667.94,15313.82
2013-11-15,2013-11-15,"Service payment - Nelson, Parks and Campbell",REF99711185,0.0,899.83,16213.65
2013-11-19,2013-11-19,Business materials,REF35469674,733.83,0.0,15479.82
2013-11-24,2013-11-24,Fuel purchase,REF56111118,278.68,0.0,15201.14
2013-11-25,2013-11-25,Permits Licenses expense,REF24787022,59.63,0.0,15141.51
2013-11-28,2013-11-28,Business materials,REF23777199,359.81,0.0,14781.7
2013-11-28,2013-11-28,Safety Equipment expense,REF49600905,99.47,0.0,14682.23
2013-11-30,2013-11-30,Project payment - Roman-Gonzalez,REF86211160,0.0,716.26,15398.49
2013-11-30,2013-11-30,Payment from Abbott-Gomez,REF67926987,0.0,806.57,16205.06
2013-11-30,2013-11-30,Payment from Porter Inc,REF99485010,0.0,518.99,16724.05
2013-11-30,2013-11-30,"Service payment - Nelson, Parks and Campbell",REF50023106,0.0,1135.9,17859.95
2013-11-30,2013-11-30,"Service payment - Mullins, Buckley and Hahn",REF69393077,0.0,612.65,18472.6
2013-12-05,2013-12-05,Fuel purchase,REF49005706,245.53,0.0,18227.07
2013-12-06,2013-12-06,Business materials,REF88588581,411.91,0.0,17815.16
2013-12-06,2013-12-06,Subcontractors expense,REF25132118,729.17,0.0,17085.99
2013-12-09,2013-12-09,Business materials,REF50173933,454.22,0.0,16631.77
2013-12-09,2013-12-09,Fuel purchase,REF14745335,92.97,0.0,16538.8
2013-12-11,2013-12-11,Vehicle Maintenance expense,REF74533569,84.26,0.0,16454.54
2013-12-12,2013-12-12,Fuel purchase,REF84603943,218.05,0.0,16236.49
2013-12-13,2013-12-13,Fuel purchase,REF86122591,272.47,0.0,15964.02
2013-12-14,2013-12-14,Fuel purchase,REF51917626,240.2,0.0,15723.82
2013-12-15,2013-12-15,Service payment - Abbott-Gomez,REF14656034,0.0,906.79,16630.61
2013-12-15,2013-12-15,Invoice payment - Porter Inc,REF93843937,0.0,449.38,17079.99
2013-12-15,2013-12-15,"Invoice payment - Nelson, Parks and Campbell",REF43118579,0.0,631.58,17711.57
2013-12-15,2013-12-15,"Invoice payment - Mullins, Buckley and Hahn",REF18795503,0.0,455.53,18167.1
2013-12-15,2013-12-15,Service payment - Roman-Gonzalez,REF11028778,0.0,574.89,18741.99
2013-12-15,2013-12-15,Business insurance premium,REF27586412,121.18,0.0,18620.81
2013-12-19,2013-12-19,Business materials,REF50108423,332.12,0.0,18288.69
2013-12-20,2013-12-20,Vehicle Maintenance expense,REF78169806,95.68,0.0,18193.01
2013-12-20,2013-12-20,Fuel purchase,REF45957833,163.25,0.0,18029.76
2013-12-21,2013-12-21,Tools expense,REF98040753,38.37,0.0,17991.39
2013-12-28,2013-12-28,Safety Equipment expense,REF46367601,42.12,0.0,17949.27
2013-12-29,2013-12-29,Safety Equipment expense,REF66733170,59.92,0.0,17889.35
2013-12-29,2013-12-29,Fuel purchase,REF65395273,180.85,0.0,17708.5
2013-12-30,2013-12-30,Invoice payment - Abbott-Gomez,REF86261579,0.0,786.12,18494.62
2013-12-30,2013-12-30,"Payment from Mullins, Buckley and Hahn",REF93073490,0.0,477.28,18971.9
2013-12-30,2013-12-30,Invoice payment - Roman-Gonzalez,REF60040104,0.0,430.41,19402.31
2013-12-30,2013-12-30,Invoice payment - Porter Inc,REF77196913,0.0,358.57,19760.88
2013-12-30,2013-12-30,"Service payment - Nelson, Parks and Campbell",REF85877351,0.0,700.59,20461.47
2013-12-31,2013-12-31,Permits Licenses expense,REF64343984,55.52,0.0,20405.95
2014-01-03,2014-01-03,Fuel purchase,REF64752751,147.65,0.0,20258.3
2014-01-04,2014-01-04,Subcontractors expense,REF20624557,685.22,0.0,19573.08
2014-01-11,2014-01-11,Permits Licenses expense,REF44128719,44.38,0.0,19528.7
2014-01-11,2014-01-11,Tools expense,REF42716012,66.29,0.0,19462.41
2014-01-11,2014-01-11,Business materials,REF15651179,496.48,0.0,18965.93
2014-01-12,2014-01-12,Equipment Rental expense,REF16527619,168.86,0.0,18797.07
2014-01-14,2014-01-14,Business materials,REF95151415,591.92,0.0,18205.15
2014-01-14,2014-01-14,Permits Licenses expense,REF25978769,71.25,0.0,18133.9
2014-01-15,2014-01-15,"Project payment - Nelson, Parks and Campbell",REF72422945,0.0,719.68,18853.58
2014-01-15,2014-01-15,Service payment - Abbott-Gomez,REF98413848,0.0,854.18,19707.76
2014-01-15,2014-01-15,Service payment - Porter Inc,REF12950655,0.0,549.53,20257.29
2014-01-15,2014-01-15,"Service payment - Mullins, Buckley and Hahn",REF88211010,0.0,489.56,20746.85
2014-01-15,2014-01-15,Business insurance premium,REF10641178,135.28,0.0,20611.57
2014-01-15,2014-01-15,Invoice payment - Roman-Gonzalez,REF29249130,0.0,719.63,21331.2
2014-01-17,2014-01-17,Permits Licenses expense,REF42653539,72.43,0.0,21258.77
2014-01-22,2014-01-22,Business materials,REF58012210,568.58,0.0,20690.19
2014-01-22,2014-01-22,Fuel purchase,REF89901095,255.5,0.0,20434.69
2014-01-23,2014-01-23,Fuel purchase,REF16640142,230.45,0.0,20204.24
2014-01-24,2014-01-24,Business materials,REF52740874,686.67,0.0,19517.57
2014-01-25,2014-01-25,Subcontractors expense,REF19102277,575.21,0.0,18942.36
2014-01-30,2014-01-30,Project payment - Roman-Gonzalez,REF71152651,0.0,602.35,19544.71
2014-01-30,2014-01-30,"Project payment - Nelson, Parks and Campbell",REF33858146,0.0,780.09,20324.8
2014-01-30,2014-01-30,Payment from Porter Inc,REF95193363,0.0,500.24,20825.04
2014-01-30,2014-01-30,Service payment - Abbott-Gomez,REF18619380,0.0,679.61,21504.65
2014-01-31,2014-01-31,Business materials,REF20324671,328.81,0.0,21175.84
2014-02-06,2014-02-06,Tools expense,REF11071670,80.86,0.0,21094.98
2014-02-07,2014-02-07,Safety Equipment expense,REF59254281,32.7,0.0,21062.28
2014-02-08,2014-02-08,Business materials,REF69099525,154.51,0.0,20907.77
2014-02-10,2014-02-10,Equipment Rental expense,REF84792882,386.52,0.0,20521.25
2014-02-12,2014-02-12,Fuel purchase,REF48008192,305.55,0.0,20215.7
2014-02-15,2014-02-15,Business insurance premium,REF69803448,149.73,0.0,20065.97
2014-02-15,2014-02-15,"Invoice payment - Mullins, Buckley and Hahn",REF62261369,0.0,653.41,20719.38
2014-02-15,2014-02-15,Project payment - Porter Inc,REF51591793,0.0,562.74,21282.12
2014-02-15,2014-02-15,Service payment - Abbott-Gomez,REF39038311,0.0,826.43,22108.55
2014-02-15,2014-02-15,Service payment - Roman-Gonzalez,REF96277002,0.0,720.92,22829.47
2014-02-15,2014-02-15,"Service payment - Nelson, Parks and Campbell",REF73327648,0.0,931.26,23760.73
2014-02-16,2014-02-16,Permits Licenses expense,REF79091972,42.85,0.0,23717.88
2014-02-25,2014-02-25,Business materials,REF52994712,475.16,0.0,23242.72
2014-02-26,2014-02-26,Business materials,REF69759244,597.54,0.0,22645.18
2014-02-28,2014-02-28,Project payment - Abbott-Gomez,REF58977001,0.0,898.06,23543.24
2014-02-28,2014-02-28,"Invoice payment - Nelson, Parks and Campbell",REF23518826,0.0,866.69,24409.93
2014-02-28,2014-02-28,Payment from Porter Inc,REF91299447,0.0,767.82,25177.75
2014-03-03,2014-03-03,Fuel purchase,REF17460928,415.94,0.0,24761.81
2014-03-08,2014-03-08,Business materials,REF10600996,615.63,0.0,24146.18
2014-03-08,2014-03-08,Subcontractors expense,REF32048418,788.86,0.0,23357.32
2014-03-09,2014-03-09,Permits Licenses expense,REF33449029,58.52,0.0,23298.8
2014-03-15,2014-03-15,Business insurance premium,REF74494940,198.46,0.0,23100.34
2014-03-15,2014-03-15,Invoice payment - Abbott-Gomez,REF74483792,0.0,798.54,23898.88
2014-03-15,2014-03-15,"Service payment - Nelson, Parks and Campbell",REF68248928,0.0,1260.17,25159.05
2014-03-15,2014-03-15,Business materials,REF16184317,896.42,0.0,24262.63
2014-03-15,2014-03-15,Payment from Roman-Gonzalez,REF79883488,0.0,895.13,25157.76
2014-03-15,2014-03-15,Invoice payment - Porter Inc,REF70448282,0.0,723.58,25881.34
2014-03-15,2014-03-15,"Service payment - Mullins, Buckley and Hahn",REF47297596,0.0,1092.91,26974.25
2014-03-20,2014-03-20,Equipment Rental expense,REF32378427,213.22,0.0,26761.03
2014-03-23,2014-03-23,Fuel purchase,REF31505240,236.01,0.0,26525.02
2014-03-25,2014-03-25,Business materials,REF55556999,732.38,0.0,25792.64
2014-03-26,2014-03-26,Business materials,REF12866317,742.27,0.0,25050.37
2014-03-30,2014-03-30,Project payment - Porter Inc,REF47719937,0.0,548.09,25598.46
2014-03-30,2014-03-30,Project payment - Roman-Gonzalez,REF40566508,0.0,700.0,26298.46
2014-03-30,2014-03-30,"Service payment - Mullins, Buckley and Hahn",REF49833077,0.0,670.8,26969.26
2014-03-30,2014-03-30,"Service payment - Nelson, Parks and Campbell",REF87517935,0.0,1287.14,28256.4
2014-04-01,2014-04-01,Safety Equipment expense,REF92079304,109.05,0.0,28147.35
2014-04-01,2014-04-01,Business materials,REF10475620,1298.0,0.0,26849.35
2014-04-02,2014-04-02,Fuel purchase,REF79595539,440.97,0.0,26408.38
2014-04-02,2014-04-02,Tools expense,REF36773470,68.54,0.0,26339.84
2014-04-08,2014-04-08,Fuel purchase,REF86418454,382.98,0.0,25956.86
2014-04-13,2014-04-13,Tools expense,REF36922884,148.73,0.0,25808.13
2014-04-15,2014-04-15,Service payment - Abbott-Gomez,REF98431374,0.0,1127.98,26936.11
2014-04-15,2014-04-15,Project payment - Roman-Gonzalez,REF34577127,0.0,1102.22,28038.33
2014-04-15,2014-04-15,Project payment - Porter Inc,REF66849907,0.0,800.41,28838.74
2014-04-15,2014-04-15,"Payment from Nelson, Parks and Campbell",REF61883117,0.0,1512.48,30351.22
2014-04-15,2014-04-15,"Payment from Mullins, Buckley and Hahn",REF82261272,0.0,1184.3,31535.52
2014-04-15,2014-04-15,Business insurance premium,REF80672866,238.86,0.0,31296.66
2014-04-17,2014-04-17,Fuel purchase,REF84063265,236.95,0.0,31059.71
2014-04-25,2014-04-25,Safety Equipment expense,REF82108117,26.95,0.0,31032.76
2014-04-30,2014-04-30,"Payment from Mullins, Buckley and Hahn",REF44103989,0.0,1259.14,32291.9
2014-04-30,2014-04-30,Project payment - Abbott-Gomez,REF56616508,0.0,1453.95,33745.85
2014-04-30,2014-04-30,Service payment - Porter Inc,REF45423806,0.0,831.62,34577.47
2014-04-30,2014-04-30,Permits Licenses expense,REF26631681,88.12,0.0,34489.35
2014-04-30,2014-04-30,Safety Equipment expense,REF52993576,68.25,0.0,34421.1
2014-04-30,2014-04-30,"Payment from Nelson, Parks and Campbell",REF99923554,0.0,1283.72,35704.82
2014-04-30,2014-04-30,Project payment - Roman-Gonzalez,REF69540136,0.0,1095.39,36800.21
2014-05-01,2014-05-01,Equipment Rental expense,REF92683932,841.45,0.0,35958.76
2014-05-05,2014-05-05,Fuel purchase,REF36370443,221.71,0.0,35737.05
2014-05-05,2014-05-05,Equipment Rental expense,REF71501246,459.58,0.0,35277.47
2014-05-07,2014-05-07,Fuel purchase,REF17456689,251.33,0.0,35026.14
2014-05-10,2014-05-10,Fuel purchase,REF27520932,716.44,0.0,34309.7
2014-05-11,2014-05-11,Fuel purchase,REF92512930,397.36,0.0,33912.34
2014-05-12,2014-05-12,Fuel purchase,REF86859911,266.21,0.0,33646.13
2014-05-13,2014-05-13,Permits Licenses expense,REF50326930,131.04,0.0,33515.09
2014-05-15,2014-05-15,Payment from Roman-Gonzalez,REF65000243,0.0,1436.4,34951.49
2014-05-15,2014-05-15,Business insurance premium,REF77855743,281.52,0.0,34669.97
2014-05-15,2014-05-15,Invoice payment - Abbott-Gomez,REF73158949,0.0,1657.26,36327.23
2014-05-15,2014-05-15,"Invoice payment - Mullins, Buckley and Hahn",REF47897247,0.0,1318.98,37646.21
2014-05-15,2014-05-15,"Payment from Nelson, Parks and Campbell",REF59669249,0.0,1484.78,39130.99
2014-05-17,2014-05-17,Permits Licenses expense,REF63945762,195.72,0.0,38935.27
2014-05-21,2014-05-21,Vehicle Maintenance expense,REF99377234,171.55,0.0,38763.72
2014-05-23,2014-05-23,Subcontractors expense,REF57389008,762.88,0.0,38000.84
2014-05-24,2014-05-24,Fuel purchase,REF63016028,437.01,0.0,37563.83
2014-05-26,2014-05-26,Safety Equipment expense,REF24865826,107.81,0.0,37456.02
2014-05-27,2014-05-27,Fuel purchase,REF73422082,363.71,0.0,37092.31
2014-05-28,2014-05-28,Subcontractors expense,REF17423416,1390.1,0.0,35702.21
2014-05-30,2014-05-30,Payment from Roman-Gonzalez,REF33173726,0.0,1138.63,36840.84
2014-05-30,2014-05-30,Invoice payment - Abbott-Gomez,REF75902794,0.0,1208.91,38049.75
2014-05-30,2014-05-30,"Project payment - Mullins, Buckley and Hahn",REF17100959,0.0,905.86,38955.61
2014-05-30,2014-05-30,Payment from Porter Inc,REF81215360,0.0,1023.29,39978.9
2014-05-30,2014-05-30,"Payment from Nelson, Parks and Campbell",REF54684734,0.0,1632.74,41611.64
2014-06-02,2014-06-02,Business materials,REF63708909,1339.46,0.0,40272.18
2014-06-03,2014-06-03,Fuel purchase,REF51806092,363.74,0.0,39908.44
2014-06-08,2014-06-08,Fuel purchase,REF49460695,12.55,0.0,39895.89
2014-06-10,2014-06-10,Fuel purchase,REF63041534,634.93,0.0,39260.96
2014-06-15,2014-06-15,Business insurance premium,REF29411086,258.88,0.0,39002.08
2014-06-15,2014-06-15,Payment from Porter Inc,REF67289814,0.0,1005.2,40007.28
2014-06-15,2014-06-15,Payment from Abbott-Gomez,REF93898142,0.0,1540.06,41547.34
2014-06-15,2014-06-15,"Project payment - Mullins, Buckley and Hahn",REF40051371,0.0,949.71,42497.05
2014-06-15,2014-06-15,Invoice payment - Roman-Gonzalez,REF26561683,0.0,1282.55,43779.6
2014-06-22,2014-06-22,Subcontractors expense,REF42882093,1328.4,0.0,42451.2
2014-06-29,2014-06-29,Fuel purchase,REF84451032,435.89,0.0,42015.31
2014-06-30,2014-06-30,"Invoice payment - Nelson, Parks and Campbell",REF94009563,0.0,1914.33,43929.64
2014-06-30,2014-06-30,Payment from Roman-Gonzalez,REF13828281,0.0,1144.29,45073.93
2014-06-30,2014-06-30,Payment from Porter Inc,REF58939248,0.0,790.04,45863.97
2014-06-30,2014-06-30,"Invoice payment - Mullins, Buckley and Hahn",REF83425113,0.0,1220.61,47084.58
2014-06-30,2014-06-30,Invoice payment - Abbott-Gomez,REF20857756,0.0,1608.04,48692.62
2014-07-04,2014-07-04,Safety Equipment expense,REF59837994,97.58,0.0,48595.04
2014-07-07,2014-07-07,Business materials,REF58663800,985.37,0.0,47609.67
2014-07-09,2014-07-09,Business materials,REF74668937,1161.03,0.0,46448.64
2014-07-09,2014-07-09,Fuel purchase,REF84999180,417.11,0.0,46031.53
2014-07-12,2014-07-12,Permits Licenses expense,REF29268415,83.48,0.0,45948.05
2014-07-12,2014-07-12,Fuel purchase,REF70301355,147.58,0.0,45800.47
2014-07-13,2014-07-13,Fuel purchase,REF11981995,281.49,0.0,45518.98
2014-07-15,2014-07-15,Business insurance premium,REF25351728,234.99,0.0,45283.99
2014-07-15,2014-07-15,"Project payment - Mullins, Buckley and Hahn",REF67016467,0.0,1245.92,46529.91
2014-07-15,2014-07-15,Service payment - Roman-Gonzalez,REF64032767,0.0,1221.43,47751.34
2014-07-15,2014-07-15,Invoice payment - Porter Inc,REF16062700,0.0,851.58,48602.92
2014-07-15,2014-07-15,"Project payment - Nelson, Parks and Campbell",REF89662913,0.0,1396.6,49999.52
2014-07-19,2014-07-19,Fuel purchase,REF59442878,365.9,0.0,49633.62
2014-07-19,2014-07-19,Business materials,REF49984013,790.66,0.0,48842.96
2014-07-20,2014-07-20,Safety Equipment expense,REF72445179,88.54,0.0,48754.42
2014-07-20,2014-07-20,Equipment Rental expense,REF53586132,342.25,0.0,48412.17
2014-07-30,2014-07-30,Service payment - Abbott-Gomez,REF49940311,0.0,1266.81,49678.98
2014-07-30,2014-07-30,Service payment - Roman-Gonzalez,REF83244914,0.0,1498.17,51177.15
2014-07-30,2014-07-30,"Project payment - Nelson, Parks and Campbell",REF53666122,0.0,1711.31,52888.46
2014-07-30,2014-07-30,"Project payment - Mullins, Buckley and Hahn",REF73735709,0.0,869.92,53758.38
2014-07-30,2014-07-30,Invoice payment - Porter Inc,REF35165561,0.0,826.56,54584.94
2014-08-03,2014-08-03,Fuel purchase,REF20795505,321.35,0.0,54263.59
2014-08-07,2014-08-07,Business materials,REF82813810,950.61,0.0,53312.98
2014-08-08,2014-08-08,Subcontractors expense,REF84146125,406.52,0.0,52906.46
2014-08-09,2014-08-09,Vehicle Maintenance expense,REF23334886,138.29,0.0,52768.17
2014-08-11,2014-08-11,Fuel purchase,REF64323860,428.86,0.0,52339.31
2014-08-13,2014-08-13,Subcontractors expense,REF87355534,1842.21,0.0,50497.1
2014-08-15,2014-08-15,Business insurance premium,REF58982683,235.33,0.0,50261.77
2014-08-15,2014-08-15,Project payment - Porter Inc,REF53082864,0.0,838.45,51100.22
2014-08-15,2014-08-15,Payment from Roman-Gonzalez,REF69072470,0.0,1168.09,52268.31
2014-08-15,2014-08-15,"Invoice payment - Nelson, Parks and Campbell",REF42791471,0.0,1576.58,53844.89
2014-08-15,2014-08-15,Service payment - Abbott-Gomez,REF48324796,0.0,1196.62,55041.51
2014-08-15,2014-08-15,"Invoice payment - Mullins, Buckley and Hahn",REF66611967,0.0,1189.81,56231.32
2014-08-17,2014-08-17,Business materials,REF85646245,1061.62,0.0,55169.7
2014-08-18,2014-08-18,Permits Licenses expense,REF13053996,109.12,0.0,55060.58
2014-08-21,2014-08-21,Safety Equipment expense,REF46274945,84.29,0.0,54976.29
2014-08-22,2014-08-22,Business materials,REF10381730,745.59,0.0,54230.7
2014-08-23,2014-08-23,Safety Equipment expense,REF40634648,103.42,0.0,54127.28
2014-08-27,2014-08-27,Permits Licenses expense,REF55222626,94.53,0.0,54032.75
2014-08-28,2014-08-28,Permits Licenses expense,REF39482019,151.95,0.0,53880.8
2014-08-30,2014-08-30,Business materials,REF49532351,910.5,0.0,52970.3
2014-08-30,2014-08-30,"Service payment - Nelson, Parks and Campbell",REF55489982,0.0,1155.96,54126.26
2014-08-30,2014-08-30,Project payment - Abbott-Gomez,REF15925533,0.0,1545.51,55671.77
2014-09-02,2014-09-02,Business materials,REF76201142,930.02,0.0,54741.75
2014-09-05,2014-09-05,Business materials,REF57025822,1524.67,0.0,53217.08
2014-09-09,2014-09-09,Safety Equipment expense,REF82422720,85.47,0.0,53131.61
2014-09-12,2014-09-12,Business materials,REF21010970,1235.64,0.0,51895.97
2014-09-15,2014-09-15,"Service payment - Mullins, Buckley and Hahn",REF32440764,0.0,834.39,52730.36
2014-09-15,2014-09-15,Project payment - Roman-Gonzalez,REF99236731,0.0,979.38,53709.74
2014-09-15,2014-09-15,Project payment - Porter Inc,REF27797540,0.0,927.16,54636.9
2014-09-15,2014-09-15,Service payment - Abbott-Gomez,REF98254831,0.0,1343.5,55980.4
2014-09-15,2014-09-15,Business insurance premium,REF18552450,228.62,0.0,55751.78
2014-09-15,2014-09-15,"Invoice payment - Nelson, Parks and Campbell",REF81839428,0.0,1257.51,57009.29
2014-09-16,2014-09-16,Fuel purchase,REF67430397,257.16,0.0,56752.13
2014-09-23,2014-09-23,Fuel purchase,REF83859088,294.82,0.0,56457.31
2014-09-24,2014-09-24,Equipment Rental expense,REF49582422,398.15,0.0,56059.16
2014-09-26,2014-09-26,Fuel purchase,REF47540554,505.22,0.0,55553.94
2014-09-27,2014-09-27,Business materials,REF26930987,576.76,0.0,54977.18
2014-09-29,2014-09-29,Fuel purchase,REF62217478,306.46,0.0,54670.72
2014-09-30,2014-09-30,Service payment - Porter Inc,REF34221627,0.0,706.94,55377.66
2014-09-30,2014-09-30,"Project payment - Mullins, Buckley and Hahn",REF19060294,0.0,943.71,56321.37
2014-09-30,2014-09-30,"Project payment - Nelson, Parks and Campbell",REF57520434,0.0,712.23,57033.6
2014-09-30,2014-09-30,Payment from Abbott-Gomez,REF52353361,0.0,1364.94,58398.54
2014-10-10,2014-10-10,Vehicle Maintenance expense,REF11345820,163.52,0.0,58235.02
2014-10-11,2014-10-11,Fuel purchase,REF73423776,286.89,0.0,57948.13
2014-10-12,2014-10-12,Business materials,REF95147275,490.97,0.0,57457.16
2014-10-14,2014-10-14,Fuel purchase,REF83208063,338.81,0.0,57118.35
2014-10-15,2014-10-15,Service payment - Abbott-Gomez,REF57129174,0.0,1371.81,58490.16
2014-10-15,2014-10-15,Business insurance premium,REF97437850,212.67,0.0,58277.49
2014-10-15,2014-10-15,"Payment from Mullins, Buckley and Hahn",REF98161022,0.0,1030.87,59308.36
2014-10-15,2014-10-15,Service payment - Roman-Gonzalez,REF42257890,0.0,1077.17,60385.53
2014-10-15,2014-10-15,"Invoice payment - Nelson, Parks and Campbell",REF49910027,0.0,948.07,61333.6
2014-10-15,2014-10-15,Invoice payment - Porter Inc,REF19326800,0.0,813.75,62147.35
2014-10-16,2014-10-16,Tools expense,REF27812168,174.45,0.0,61972.9
2014-10-17,2014-10-17,Fuel purchase,REF40214729,236.37,0.0,61736.53
2014-10-19,2014-10-19,Tools expense,REF15447378,93.46,0.0,61643.07
2014-10-20,2014-10-20,Fuel purchase,REF19531009,229.45,0.0,61413.62
2014-10-21,2014-10-21,Safety Equipment expense,REF71071606,64.64,0.0,61348.98
2014-10-27,2014-10-27,Vehicle Maintenance expense,REF86487344,195.53,0.0,61153.45
2014-10-27,2014-10-27,Fuel purchase,REF65515498,251.92,0.0,60901.53
2014-10-30,2014-10-30,"Payment from Mullins, Buckley and Hahn",REF86261685,0.0,1053.64,61955.17
2014-10-30,2014-10-30,Invoice payment - Roman-Gonzalez,REF58925262,0.0,1021.1,62976.27
2014-10-30,2014-10-30,"Payment from Nelson, Parks and Campbell",REF18557348,0.0,709.89,63686.16
2014-10-30,2014-10-30,Payment from Abbott-Gomez,REF36645377,0.0,979.16,64665.32
2014-10-30,2014-10-30,Project payment - Porter Inc,REF21511033,0.0,914.25,65579.57
2014-10-31,2014-10-31,Fuel purchase,REF79175865,124.61,0.0,65454.96
2014-11-08,2014-11-08,Permits Licenses expense,REF40926724,66.34,0.0,65388.62
2014-11-10,2014-11-10,Business materials,REF69999584,663.71,0.0,64724.91
2014-11-10,2014-11-10,Permits Licenses expense,REF36657287,32.22,0.0,64692.69
2014-11-11,2014-11-11,Fuel purchase,REF73393095,337.05,0.0,64355.64
2014-11-12,2014-11-12,Fuel purchase,REF95324161,156.19,0.0,64199.45
2014-11-13,2014-11-13,Fuel purchase,REF15398015,300.23,0.0,63899.22
2014-11-15,2014-11-15,"Project payment - Mullins, Buckley and Hahn",REF49125800,0.0,835.0,64734.22
2014-11-15,2014-11-15,Fuel purchase,REF89524060,341.97,0.0,64392.25
2014-11-15,2014-11-15,"Project payment - Nelson, Parks and Campbell",REF53502918,0.0,1021.79,65414.04
2014-11-15,2014-11-15,Invoice payment - Roman-Gonzalez,REF23922204,0.0,841.59,66255.63
2014-11-15,2014-11-15,Project payment - Porter Inc,REF18109445,0.0,768.44,67024.07
2014-11-15,2014-11-15,Business insurance premium,REF96005287,151.35,0.0,66872.72
2014-11-16,2014-11-16,Fuel purchase,REF16064832,227.41,0.0,66645.31
2014-11-18,2014-11-18,Business materials,REF29038389,1010.81,0.0,65634.5
2014-11-19,2014-11-19,Business materials,REF92151340,435.17,0.0,65199.33
2014-11-20,2014-11-20,Subcontractors expense,REF58210924,635.17,0.0,64564.16
2014-11-24,2014-11-24,Permits Licenses expense,REF78744206,54.55,0.0,64509.61
2014-11-26,2014-11-26,Equipment Rental expense,REF90048726,361.8,0.0,64147.81
2014-11-30,2014-11-30,"Invoice payment - Nelson, Parks and Campbell",REF83304319,0.0,901.84,65049.65
2014-11-30,2014-11-30,"Invoice payment - Mullins, Buckley and Hahn",REF72509837,0.0,747.28,65796.93
2014-11-30,2014-11-30,Payment from Porter Inc,REF85048675,0.0,562.42,66359.35
2014-11-30,2014-11-30,Payment from Roman-Gonzalez,REF96024168,0.0,881.92,67241.27
2014-11-30,2014-11-30,Service payment - Abbott-Gomez,REF18824083,0.0,919.23,68160.5
2014-12-01,2014-12-01,Fuel purchase,REF60224189,176.36,0.0,67984.14
2014-12-09,2014-12-09,Subcontractors expense,REF10568824,518.99,0.0,67465.15
2014-12-10,2014-12-10,Subcontractors expense,REF96806759,538.53,0.0,66926.62
2014-12-15,2014-12-15,Safety Equipment expense,REF92510101,45.54,0.0,66881.08
2014-12-15,2014-12-15,"Project payment - Mullins, Buckley and Hahn",REF61574573,0.0,529.56,67410.64
2014-12-15,2014-12-15,Payment from Roman-Gonzalez,REF32077849,0.0,516.71,67927.35
2014-12-15,2014-12-15,"Payment from Nelson, Parks and Campbell",REF77772628,0.0,842.56,68769.91
2014-12-15,2014-12-15,Business insurance premium,REF17724921,118.35,0.0,68651.56
2014-12-15,2014-12-15,Service payment - Porter Inc,REF14162587,0.0,350.97,69002.53
2014-12-15,2014-12-15,Invoice payment - Abbott-Gomez,REF33619982,0.0,725.45,69727.98
2014-12-17,2014-12-17,Business materials,REF78204738,204.93,0.0,69523.05
2014-12-19,2014-12-19,Fuel purchase,REF74758240,176.98,0.0,69346.07
2014-12-19,2014-12-19,Vehicle Maintenance expense,REF36299367,80.81,0.0,69265.26
2014-12-22,2014-12-22,Equipment Rental expense,REF51830850,305.2,0.0,68960.06
2014-12-23,2014-12-23,Fuel purchase,REF43278010,176.29,0.0,68783.77
2014-12-26,2014-12-26,Business materials,REF88233059,659.4,0.0,68124.37
2014-12-27,2014-12-27,Vehicle Maintenance expense,REF96806511,87.1,0.0,68037.27
2014-12-30,2014-12-30,"Project payment - Nelson, Parks and Campbell",REF35927661,0.0,710.68,68747.95
2014-12-30,2014-12-30,Project payment - Porter Inc,REF72256043,0.0,514.26,69262.21
2014-12-30,2014-12-30,Payment from Roman-Gonzalez,REF65085709,0.0,566.39,69828.6
2014-12-30,2014-12-30,"Invoice payment - Mullins, Buckley and Hahn",REF64809478,0.0,498.56,70327.16
2014-12-31,2014-12-31,Subcontractors expense,REF54342587,480.16,0.0,69847.0
2015-01-08,2015-01-08,Fuel purchase,REF47502625,175.72,0.0,69671.28
2015-01-15,2015-01-15,Business insurance premium,REF65527811,149.63,0.0,69521.65
2015-01-15,2015-01-15,Project payment - Roman-Gonzalez,REF93525408,0.0,621.58,70143.23
2015-01-15,2015-01-15,Project payment - Porter Inc,REF70202699,0.0,458.0,70601.23
2015-01-15,2015-01-15,"Project payment - Nelson, Parks and Campbell",REF24902979,0.0,758.98,71360.21
2015-01-15,2015-01-15,Invoice payment - Abbott-Gomez,REF39614937,0.0,622.93,71983.14
2015-01-18,2015-01-18,Tools expense,REF75123319,82.93,0.0,71900.21
2015-01-20,2015-01-20,Fuel purchase,REF49629890,248.0,0.0,71652.21
2015-01-22,2015-01-22,Tools expense,REF50959616,51.69,0.0,71600.52
2015-01-25,2015-01-25,Equipment Rental expense,REF46361623,309.64,0.0,71290.88
2015-01-27,2015-01-27,Equipment Rental expense,REF82691398,310.64,0.0,70980.24
2015-01-29,2015-01-29,Fuel purchase,REF19586114,221.16,0.0,70759.08
2015-01-30,2015-01-30,Project payment - Abbott-Gomez,REF81130957,0.0,650.87,71409.95
2015-01-30,2015-01-30,"Project payment - Mullins, Buckley and Hahn",REF34779048,0.0,617.94,72027.89
2015-01-30,2015-01-30,Payment from Porter Inc,REF21736077,0.0,606.73,72634.62
2015-01-30,2015-01-30,"Payment from Nelson, Parks and Campbell",REF10234623,0.0,873.09,73507.71
2015-01-30,2015-01-30,Service payment - Roman-Gonzalez,REF69783493,0.0,602.49,74110.2
2015-02-08,2015-02-08,Tools expense,REF55965644,108.88,0.0,74001.32
2015-02-12,2015-02-12,Business materials,REF14159371,765.75,0.0,73235.57
2015-02-15,2015-02-15,Business insurance premium,REF41758517,148.04,0.0,73087.53
2015-02-15,2015-02-15,Service payment - Roman-Gonzalez,REF90279181,0.0,823.26,73910.79
2015-02-15,2015-02-15,"Service payment - Nelson, Parks and Campbell",REF45903220,0.0,976.81,74887.6
2015-02-15,2015-02-15,Invoice payment - Porter Inc,REF68145052,0.0,533.79,75421.39
2015-02-15,2015-02-15,Payment from Abbott-Gomez,REF45923727,0.0,942.8,76364.19
2015-02-15,2015-02-15,"Invoice payment - Mullins, Buckley and Hahn",REF50575404,0.0,661.28,77025.47
2015-02-16,2015-02-16,Business materials,REF83348694,666.34,0.0,76359.13
2015-02-19,2015-02-19,Tools expense,REF49105082,63.29,0.0,76295.84
2015-02-19,2015-02-19,Fuel purchase,REF28141846,261.56,0.0,76034.28
2015-02-19,2015-02-19,Permits Licenses expense,REF32353601,93.79,0.0,75940.49
2015-02-22,2015-02-22,Subcontractors expense,REF10705232,973.88,0.0,74966.61
2015-02-23,2015-02-23,Safety Equipment expense,REF36365601,33.85,0.0,74932.76
2015-02-28,2015-02-28,Permits Licenses expense,REF91427684,55.45,0.0,74877.31
2015-02-28,2015-02-28,"Project payment - Nelson, Parks and Campbell",REF80812790,0.0,786.14,75663.45
2015-02-28,2015-02-28,"Project payment - Mullins, Buckley and Hahn",REF44277028,0.0,830.61,76494.06
2015-02-28,2015-02-28,Project payment - Porter Inc,REF93469907,0.0,450.33,76944.39
2015-02-28,2015-02-28,Project payment - Roman-Gonzalez,REF28289844,0.0,816.85,77761.24
2015-03-03,2015-03-03,Fuel purchase,REF53409938,418.44,0.0,77342.8
2015-03-05,2015-03-05,Subcontractors expense,REF85003010,643.35,0.0,76699.45
2015-03-06,2015-03-06,Vehicle Maintenance expense,REF35727384,151.59,0.0,76547.86
2015-03-07,2015-03-07,Fuel purchase,REF67241180,402.32,0.0,76145.54
2015-03-08,2015-03-08,Fuel purchase,REF22902601,295.32,0.0,75850.22
2015-03-09,2015-03-09,Business materials,REF91480695,601.23,0.0,75248.99
2015-03-10,2015-03-10,Permits Licenses expense,REF83605807,58.06,0.0,75190.93
2015-03-15,2015-03-15,"Invoice payment - Mullins, Buckley and Hahn",REF76676141,0.0,1087.71,76278.64
2015-03-15,2015-03-15,Project payment - Porter Inc,REF21410690,0.0,965.34,77243.98
2015-03-15,2015-03-15,Business insurance premium,REF34708783,208.48,0.0,77035.5
2015-03-16,2015-03-16,Safety Equipment expense,REF16222201,57.32,0.0,76978.18
2015-03-23,2015-03-23,Permits Licenses expense,REF61647239,99.46,0.0,76878.72
2015-03-23,2015-03-23,Business materials,REF55090450,1181.08,0.0,75697.64
2015-03-25,2015-03-25,Subcontractors expense,REF35991329,1159.09,0.0,74538.55
2015-03-25,2015-03-25,Business materials,REF50563928,1343.26,0.0,73195.29
2015-03-26,2015-03-26,Equipment Rental expense,REF81960965,428.3,0.0,72766.99
2015-03-26,2015-03-26,Business materials,REF87095788,982.65,0.0,71784.34
2015-03-29,2015-03-29,Business materials,REF84122727,363.28,0.0,71421.06
2015-03-30,2015-03-30,"Project payment - Nelson, Parks and Campbell",REF97181540,0.0,1412.63,72833.69
2015-03-30,2015-03-30,Service payment - Abbott-Gomez,REF20455528,0.0,899.61,73733.3
2015-03-30,2015-03-30,"Project payment - Mullins, Buckley and Hahn",REF75268904,0.0,841.19,74574.49
2015-04-06,2015-04-06,Fuel purchase,REF60957414,285.88,0.0,74288.61
2015-04-08,2015-04-08,Vehicle Maintenance expense,REF72575676,160.18,0.0,74128.43
2015-04-11,2015-04-11,Vehicle Maintenance expense,REF18444480,202.8,0.0,73925.63
2015-04-14,2015-04-14,Business materials,REF96810014,936.35,0.0,72989.28
2015-04-15,2015-04-15,Payment from Abbott-Gomez,REF64249442,0.0,1115.09,74104.37
2015-04-15,2015-04-15,Business insurance premium,REF62586159,227.59,0.0,73876.78
2015-04-15,2015-04-15,Invoice payment - Porter Inc,REF89170468,0.0,767.61,74644.39
2015-04-15,2015-04-15,"Payment from Nelson, Parks and Campbell",REF17306091,0.0,1237.36,75881.75
2015-04-15,2015-04-15,"Invoice payment - Mullins, Buckley and Hahn",REF91666660,0.0,1045.62,76927.37
2015-04-18,2015-04-18,Equipment Rental expense,REF85995385,465.41,0.0,76461.96
2015-04-20,2015-04-20,Permits Licenses expense,REF63565022,119.55,0.0,76342.41
2015-04-20,2015-04-20,Business materials,REF23457897,1349.22,0.0,74993.19
2015-04-25,2015-04-25,Safety Equipment expense,REF32161712,59.8,0.0,74933.39
2015-04-30,2015-04-30,Service payment - Roman-Gonzalez,REF27554619,0.0,943.09,75876.48
2015-04-30,2015-04-30,Invoice payment - Porter Inc,REF29323986,0.0,1057.28,76933.76
2015-04-30,2015-04-30,"Project payment - Nelson, Parks and Campbell",REF33095261,0.0,1559.82,78493.58
2015-04-30,2015-04-30,"Payment from Mullins, Buckley and Hahn",REF91094858,0.0,1022.5,79516.08
2015-04-30,2015-04-30,Payment from Abbott-Gomez,REF79546113,0.0,1654.49,81170.57
2015-05-01,2015-05-01,Business materials,REF13650393,1162.97,0.0,80007.6
2015-05-04,2015-05-04,Tools expense,REF62104531,177.78,0.0,79829.82
2015-05-08,2015-05-08,Permits Licenses expense,REF44306639,97.94,0.0,79731.88
2015-05-14,2015-05-14,Business materials,REF35336874,711.22,0.0,79020.66
2015-05-15,2015-05-15,Business insurance premium,REF97628304,283.4,0.0,78737.26
2015-05-15,2015-05-15,Payment from Abbott-Gomez,REF71776071,0.0,1704.1,80441.36
2015-05-15,2015-05-15,Service payment - Porter Inc,REF39961319,0.0,1054.89,81496.25
2015-05-15,2015-05-15,Service payment - Roman-Gonzalez,REF80264431,0.0,1416.84,82913.09
2015-05-15,2015-05-15,"Payment from Mullins, Buckley and Hahn",REF86362418,0.0,871.91,83785.0
2015-05-15,2015-05-15,"Project payment - Nelson, Parks and Campbell",REF85646865,0.0,1630.18,85415.18
2015-05-29,2015-05-29,Business materials,REF41927644,1304.75,0.0,84110.43
2015-05-30,2015-05-30,"Service payment - Mullins, Buckley and Hahn",REF77353634,0.0,1102.16,85212.59
2015-05-30,2015-05-30,"Payment from Nelson, Parks and Campbell",REF67215371,0.0,1449.91,86662.5
2015-05-30,2015-05-30,Project payment - Porter Inc,REF19997768,0.0,1222.29,87884.79
2015-05-30,2015-05-30,Invoice payment - Roman-Gonzalez,REF42927541,0.0,796.11,88680.9
2015-05-30,2015-05-30,Service payment - Abbott-Gomez,REF77993461,0.0,1483.59,90164.49
2015-05-31,2015-05-31,Safety Equipment expense,REF49474955,109.67,0.0,90054.82
2015-05-31,2015-05-31,Vehicle Maintenance expense,REF98945455,173.2,0.0,89881.62
2015-06-02,2015-06-02,Subcontractors expense,REF98007267,861.75,0.0,89019.87
2015-06-03,2015-06-03,Permits Licenses expense,REF80134050,135.0,0.0,88884.87
2015-06-05,2015-06-05,Subcontractors expense,REF58852304,2099.36,0.0,86785.51
2015-06-06,2015-06-06,Business materials,REF14617811,1446.3,0.0,85339.21
2015-06-08,2015-06-08,Fuel purchase,REF80420750,176.23,0.0,85162.98
2015-06-08,2015-06-08,Safety Equipment expense,REF64575213,93.49,0.0,85069.49
2015-06-10,2015-06-10,Tools expense,REF36884481,149.33,0.0,84920.16
2015-06-15,2015-06-15,"Payment from Nelson, Parks and Campbell",REF75654871,0.0,1364.11,86284.27
2015-06-15,2015-06-15,Business insurance premium,REF85734703,273.35,0.0,86010.92
2015-06-15,2015-06-15,Service payment - Abbott-Gomez,REF34102364,0.0,1375.62,87386.54
2015-06-15,2015-06-15,Project payment - Porter Inc,REF72289084,0.0,938.78,88325.32
2015-06-15,2015-06-15,"Payment from Mullins, Buckley and Hahn",REF30025721,0.0,1296.42,89621.74
2015-06-15,2015-06-15,Invoice payment - Roman-Gonzalez,REF39438071,0.0,1020.91,90642.65
2015-06-23,2015-06-23,Business materials,REF27785979,972.61,0.0,89670.04
2015-06-23,2015-06-23,Vehicle Maintenance expense,REF19330212,196.51,0.0,89473.53
2015-06-26,2015-06-26,Fuel purchase,REF34572209,392.64,0.0,89080.89
2015-06-29,2015-06-29,Fuel purchase,REF70291897,280.59,0.0,88800.3
2015-06-30,2015-06-30,Project payment - Abbott-Gomez,REF72522210,0.0,1649.62,90449.92
2015-06-30,2015-06-30,Project payment - Porter Inc,REF26166446,0.0,1067.96,91517.88
2015-06-30,2015-06-30,Invoice payment - Roman-Gonzalez,REF82999239,0.0,1533.47,93051.35
2015-06-30,2015-06-30,"Invoice payment - Mullins, Buckley and Hahn",REF90093677,0.0,931.23,93982.58
2015-06-30,2015-06-30,"Payment from Nelson, Parks and Campbell",REF53683115,0.0,1790.04,95772.62
2015-07-04,2015-07-04,Vehicle Maintenance expense,REF46532535,220.58,0.0,95552.04
2015-07-07,2015-07-07,Subcontractors expense,REF29691598,1051.2,0.0,94500.84
2015-07-08,2015-07-08,Fuel purchase,REF11522483,333.79,0.0,94167.05
2015-07-12,2015-07-12,Fuel purchase,REF72232752,473.67,0.0,93693.38
2015-07-12,2015-07-12,Safety Equipment expense,REF39083048,106.53,0.0,93586.85
2015-07-15,2015-07-15,Business insurance premium,REF66081083,237.73,0.0,93349.12
2015-07-15,2015-07-15,Payment from Roman-Gonzalez,REF14869109,0.0,1383.63,94732.75
2015-07-15,2015-07-15,"Project payment - Mullins, Buckley and Hahn",REF28349426,0.0,970.37,95703.12
2015-07-15,2015-07-15,"Payment from Nelson, Parks and Campbell",REF41761912,0.0,1047.61,96750.73
2015-07-15,2015-07-15,Invoice payment - Porter Inc,REF51708993,0.0,921.71,97672.44
2015-07-15,2015-07-15,Service payment - Abbott-Gomez,REF99571936,0.0,1285.84,98958.28
2015-07-18,2015-07-18,Tools expense,REF70126237,114.07,0.0,98844.21
2015-07-24,2015-07-24,Business materials,REF90011142,919.28,0.0,97924.93
2015-07-25,2015-07-25,Business materials,REF34613068,699.83,0.0,97225.1
2015-07-27,2015-07-27,Fuel purchase,REF17463781,434.75,0.0,96790.35
2015-07-30,2015-07-30,Service payment - Abbott-Gomez,REF44143119,0.0,1486.36,98276.71
2015-07-30,2015-07-30,Payment from Porter Inc,REF38662993,0.0,880.38,99157.09
2015-07-30,2015-07-30,"Invoice payment - Mullins, Buckley and Hahn",REF51312510,0.0,1060.17,100217.26
2015-07-30,2015-07-30,Project payment - Roman-Gonzalez,REF16443594,0.0,1404.24,101621.5
2015-07-30,2015-07-30,"Project payment - Nelson, Parks and Campbell",REF99727266,0.0,1132.57,102754.07
2015-08-07,2015-08-07,Fuel purchase,REF82272120,395.66,0.0,102358.41
2015-08-09,2015-08-09,Business materials,REF28892275,1217.64,0.0,101140.77
2015-08-10,2015-08-10,Fuel purchase,REF70933056,411.31,0.0,100729.46
2015-08-11,2015-08-11,Fuel purchase,REF63260226,462.79,0.0,100266.67
2015-08-12,2015-08-12,Tools expense,REF16872198,154.0,0.0,100112.67
2015-08-14,2015-08-14,Fuel purchase,REF24341587,389.21,0.0,99723.46
2015-08-15,2015-08-15,Payment from Roman-Gonzalez,REF79981556,0.0,1325.91,101049.37
2015-08-15,2015-08-15,Business insurance premium,REF73248388,236.51,0.0,100812.86
2015-08-15,2015-08-15,"Project payment - Mullins, Buckley and Hahn",REF49453230,0.0,946.78,101759.64
2015-08-15,2015-08-15,Invoice payment - Abbott-Gomez,REF53674286,0.0,1969.58,103729.22
2015-08-15,2015-08-15,Project payment - Porter Inc,REF19466858,0.0,715.43,104444.65
2015-08-18,2015-08-18,Business materials,REF70996578,517.41,0.0,103927.24
2015-08-22,2015-08-22,Business materials,REF99742211,1508.88,0.0,102418.36
2015-08-23,2015-08-23,Fuel purchase,REF77589836,21.16,0.0,102397.2
2015-08-27,2015-08-27,Business materials,REF47903990,936.97,0.0,101460.23
2015-08-30,2015-08-30,Business materials,REF25879324,1333.89,0.0,100126.34
2015-08-30,2015-08-30,Payment from Abbott-Gomez,REF30800796,0.0,1442.72,101569.06
2015-08-30,2015-08-30,Payment from Porter Inc,REF70888236,0.0,682.86,102251.92
2015-08-30,2015-08-30,"Invoice payment - Nelson, Parks and Campbell",REF33234962,0.0,1203.87,103455.79
2015-08-30,2015-08-30,Service payment - Roman-Gonzalez,REF70477257,0.0,1309.25,104765.04
2015-09-04,2015-09-04,Business materials,REF60187892,1166.97,0.0,103598.07
2015-09-06,2015-09-06,Tools expense,REF88750286,90.91,0.0,103507.16
2015-09-13,2015-09-13,Fuel purchase,REF36754043,522.54,0.0,102984.62
2015-09-13,2015-09-13,Vehicle Maintenance expense,REF73130083,220.44,0.0,102764.18
2015-09-14,2015-09-14,Business materials,REF25622925,1181.2,0.0,101582.98
2015-09-15,2015-09-15,Project payment - Porter Inc,REF11998993,0.0,686.48,102269.46
2015-09-15,2015-09-15,Business insurance premium,REF11537424,234.31,0.0,102035.15
2015-09-15,2015-09-15,"Service payment - Nelson, Parks and Campbell",REF77869441,0.0,1210.48,103245.63
2015-09-15,2015-09-15,Project payment - Roman-Gonzalez,REF65994838,0.0,1207.11,104452.74
2015-09-15,2015-09-15,"Project payment - Mullins, Buckley and Hahn",REF83563688,0.0,1116.24,105568.98
2015-09-15,2015-09-15,Fuel purchase,REF43146151,381.28,0.0,105187.7
2015-09-17,2015-09-17,Business materials,REF93356328,982.55,0.0,104205.15
2015-09-20,2015-09-20,Tools expense,REF23320937,170.44,0.0,104034.71
2015-09-21,2015-09-21,Business materials,REF29639500,1218.78,0.0,102815.93
2015-09-21,2015-09-21,Permits Licenses expense,REF11044551,61.34,0.0,102754.59
2015-09-22,2015-09-22,Subcontractors expense,REF25511555,1299.23,0.0,101455.36
2015-09-23,2015-09-23,Safety Equipment expense,REF16636707,27.14,0.0,101428.22
2015-09-23,2015-09-23,Fuel purchase,REF47339570,542.63,0.0,100885.59
2015-09-27,2015-09-27,Business materials,REF74304213,811.54,0.0,100074.05
2015-09-30,2015-09-30,Invoice payment - Porter Inc,REF55812329,0.0,869.06,100943.11
2015-09-30,2015-09-30,Invoice payment - Roman-Gonzalez,REF69674893,0.0,864.99,101808.1
2015-09-30,2015-09-30,Business materials,REF79743352,848.11,0.0,100959.99
2015-09-30,2015-09-30,Project payment - Abbott-Gomez,REF56511950,0.0,1052.29,102012.28
2015-09-30,2015-09-30,"Project payment - Nelson, Parks and Campbell",REF33910413,0.0,1477.8,103490.08
2015-09-30,2015-09-30,"Project payment - Mullins, Buckley and Hahn",REF68736293,0.0,1094.15,104584.23
2015-10-01,2015-10-01,Equipment Rental expense,REF85874364,356.25,0.0,104227.98
2015-10-02,2015-10-02,Subcontractors expense,REF99777823,748.69,0.0,103479.29
2015-10-03,2015-10-03,Tools expense,REF72298187,118.91,0.0,103360.38
2015-10-05,2015-10-05,Fuel purchase,REF34720757,266.07,0.0,103094.31
2015-10-06,2015-10-06,Business materials,REF16865597,780.91,0.0,102313.4
2015-10-07,2015-10-07,Fuel purchase,REF10040144,315.0,0.0,101998.4
2015-10-08,2015-10-08,Safety Equipment expense,REF63485375,98.11,0.0,101900.29
2015-10-08,2015-10-08,Business materials,REF41933311,536.08,0.0,101364.21
2015-10-09,2015-10-09,Business materials,REF15657471,562.46,0.0,100801.75
2015-10-10,2015-10-10,Vehicle Maintenance expense,REF44350095,179.39,0.0,100622.36
2015-10-11,2015-10-11,Tools expense,REF61863538,112.26,0.0,100510.1
2015-10-12,2015-10-12,Permits Licenses expense,REF62416945,72.97,0.0,100437.13
2015-10-12,2015-10-12,Equipment Rental expense,REF45953449,280.85,0.0,100156.28
2015-10-15,2015-10-15,"Service payment - Nelson, Parks and Campbell",REF88886963,0.0,1079.73,101236.01
2015-10-15,2015-10-15,Project payment - Roman-Gonzalez,REF59656323,0.0,669.48,101905.49
2015-10-15,2015-10-15,Invoice payment - Porter Inc,REF10896686,0.0,694.74,102600.23
2015-10-15,2015-10-15,Business insurance premium,REF87426424,214.45,0.0,102385.78
2015-10-15,2015-10-15,"Project payment - Mullins, Buckley and Hahn",REF15804897,0.0,757.66,103143.44
2015-10-24,2015-10-24,Fuel purchase,REF27066140,319.22,0.0,102824.22
2015-10-26,2015-10-26,Fuel purchase,REF92975980,300.35,0.0,102523.87
2015-10-28,2015-10-28,Equipment Rental expense,REF47103527,304.79,0.0,102219.08
2015-10-29,2015-10-29,Fuel purchase,REF26131374,304.89,0.0,101914.19
2015-10-29,2015-10-29,Vehicle Maintenance expense,REF18624724,83.54,0.0,101830.65
2015-10-30,2015-10-30,Payment from Abbott-Gomez,REF76377018,0.0,1052.58,102883.23
2015-10-30,2015-10-30,Invoice payment - Roman-Gonzalez,REF46762649,0.0,1084.61,103967.84
2015-10-30,2015-10-30,"Project payment - Nelson, Parks and Campbell",REF27249880,0.0,1224.4,105192.24
2015-10-30,2015-10-30,"Payment from Mullins, Buckley and Hahn",REF59524609,0.0,714.8,105907.04
2015-10-30,2015-10-30,Service payment - Porter Inc,REF30441994,0.0,763.53,106670.57
2015-11-01,2015-11-01,Fuel purchase,REF10029723,318.11,0.0,106352.46
2015-11-03,2015-11-03,Vehicle Maintenance expense,REF44514773,124.76,0.0,106227.7
2015-11-04,2015-11-04,Permits Licenses expense,REF90698063,55.6,0.0,106172.1
2015-11-04,2015-11-04,Fuel purchase,REF40410159,244.59,0.0,105927.51
2015-11-06,2015-11-06,Business materials,REF95200317,572.36,0.0,105355.15
2015-11-14,2015-11-14,Business materials,REF34066841,827.5,0.0,104527.65
2015-11-15,2015-11-15,Invoice payment - Abbott-Gomez,REF15039711,0.0,934.85,105462.5
2015-11-15,2015-11-15,Payment from Porter Inc,REF36508722,0.0,651.2,106113.7
2015-11-15,2015-11-15,"Invoice payment - Nelson, Parks and Campbell",REF54800076,0.0,790.22,106903.92
2015-11-15,2015-11-15,Business insurance premium,REF18938841,142.58,0.0,106761.34
2015-11-15,2015-11-15,"Project payment - Mullins, Buckley and Hahn",REF55710370,0.0,608.05,107369.39
2015-11-21,2015-11-21,Business materials,REF27078763,168.85,0.0,107200.54
2015-11-24,2015-11-24,Business materials,REF84931688,761.6,0.0,106438.94
2015-11-24,2015-11-24,Permits Licenses expense,REF41389165,53.03,0.0,106385.91
2015-11-30,2015-11-30,Payment from Porter Inc,REF86285654,0.0,660.8,107046.71
2015-11-30,2015-11-30,Project payment - Abbott-Gomez,REF79919408,0.0,813.43,107860.14
2015-11-30,2015-11-30,Invoice payment - Roman-Gonzalez,REF52118568,0.0,917.42,108777.56
2015-12-01,2015-12-01,Equipment Rental expense,REF71573173,167.27,0.0,108610.29
2015-12-04,2015-12-04,Tools expense,REF42383102,48.11,0.0,108562.18
2015-12-07,2015-12-07,Permits Licenses expense,REF74449611,59.33,0.0,108502.85
2015-12-11,2015-12-11,Business materials,REF43924428,503.73,0.0,107999.12
2015-12-14,2015-12-14,Subcontractors expense,REF98377901,489.49,0.0,107509.63
2015-12-15,2015-12-15,Business insurance premium,REF17676143,116.19,0.0,107393.44
2015-12-15,2015-12-15,"Service payment - Mullins, Buckley and Hahn",REF87484175,0.0,559.11,107952.55
2015-12-15,2015-12-15,Service payment - Roman-Gonzalez,REF12322556,0.0,497.59,108450.14
2015-12-15,2015-12-15,Service payment - Abbott-Gomez,REF94454140,0.0,432.5,108882.64
2015-12-15,2015-12-15,Project payment - Porter Inc,REF74139748,0.0,464.76,109347.4
2015-12-16,2015-12-16,Subcontractors expense,REF76968538,471.2,0.0,108876.2
2015-12-18,2015-12-18,Safety Equipment expense,REF16428199,57.22,0.0,108818.98
2015-12-19,2015-12-19,Equipment Rental expense,REF57841235,270.5,0.0,108548.48
2015-12-19,2015-12-19,Fuel purchase,REF34710099,222.06,0.0,108326.42
2015-12-25,2015-12-25,Fuel purchase,REF97869913,192.24,0.0,108134.18
2015-12-26,2015-12-26,Fuel purchase,REF36865572,267.26,0.0,107866.92
2015-12-29,2015-12-29,Safety Equipment expense,REF83392529,49.87,0.0,107817.05
2015-12-30,2015-12-30,"Invoice payment - Nelson, Parks and Campbell",REF52106525,0.0,749.83,108566.88
2015-12-30,2015-12-30,Equipment Rental expense,REF86986189,253.42,0.0,108313.46
2015-12-30,2015-12-30,Service payment - Porter Inc,REF87785538,0.0,489.85,108803.31
2015-12-30,2015-12-30,"Project payment - Mullins, Buckley and Hahn",REF33478614,0.0,518.45,109321.76
2015-12-30,2015-12-30,Payment from Abbott-Gomez,REF93590301,0.0,462.64,109784.4
2015-12-30,2015-12-30,Invoice payment - Roman-Gonzalez,REF69999602,0.0,607.33,110391.73
2015-12-31,2015-12-31,Permits Licenses expense,REF46128585,50.19,0.0,110341.54
2015-12-31,2015-12-31,Business materials,REF61466890,520.74,0.0,109820.8
2016-01-01,2016-01-01,Tools expense,REF17080537,125.09,0.0,109695.71
2016-01-02,2016-01-02,Vehicle Maintenance expense,REF26129182,127.98,0.0,109567.73
2016-01-04,2016-01-04,Fuel purchase,REF81385230,224.51,0.0,109343.22
2016-01-04,2016-01-04,Permits Licenses expense,REF68138541,44.33,0.0,109298.89
2016-01-06,2016-01-06,Fuel purchase,REF24569394,243.39,0.0,109055.5
2016-01-07,2016-01-07,Fuel purchase,REF84089585,141.04,0.0,108914.46
2016-01-07,2016-01-07,Safety Equipment expense,REF67676229,62.81,0.0,108851.65
2016-01-08,2016-01-08,Tools expense,REF35108663,60.63,0.0,108791.02
2016-01-08,2016-01-08,Fuel purchase,REF83939831,249.21,0.0,108541.81
2016-01-10,2016-01-10,Fuel purchase,REF34222363,342.92,0.0,108198.89
2016-01-10,2016-01-10,Business materials,REF18955061,684.5,0.0,107514.39
2016-01-14,2016-01-14,Fuel purchase,REF12023586,196.63,0.0,107317.76
2016-01-15,2016-01-15,Invoice payment - Abbott-Gomez,REF31902820,0.0,912.73,108230.49
2016-01-15,2016-01-15,Business insurance premium,REF45802678,145.02,0.0,108085.47
2016-01-15,2016-01-15,"Project payment - Nelson, Parks and Campbell",REF12775527,0.0,604.7,108690.17
2016-01-15,2016-01-15,Invoice payment - Roman-Gonzalez,REF88591097,0.0,693.94,109384.11
2016-01-15,2016-01-15,Project payment - Porter Inc,REF24125424,0.0,420.13,109804.24
2016-01-15,2016-01-15,"Payment from Mullins, Buckley and Hahn",REF21208514,0.0,500.68,110304.92
2016-01-22,2016-01-22,Equipment Rental expense,REF77675018,261.82,0.0,110043.1
2016-01-26,2016-01-26,Fuel purchase,REF42220595,432.83,0.0,109610.27
2016-01-27,2016-01-27,Permits Licenses expense,REF64778661,56.38,0.0,109553.89
2016-01-27,2016-01-27,Business materials,REF57573905,581.3,0.0,108972.59
2016-01-27,2016-01-27,Fuel purchase,REF18057418,190.47,0.0,108782.12
2016-01-30,2016-01-30,"Project payment - Nelson, Parks and Campbell",REF92922892,0.0,912.87,109694.99
2016-01-30,2016-01-30,Project payment - Abbott-Gomez,REF39418678,0.0,757.16,110452.15
2016-01-30,2016-01-30,Payment from Porter Inc,REF14745296,0.0,640.58,111092.73
2016-01-30,2016-01-30,"Project payment - Mullins, Buckley and Hahn",REF92653422,0.0,589.43,111682.16
2016-01-30,2016-01-30,Business materials,REF40198402,474.37,0.0,111207.79
2016-01-30,2016-01-30,Project payment - Roman-Gonzalez,REF19849376,0.0,657.93,111865.72
2016-01-31,2016-01-31,Permits Licenses expense,REF68871084,94.72,0.0,111771.0
2016-01-31,2016-01-31,Vehicle Maintenance expense,REF26534856,100.59,0.0,111670.41
2016-02-04,2016-02-04,Business materials,REF12031261,824.34,0.0,110846.07
2016-02-07,2016-02-07,Fuel purchase,REF26190336,323.4,0.0,110522.67
2016-02-10,2016-02-10,Vehicle Maintenance expense,REF33925387,162.22,0.0,110360.45
2016-02-15,2016-02-15,Service payment - Porter Inc,REF97777378,0.0,572.49,110932.94
2016-02-15,2016-02-15,Service payment - Roman-Gonzalez,REF72683256,0.0,629.49,111562.43
2016-02-15,2016-02-15,"Payment from Mullins, Buckley and Hahn",REF37873019,0.0,752.83,112315.26
2016-02-15,2016-02-15,"Service payment - Nelson, Parks and Campbell",REF72267650,0.0,1020.68,113335.94
2016-02-15,2016-02-15,Equipment Rental expense,REF63075943,350.15,0.0,112985.79
2016-02-15,2016-02-15,Payment from Abbott-Gomez,REF88425713,0.0,1051.46,114037.25
2016-02-15,2016-02-15,Business insurance premium,REF82311773,152.87,0.0,113884.38
2016-02-16,2016-02-16,Fuel purchase,REF13351127,192.48,0.0,113691.9
2016-02-19,2016-02-19,Permits Licenses expense,REF37693924,78.39,0.0,113613.51
2016-02-21,2016-02-21,Subcontractors expense,REF27914261,767.73,0.0,112845.78
2016-02-28,2016-02-28,Service payment - Abbott-Gomez,REF14975144,0.0,630.07,113475.85
2016-02-28,2016-02-28,"Invoice payment - Mullins, Buckley and Hahn",REF58327991,0.0,878.96,114354.81
2016-02-28,2016-02-28,"Service payment - Nelson, Parks and Campbell",REF32189459,0.0,1135.27,115490.08
2016-02-28,2016-02-28,Service payment - Porter Inc,REF57482991,0.0,771.6,116261.68
2016-02-28,2016-02-28,Project payment - Roman-Gonzalez,REF20904479,0.0,760.67,117022.35
2016-03-01,2016-03-01,Business materials,REF34415891,535.67,0.0,116486.68
2016-03-02,2016-03-02,Business materials,REF33234098,833.9,0.0,115652.78
2016-03-06,2016-03-06,Tools expense,REF53877823,114.04,0.0,115538.74
2016-03-08,2016-03-08,Business materials,REF95230567,1047.29,0.0,114491.45
2016-03-12,2016-03-12,Fuel purchase,REF49272922,375.62,0.0,114115.83
2016-03-15,2016-03-15,Payment from Porter Inc,REF82166948,0.0,747.11,114862.94
2016-03-15,2016-03-15,Payment from Roman-Gonzalez,REF62710343,0.0,814.24,115677.18
2016-03-15,2016-03-15,Business insurance premium,REF54970785,190.08,0.0,115487.1
2016-03-15,2016-03-15,Payment from Abbott-Gomez,REF67110861,0.0,987.62,116474.72
2016-03-15,2016-03-15,"Project payment - Nelson, Parks and Campbell",REF36644110,0.0,705.31,117180.03
2016-03-15,2016-03-15,"Invoice payment - Mullins, Buckley and Hahn",REF23554361,0.0,1014.16,118194.19
2016-03-18,2016-03-18,Business materials,REF27330338,899.06,0.0,117295.13
2016-03-19,2016-03-19,Permits Licenses expense,REF10343893,138.76,0.0,117156.37
2016-03-19,2016-03-19,Business materials,REF37966866,865.96,0.0,116290.41
2016-03-20,2016-03-20,Fuel purchase,REF11878043,422.73,0.0,115867.68
2016-03-21,2016-03-21,Tools expense,REF77788970,126.67,0.0,115741.01
2016-03-24,2016-03-24,Vehicle Maintenance expense,REF43834686,195.45,0.0,115545.56
2016-03-25,2016-03-25,Permits Licenses expense,REF79450466,88.84,0.0,115456.72
2016-03-25,2016-03-25,Subcontractors expense,REF69871619,1645.11,0.0,113811.61
2016-03-28,2016-03-28,Permits Licenses expense,REF79990727,98.5,0.0,113713.11
2016-03-29,2016-03-29,Permits Licenses expense,REF89107268,98.74,0.0,113614.37
2016-03-29,2016-03-29,Business materials,REF44792382,702.6,0.0,112911.77
2016-03-30,2016-03-30,Service payment - Abbott-Gomez,REF57516509,0.0,1243.0,114154.77
2016-03-30,2016-03-30,Project payment - Roman-Gonzalez,REF18644481,0.0,865.36,115020.13
2016-03-30,2016-03-30,Invoice payment - Porter Inc,REF90953400,0.0,820.65,115840.78
2016-03-30,2016-03-30,"Payment from Mullins, Buckley and Hahn",REF74243831,0.0,1013.43,116854.21
2016-03-30,2016-03-30,"Invoice payment - Nelson, Parks and Campbell",REF45092739,0.0,1089.03,117943.24
2016-03-31,2016-03-31,Equipment Rental expense,REF28301780,377.05,0.0,117566.19
2016-04-03,2016-04-03,Fuel purchase,REF98242883,463.49,0.0,117102.7
2016-04-06,2016-04-06,Fuel purchase,REF90644633,475.41,0.0,116627.29
2016-04-09,2016-04-09,Subcontractors expense,REF45356958,589.96,0.0,116037.33
2016-04-12,2016-04-12,Business materials,REF62271046,764.85,0.0,115272.48
2016-04-12,2016-04-12,Vehicle Maintenance expense,REF98840585,180.28,0.0,115092.2
2016-04-12,2016-04-12,Fuel purchase,REF41941329,336.93,0.0,114755.27
2016-04-15,2016-04-15,"Project payment - Mullins, Buckley and Hahn",REF85830516,0.0,1067.99,115823.26
2016-04-15,2016-04-15,"Payment from Nelson, Parks and Campbell",REF57898987,0.0,1305.35,117128.61
2016-04-15,2016-04-15,Business insurance premium,REF51620533,229.8,0.0,116898.81
2016-04-15,2016-04-15,Business materials,REF56560170,909.05,0.0,115989.76
2016-04-15,2016-04-15,Payment from Roman-Gonzalez,REF73209250,0.0,1137.57,117127.33
2016-04-15,2016-04-15,Project payment - Abbott-Gomez,REF87942034,0.0,1604.08,118731.41
2016-04-15,2016-04-15,Project payment - Porter Inc,REF14956040,0.0,797.1,119528.51
2016-04-16,2016-04-16,Subcontractors expense,REF97535733,1270.22,0.0,118258.29
2016-04-18,2016-04-18,Business materials,REF49388670,1069.47,0.0,117188.82
2016-04-19,2016-04-19,Tools expense,REF54306344,144.37,0.0,117044.45
2016-04-21,2016-04-21,Subcontractors expense,REF90560421,664.96,0.0,116379.49
2016-04-22,2016-04-22,Tools expense,REF15995271,117.86,0.0,116261.63
2016-04-23,2016-04-23,Business materials,REF76414441,969.09,0.0,115292.54
2016-04-25,2016-04-25,Business materials,REF54886593,914.43,0.0,114378.11
2016-04-27,2016-04-27,Fuel purchase,REF11698665,325.58,0.0,114052.53
2016-04-30,2016-04-30,"Service payment - Nelson, Parks and Campbell",REF93900624,0.0,1406.2,115458.73
2016-04-30,2016-04-30,Project payment - Porter Inc,REF18189879,0.0,908.9,116367.63
2016-04-30,2016-04-30,"Invoice payment - Mullins, Buckley and Hahn",REF15729429,0.0,1074.16,117441.79
2016-05-03,2016-05-03,Business materials,REF33981483,1226.96,0.0,116214.83
2016-05-05,2016-05-05,Tools expense,REF40596930,169.45,0.0,116045.38
2016-05-06,2016-05-06,Business materials,REF21111630,1479.13,0.0,114566.25
2016-05-07,2016-05-07,Permits Licenses expense,REF22465884,149.79,0.0,114416.46
2016-05-07,2016-05-07,Vehicle Maintenance expense,REF69083154,304.27,0.0,114112.19
2016-05-07,2016-05-07,Fuel purchase,REF73169434,352.87,0.0,113759.32
2016-05-13,2016-05-13,Fuel purchase,REF77406071,415.77,0.0,113343.55
2016-05-15,2016-05-15,Business insurance premium,REF99460764,271.52,0.0,113072.03
2016-05-15,2016-05-15,Fuel purchase,REF57144295,396.5,0.0,112675.53
2016-05-15,2016-05-15,"Invoice payment - Mullins, Buckley and Hahn",REF21942645,0.0,1184.27,113859.8
2016-05-15,2016-05-15,"Payment from Nelson, Parks and Campbell",REF73334805,0.0,1332.92,115192.72
2016-05-15,2016-05-15,Payment from Roman-Gonzalez,REF69740349,0.0,1107.68,116300.4
2016-05-15,2016-05-15,Payment from Abbott-Gomez,REF89770036,0.0,1624.8,117925.2
2016-05-15,2016-05-15,Payment from Porter Inc,REF59576517,0.0,1074.02,118999.22
2016-05-19,2016-05-19,Business materials,REF77219823,693.01,0.0,118306.21
2016-05-21,2016-05-21,Business materials,REF23669834,1136.86,0.0,117169.35
2016-05-22,2016-05-22,Subcontractors expense,REF11185052,1113.93,0.0,116055.42
2016-05-25,2016-05-25,Business materials,REF36528865,778.05,0.0,115277.37
2016-05-30,2016-05-30,Tools expense,REF23432254,181.01,0.0,115096.36
2016-05-30,2016-05-30,Project payment - Abbott-Gomez,REF20710750,0.0,1319.22,116415.58
2016-05-30,2016-05-30,Project payment - Porter Inc,REF31269141,0.0,992.52,117408.1
2016-05-30,2016-05-30,Invoice payment - Roman-Gonzalez,REF36178819,0.0,1445.66,118853.76
2016-05-30,2016-05-30,"Project payment - Nelson, Parks and Campbell",REF26867950,0.0,1544.99,120398.75
2016-05-30,2016-05-30,"Project payment - Mullins, Buckley and Hahn",REF43191428,0.0,909.81,121308.56
2016-05-30,2016-05-30,Subcontractors expense,REF56900059,620.65,0.0,120687.91
2016-06-02,2016-06-02,Safety Equipment expense,REF54417136,71.63,0.0,120616.28
2016-06-11,2016-06-11,Tools expense,REF12736528,99.41,0.0,120516.87
2016-06-13,2016-06-13,Business materials,REF21742370,836.37,0.0,119680.5
2016-06-14,2016-06-14,Fuel purchase,REF43915587,394.13,0.0,119286.37
2016-06-15,2016-06-15,Business insurance premium,REF65292827,239.73,0.0,119046.64
2016-06-15,2016-06-15,Project payment - Roman-Gonzalez,REF58722415,0.0,821.35,119867.99
2016-06-15,2016-06-15,"Payment from Nelson, Parks and Campbell",REF78383391,0.0,1101.46,120969.45
2016-06-15,2016-06-15,"Project payment - Mullins, Buckley and Hahn",REF92757675,0.0,902.67,121872.12
2016-06-15,2016-06-15,Project payment - Abbott-Gomez,REF33122734,0.0,1089.1,122961.22
2016-06-15,2016-06-15,Service payment - Porter Inc,REF88680016,0.0,1059.79,124021.01
2016-06-19,2016-06-19,Tools expense,REF36719627,192.04,0.0,123828.97
2016-06-28,2016-06-28,Vehicle Maintenance expense,REF75902310,135.91,0.0,123693.06
2016-06-29,2016-06-29,Business materials,REF94708594,1215.26,0.0,122477.8
2016-06-30,2016-06-30,Payment from Abbott-Gomez,REF79752256,0.0,1833.36,124311.16
2016-06-30,2016-06-30,"Invoice payment - Nelson, Parks and Campbell",REF19316391,0.0,1260.46,125571.62
2016-06-30,2016-06-30,Payment from Porter Inc,REF88486675,0.0,835.47,126407.09
2016-07-01,2016-07-01,Permits Licenses expense,REF73669914,144.26,0.0,126262.83
2016-07-03,2016-07-03,Fuel purchase,REF33175400,445.69,0.0,125817.14
2016-07-04,2016-07-04,Vehicle Maintenance expense,REF91885989,130.09,0.0,125687.05
2016-07-06,2016-07-06,Safety Equipment expense,REF23106260,77.88,0.0,125609.17
2016-07-07,2016-07-07,Permits Licenses expense,REF89275680,82.87,0.0,125526.3
2016-07-10,2016-07-10,Fuel purchase,REF70222955,453.92,0.0,125072.38
2016-07-12,2016-07-12,Fuel purchase,REF21577386,476.26,0.0,124596.12
2016-07-14,2016-07-14,Permits Licenses expense,REF83880678,149.18,0.0,124446.94
2016-07-14,2016-07-14,Fuel purchase,REF97331643,328.58,0.0,124118.36
2016-07-15,2016-07-15,Business insurance premium,REF84134101,232.48,0.0,123885.88
2016-07-15,2016-07-15,Payment from Roman-Gonzalez,REF16804918,0.0,1476.43,125362.31
2016-07-15,2016-07-15,"Invoice payment - Mullins, Buckley and Hahn",REF85489841,0.0,1459.1,126821.41
2016-07-15,2016-07-15,Payment from Abbott-Gomez,REF35207819,0.0,1150.12,127971.53
2016-07-15,2016-07-15,"Project payment - Nelson, Parks and Campbell",REF85826628,0.0,1259.76,129231.29
2016-07-15,2016-07-15,Payment from Porter Inc,REF60816600,0.0,923.38,130154.67
2016-07-17,2016-07-17,Vehicle Maintenance expense,REF84040775,184.45,0.0,129970.22
2016-07-18,2016-07-18,Business materials,REF23781920,923.43,0.0,129046.79
2016-07-21,2016-07-21,Vehicle Maintenance expense,REF26013534,118.57,0.0,128928.22
2016-07-22,2016-07-22,Subcontractors expense,REF63679400,1303.39,0.0,127624.83
2016-07-25,2016-07-25,Vehicle Maintenance expense,REF38253637,159.16,0.0,127465.67
2016-07-30,2016-07-30,Payment from Porter Inc,REF39745562,0.0,756.97,128222.64
2016-07-30,2016-07-30,"Service payment - Nelson, Parks and Campbell",REF60761943,0.0,1345.25,129567.89
2016-07-30,2016-07-30,Invoice payment - Abbott-Gomez,REF66017751,0.0,1601.51,131169.4
2016-07-30,2016-07-30,"Invoice payment - Mullins, Buckley and Hahn",REF86296391,0.0,1088.85,132258.25
2016-07-30,2016-07-30,Project payment - Roman-Gonzalez,REF84675117,0.0,1270.7,133528.95
2016-08-12,2016-08-12,Tools expense,REF53000084,117.57,0.0,133411.38
2016-08-14,2016-08-14,Vehicle Maintenance expense,REF79145062,142.07,0.0,133269.31
2016-08-15,2016-08-15,"Service payment - Nelson, Parks and Campbell",REF45553264,0.0,1231.52,134500.83
2016-08-15,2016-08-15,Project payment - Porter Inc,REF42560087,0.0,933.54,135434.37
2016-08-15,2016-08-15,Invoice payment - Abbott-Gomez,REF67603231,0.0,1267.44,136701.81
2016-08-15,2016-08-15,Business insurance premium,REF59115608,219.69,0.0,136482.12
2016-08-15,2016-08-15,"Invoice payment - Mullins, Buckley and Hahn",REF76230077,0.0,1069.08,137551.2
2016-08-15,2016-08-15,Invoice payment - Roman-Gonzalez,REF99215060,0.0,1395.39,138946.59
2016-08-15,2016-08-15,Permits Licenses expense,REF73883809,100.42,0.0,138846.17
2016-08-20,2016-08-20,Business materials,REF85719344,915.43,0.0,137930.74
2016-08-22,2016-08-22,Fuel purchase,REF57853350,404.17,0.0,137526.57
2016-08-25,2016-08-25,Permits Licenses expense,REF60600931,86.88,0.0,137439.69
2016-08-26,2016-08-26,Fuel purchase,REF75943993,416.59,0.0,137023.1
2016-08-29,2016-08-29,Tools expense,REF49689993,156.57,0.0,136866.53
2016-08-30,2016-08-30,Invoice payment - Porter Inc,REF50076282,0.0,996.09,137862.62
2016-08-30,2016-08-30,"Project payment - Nelson, Parks and Campbell",REF12951295,0.0,1440.84,139303.46
2016-08-30,2016-08-30,"Service payment - Mullins, Buckley and Hahn",REF22641567,0.0,1063.21,140366.67
2016-09-01,2016-09-01,Business materials,REF65711211,386.14,0.0,139980.53
2016-09-03,2016-09-03,Permits Licenses expense,REF50769558,89.42,0.0,139891.11
2016-09-03,2016-09-03,Safety Equipment expense,REF74214990,67.59,0.0,139823.52
2016-09-06,2016-09-06,Safety Equipment expense,REF28311722,36.61,0.0,139786.91
2016-09-07,2016-09-07,Vehicle Maintenance expense,REF34975720,244.98,0.0,139541.93
2016-09-11,2016-09-11,Business materials,REF59187690,1233.17,0.0,138308.76
2016-09-12,2016-09-12,Vehicle Maintenance expense,REF96380917,128.33,0.0,138180.43
2016-09-15,2016-09-15,Project payment - Abbott-Gomez,REF77286526,0.0,1093.05,139273.48
2016-09-15,2016-09-15,Invoice payment - Porter Inc,REF20752054,0.0,970.52,140244.0
2016-09-15,2016-09-15,"Project payment - Nelson, Parks and Campbell",REF91094553,0.0,1321.99,141565.99
2016-09-15,2016-09-15,"Payment from Mullins, Buckley and Hahn",REF19815022,0.0,961.28,142527.27
2016-09-15,2016-09-15,Business insurance premium,REF56722915,245.72,0.0,142281.55
2016-09-18,2016-09-18,Fuel purchase,REF89749936,354.6,0.0,141926.95
2016-09-19,2016-09-19,Safety Equipment expense,REF92163583,60.08,0.0,141866.87
2016-09-21,2016-09-21,Business materials,REF54695749,552.93,0.0,141313.94
2016-09-27,2016-09-27,Subcontractors expense,REF55943519,1497.48,0.0,139816.46
2016-09-27,2016-09-27,Vehicle Maintenance expense,REF40119812,113.21,0.0,139703.25
2016-09-30,2016-09-30,"Invoice payment - Nelson, Parks and Campbell",REF13741064,0.0,1345.41,141048.66
2016-09-30,2016-09-30,Project payment - Abbott-Gomez,REF99703900,0.0,1456.47,142505.13
2016-09-30,2016-09-30,"Project payment - Mullins, Buckley and Hahn",REF69271351,0.0,937.01,143442.14
2016-10-01,2016-10-01,Equipment Rental expense,REF72761148,693.27,0.0,142748.87
2016-10-07,2016-10-07,Business materials,REF98604884,942.02,0.0,141806.85
2016-10-10,2016-10-10,Tools expense,REF45901435,33.99,0.0,141772.86
2016-10-10,2016-10-10,Permits Licenses expense,REF99111847,138.0,0.0,141634.86
2016-10-11,2016-10-11,Fuel purchase,REF48402015,277.03,0.0,141357.83
2016-10-15,2016-10-15,Service payment - Abbott-Gomez,REF94960648,0.0,1506.21,142864.04
2016-10-15,2016-10-15,"Project payment - Nelson, Parks and Campbell",REF25543131,0.0,892.29,143756.33
2016-10-15,2016-10-15,Project payment - Porter Inc,REF56190405,0.0,688.82,144445.15
2016-10-15,2016-10-15,Business insurance premium,REF43545465,218.83,0.0,144226.32
2016-10-15,2016-10-15,Service payment - Roman-Gonzalez,REF71524410,0.0,885.59,145111.91
2016-10-17,2016-10-17,Permits Licenses expense,REF80355137,96.61,0.0,145015.3
2016-10-18,2016-10-18,Business materials,REF81905544,813.4,0.0,144201.9
2016-10-19,2016-10-19,Fuel purchase,REF54548054,266.36,0.0,143935.54
2016-10-21,2016-10-21,Subcontractors expense,REF19692508,858.52,0.0,143077.02
2016-10-23,2016-10-23,Tools expense,REF70958909,93.69,0.0,142983.33
2016-10-26,2016-10-26,Vehicle Maintenance expense,REF35742886,123.8,0.0,142859.53
2016-10-27,2016-10-27,Vehicle Maintenance expense,REF66090383,225.65,0.0,142633.88
2016-10-30,2016-10-30,Project payment - Porter Inc,REF63273388,0.0,643.44,143277.32
2016-10-30,2016-10-30,"Service payment - Mullins, Buckley and Hahn",REF28668668,0.0,876.15,144153.47
2016-10-30,2016-10-30,Project payment - Roman-Gonzalez,REF92204229,0.0,896.26,145049.73
2016-10-30,2016-10-30,Fuel purchase,REF69780786,478.54,0.0,144571.19
2016-10-30,2016-10-30,"Project payment - Nelson, Parks and Campbell",REF44236182,0.0,1196.38,145767.57
2016-10-31,2016-10-31,Fuel purchase,REF58050603,406.46,0.0,145361.11
2016-11-01,2016-11-01,Tools expense,REF20706850,54.8,0.0,145306.31
2016-11-02,2016-11-02,Fuel purchase,REF18461239,275.45,0.0,145030.86
2016-11-02,2016-11-02,Safety Equipment expense,REF13690907,73.87,0.0,144956.99
2016-11-05,2016-11-05,Business materials,REF17639565,455.46,0.0,144501.53
2016-11-06,2016-11-06,Permits Licenses expense,REF99945358,74.65,0.0,144426.88
2016-11-08,2016-11-08,Fuel purchase,REF82177473,258.11,0.0,144168.77
2016-11-12,2016-11-12,Business materials,REF55654594,580.28,0.0,143588.49
2016-11-14,2016-11-14,Business materials,REF87469767,504.54,0.0,143083.95
2016-11-14,2016-11-14,Fuel purchase,REF40789095,237.99,0.0,142845.96
2016-11-15,2016-11-15,Vehicle Maintenance expense,REF64197560,149.87,0.0,142696.09
2016-11-15,2016-11-15,"Payment from Mullins, Buckley and Hahn",REF57128858,0.0,706.19,143402.28
2016-11-15,2016-11-15,"Service payment - Nelson, Parks and Campbell",REF64700019,0.0,768.09,144170.37
2016-11-15,2016-11-15,Business insurance premium,REF87567572,164.58,0.0,144005.79
2016-11-15,2016-11-15,Permits Licenses expense,REF63313591,73.49,0.0,143932.3
2016-11-15,2016-11-15,Project payment - Roman-Gonzalez,REF55263531,0.0,937.38,144869.68
2016-11-18,2016-11-18,Safety Equipment expense,REF59608322,43.8,0.0,144825.88
2016-11-19,2016-11-19,Vehicle Maintenance expense,REF40355018,104.2,0.0,144721.68
2016-11-21,2016-11-21,Equipment Rental expense,REF81970132,356.97,0.0,144364.71
2016-11-22,2016-11-22,Business materials,REF53062001,477.66,0.0,143887.05
2016-11-30,2016-11-30,"Project payment - Nelson, Parks and Campbell",REF47213685,0.0,965.68,144852.73
2016-11-30,2016-11-30,"Project payment - Mullins, Buckley and Hahn",REF59264730,0.0,919.83,145772.56
2016-11-30,2016-11-30,Project payment - Abbott-Gomez,REF78445679,0.0,1123.72,146896.28
2016-11-30,2016-11-30,Project payment - Roman-Gonzalez,REF41435927,0.0,753.84,147650.12
2016-11-30,2016-11-30,Payment from Porter Inc,REF25115331,0.0,849.93,148500.05
2016-12-03,2016-12-03,Equipment Rental expense,REF69948618,228.86,0.0,148271.19
2016-12-04,2016-12-04,Tools expense,REF13835388,38.51,0.0,148232.68
2016-12-05,2016-12-05,Permits Licenses expense,REF31310254,50.93,0.0,148181.75
2016-12-05,2016-12-05,Safety Equipment expense,REF83238595,32.56,0.0,148149.19
2016-12-11,2016-12-11,Business materials,REF62666696,776.94,0.0,147372.25
2016-12-11,2016-12-11,Permits Licenses expense,REF96410297,51.75,0.0,147320.5
2016-12-12,2016-12-12,Business materials,REF74658015,437.48,0.0,146883.02
2016-12-13,2016-12-13,Permits Licenses expense,REF34454208,59.26,0.0,146823.76
2016-12-13,2016-12-13,Business materials,REF11829611,450.6,0.0,146373.16
2016-12-15,2016-12-15,Equipment Rental expense,REF78201132,329.07,0.0,146044.09
2016-12-15,2016-12-15,"Service payment - Mullins, Buckley and Hahn",REF44554241,0.0,603.51,146647.6
2016-12-15,2016-12-15,Service payment - Porter Inc,REF90043196,0.0,637.02,147284.62
2016-12-15,2016-12-15,Invoice payment - Abbott-Gomez,REF45539047,0.0,624.45,147909.07
2016-12-15,2016-12-15,Business insurance premium,REF39348767,124.5,0.0,147784.57
2016-12-15,2016-12-15,Project payment - Roman-Gonzalez,REF57050039,0.0,515.54,148300.11
2016-12-18,2016-12-18,Permits Licenses expense,REF45989453,64.47,0.0,148235.64
2016-12-19,2016-12-19,Business materials,REF42508371,415.95,0.0,147819.69
2016-12-22,2016-12-22,Equipment Rental expense,REF26978674,270.63,0.0,147549.06
2016-12-23,2016-12-23,Fuel purchase,REF69937863,239.43,0.0,147309.63
2016-12-25,2016-12-25,Tools expense,REF62252333,60.45,0.0,147249.18
2016-12-25,2016-12-25,Safety Equipment expense,REF59813119,53.59,0.0,147195.59
2016-12-29,2016-12-29,Permits Licenses expense,REF98587112,46.02,0.0,147149.57
2016-12-30,2016-12-30,Payment from Porter Inc,REF35649772,0.0,414.5,147564.07
2016-12-30,2016-12-30,"Payment from Mullins, Buckley and Hahn",REF14542281,0.0,485.92,148049.99
2016-12-30,2016-12-30,"Project payment - Nelson, Parks and Campbell",REF23188264,0.0,707.65,148757.64
2016-12-30,2016-12-30,Invoice payment - Abbott-Gomez,REF19642160,0.0,649.57,149407.21
2016-12-30,2016-12-30,Payment from Roman-Gonzalez,REF15295935,0.0,752.78,150159.99
2016-12-31,2016-12-31,Equipment Rental expense,REF70459098,139.09,0.0,150020.9
2016-12-31,2016-12-31,Business materials,REF40539015,521.23,0.0,149499.67
2017-01-02,2017-01-02,Permits Licenses expense,REF12692439,51.48,0.0,149448.19
2017-01-05,2017-01-05,Tools expense,REF56814541,90.81,0.0,149357.38
2017-01-07,2017-01-07,Fuel purchase,REF94410775,200.19,0.0,149157.19
2017-01-15,2017-01-15,Business insurance premium,REF35202940,139.88,0.0,149017.31
2017-01-15,2017-01-15,"Service payment - Mullins, Buckley and Hahn",REF19670893,0.0,693.05,149710.36
2017-01-15,2017-01-15,Invoice payment - Abbott-Gomez,REF37644240,0.0,1049.14,150759.5
2017-01-15,2017-01-15,Business materials,REF19356840,473.29,0.0,150286.21
2017-01-15,2017-01-15,"Service payment - Nelson, Parks and Campbell",REF37174403,0.0,1057.82,151344.03
2017-01-15,2017-01-15,Invoice payment - Porter Inc,REF20182739,0.0,645.59,151989.62
2017-01-15,2017-01-15,Payment from Roman-Gonzalez,REF20358284,0.0,934.23,152923.85
2017-01-18,2017-01-18,Permits Licenses expense,REF91034940,39.22,0.0,152884.63
2017-01-18,2017-01-18,Tools expense,REF38146387,22.76,0.0,152861.87
2017-01-19,2017-01-19,Vehicle Maintenance expense,REF11087484,99.19,0.0,152762.68
2017-01-23,2017-01-23,Tools expense,REF50555361,44.16,0.0,152718.52
2017-01-24,2017-01-24,Tools expense,REF33849785,101.75,0.0,152616.77
2017-01-25,2017-01-25,Business materials,REF96066975,360.87,0.0,152255.9
2017-01-28,2017-01-28,Business materials,REF97490032,395.29,0.0,151860.61
2017-01-30,2017-01-30,Payment from Porter Inc,REF34525137,0.0,468.89,152329.5
2017-01-30,2017-01-30,Service payment - Abbott-Gomez,REF19940188,0.0,976.62,153306.12
2017-01-30,2017-01-30,Service payment - Roman-Gonzalez,REF28674466,0.0,692.4,153998.52
2017-01-30,2017-01-30,"Invoice payment - Nelson, Parks and Campbell",REF43103643,0.0,852.53,154851.05
2017-01-30,2017-01-30,"Invoice payment - Mullins, Buckley and Hahn",REF29728516,0.0,633.9,155484.95
2017-01-30,2017-01-30,Equipment Rental expense,REF82608499,168.32,0.0,155316.63
2017-02-02,2017-02-02,Fuel purchase,REF30732238,289.85,0.0,155026.78
2017-02-03,2017-02-03,Equipment Rental expense,REF30336693,397.12,0.0,154629.66
2017-02-05,2017-02-05,Fuel purchase,REF72255563,228.55,0.0,154401.11
2017-02-07,2017-02-07,Business materials,REF35094250,896.89,0.0,153504.22
2017-02-15,2017-02-15,Business insurance premium,REF87321392,166.2,0.0,153338.02
2017-02-15,2017-02-15,Service payment - Porter Inc,REF20667450,0.0,558.42,153896.44
2017-02-15,2017-02-15,Service payment - Abbott-Gomez,REF96497910,0.0,1022.48,154918.92
2017-02-15,2017-02-15,"Invoice payment - Mullins, Buckley and Hahn",REF94836453,0.0,875.1,155794.02
2017-02-15,2017-02-15,Project payment - Roman-Gonzalez,REF78189293,0.0,791.63,156585.65
2017-02-15,2017-02-15,"Service payment - Nelson, Parks and Campbell",REF27655251,0.0,875.81,157461.46
2017-02-18,2017-02-18,Permits Licenses expense,REF99206619,75.6,0.0,157385.86
2017-02-18,2017-02-18,Business materials,REF57856716,1107.69,0.0,156278.17
2017-02-19,2017-02-19,Safety Equipment expense,REF86792568,58.25,0.0,156219.92
2017-02-19,2017-02-19,Vehicle Maintenance expense,REF81235332,109.41,0.0,156110.51
2017-02-28,2017-02-28,"Service payment - Nelson, Parks and Campbell",REF45375977,0.0,1230.36,157340.87
2017-02-28,2017-02-28,Project payment - Porter Inc,REF73658116,0.0,500.07,157840.94
2017-02-28,2017-02-28,Service payment - Roman-Gonzalez,REF24575375,0.0,960.05,158800.99
2017-02-28,2017-02-28,Business materials,REF34430124,976.3,0.0,157824.69
2017-02-28,2017-02-28,"Project payment - Mullins, Buckley and Hahn",REF25072355,0.0,777.32,158602.01
2017-02-28,2017-02-28,Project payment - Abbott-Gomez,REF97923143,0.0,996.41,159598.42
2017-03-08,2017-03-08,Fuel purchase,REF36979386,191.89,0.0,159406.53
2017-03-09,2017-03-09,Business materials,REF59110785,655.68,0.0,158750.85
2017-03-11,2017-03-11,Business materials,REF74669351,1056.45,0.0,157694.4
2017-03-12,2017-03-12,Tools expense,REF17479733,74.58,0.0,157619.82
2017-03-14,2017-03-14,Business materials,REF35469793,779.95,0.0,156839.87
2017-03-15,2017-03-15,Business insurance premium,REF58142004,208.94,0.0,156630.93
2017-03-15,2017-03-15,"Payment from Mullins, Buckley and Hahn",REF50416771,0.0,1127.78,157758.71
2017-03-15,2017-03-15,Invoice payment - Abbott-Gomez,REF22524691,0.0,954.47,158713.18
2017-03-15,2017-03-15,"Invoice payment - Nelson, Parks and Campbell",REF59177301,0.0,1051.51,159764.69
2017-03-15,2017-03-15,Project payment - Porter Inc,REF39967725,0.0,435.57,160200.26
2017-03-15,2017-03-15,Invoice payment - Roman-Gonzalez,REF32754802,0.0,850.42,161050.68
2017-03-18,2017-03-18,Vehicle Maintenance expense,REF86729037,125.9,0.0,160924.78
2017-03-22,2017-03-22,Safety Equipment expense,REF50266149,91.31,0.0,160833.47
2017-03-23,2017-03-23,Equipment Rental expense,REF17292079,442.82,0.0,160390.65
2017-03-23,2017-03-23,Business materials,REF24700702,854.42,0.0,159536.23
2017-03-25,2017-03-25,Subcontractors expense,REF17863903,1212.77,0.0,158323.46
2017-03-26,2017-03-26,Business materials,REF93724240,568.13,0.0,157755.33
2017-03-27,2017-03-27,Permits Licenses expense,REF51855029,76.14,0.0,157679.19
2017-03-30,2017-03-30,Project payment - Roman-Gonzalez,REF95013894,0.0,961.71,158640.9
2017-03-30,2017-03-30,Service payment - Abbott-Gomez,REF85294427,0.0,1079.61,159720.51
2017-03-30,2017-03-30,Invoice payment - Porter Inc,REF72341709,0.0,617.96,160338.47
2017-03-30,2017-03-30,"Service payment - Nelson, Parks and Campbell",REF48410510,0.0,671.98,161010.45
2017-03-30,2017-03-30,"Payment from Mullins, Buckley and Hahn",REF32525734,0.0,1144.12,162154.57
2017-04-01,2017-04-01,Subcontractors expense,REF19478192,1084.87,0.0,161069.7
2017-04-03,2017-04-03,Fuel purchase,REF37995271,197.01,0.0,160872.69
2017-04-06,2017-04-06,Tools expense,REF77413312,125.44,0.0,160747.25
2017-04-08,2017-04-08,Safety Equipment expense,REF87889539,101.38,0.0,160645.87
2017-04-10,2017-04-10,Business materials,REF71677436,1254.63,0.0,159391.24
2017-04-14,2017-04-14,Permits Licenses expense,REF99723494,121.43,0.0,159269.81
2017-04-15,2017-04-15,Payment from Abbott-Gomez,REF73919911,0.0,847.76,160117.57
2017-04-15,2017-04-15,Business materials,REF57681780,1046.78,0.0,159070.79
2017-04-15,2017-04-15,Business insurance premium,REF32268878,265.36,0.0,158805.43
2017-04-15,2017-04-15,Service payment - Porter Inc,REF24400956,0.0,652.78,159458.21
2017-04-15,2017-04-15,"Project payment - Mullins, Buckley and Hahn",REF71850695,0.0,1103.65,160561.86
2017-04-15,2017-04-15,Project payment - Roman-Gonzalez,REF95741165,0.0,1037.36,161599.22
2017-04-15,2017-04-15,"Invoice payment - Nelson, Parks and Campbell",REF73133760,0.0,1274.95,162874.17
2017-04-18,2017-04-18,Subcontractors expense,REF11057871,1345.02,0.0,161529.15
2017-04-23,2017-04-23,Tools expense,REF10207788,125.42,0.0,161403.73
2017-04-30,2017-04-30,Invoice payment - Roman-Gonzalez,REF50492688,0.0,1315.65,162719.38
2017-04-30,2017-04-30,Project payment - Abbott-Gomez,REF79008865,0.0,1580.67,164300.05
2017-04-30,2017-04-30,"Payment from Nelson, Parks and Campbell",REF93956802,0.0,1285.68,165585.73
2017-04-30,2017-04-30,Fuel purchase,REF12445976,305.54,0.0,165280.19
2017-05-01,2017-05-01,Subcontractors expense,REF19494144,1561.35,0.0,163718.84
2017-05-01,2017-05-01,Business materials,REF51418261,452.43,0.0,163266.41
2017-05-09,2017-05-09,Business materials,REF81289236,1402.93,0.0,161863.48
2017-05-11,2017-05-11,Permits Licenses expense,REF39697202,81.57,0.0,161781.91
2017-05-15,2017-05-15,"Payment from Nelson, Parks and Campbell",REF34854547,0.0,1710.79,163492.7
2017-05-15,2017-05-15,"Payment from Mullins, Buckley and Hahn",REF63074984,0.0,1027.83,164520.53
2017-05-15,2017-05-15,Business insurance premium,REF39245085,235.39,0.0,164285.14
2017-05-15,2017-05-15,Invoice payment - Abbott-Gomez,REF17078679,0.0,1136.2,165421.34
2017-05-15,2017-05-15,Project payment - Roman-Gonzalez,REF91382372,0.0,1375.85,166797.19
2017-05-15,2017-05-15,Business materials,REF41882222,561.81,0.0,166235.38
2017-05-25,2017-05-25,Safety Equipment expense,REF23341891,142.04,0.0,166093.34
2017-05-26,2017-05-26,Subcontractors expense,REF48448554,1154.83,0.0,164938.51
2017-05-26,2017-05-26,Permits Licenses expense,REF68536560,103.35,0.0,164835.16
2017-05-26,2017-05-26,Fuel purchase,REF99922605,323.49,0.0,164511.67
2017-05-28,2017-05-28,Equipment Rental expense,REF81150006,512.87,0.0,163998.8
2017-05-29,2017-05-29,Fuel purchase,REF81398612,470.26,0.0,163528.54
2017-05-30,2017-05-30,"Project payment - Nelson, Parks and Campbell",REF98230849,0.0,1478.22,165006.76
2017-05-30,2017-05-30,Project payment - Porter Inc,REF89901002,0.0,965.13,165971.89
2017-05-30,2017-05-30,Invoice payment - Roman-Gonzalez,REF96358666,0.0,975.73,166947.62
2017-05-30,2017-05-30,"Payment from Mullins, Buckley and Hahn",REF40237280,0.0,1052.87,168000.49
2017-05-30,2017-05-30,Payment from Abbott-Gomez,REF70129611,0.0,1388.28,169388.77
2017-06-01,2017-06-01,Subcontractors expense,REF77906858,1656.14,0.0,167732.63
2017-06-01,2017-06-01,Tools expense,REF19730765,148.73,0.0,167583.9
2017-06-04,2017-06-04,Tools expense,REF82121818,112.58,0.0,167471.32
2017-06-06,2017-06-06,Equipment Rental expense,REF37197527,754.48,0.0,166716.84
2017-06-06,2017-06-06,Fuel purchase,REF12917800,687.28,0.0,166029.56
2017-06-07,2017-06-07,Vehicle Maintenance expense,REF85998561,146.74,0.0,165882.82
2017-06-08,2017-06-08,Business materials,REF59295825,741.1,0.0,165141.72
2017-06-09,2017-06-09,Business materials,REF24802856,1576.99,0.0,163564.73
2017-06-10,2017-06-10,Permits Licenses expense,REF94424529,91.07,0.0,163473.66
2017-06-11,2017-06-11,Fuel purchase,REF88153747,321.4,0.0,163152.26
2017-06-13,2017-06-13,Safety Equipment expense,REF27752524,134.09,0.0,163018.17
2017-06-15,2017-06-15,Service payment - Porter Inc,REF11279665,0.0,865.74,163883.91
2017-06-15,2017-06-15,Payment from Abbott-Gomez,REF70655131,0.0,1296.91,165180.82
2017-06-15,2017-06-15,"Invoice payment - Mullins, Buckley and Hahn",REF30067677,0.0,930.27,166111.09
2017-06-15,2017-06-15,"Project payment - Nelson, Parks and Campbell",REF68943394,0.0,1732.65,167843.74
2017-06-15,2017-06-15,Business insurance premium,REF27784275,255.6,0.0,167588.14
2017-06-17,2017-06-17,Subcontractors expense,REF31151394,1600.41,0.0,165987.73
2017-06-22,2017-06-22,Fuel purchase,REF82939570,409.6,0.0,165578.13
2017-06-23,2017-06-23,Business materials,REF20261147,794.09,0.0,164784.04
2017-06-24,2017-06-24,Business materials,REF61942085,1043.68,0.0,163740.36
2017-06-26,2017-06-26,Business materials,REF19791996,1157.53,0.0,162582.83
2017-06-27,2017-06-27,Fuel purchase,REF81565582,513.4,0.0,162069.43
2017-06-30,2017-06-30,Invoice payment - Roman-Gonzalez,REF13271841,0.0,1115.23,163184.66
2017-06-30,2017-06-30,Service payment - Porter Inc,REF60029698,0.0,1103.28,164287.94
2017-06-30,2017-06-30,Invoice payment - Abbott-Gomez,REF15164309,0.0,1708.97,165996.91
2017-06-30,2017-06-30,"Service payment - Mullins, Buckley and Hahn",REF33115962,0.0,1113.75,167110.66
2017-06-30,2017-06-30,"Project payment - Nelson, Parks and Campbell",REF99300994,0.0,1605.33,168715.99
2017-07-04,2017-07-04,Permits Licenses expense,REF74866086,91.18,0.0,168624.81
2017-07-06,2017-07-06,Business materials,REF29507505,1288.91,0.0,167335.9
2017-07-14,2017-07-14,Business materials,REF41296141,1417.21,0.0,165918.69
2017-07-15,2017-07-15,"Service payment - Mullins, Buckley and Hahn",REF40418169,0.0,956.29,166874.98
2017-07-15,2017-07-15,Payment from Roman-Gonzalez,REF77388821,0.0,1225.34,168100.32
2017-07-15,2017-07-15,Invoice payment - Porter Inc,REF40603627,0.0,988.88,169089.2
2017-07-15,2017-07-15,Business insurance premium,REF74105447,236.32,0.0,168852.88
2017-07-15,2017-07-15,"Service payment - Nelson, Parks and Campbell",REF65513356,0.0,1582.77,170435.65
2017-07-15,2017-07-15,Project payment - Abbott-Gomez,REF34857884,0.0,1152.15,171587.8
2017-07-21,2017-07-21,Business materials,REF88189563,1092.87,0.0,170494.93
2017-07-29,2017-07-29,Business materials,REF41477830,1104.77,0.0,169390.16
2017-07-30,2017-07-30,"Service payment - Nelson, Parks and Campbell",REF80796197,0.0,1144.78,170534.94
2017-07-30,2017-07-30,Invoice payment - Porter Inc,REF53668718,0.0,807.58,171342.52
2017-07-30,2017-07-30,"Invoice payment - Mullins, Buckley and Hahn",REF87328947,0.0,1036.46,172378.98
2017-07-30,2017-07-30,Service payment - Roman-Gonzalez,REF68438417,0.0,1275.7,173654.68
2017-07-30,2017-07-30,Invoice payment - Abbott-Gomez,REF70772576,0.0,1393.42,175048.1
2017-07-31,2017-07-31,Business materials,REF40576770,1227.51,0.0,173820.59
2017-08-01,2017-08-01,Business materials,REF15152461,1248.89,0.0,172571.7
2017-08-01,2017-08-01,Vehicle Maintenance expense,REF78629133,215.45,0.0,172356.25
2017-08-04,2017-08-04,Business materials,REF89453726,652.12,0.0,171704.13
2017-08-04,2017-08-04,Equipment Rental expense,REF14599008,266.66,0.0,171437.47
2017-08-05,2017-08-05,Business materials,REF89792732,746.66,0.0,170690.81
2017-08-07,2017-08-07,Fuel purchase,REF39944524,410.02,0.0,170280.79
2017-08-08,2017-08-08,Business materials,REF46659443,852.71,0.0,169428.08
2017-08-10,2017-08-10,Subcontractors expense,REF32239617,1560.16,0.0,167867.92
2017-08-10,2017-08-10,Business materials,REF98488150,698.14,0.0,167169.78
2017-08-11,2017-08-11,Vehicle Maintenance expense,REF79987187,208.19,0.0,166961.59
2017-08-13,2017-08-13,Fuel purchase,REF88949356,98.02,0.0,166863.57
2017-08-15,2017-08-15,"Project payment - Mullins, Buckley and Hahn",REF57611002,0.0,1089.23,167952.8
2017-08-15,2017-08-15,Business insurance premium,REF14100841,230.17,0.0,167722.63
2017-08-15,2017-08-15,Payment from Roman-Gonzalez,REF23650872,0.0,1132.67,168855.3
2017-08-15,2017-08-15,Payment from Abbott-Gomez,REF28939149,0.0,1633.61,170488.91
2017-08-15,2017-08-15,"Payment from Nelson, Parks and Campbell",REF29095015,0.0,1358.25,171847.16
2017-08-15,2017-08-15,Payment from Porter Inc,REF31578880,0.0,846.46,172693.62
2017-08-16,2017-08-16,Equipment Rental expense,REF73982533,327.21,0.0,172366.41
2017-08-19,2017-08-19,Fuel purchase,REF51503561,350.91,0.0,172015.5
2017-08-28,2017-08-28,Permits Licenses expense,REF29753935,110.04,0.0,171905.46
2017-08-29,2017-08-29,Business materials,REF81767390,766.53,0.0,171138.93
2017-08-30,2017-08-30,Invoice payment - Abbott-Gomez,REF50815214,0.0,1569.5,172708.43
2017-08-30,2017-08-30,"Payment from Mullins, Buckley and Hahn",REF96542585,0.0,1078.16,173786.59
2017-08-30,2017-08-30,Project payment - Roman-Gonzalez,REF83805853,0.0,1435.1,175221.69
2017-08-30,2017-08-30,Service payment - Porter Inc,REF59713335,0.0,912.87,176134.56
2017-09-01,2017-09-01,Tools expense,REF55940873,107.43,0.0,176027.13
2017-09-05,2017-09-05,Business materials,REF36681480,976.8,0.0,175050.33
2017-09-06,2017-09-06,Business materials,REF96302145,574.28,0.0,174476.05
2017-09-09,2017-09-09,Vehicle Maintenance expense,REF37077939,170.4,0.0,174305.65
2017-09-15,2017-09-15,Business insurance premium,REF37372370,217.77,0.0,174087.88
2017-09-15,2017-09-15,Tools expense,REF27414330,110.79,0.0,173977.09
2017-09-15,2017-09-15,Payment from Abbott-Gomez,REF71222008,0.0,1177.81,175154.9
2017-09-15,2017-09-15,"Payment from Nelson, Parks and Campbell",REF19756520,0.0,1423.58,176578.48
2017-09-15,2017-09-15,Business materials,REF14957918,1014.58,0.0,175563.9
2017-09-15,2017-09-15,Service payment - Roman-Gonzalez,REF86572000,0.0,1383.44,176947.34
2017-09-15,2017-09-15,Project payment - Porter Inc,REF82210867,0.0,918.05,177865.39
2017-09-15,2017-09-15,"Project payment - Mullins, Buckley and Hahn",REF61603022,0.0,822.26,178687.65
2017-09-18,2017-09-18,Permits Licenses expense,REF18221838,99.63,0.0,178588.02
2017-09-20,2017-09-20,Fuel purchase,REF44145006,278.07,0.0,178309.95
2017-09-21,2017-09-21,Safety Equipment expense,REF62009124,86.39,0.0,178223.56
2017-09-23,2017-09-23,Equipment Rental expense,REF58309304,234.7,0.0,177988.86
2017-09-24,2017-09-24,Fuel purchase,REF82908292,342.33,0.0,177646.53
2017-09-25,2017-09-25,Vehicle Maintenance expense,REF25395090,192.94,0.0,177453.59
2017-09-29,2017-09-29,Subcontractors expense,REF12102534,859.31,0.0,176594.28
2017-09-30,2017-09-30,"Invoice payment - Nelson, Parks and Campbell",REF15755246,0.0,1064.32,177658.6
2017-09-30,2017-09-30,Service payment - Roman-Gonzalez,REF26523093,0.0,1232.55,178891.15
2017-09-30,2017-09-30,Invoice payment - Abbott-Gomez,REF16528032,0.0,1254.03,180145.18
2017-09-30,2017-09-30,"Project payment - Mullins, Buckley and Hahn",REF94867111,0.0,912.68,181057.86
2017-09-30,2017-09-30,Invoice payment - Porter Inc,REF99000581,0.0,884.05,181941.91
2017-10-04,2017-10-04,Fuel purchase,REF28619295,275.67,0.0,181666.24
2017-10-05,2017-10-05,Subcontractors expense,REF15941468,1199.21,0.0,180467.03
2017-10-07,2017-10-07,Fuel purchase,REF72312091,315.97,0.0,180151.06
2017-10-09,2017-10-09,Fuel purchase,REF34573223,351.79,0.0,179799.27
2017-10-15,2017-10-15,Invoice payment - Porter Inc,REF96158556,0.0,683.95,180483.22
2017-10-15,2017-10-15,Business insurance premium,REF22543950,206.29,0.0,180276.93
2017-10-15,2017-10-15,"Service payment - Mullins, Buckley and Hahn",REF42590538,0.0,1075.06,181351.99
2017-10-15,2017-10-15,Project payment - Roman-Gonzalez,REF40380485,0.0,1092.67,182444.66
2017-10-15,2017-10-15,Invoice payment - Abbott-Gomez,REF56365140,0.0,1102.7,183547.36
2017-10-19,2017-10-19,Fuel purchase,REF83087262,210.06,0.0,183337.3
2017-10-19,2017-10-19,Business materials,REF20673358,824.12,0.0,182513.18
2017-10-26,2017-10-26,Fuel purchase,REF56364035,248.21,0.0,182264.97
2017-10-27,2017-10-27,Fuel purchase,REF91180427,297.98,0.0,181966.99
2017-10-28,2017-10-28,Vehicle Maintenance expense,REF72328410,163.5,0.0,181803.49
2017-10-28,2017-10-28,Business materials,REF78718685,653.37,0.0,181150.12
2017-10-30,2017-10-30,"Payment from Mullins, Buckley and Hahn",REF42145355,0.0,710.57,181860.69
2017-10-30,2017-10-30,Invoice payment - Porter Inc,REF55456535,0.0,725.06,182585.75
2017-10-30,2017-10-30,Project payment - Roman-Gonzalez,REF49913900,0.0,795.74,183381.49
2017-10-30,2017-10-30,Service payment - Abbott-Gomez,REF39923262,0.0,1229.16,184610.65
2017-10-30,2017-10-30,"Payment from Nelson, Parks and Campbell",REF32449106,0.0,1048.92,185659.57
2017-10-31,2017-10-31,Business materials,REF24642589,794.7,0.0,184864.87
2017-11-01,2017-11-01,Business materials,REF26797591,662.51,0.0,184202.36
2017-11-02,2017-11-02,Subcontractors expense,REF53869987,1109.0,0.0,183093.36
2017-11-04,2017-11-04,Permits Licenses expense,REF45679906,44.45,0.0,183048.91
2017-11-06,2017-11-06,Permits Licenses expense,REF43414037,80.81,0.0,182968.1
2017-11-10,2017-11-10,Subcontractors expense,REF49691277,615.11,0.0,182352.99
2017-11-12,2017-11-12,Business materials,REF62683954,1148.32,0.0,181204.67
2017-11-15,2017-11-15,Vehicle Maintenance expense,REF12882830,130.6,0.0,181074.07
2017-11-15,2017-11-15,Invoice payment - Roman-Gonzalez,REF67285330,0.0,727.02,181801.09
2017-11-15,2017-11-15,"Project payment - Mullins, Buckley and Hahn",REF55845458,0.0,797.72,182598.81
2017-11-15,2017-11-15,Business insurance premium,REF36693262,164.9,0.0,182433.91
2017-11-15,2017-11-15,Service payment - Abbott-Gomez,REF52972104,0.0,707.22,183141.13
2017-11-17,2017-11-17,Safety Equipment expense,REF92804767,42.91,0.0,183098.22
2017-11-19,2017-11-19,Fuel purchase,REF40296171,243.01,0.0,182855.21
2017-11-24,2017-11-24,Fuel purchase,REF56380563,248.54,0.0,182606.67
2017-11-25,2017-11-25,Subcontractors expense,REF33362106,848.36,0.0,181758.31
2017-11-30,2017-11-30,Tools expense,REF75647895,104.9,0.0,181653.41
2017-11-30,2017-11-30,Service payment - Abbott-Gomez,REF35932788,0.0,835.54,182488.95
2017-11-30,2017-11-30,"Service payment - Nelson, Parks and Campbell",REF15470474,0.0,889.57,183378.52
2017-11-30,2017-11-30,Service payment - Roman-Gonzalez,REF83533374,0.0,876.78,184255.3
2017-11-30,2017-11-30,Project payment - Porter Inc,REF37900823,0.0,569.19,184824.49
2017-11-30,2017-11-30,"Service payment - Mullins, Buckley and Hahn",REF61033128,0.0,621.42,185445.91
2017-12-15,2017-12-15,Business insurance premium,REF16693040,111.38,0.0,185334.53
2017-12-15,2017-12-15,"Project payment - Mullins, Buckley and Hahn",REF38971204,0.0,622.88,185957.41
2017-12-15,2017-12-15,"Project payment - Nelson, Parks and Campbell",REF18800346,0.0,548.11,186505.52
2017-12-15,2017-12-15,Project payment - Roman-Gonzalez,REF97181451,0.0,627.06,187132.58
2017-12-15,2017-12-15,Project payment - Abbott-Gomez,REF68208608,0.0,679.33,187811.91
2017-12-15,2017-12-15,Service payment - Porter Inc,REF26535181,0.0,384.07,188195.98
2017-12-17,2017-12-17,Fuel purchase,REF32959651,153.88,0.0,188042.1
2017-12-18,2017-12-18,Safety Equipment expense,REF61999084,44.28,0.0,187997.82
2017-12-18,2017-12-18,Business materials,REF14497081,384.36,0.0,187613.46
2017-12-18,2017-12-18,Tools expense,REF17511128,64.86,0.0,187548.6
2017-12-20,2017-12-20,Subcontractors expense,REF13789171,583.99,0.0,186964.61
2017-12-22,2017-12-22,Permits Licenses expense,REF48412737,54.24,0.0,186910.37
2017-12-26,2017-12-26,Tools expense,REF24418289,66.75,0.0,186843.62
2017-12-30,2017-12-30,Service payment - Porter Inc,REF89821873,0.0,434.48,187278.1
2017-12-30,2017-12-30,Service payment - Abbott-Gomez,REF35606904,0.0,614.27,187892.37
2017-12-30,2017-12-30,"Payment from Nelson, Parks and Campbell",REF30718997,0.0,470.15,188362.52
2017-12-30,2017-12-30,"Payment from Mullins, Buckley and Hahn",REF55268022,0.0,713.66,189076.18
2018-01-03,2018-01-03,Tools expense,REF21009755,46.7,0.0,189029.48
2018-01-03,2018-01-03,Permits Licenses expense,REF38258765,80.29,0.0,188949.19
2018-01-04,2018-01-04,Business materials,REF53754757,392.77,0.0,188556.42
2018-01-06,2018-01-06,Vehicle Maintenance expense,REF63440594,96.06,0.0,188460.36
2018-01-07,2018-01-07,Fuel purchase,REF49171913,241.24,0.0,188219.12
2018-01-09,2018-01-09,Fuel purchase,REF80969149,160.85,0.0,188058.27
2018-01-09,2018-01-09,Tools expense,REF55940216,75.8,0.0,187982.47
2018-01-13,2018-01-13,Fuel purchase,REF48135896,235.39,0.0,187747.08
2018-01-15,2018-01-15,Service payment - Porter Inc,REF54627914,0.0,399.18,188146.26
2018-01-15,2018-01-15,"Payment from Nelson, Parks and Campbell",REF28858689,0.0,768.0,188914.26
2018-01-15,2018-01-15,Service payment - Abbott-Gomez,REF89570229,0.0,710.5,189624.76
2018-01-15,2018-01-15,Vehicle Maintenance expense,REF11098702,85.3,0.0,189539.46
2018-01-15,2018-01-15,Invoice payment - Roman-Gonzalez,REF35958273,0.0,728.86,190268.32
2018-01-15,2018-01-15,"Payment from Mullins, Buckley and Hahn",REF93690706,0.0,657.26,190925.58
2018-01-15,2018-01-15,Business insurance premium,REF61851098,146.49,0.0,190779.09
2018-01-22,2018-01-22,Business materials,REF52997378,626.32,0.0,190152.77
2018-01-26,2018-01-26,Fuel purchase,REF23693845,224.56,0.0,189928.21
2018-01-29,2018-01-29,Tools expense,REF35591137,20.86,0.0,189907.35
2018-01-30,2018-01-30,Project payment - Abbott-Gomez,REF16644707,0.0,923.91,190831.26
2018-01-30,2018-01-30,"Project payment - Nelson, Parks and Campbell",REF18492990,0.0,562.73,191393.99
2018-01-30,2018-01-30,"Payment from Mullins, Buckley and Hahn",REF18672867,0.0,731.17,192125.16
2018-01-30,2018-01-30,Payment from Roman-Gonzalez,REF54095071,0.0,866.56,192991.72
2018-01-30,2018-01-30,Payment from Porter Inc,REF35621578,0.0,543.77,193535.49
2018-02-03,2018-02-03,Vehicle Maintenance expense,REF61118372,82.34,0.0,193453.15
2018-02-03,2018-02-03,Business materials,REF39853198,731.92,0.0,192721.23
2018-02-04,2018-02-04,Fuel purchase,REF24164556,204.02,0.0,192517.21
2018-02-04,2018-02-04,Vehicle Maintenance expense,REF18337809,165.24,0.0,192351.97
2018-02-05,2018-02-05,Fuel purchase,REF61505459,227.65,0.0,192124.32
2018-02-10,2018-02-10,Business materials,REF54840907,242.02,0.0,191882.3
2018-02-11,2018-02-11,Business materials,REF52490207,675.16,0.0,191207.14
2018-02-14,2018-02-14,Business materials,REF17303203,451.9,0.0,190755.24
2018-02-15,2018-02-15,Invoice payment - Roman-Gonzalez,REF57804065,0.0,638.52,191393.76
2018-02-15,2018-02-15,Payment from Abbott-Gomez,REF33462938,0.0,744.96,192138.72
2018-02-15,2018-02-15,Business insurance premium,REF40893445,170.08,0.0,191968.64
2018-02-15,2018-02-15,"Service payment - Mullins, Buckley and Hahn",REF84359180,0.0,605.59,192574.23
2018-02-15,2018-02-15,"Payment from Nelson, Parks and Campbell",REF45358993,0.0,849.96,193424.19
2018-02-15,2018-02-15,Service payment - Porter Inc,REF30187146,0.0,633.15,194057.34
2018-02-18,2018-02-18,Permits Licenses expense,REF64460896,61.42,0.0,193995.92
2018-02-20,2018-02-20,Vehicle Maintenance expense,REF92501994,116.87,0.0,193879.05
2018-02-22,2018-02-22,Fuel purchase,REF94761791,294.87,0.0,193584.18
2018-02-23,2018-02-23,Subcontractors expense,REF92219067,436.76,0.0,193147.42
2018-02-23,2018-02-23,Business materials,REF66655775,919.52,0.0,192227.9
2018-02-26,2018-02-26,Equipment Rental expense,REF54019904,268.83,0.0,191959.07
2018-02-28,2018-02-28,Service payment - Abbott-Gomez,REF55835502,0.0,592.53,192551.6
2018-02-28,2018-02-28,Safety Equipment expense,REF19226364,65.21,0.0,192486.39
2018-02-28,2018-02-28,Service payment - Porter Inc,REF38420725,0.0,599.73,193086.12
2018-02-28,2018-02-28,"Payment from Nelson, Parks and Campbell",REF45336937,0.0,1096.95,194183.07
2018-02-28,2018-02-28,"Payment from Mullins, Buckley and Hahn",REF62465331,0.0,682.6,194865.67
2018-02-28,2018-02-28,Payment from Roman-Gonzalez,REF23184949,0.0,708.55,195574.22
2018-03-02,2018-03-02,Safety Equipment expense,REF20958101,45.79,0.0,195528.43
2018-03-02,2018-03-02,Fuel purchase,REF16934496,232.6,0.0,195295.83
2018-03-04,2018-03-04,Permits Licenses expense,REF23675790,49.43,0.0,195246.4
2018-03-08,2018-03-08,Subcontractors expense,REF36977065,1256.44,0.0,193989.96
2018-03-12,2018-03-12,Tools expense,REF92782367,96.98,0.0,193892.98
2018-03-14,2018-03-14,Fuel purchase,REF70992758,432.0,0.0,193460.98
2018-03-14,2018-03-14,Subcontractors expense,REF56432323,962.31,0.0,192498.67
2018-03-15,2018-03-15,Business insurance premium,REF71012937,224.27,0.0,192274.4
2018-03-15,2018-03-15,"Payment from Mullins, Buckley and Hahn",REF12936697,0.0,893.25,193167.65
2018-03-15,2018-03-15,Project payment - Porter Inc,REF55444309,0.0,592.35,193760.0
2018-03-15,2018-03-15,Payment from Roman-Gonzalez,REF96099590,0.0,1032.41,194792.41
2018-03-15,2018-03-15,Service payment - Abbott-Gomez,REF60923518,0.0,1211.8,196004.21
2018-03-16,2018-03-16,Equipment Rental expense,REF17659245,442.01,0.0,195562.2
2018-03-20,2018-03-20,Tools expense,REF75741217,129.45,0.0,195432.75
2018-03-21,2018-03-21,Fuel purchase,REF62885938,352.56,0.0,195080.19
2018-03-24,2018-03-24,Fuel purchase,REF97728874,220.56,0.0,194859.63
2018-03-26,2018-03-26,Fuel purchase,REF96701612,323.45,0.0,194536.18
2018-03-28,2018-03-28,Tools expense,REF20539343,122.35,0.0,194413.83
2018-03-30,2018-03-30,Equipment Rental expense,REF32332500,299.8,0.0,194114.03
2018-03-30,2018-03-30,"Invoice payment - Mullins, Buckley and Hahn",REF21246117,0.0,791.48,194905.51
2018-03-30,2018-03-30,Project payment - Porter Inc,REF92150053,0.0,727.49,195633.0
2018-03-30,2018-03-30,"Invoice payment - Nelson, Parks and Campbell",REF43175129,0.0,900.25,196533.25
2018-03-30,2018-03-30,Service payment - Abbott-Gomez,REF20133238,0.0,1369.67,197902.92
2018-03-30,2018-03-30,Service payment - Roman-Gonzalez,REF60261165,0.0,660.32,198563.24
2018-04-06,2018-04-06,Fuel purchase,REF77112199,293.21,0.0,198270.03
2018-04-08,2018-04-08,Tools expense,REF25735120,115.98,0.0,198154.05
2018-04-09,2018-04-09,Safety Equipment expense,REF28276383,98.84,0.0,198055.21
2018-04-10,2018-04-10,Business materials,REF64084671,972.88,0.0,197082.33
2018-04-12,2018-04-12,Permits Licenses expense,REF48867546,131.09,0.0,196951.24
2018-04-12,2018-04-12,Fuel purchase,REF12205873,441.8,0.0,196509.44
2018-04-14,2018-04-14,Business materials,REF16442111,634.73,0.0,195874.71
2018-04-15,2018-04-15,Business insurance premium,REF44671934,229.96,0.0,195644.75
2018-04-15,2018-04-15,Service payment - Porter Inc,REF75046007,0.0,799.92,196444.67
2018-04-15,2018-04-15,"Project payment - Nelson, Parks and Campbell",REF84353905,0.0,1117.95,197562.62
2018-04-15,2018-04-15,"Invoice payment - Mullins, Buckley and Hahn",REF45833241,0.0,921.4,198484.02
2018-04-15,2018-04-15,Invoice payment - Roman-Gonzalez,REF34478650,0.0,1098.35,199582.37
2018-04-15,2018-04-15,Project payment - Abbott-Gomez,REF65065747,0.0,1705.03,201287.4
2018-04-27,2018-04-27,Vehicle Maintenance expense,REF75852640,150.99,0.0,201136.41
2018-04-29,2018-04-29,Subcontractors expense,REF82237700,1436.51,0.0,199699.9
2018-04-29,2018-04-29,Fuel purchase,REF35643835,428.19,0.0,199271.71
2018-04-30,2018-04-30,Service payment - Abbott-Gomez,REF35471535,0.0,1428.87,200700.58
2018-04-30,2018-04-30,"Invoice payment - Mullins, Buckley and Hahn",REF52875694,0.0,1134.18,201834.76
2018-04-30,2018-04-30,Payment from Porter Inc,REF10691907,0.0,818.01,202652.77
2018-04-30,2018-04-30,"Payment from Nelson, Parks and Campbell",REF57033344,0.0,1381.52,204034.29
2018-04-30,2018-04-30,Payment from Roman-Gonzalez,REF40282887,0.0,1047.9,205082.19
2018-05-02,2018-05-02,Permits Licenses expense,REF21009787,153.33,0.0,204928.86
2018-05-04,2018-05-04,Fuel purchase,REF14037754,171.86,0.0,204757.0
2018-05-05,2018-05-05,Business materials,REF98718497,1197.88,0.0,203559.12
2018-05-09,2018-05-09,Tools expense,REF16261955,159.21,0.0,203399.91
2018-05-11,2018-05-11,Subcontractors expense,REF70167233,1203.37,0.0,202196.54
2018-05-14,2018-05-14,Fuel purchase,REF88720568,455.13,0.0,201741.41
2018-05-15,2018-05-15,Business insurance premium,REF17421800,246.14,0.0,201495.27
2018-05-15,2018-05-15,"Project payment - Nelson, Parks and Campbell",REF53175860,0.0,1596.25,203091.52
2018-05-15,2018-05-15,Invoice payment - Porter Inc,REF17867037,0.0,1035.39,204126.91
2018-05-15,2018-05-15,"Payment from Mullins, Buckley and Hahn",REF62706932,0.0,1109.93,205236.84
2018-05-15,2018-05-15,Service payment - Roman-Gonzalez,REF73809648,0.0,994.08,206230.92
2018-05-15,2018-05-15,Payment from Abbott-Gomez,REF84576234,0.0,1735.66,207966.58
2018-05-16,2018-05-16,Vehicle Maintenance expense,REF56153043,273.88,0.0,207692.7
2018-05-18,2018-05-18,Safety Equipment expense,REF34092214,24.52,0.0,207668.18
2018-05-24,2018-05-24,Subcontractors expense,REF82735936,1595.32,0.0,206072.86
2018-05-26,2018-05-26,Business materials,REF58544443,734.52,0.0,205338.34
2018-05-30,2018-05-30,Service payment - Roman-Gonzalez,REF79248623,0.0,977.09,206315.43
2018-05-30,2018-05-30,"Payment from Nelson, Parks and Campbell",REF90834758,0.0,933.9,207249.33
2018-05-30,2018-05-30,Service payment - Porter Inc,REF11812019,0.0,1205.37,208454.7
2018-05-30,2018-05-30,"Invoice payment - Mullins, Buckley and Hahn",REF79942055,0.0,879.86,209334.56
2018-05-30,2018-05-30,Service payment - Abbott-Gomez,REF87608013,0.0,1399.42,210733.98
2018-05-31,2018-05-31,Permits Licenses expense,REF59755609,86.52,0.0,210647.46
2018-06-07,2018-06-07,Fuel purchase,REF40180071,284.69,0.0,210362.77
2018-06-09,2018-06-09,Safety Equipment expense,REF10167990,108.75,0.0,210254.02
2018-06-12,2018-06-12,Permits Licenses expense,REF22173740,90.12,0.0,210163.9
2018-06-13,2018-06-13,Equipment Rental expense,REF30766169,575.85,0.0,209588.05
2018-06-14,2018-06-14,Business materials,REF89171888,1072.14,0.0,208515.91
2018-06-15,2018-06-15,Invoice payment - Abbott-Gomez,REF70753805,0.0,1027.71,209543.62
2018-06-15,2018-06-15,Payment from Roman-Gonzalez,REF75035002,0.0,1198.03,210741.65
2018-06-15,2018-06-15,Business insurance premium,REF29693573,274.33,0.0,210467.32
2018-06-15,2018-06-15,Payment from Porter Inc,REF29289088,0.0,663.8,211131.12
2018-06-15,2018-06-15,"Payment from Mullins, Buckley and Hahn",REF39025724,0.0,1113.03,212244.15
2018-06-15,2018-06-15,"Invoice payment - Nelson, Parks and Campbell",REF94772804,0.0,1498.43,213742.58
2018-06-16,2018-06-16,Vehicle Maintenance expense,REF32011278,180.08,0.0,213562.5
2018-06-16,2018-06-16,Permits Licenses expense,REF22741043,106.68,0.0,213455.82
2018-06-19,2018-06-19,Subcontractors expense,REF30739079,1473.52,0.0,211982.3
2018-06-28,2018-06-28,Vehicle Maintenance expense,REF35102018,206.14,0.0,211776.16
2018-06-30,2018-06-30,Invoice payment - Roman-Gonzalez,REF84131592,0.0,1113.92,212890.08
2018-06-30,2018-06-30,Project payment - Abbott-Gomez,REF91442600,0.0,1834.96,214725.04
2018-06-30,2018-06-30,Payment from Porter Inc,REF60386256,0.0,890.31,215615.35
2018-06-30,2018-06-30,"Payment from Nelson, Parks and Campbell",REF59698543,0.0,1188.77,216804.12
2018-06-30,2018-06-30,"Service payment - Mullins, Buckley and Hahn",REF65759642,0.0,1223.17,218027.29
2018-07-01,2018-07-01,Tools expense,REF63952549,143.83,0.0,217883.46
2018-07-02,2018-07-02,Permits Licenses expense,REF49708154,80.68,0.0,217802.78
2018-07-03,2018-07-03,Safety Equipment expense,REF74241330,105.22,0.0,217697.56
2018-07-08,2018-07-08,Safety Equipment expense,REF26112652,69.94,0.0,217627.62
2018-07-11,2018-07-11,Tools expense,REF26718241,84.22,0.0,217543.4
2018-07-13,2018-07-13,Tools expense,REF63733900,82.26,0.0,217461.14
2018-07-15,2018-07-15,Business insurance premium,REF86330663,231.39,0.0,217229.75
2018-07-15,2018-07-15,"Invoice payment - Nelson, Parks and Campbell",REF32188402,0.0,1527.22,218756.97
2018-07-15,2018-07-15,Business materials,REF34315207,1120.44,0.0,217636.53
2018-07-15,2018-07-15,Payment from Porter Inc,REF62516800,0.0,1022.59,218659.12
2018-07-15,2018-07-15,Service payment - Roman-Gonzalez,REF33720980,0.0,1242.88,219902.0
2018-07-15,2018-07-15,Project payment - Abbott-Gomez,REF50322847,0.0,1066.54,220968.54
2018-07-19,2018-07-19,Equipment Rental expense,REF12529349,622.86,0.0,220345.68
2018-07-25,2018-07-25,Safety Equipment expense,REF92263264,109.65,0.0,220236.03
2018-07-26,2018-07-26,Tools expense,REF18750677,143.39,0.0,220092.64
2018-07-30,2018-07-30,Service payment - Abbott-Gomez,REF21911810,0.0,1479.21,221571.85
2018-07-30,2018-07-30,Permits Licenses expense,REF44641076,102.38,0.0,221469.47
2018-07-30,2018-07-30,Service payment - Porter Inc,REF68233392,0.0,697.78,222167.25
2018-07-30,2018-07-30,"Payment from Nelson, Parks and Campbell",REF31504493,0.0,1365.67,223532.92
2018-07-30,2018-07-30,"Project payment - Mullins, Buckley and Hahn",REF16471226,0.0,1062.14,224595.06
2018-08-05,2018-08-05,Tools expense,REF88933329,164.43,0.0,224430.63
2018-08-05,2018-08-05,Business materials,REF21410423,695.76,0.0,223734.87
2018-08-07,2018-08-07,Fuel purchase,REF70870887,284.27,0.0,223450.6
2018-08-08,2018-08-08,Business materials,REF23625214,1387.31,0.0,222063.29
2018-08-12,2018-08-12,Fuel purchase,REF93270491,358.53,0.0,221704.76
2018-08-13,2018-08-13,Tools expense,REF30866474,105.45,0.0,221599.31
2018-08-15,2018-08-15,Invoice payment - Roman-Gonzalez,REF98990572,0.0,1185.15,222784.46
2018-08-15,2018-08-15,Business insurance premium,REF34924388,252.25,0.0,222532.21
2018-08-15,2018-08-15,Payment from Abbott-Gomez,REF42857802,0.0,1078.36,223610.57
2018-08-15,2018-08-15,"Project payment - Mullins, Buckley and Hahn",REF20387200,0.0,1285.88,224896.45
2018-08-15,2018-08-15,"Project payment - Nelson, Parks and Campbell",REF26302829,0.0,853.14,225749.59
2018-08-17,2018-08-17,Tools expense,REF82981938,149.61,0.0,225599.98
2018-08-21,2018-08-21,Fuel purchase,REF62277225,166.66,0.0,225433.32
2018-08-22,2018-08-22,Safety Equipment expense,REF45788041,72.9,0.0,225360.42
2018-08-23,2018-08-23,Permits Licenses expense,REF71711493,71.12,0.0,225289.3
2018-08-23,2018-08-23,Vehicle Maintenance expense,REF17571083,196.86,0.0,225092.44
2018-08-27,2018-08-27,Business materials,REF41540002,628.78,0.0,224463.66
2018-08-29,2018-08-29,Fuel purchase,REF22409192,388.03,0.0,224075.63
2018-08-30,2018-08-30,"Service payment - Mullins, Buckley and Hahn",REF30070517,0.0,862.38,224938.01
2018-08-30,2018-08-30,"Invoice payment - Nelson, Parks and Campbell",REF78263455,0.0,1272.33,226210.34
2018-08-30,2018-08-30,Invoice payment - Abbott-Gomez,REF63840414,0.0,1349.33,227559.67
2018-08-30,2018-08-30,Payment from Porter Inc,REF93957578,0.0,777.25,228336.92
2018-08-30,2018-08-30,Project payment - Roman-Gonzalez,REF93462875,0.0,1251.19,229588.11
2018-08-31,2018-08-31,Business materials,REF40241016,759.69,0.0,228828.42
2018-09-02,2018-09-02,Business materials,REF50039791,1225.31,0.0,227603.11
2018-09-05,2018-09-05,Business materials,REF56562772,257.72,0.0,227345.39
2018-09-06,2018-09-06,Permits Licenses expense,REF93721317,104.19,0.0,227241.2
2018-09-06,2018-09-06,Subcontractors expense,REF37443763,1386.4,0.0,225854.8
2018-09-15,2018-09-15,Business insurance premium,REF25997977,227.84,0.0,225626.96
2018-09-15,2018-09-15,Fuel purchase,REF63298853,124.23,0.0,225502.73
2018-09-15,2018-09-15,"Service payment - Nelson, Parks and Campbell",REF95888671,0.0,493.18,225995.91
2018-09-15,2018-09-15,"Invoice payment - Mullins, Buckley and Hahn",REF11925470,0.0,722.68,226718.59
2018-09-15,2018-09-15,Project payment - Roman-Gonzalez,REF37771677,0.0,1051.3,227769.89
2018-09-15,2018-09-15,Project payment - Porter Inc,REF75750684,0.0,780.6,228550.49
2018-09-16,2018-09-16,Equipment Rental expense,REF75339827,337.75,0.0,228212.74
2018-09-16,2018-09-16,Vehicle Maintenance expense,REF29223103,125.14,0.0,228087.6
2018-09-17,2018-09-17,Business materials,REF87247395,1133.06,0.0,226954.54
2018-09-20,2018-09-20,Permits Licenses expense,REF19763776,71.39,0.0,226883.15
2018-09-21,2018-09-21,Vehicle Maintenance expense,REF43489549,221.09,0.0,226662.06
2018-09-23,2018-09-23,Equipment Rental expense,REF76874052,480.4,0.0,226181.66
2018-09-25,2018-09-25,Business materials,REF85812650,643.77,0.0,225537.89
2018-09-30,2018-09-30,"Payment from Nelson, Parks and Campbell",REF61554548,0.0,1224.38,226762.27
2018-09-30,2018-09-30,Invoice payment - Porter Inc,REF70214871,0.0,604.96,227367.23
2018-09-30,2018-09-30,Service payment - Roman-Gonzalez,REF56725630,0.0,1071.98,228439.21
2018-09-30,2018-09-30,Project payment - Abbott-Gomez,REF47437149,0.0,981.41,229420.62
2018-09-30,2018-09-30,"Invoice payment - Mullins, Buckley and Hahn",REF99392777,0.0,976.02,230396.64
2018-10-02,2018-10-02,Safety Equipment expense,REF12501816,117.31,0.0,230279.33
2018-10-08,2018-10-08,Safety Equipment expense,REF14356382,78.62,0.0,230200.71
2018-10-09,2018-10-09,Equipment Rental expense,REF68968568,480.14,0.0,229720.57
2018-10-12,2018-10-12,Permits Licenses expense,REF78429464,86.37,0.0,229634.2
2018-10-13,2018-10-13,Fuel purchase,REF46372838,399.12,0.0,229235.08
2018-10-15,2018-10-15,Project payment - Porter Inc,REF17765064,0.0,799.69,230034.77
2018-10-15,2018-10-15,Tools expense,REF68320143,76.56,0.0,229958.21
2018-10-15,2018-10-15,Payment from Abbott-Gomez,REF70010580,0.0,1156.14,231114.35
2018-10-15,2018-10-15,"Project payment - Mullins, Buckley and Hahn",REF21819020,0.0,769.98,231884.33
2018-10-15,2018-10-15,Project payment - Roman-Gonzalez,REF53332734,0.0,927.79,232812.12
2018-10-15,2018-10-15,Business insurance premium,REF12747818,216.15,0.0,232595.97
2018-10-18,2018-10-18,Fuel purchase,REF90329614,509.42,0.0,232086.55
2018-10-22,2018-10-22,Subcontractors expense,REF45438871,883.59,0.0,231202.96
2018-10-24,2018-10-24,Vehicle Maintenance expense,REF99440913,110.06,0.0,231092.9
2018-10-26,2018-10-26,Vehicle Maintenance expense,REF46577634,183.05,0.0,230909.85
2018-10-27,2018-10-27,Fuel purchase,REF31397453,273.77,0.0,230636.08
2018-10-30,2018-10-30,Project payment - Roman-Gonzalez,REF60346045,0.0,957.47,231593.55
2018-10-30,2018-10-30,"Service payment - Nelson, Parks and Campbell",REF18270828,0.0,1233.23,232826.78
2018-10-30,2018-10-30,"Payment from Mullins, Buckley and Hahn",REF11165398,0.0,908.48,233735.26
2018-10-30,2018-10-30,Project payment - Abbott-Gomez,REF57726359,0.0,1327.26,235062.52
2018-11-02,2018-11-02,Business materials,REF37436520,670.07,0.0,234392.45
2018-11-04,2018-11-04,Fuel purchase,REF26373903,253.64,0.0,234138.81
2018-11-07,2018-11-07,Fuel purchase,REF64380438,192.62,0.0,233946.19
2018-11-11,2018-11-11,Business materials,REF12623211,665.9,0.0,233280.29
2018-11-14,2018-11-14,Business materials,REF79531175,530.71,0.0,232749.58
2018-11-15,2018-11-15,Business insurance premium,REF36521156,163.48,0.0,232586.1
2018-11-15,2018-11-15,"Payment from Mullins, Buckley and Hahn",REF57970791,0.0,633.2,233219.3
2018-11-15,2018-11-15,"Service payment - Nelson, Parks and Campbell",REF47108122,0.0,1049.51,234268.81
2018-11-15,2018-11-15,Payment from Porter Inc,REF92397338,0.0,597.72,234866.53
2018-11-20,2018-11-20,Fuel purchase,REF49690426,234.93,0.0,234631.6
2018-11-22,2018-11-22,Business materials,REF80819461,591.53,0.0,234040.07
2018-11-23,2018-11-23,Equipment Rental expense,REF73728283,269.57,0.0,233770.5
2018-11-24,2018-11-24,Fuel purchase,REF72580878,354.09,0.0,233416.41
2018-11-27,2018-11-27,Business materials,REF13791701,268.74,0.0,233147.67
2018-11-29,2018-11-29,Subcontractors expense,REF44665170,1091.63,0.0,232056.04
2018-11-30,2018-11-30,Project payment - Abbott-Gomez,REF99865115,0.0,951.72,233007.76
2018-11-30,2018-11-30,"Project payment - Mullins, Buckley and Hahn",REF65132881,0.0,858.98,233866.74
2018-11-30,2018-11-30,Project payment - Porter Inc,REF10214628,0.0,583.45,234450.19
2018-11-30,2018-11-30,"Payment from Nelson, Parks and Campbell",REF42750367,0.0,1087.78,235537.97
2018-11-30,2018-11-30,Safety Equipment expense,REF38141657,92.25,0.0,235445.72
2018-12-06,2018-12-06,Vehicle Maintenance expense,REF84186298,39.85,0.0,235405.87
2018-12-07,2018-12-07,Vehicle Maintenance expense,REF94049231,123.42,0.0,235282.45
2018-12-09,2018-12-09,Permits Licenses expense,REF69704996,57.26,0.0,235225.19
2018-12-10,2018-12-10,Equipment Rental expense,REF41177837,268.35,0.0,234956.84
2018-12-12,2018-12-12,Business materials,REF31638194,554.01,0.0,234402.83
2018-12-15,2018-12-15,Business insurance premium,REF39677372,118.98,0.0,234283.85
2018-12-15,2018-12-15,"Invoice payment - Nelson, Parks and Campbell",REF33783206,0.0,659.73,234943.58
2018-12-15,2018-12-15,Project payment - Abbott-Gomez,REF97539617,0.0,713.8,235657.38
2018-12-15,2018-12-15,Service payment - Porter Inc,REF41279697,0.0,410.03,236067.41
2018-12-15,2018-12-15,"Project payment - Mullins, Buckley and Hahn",REF26120468,0.0,535.37,236602.78
2018-12-15,2018-12-15,Invoice payment - Roman-Gonzalez,REF93689236,0.0,541.0,237143.78
2018-12-17,2018-12-17,Business materials,REF99992269,507.76,0.0,236636.02
2018-12-18,2018-12-18,Business materials,REF49468491,399.96,0.0,236236.06
2018-12-21,2018-12-21,Fuel purchase,REF68360178,215.6,0.0,236020.46
2018-12-22,2018-12-22,Fuel purchase,REF89413965,227.28,0.0,235793.18
2018-12-23,2018-12-23,Tools expense,REF92657056,55.34,0.0,235737.84
2018-12-23,2018-12-23,Vehicle Maintenance expense,REF74449619,65.74,0.0,235672.1
2018-12-28,2018-12-28,Safety Equipment expense,REF25855929,49.22,0.0,235622.88
2018-12-29,2018-12-29,Fuel purchase,REF52088813,149.7,0.0,235473.18
2018-12-30,2018-12-30,"Project payment - Nelson, Parks and Campbell",REF22839417,0.0,800.66,236273.84
2018-12-30,2018-12-30,"Service payment - Mullins, Buckley and Hahn",REF49206434,0.0,528.91,236802.75
2018-12-30,2018-12-30,Payment from Porter Inc,REF25135068,0.0,402.13,237204.88
2018-12-30,2018-12-30,Payment from Roman-Gonzalez,REF18878276,0.0,544.14,237749.02
2018-12-30,2018-12-30,Service payment - Abbott-Gomez,REF98886905,0.0,683.94,238432.96
2019-01-02,2019-01-02,Business materials,REF40666521,677.26,0.0,237755.7
2019-01-04,2019-01-04,Safety Equipment expense,REF47855785,38.29,0.0,237717.41
2019-01-10,2019-01-10,Business materials,REF73919440,360.93,0.0,237356.48
2019-01-14,2019-01-14,Business materials,REF51354486,662.32,0.0,236694.16
2019-01-15,2019-01-15,Invoice payment - Abbott-Gomez,REF89330005,0.0,666.6,237360.76
2019-01-15,2019-01-15,"Payment from Mullins, Buckley and Hahn",REF75429410,0.0,596.92,237957.68
2019-01-15,2019-01-15,Project payment - Porter Inc,REF91941952,0.0,417.71,238375.39
2019-01-15,2019-01-15,Invoice payment - Roman-Gonzalez,REF37331926,0.0,601.19,238976.58
2019-01-15,2019-01-15,"Service payment - Nelson, Parks and Campbell",REF51139107,0.0,698.03,239674.61
2019-01-15,2019-01-15,Business insurance premium,REF18218891,140.3,0.0,239534.31
2019-01-18,2019-01-18,Business materials,REF99611594,906.34,0.0,238627.97
2019-01-19,2019-01-19,Fuel purchase,REF55452699,86.59,0.0,238541.38
2019-01-20,2019-01-20,Equipment Rental expense,REF87382084,270.06,0.0,238271.32
2019-01-22,2019-01-22,Fuel purchase,REF79595844,170.98,0.0,238100.34
2019-01-28,2019-01-28,Fuel purchase,REF17213781,203.98,0.0,237896.36
2019-01-30,2019-01-30,Project payment - Abbott-Gomez,REF95826021,0.0,676.71,238573.07
2019-01-30,2019-01-30,"Invoice payment - Nelson, Parks and Campbell",REF92110148,0.0,658.41,239231.48
2019-01-30,2019-01-30,Invoice payment - Porter Inc,REF28197947,0.0,618.41,239849.89
2019-01-30,2019-01-30,"Invoice payment - Mullins, Buckley and Hahn",REF59015085,0.0,431.91,240281.8
2019-01-31,2019-01-31,Tools expense,REF18010371,104.93,0.0,240176.87
2019-01-31,2019-01-31,Fuel purchase,REF18554135,295.97,0.0,239880.9
2019-02-01,2019-02-01,Fuel purchase,REF89959569,256.45,0.0,239624.45
2019-02-05,2019-02-05,Subcontractors expense,REF38773669,1124.5,0.0,238499.95
2019-02-10,2019-02-10,Business materials,REF24640715,669.99,0.0,237829.96
2019-02-11,2019-02-11,Permits Licenses expense,REF60120466,80.91,0.0,237749.05
2019-02-12,2019-02-12,Business materials,REF40532946,547.8,0.0,237201.25
2019-02-15,2019-02-15,Business insurance premium,REF24750206,161.99,0.0,237039.26
2019-02-15,2019-02-15,"Service payment - Mullins, Buckley and Hahn",REF12392236,0.0,725.08,237764.34
2019-02-15,2019-02-15,"Invoice payment - Nelson, Parks and Campbell",REF39161653,0.0,745.67,238510.01
2019-02-15,2019-02-15,Payment from Roman-Gonzalez,REF69735074,0.0,855.75,239365.76
2019-02-15,2019-02-15,Invoice payment - Abbott-Gomez,REF14755786,0.0,885.81,240251.57
2019-02-19,2019-02-19,Fuel purchase,REF86531688,225.62,0.0,240025.95
2019-02-20,2019-02-20,Business materials,REF35465004,649.57,0.0,239376.38
2019-02-23,2019-02-23,Fuel purchase,REF40328552,140.57,0.0,239235.81
2019-02-28,2019-02-28,Project payment - Roman-Gonzalez,REF65887130,0.0,589.81,239825.62
2019-02-28,2019-02-28,"Payment from Nelson, Parks and Campbell",REF83305009,0.0,812.2,240637.82
2019-02-28,2019-02-28,Project payment - Porter Inc,REF68071576,0.0,578.98,241216.8
2019-02-28,2019-02-28,"Invoice payment - Mullins, Buckley and Hahn",REF31750071,0.0,683.24,241900.04
2019-02-28,2019-02-28,Invoice payment - Abbott-Gomez,REF59971841,0.0,872.35,242772.39
2019-03-09,2019-03-09,Fuel purchase,REF67174416,319.66,0.0,242452.73
2019-03-09,2019-03-09,Subcontractors expense,REF86520941,1405.69,0.0,241047.04
2019-03-15,2019-03-15,Invoice payment - Roman-Gonzalez,REF77226981,0.0,824.35,241871.39
2019-03-15,2019-03-15,Payment from Porter Inc,REF39384043,0.0,721.79,242593.18
2019-03-15,2019-03-15,"Service payment - Nelson, Parks and Campbell",REF57659563,0.0,1431.11,244024.29
2019-03-15,2019-03-15,Business insurance premium,REF55803389,194.17,0.0,243830.12
2019-03-15,2019-03-15,"Payment from Mullins, Buckley and Hahn",REF42140936,0.0,1001.52,244831.64
2019-03-15,2019-03-15,Payment from Abbott-Gomez,REF80180381,0.0,1195.91,246027.55
2019-03-17,2019-03-17,Fuel purchase,REF23615385,338.94,0.0,245688.61
2019-03-27,2019-03-27,Fuel purchase,REF91438287,306.58,0.0,245382.03
2019-03-30,2019-03-30,Service payment - Porter Inc,REF83890273,0.0,717.72,246099.75
2019-03-30,2019-03-30,Invoice payment - Abbott-Gomez,REF43399224,0.0,1006.5,247106.25
2019-03-30,2019-03-30,"Payment from Nelson, Parks and Campbell",REF72881547,0.0,950.81,248057.06
2019-03-30,2019-03-30,Invoice payment - Roman-Gonzalez,REF93889966,0.0,943.62,249000.68
2019-04-03,2019-04-03,Fuel purchase,REF26115127,379.58,0.0,248621.1
2019-04-08,2019-04-08,Business materials,REF28592810,96.72,0.0,248524.38
2019-04-09,2019-04-09,Subcontractors expense,REF84639559,1394.42,0.0,247129.96
2019-04-11,2019-04-11,Fuel purchase,REF90553240,232.81,0.0,246897.15
2019-04-14,2019-04-14,Business materials,REF61637452,1144.26,0.0,245752.89
2019-04-15,2019-04-15,"Payment from Mullins, Buckley and Hahn",REF89157772,0.0,865.57,246618.46
2019-04-15,2019-04-15,Service payment - Porter Inc,REF77530733,0.0,963.52,247581.98
2019-04-15,2019-04-15,Service payment - Abbott-Gomez,REF42953283,0.0,1360.84,248942.82
2019-04-15,2019-04-15,"Project payment - Nelson, Parks and Campbell",REF51367071,0.0,1239.59,250182.41
2019-04-15,2019-04-15,Project payment - Roman-Gonzalez,REF38890457,0.0,1011.93,251194.34
2019-04-15,2019-04-15,Business insurance premium,REF77186833,240.8,0.0,250953.54
2019-04-20,2019-04-20,Fuel purchase,REF70885514,393.21,0.0,250560.33
2019-04-21,2019-04-21,Fuel purchase,REF93428269,313.09,0.0,250247.24
2019-04-28,2019-04-28,Permits Licenses expense,REF26224327,95.12,0.0,250152.12
2019-04-30,2019-04-30,"Payment from Nelson, Parks and Campbell",REF72594468,0.0,1235.72,251387.84
2019-04-30,2019-04-30,Service payment - Abbott-Gomez,REF56227897,0.0,1376.29,252764.13
2019-04-30,2019-04-30,Service payment - Roman-Gonzalez,REF29453416,0.0,884.86,253648.99
2019-04-30,2019-04-30,Service payment - Porter Inc,REF25474772,0.0,788.22,254437.21
2019-04-30,2019-04-30,"Service payment - Mullins, Buckley and Hahn",REF33745830,0.0,816.35,255253.56
2019-05-01,2019-05-01,Business materials,REF60872899,1086.49,0.0,254167.07
2019-05-09,2019-05-09,Safety Equipment expense,REF56693539,121.06,0.0,254046.01
2019-05-14,2019-05-14,Safety Equipment expense,REF54531033,35.71,0.0,254010.3
2019-05-15,2019-05-15,Business insurance premium,REF68673741,257.13,0.0,253753.17
2019-05-15,2019-05-15,"Project payment - Nelson, Parks and Campbell",REF45477910,0.0,1376.99,255130.16
2019-05-15,2019-05-15,Project payment - Abbott-Gomez,REF91116165,0.0,1616.94,256747.1
2019-05-15,2019-05-15,Project payment - Roman-Gonzalez,REF21529655,0.0,1153.55,257900.65
2019-05-15,2019-05-15,Project payment - Porter Inc,REF78775176,0.0,947.89,258848.54
2019-05-21,2019-05-21,Equipment Rental expense,REF33581437,470.4,0.0,258378.14
2019-05-23,2019-05-23,Permits Licenses expense,REF82715146,159.63,0.0,258218.51
2019-05-24,2019-05-24,Fuel purchase,REF25197524,460.37,0.0,257758.14
2019-05-25,2019-05-25,Tools expense,REF89639018,138.81,0.0,257619.33
2019-05-25,2019-05-25,Fuel purchase,REF18928304,377.86,0.0,257241.47
2019-05-28,2019-05-28,Permits Licenses expense,REF30744816,95.76,0.0,257145.71
2019-05-30,2019-05-30,"Invoice payment - Mullins, Buckley and Hahn",REF84686402,0.0,1133.55,258279.26
2019-05-30,2019-05-30,Payment from Roman-Gonzalez,REF89224096,0.0,1395.63,259674.89
2019-05-30,2019-05-30,Payment from Abbott-Gomez,REF43917813,0.0,2032.69,261707.58
2019-05-30,2019-05-30,Safety Equipment expense,REF32715976,67.25,0.0,261640.33
2019-05-30,2019-05-30,"Payment from Nelson, Parks and Campbell",REF22028421,0.0,985.88,262626.21
2019-05-30,2019-05-30,Payment from Porter Inc,REF27163462,0.0,1253.94,263880.15
2019-06-01,2019-06-01,Vehicle Maintenance expense,REF23790459,146.76,0.0,263733.39
2019-06-08,2019-06-08,Business materials,REF20528583,1079.72,0.0,262653.67
2019-06-09,2019-06-09,Fuel purchase,REF14194680,426.21,0.0,262227.46
2019-06-09,2019-06-09,Subcontractors expense,REF47577082,1437.24,0.0,260790.22
2019-06-15,2019-06-15,"Service payment - Mullins, Buckley and Hahn",REF51956694,0.0,891.16,261681.38
2019-06-15,2019-06-15,Payment from Roman-Gonzalez,REF73724968,0.0,1168.2,262849.58
2019-06-15,2019-06-15,Project payment - Abbott-Gomez,REF50890092,0.0,1522.34,264371.92
2019-06-15,2019-06-15,Business insurance premium,REF67619217,284.58,0.0,264087.34
2019-06-16,2019-06-16,Business materials,REF18585745,943.47,0.0,263143.87
2019-06-16,2019-06-16,Subcontractors expense,REF82132394,1657.18,0.0,261486.69
2019-06-17,2019-06-17,Business materials,REF73471055,938.34,0.0,260548.35
2019-06-19,2019-06-19,Fuel purchase,REF66170298,394.28,0.0,260154.07
2019-06-20,2019-06-20,Fuel purchase,REF31142030,437.03,0.0,259717.04
2019-06-22,2019-06-22,Permits Licenses expense,REF59222619,72.16,0.0,259644.88
2019-06-29,2019-06-29,Fuel purchase,REF24974046,360.5,0.0,259284.38
2019-06-30,2019-06-30,"Project payment - Nelson, Parks and Campbell",REF83419437,0.0,1372.81,260657.19
2019-06-30,2019-06-30,Invoice payment - Roman-Gonzalez,REF95726156,0.0,1019.11,261676.3
2019-06-30,2019-06-30,Payment from Abbott-Gomez,REF25596606,0.0,1118.01,262794.31
2019-06-30,2019-06-30,Project payment - Porter Inc,REF64389010,0.0,1007.73,263802.04
2019-06-30,2019-06-30,"Payment from Mullins, Buckley and Hahn",REF59514205,0.0,1005.99,264808.03
2019-07-04,2019-07-04,Business materials,REF63327641,812.46,0.0,263995.57
2019-07-07,2019-07-07,Safety Equipment expense,REF21994425,70.25,0.0,263925.32
2019-07-08,2019-07-08,Permits Licenses expense,REF14902295,156.17,0.0,263769.15
2019-07-11,2019-07-11,Equipment Rental expense,REF15631886,584.06,0.0,263185.09
2019-07-14,2019-07-14,Business materials,REF35250062,495.17,0.0,262689.92
2019-07-14,2019-07-14,Permits Licenses expense,REF66323971,55.62,0.0,262634.3
2019-07-15,2019-07-15,Fuel purchase,REF17807040,271.53,0.0,262362.77
2019-07-15,2019-07-15,Business insurance premium,REF45688514,245.1,0.0,262117.67
2019-07-15,2019-07-15,"Invoice payment - Nelson, Parks and Campbell",REF91171041,0.0,1474.44,263592.11
2019-07-15,2019-07-15,Service payment - Roman-Gonzalez,REF24716933,0.0,1099.01,264691.12
2019-07-15,2019-07-15,Project payment - Abbott-Gomez,REF56873364,0.0,1567.34,266258.46
2019-07-15,2019-07-15,"Invoice payment - Mullins, Buckley and Hahn",REF50844346,0.0,1187.04,267445.5
2019-07-15,2019-07-15,Service payment - Porter Inc,REF35142543,0.0,714.31,268159.81
2019-07-17,2019-07-17,Fuel purchase,REF73919694,392.91,0.0,267766.9
2019-07-18,2019-07-18,Business materials,REF92059199,1055.57,0.0,266711.33
2019-07-19,2019-07-19,Fuel purchase,REF58751831,348.62,0.0,266362.71
2019-07-21,2019-07-21,Business materials,REF33228150,1168.7,0.0,265194.01
2019-07-27,2019-07-27,Business materials,REF13496872,1794.61,0.0,263399.4
2019-07-27,2019-07-27,Fuel purchase,REF20282391,452.24,0.0,262947.16
2019-07-30,2019-07-30,Equipment Rental expense,REF47189944,550.03,0.0,262397.13
2019-07-30,2019-07-30,"Project payment - Nelson, Parks and Campbell",REF72038306,0.0,1708.49,264105.62
2019-07-30,2019-07-30,Project payment - Roman-Gonzalez,REF28101365,0.0,1173.3,265278.92
2019-07-30,2019-07-30,Service payment - Abbott-Gomez,REF25801593,0.0,1384.42,266663.34
2019-07-30,2019-07-30,Project payment - Porter Inc,REF35672844,0.0,682.26,267345.6
2019-07-31,2019-07-31,Business materials,REF60878069,805.59,0.0,266540.01
2019-08-05,2019-08-05,Business materials,REF33978430,1262.14,0.0,265277.87
2019-08-09,2019-08-09,Business materials,REF30284328,503.61,0.0,264774.26
2019-08-10,2019-08-10,Equipment Rental expense,REF83470984,402.02,0.0,264372.24
2019-08-12,2019-08-12,Business materials,REF29848505,970.9,0.0,263401.34
2019-08-12,2019-08-12,Fuel purchase,REF51331238,337.29,0.0,263064.05
2019-08-15,2019-08-15,Business insurance premium,REF56885507,232.19,0.0,262831.86
2019-08-15,2019-08-15,"Payment from Mullins, Buckley and Hahn",REF49791837,0.0,967.8,263799.66
2019-08-15,2019-08-15,Payment from Roman-Gonzalez,REF92085629,0.0,1013.97,264813.63
2019-08-15,2019-08-15,Project payment - Porter Inc,REF81099475,0.0,893.44,265707.07
2019-08-15,2019-08-15,Service payment - Abbott-Gomez,REF70063411,0.0,1488.26,267195.33
2019-08-17,2019-08-17,Business materials,REF39109389,276.76,0.0,266918.57
2019-08-21,2019-08-21,Tools expense,REF78346004,110.62,0.0,266807.95
2019-08-23,2019-08-23,Business materials,REF65898828,1257.44,0.0,265550.51
2019-08-24,2019-08-24,Vehicle Maintenance expense,REF48998133,75.85,0.0,265474.66
2019-08-29,2019-08-29,Safety Equipment expense,REF39624680,122.54,0.0,265352.12
2019-08-30,2019-08-30,Invoice payment - Abbott-Gomez,REF80352960,0.0,1549.52,266901.64
2019-08-30,2019-08-30,"Service payment - Mullins, Buckley and Hahn",REF80292191,0.0,1146.97,268048.61
2019-08-30,2019-08-30,Safety Equipment expense,REF30240063,111.55,0.0,267937.06
2019-08-30,2019-08-30,Service payment - Roman-Gonzalez,REF58139266,0.0,784.78,268721.84
2019-08-30,2019-08-30,"Payment from Nelson, Parks and Campbell",REF51100259,0.0,1332.4,270054.24
2019-08-30,2019-08-30,Project payment - Porter Inc,REF77982849,0.0,845.92,270900.16
2019-09-01,2019-09-01,Permits Licenses expense,REF92158351,46.37,0.0,270853.79
2019-09-06,2019-09-06,Business materials,REF29508811,894.28,0.0,269959.51
2019-09-09,2019-09-09,Permits Licenses expense,REF48124666,70.39,0.0,269889.12
2019-09-12,2019-09-12,Fuel purchase,REF91313536,204.75,0.0,269684.37
2019-09-13,2019-09-13,Business materials,REF71345308,719.19,0.0,268965.18
2019-09-15,2019-09-15,Invoice payment - Roman-Gonzalez,REF74124631,0.0,936.31,269901.49
2019-09-15,2019-09-15,Business insurance premium,REF97088232,210.07,0.0,269691.42
2019-09-15,2019-09-15,Service payment - Abbott-Gomez,REF97307458,0.0,962.5,270653.92
2019-09-15,2019-09-15,Service payment - Porter Inc,REF88036074,0.0,885.54,271539.46
2019-09-15,2019-09-15,"Payment from Mullins, Buckley and Hahn",REF53027336,0.0,870.49,272409.95
2019-09-19,2019-09-19,Safety Equipment expense,REF47184380,68.66,0.0,272341.29
2019-09-21,2019-09-21,Safety Equipment expense,REF59207556,134.37,0.0,272206.92
2019-09-25,2019-09-25,Permits Licenses expense,REF98769320,67.34,0.0,272139.58
2019-09-25,2019-09-25,Fuel purchase,REF56508859,308.39,0.0,271831.19
2019-09-27,2019-09-27,Fuel purchase,REF25902136,289.45,0.0,271541.74
2019-09-30,2019-09-30,"Service payment - Nelson, Parks and Campbell",REF25918496,0.0,1293.8,272835.54
2019-09-30,2019-09-30,"Invoice payment - Mullins, Buckley and Hahn",REF89567780,0.0,947.97,273783.51
2019-09-30,2019-09-30,Project payment - Abbott-Gomez,REF17182517,0.0,1129.77,274913.28
2019-09-30,2019-09-30,Payment from Porter Inc,REF85895089,0.0,755.57,275668.85
2019-09-30,2019-09-30,Payment from Roman-Gonzalez,REF19829652,0.0,1314.03,276982.88
2019-10-03,2019-10-03,Safety Equipment expense,REF99414066,27.5,0.0,276955.38
2019-10-06,2019-10-06,Business materials,REF69936534,748.56,0.0,276206.82
2019-10-10,2019-10-10,Permits Licenses expense,REF95735790,80.0,0.0,276126.82
2019-10-12,2019-10-12,Business materials,REF52917163,503.15,0.0,275623.67
2019-10-15,2019-10-15,Payment from Porter Inc,REF44419855,0.0,845.12,276468.79
2019-10-15,2019-10-15,"Service payment - Mullins, Buckley and Hahn",REF53764150,0.0,774.11,277242.9
2019-10-15,2019-10-15,Business insurance premium,REF82215519,201.14,0.0,277041.76
2019-10-15,2019-10-15,Invoice payment - Roman-Gonzalez,REF88496065,0.0,857.15,277898.91
2019-10-15,2019-10-15,"Service payment - Nelson, Parks and Campbell",REF64179130,0.0,1222.91,279121.82
2019-10-16,2019-10-16,Business materials,REF58373275,523.59,0.0,278598.23
2019-10-19,2019-10-19,Equipment Rental expense,REF20178767,440.2,0.0,278158.03
2019-10-24,2019-10-24,Vehicle Maintenance expense,REF95934245,289.36,0.0,277868.67
2019-10-25,2019-10-25,Equipment Rental expense,REF43746421,460.58,0.0,277408.09
2019-10-26,2019-10-26,Safety Equipment expense,REF37973121,72.25,0.0,277335.84
2019-10-28,2019-10-28,Safety Equipment expense,REF36613592,102.34,0.0,277233.5
2019-10-30,2019-10-30,"Service payment - Nelson, Parks and Campbell",REF18727831,0.0,1275.55,278509.05
2019-10-30,2019-10-30,Project payment - Roman-Gonzalez,REF26064048,0.0,940.64,279449.69
2019-10-30,2019-10-30,Service payment - Porter Inc,REF93867958,0.0,755.45,280205.14
2019-10-30,2019-10-30,Service payment - Abbott-Gomez,REF84023144,0.0,1078.66,281283.8
2019-11-04,2019-11-04,Equipment Rental expense,REF54859050,226.24,0.0,281057.56
2019-11-06,2019-11-06,Permits Licenses expense,REF25172144,48.09,0.0,281009.47
2019-11-13,2019-11-13,Vehicle Maintenance expense,REF73906200,127.43,0.0,280882.04
2019-11-14,2019-11-14,Safety Equipment expense,REF90416883,81.3,0.0,280800.74
2019-11-15,2019-11-15,Service payment - Roman-Gonzalez,REF51253621,0.0,858.69,281659.43
2019-11-15,2019-11-15,Invoice payment - Abbott-Gomez,REF97506407,0.0,1067.36,282726.79
2019-11-15,2019-11-15,"Invoice payment - Mullins, Buckley and Hahn",REF61268405,0.0,852.52,283579.31
2019-11-15,2019-11-15,Invoice payment - Porter Inc,REF59500447,0.0,583.88,284163.19
2019-11-15,2019-11-15,Business materials,REF55041624,609.5,0.0,283553.69
2019-11-15,2019-11-15,"Project payment - Nelson, Parks and Campbell",REF31086807,0.0,1132.59,284686.28
2019-11-15,2019-11-15,Business insurance premium,REF97152081,161.33,0.0,284524.95
2019-11-18,2019-11-18,Fuel purchase,REF86655615,233.25,0.0,284291.7
2019-11-20,2019-11-20,Fuel purchase,REF33686568,148.87,0.0,284142.83
2019-11-21,2019-11-21,Fuel purchase,REF53436445,296.01,0.0,283846.82
2019-11-21,2019-11-21,Permits Licenses expense,REF89270082,79.35,0.0,283767.47
2019-11-21,2019-11-21,Business materials,REF72191857,371.1,0.0,283396.37
2019-11-29,2019-11-29,Tools expense,REF92089160,84.05,0.0,283312.32
2019-11-30,2019-11-30,"Service payment - Nelson, Parks and Campbell",REF37747825,0.0,881.74,284194.06
2019-11-30,2019-11-30,"Project payment - Mullins, Buckley and Hahn",REF22713924,0.0,670.21,284864.27
2019-11-30,2019-11-30,Project payment - Porter Inc,REF45163251,0.0,595.02,285459.29
2019-11-30,2019-11-30,Payment from Abbott-Gomez,REF72992902,0.0,808.04,286267.33
2019-11-30,2019-11-30,Invoice payment - Roman-Gonzalez,REF13276256,0.0,858.76,287126.09
2019-12-01,2019-12-01,Fuel purchase,REF54956727,177.9,0.0,286948.19
2019-12-05,2019-12-05,Fuel purchase,REF61287028,234.76,0.0,286713.43
2019-12-06,2019-12-06,Fuel purchase,REF96717622,140.03,0.0,286573.4
2019-12-15,2019-12-15,Business insurance premium,REF67282253,119.48,0.0,286453.92
2019-12-15,2019-12-15,Invoice payment - Porter Inc,REF74474390,0.0,416.01,286869.93
2019-12-15,2019-12-15,Project payment - Abbott-Gomez,REF30914429,0.0,758.5,287628.43
2019-12-15,2019-12-15,"Service payment - Nelson, Parks and Campbell",REF51184017,0.0,700.35,288328.78
2019-12-15,2019-12-15,"Project payment - Mullins, Buckley and Hahn",REF87419543,0.0,617.72,288946.5
2019-12-18,2019-12-18,Fuel purchase,REF83773033,217.13,0.0,288729.37
2019-12-30,2019-12-30,"Service payment - Nelson, Parks and Campbell",REF97754445,0.0,740.29,289469.66
2019-12-30,2019-12-30,"Project payment - Mullins, Buckley and Hahn",REF38363799,0.0,648.77,290118.43
2019-12-30,2019-12-30,Payment from Abbott-Gomez,REF67252982,0.0,690.91,290809.34
2019-12-30,2019-12-30,Payment from Porter Inc,REF57269652,0.0,519.32,291328.66
2020-01-04,2020-01-04,Equipment Rental expense,REF93223758,263.5,0.0,291065.16
2020-01-06,2020-01-06,Safety Equipment expense,REF19834475,66.25,0.0,290998.91
2020-01-08,2020-01-08,Fuel purchase,REF84506051,176.37,0.0,290822.54
2020-01-09,2020-01-09,Vehicle Maintenance expense,REF99728295,129.82,0.0,290692.72
2020-01-13,2020-01-13,Equipment Rental expense,REF47382664,208.53,0.0,290484.19
2020-01-13,2020-01-13,Fuel purchase,REF14556975,120.46,0.0,290363.73
2020-01-15,2020-01-15,Tools expense,REF16373344,90.69,0.0,290273.04
2020-01-15,2020-01-15,Business insurance premium,REF85736043,148.37,0.0,290124.67
2020-01-15,2020-01-15,Invoice payment - Roman-Gonzalez,REF68085438,0.0,655.67,290780.34
2020-01-15,2020-01-15,"Service payment - Mullins, Buckley and Hahn",REF52645494,0.0,820.89,291601.23
2020-01-15,2020-01-15,Service payment - Abbott-Gomez,REF18252241,0.0,710.59,292311.82
2020-01-18,2020-01-18,Fuel purchase,REF95942213,134.47,0.0,292177.35
2020-01-19,2020-01-19,Permits Licenses expense,REF11111964,50.42,0.0,292126.93
2020-01-21,2020-01-21,Business materials,REF27973462,142.21,0.0,291984.72
2020-01-23,2020-01-23,Tools expense,REF44981089,75.9,0.0,291908.82
2020-01-26,2020-01-26,Business materials,REF85629693,633.6,0.0,291275.22
2020-01-27,2020-01-27,Fuel purchase,REF77715728,193.97,0.0,291081.25
2020-01-28,2020-01-28,Business materials,REF56803633,529.95,0.0,290551.3
2020-01-30,2020-01-30,Project payment - Abbott-Gomez,REF11960047,0.0,680.1,291231.4
2020-01-30,2020-01-30,"Service payment - Nelson, Parks and Campbell",REF23999772,0.0,617.08,291848.48
2020-01-30,2020-01-30,Payment from Roman-Gonzalez,REF54420996,0.0,684.42,292532.9
2020-01-30,2020-01-30,Service payment - Porter Inc,REF71701989,0.0,529.39,293062.29
2020-01-30,2020-01-30,"Service payment - Mullins, Buckley and Hahn",REF81574785,0.0,569.11,293631.4
2020-01-31,2020-01-31,Business materials,REF84914581,485.82,0.0,293145.58
2020-02-02,2020-02-02,Equipment Rental expense,REF52519006,412.27,0.0,292733.31
2020-02-06,2020-02-06,Business materials,REF22021809,513.19,0.0,292220.12
2020-02-06,2020-02-06,Fuel purchase,REF38710196,289.84,0.0,291930.28
2020-02-08,2020-02-08,Fuel purchase,REF66411392,182.77,0.0,291747.51
2020-02-14,2020-02-14,Fuel purchase,REF20307738,174.42,0.0,291573.09
2020-02-15,2020-02-15,Business insurance premium,REF92333118,160.0,0.0,291413.09
2020-02-15,2020-02-15,Payment from Abbott-Gomez,REF68728516,0.0,1117.39,292530.48
2020-02-15,2020-02-15,"Payment from Mullins, Buckley and Hahn",REF77825837,0.0,779.38,293309.86
2020-02-15,2020-02-15,Payment from Roman-Gonzalez,REF66685565,0.0,773.21,294083.07
2020-02-19,2020-02-19,Business materials,REF63877192,540.28,0.0,293542.79
2020-02-22,2020-02-22,Business materials,REF69736086,673.51,0.0,292869.28
2020-02-24,2020-02-24,Equipment Rental expense,REF13116475,477.56,0.0,292391.72
2020-02-27,2020-02-27,Fuel purchase,REF87521024,98.99,0.0,292292.73
2020-02-27,2020-02-27,Permits Licenses expense,REF61795897,41.14,0.0,292251.59
2020-02-28,2020-02-28,"Project payment - Mullins, Buckley and Hahn",REF98031813,0.0,581.32,292832.91
2020-02-28,2020-02-28,Payment from Abbott-Gomez,REF66496281,0.0,897.34,293730.25
2020-02-28,2020-02-28,Project payment - Porter Inc,REF76573119,0.0,585.59,294315.84
2020-02-28,2020-02-28,"Service payment - Nelson, Parks and Campbell",REF25783101,0.0,1211.16,295527.0
2020-02-28,2020-02-28,Safety Equipment expense,REF41112131,71.97,0.0,295455.03
2020-02-29,2020-02-29,Tools expense,REF50731018,27.24,0.0,295427.79
2020-03-06,2020-03-06,Fuel purchase,REF16316321,358.37,0.0,295069.42
2020-03-11,2020-03-11,Business materials,REF50765166,809.87,0.0,294259.55
2020-03-15,2020-03-15,Business insurance premium,REF24557578,203.63,0.0,294055.92
2020-03-15,2020-03-15,Project payment - Porter Inc,REF66190626,0.0,709.54,294765.46
2020-03-15,2020-03-15,"Payment from Mullins, Buckley and Hahn",REF65448739,0.0,986.24,295751.7
2020-03-15,2020-03-15,"Payment from Nelson, Parks and Campbell",REF69599287,0.0,1096.34,296848.04
2020-03-15,2020-03-15,Project payment - Roman-Gonzalez,REF68167708,0.0,1138.16,297986.2
2020-03-15,2020-03-15,Service payment - Abbott-Gomez,REF91457884,0.0,1294.81,299281.01
2020-03-15,2020-03-15,Fuel purchase,REF73222865,193.49,0.0,299087.52
2020-03-16,2020-03-16,Tools expense,REF16204822,100.24,0.0,298987.28
2020-03-16,2020-03-16,Safety Equipment expense,REF44480131,43.26,0.0,298944.02
2020-03-21,2020-03-21,Fuel purchase,REF83054437,287.92,0.0,298656.1
2020-03-26,2020-03-26,Vehicle Maintenance expense,REF66389196,88.94,0.0,298567.16
2020-03-29,2020-03-29,Business materials,REF93319422,883.07,0.0,297684.09
2020-03-30,2020-03-30,Permits Licenses expense,REF84068319,80.17,0.0,297603.92
2020-03-30,2020-03-30,"Service payment - Mullins, Buckley and Hahn",REF20759827,0.0,740.23,298344.15
2020-03-30,2020-03-30,Invoice payment - Abbott-Gomez,REF30385383,0.0,1127.99,299472.14
2020-03-30,2020-03-30,Service payment - Roman-Gonzalez,REF83175853,0.0,829.18,300301.32
2020-03-30,2020-03-30,"Invoice payment - Nelson, Parks and Campbell",REF46384781,0.0,1244.33,301545.65
2020-03-30,2020-03-30,Subcontractors expense,REF54048995,1096.14,0.0,300449.51
2020-03-30,2020-03-30,Service payment - Porter Inc,REF18139319,0.0,621.56,301071.07
2020-03-31,2020-03-31,Fuel purchase,REF66547792,228.19,0.0,300842.88
2020-04-01,2020-04-01,Business materials,REF95776626,782.29,0.0,300060.59
2020-04-02,2020-04-02,Safety Equipment expense,REF13757164,91.65,0.0,299968.94
2020-04-06,2020-04-06,Fuel purchase,REF39887585,424.8,0.0,299544.14
2020-04-10,2020-04-10,Equipment Rental expense,REF50495404,331.76,0.0,299212.38
2020-04-13,2020-04-13,Business materials,REF96962481,331.48,0.0,298880.9
2020-04-15,2020-04-15,Equipment Rental expense,REF77340165,434.59,0.0,298446.31
2020-04-15,2020-04-15,Business insurance premium,REF81171326,246.14,0.0,298200.17
2020-04-15,2020-04-15,Fuel purchase,REF79142314,211.66,0.0,297988.51
2020-04-15,2020-04-15,Payment from Abbott-Gomez,REF79722425,0.0,1077.37,299065.88
2020-04-15,2020-04-15,Service payment - Porter Inc,REF47322005,0.0,918.22,299984.1
2020-04-15,2020-04-15,"Payment from Mullins, Buckley and Hahn",REF24711563,0.0,1298.13,301282.23
2020-04-15,2020-04-15,Service payment - Roman-Gonzalez,REF92020006,0.0,1106.78,302389.01
2020-04-15,2020-04-15,"Service payment - Nelson, Parks and Campbell",REF87668855,0.0,1578.68,303967.69
2020-04-18,2020-04-18,Fuel purchase,REF31412406,203.52,0.0,303764.17
2020-04-19,2020-04-19,Business materials,REF83879117,945.13,0.0,302819.04
2020-04-21,2020-04-21,Business materials,REF55635016,1049.47,0.0,301769.57
2020-04-22,2020-04-22,Business materials,REF16578989,936.78,0.0,300832.79
2020-04-27,2020-04-27,Permits Licenses expense,REF45228889,128.82,0.0,300703.97
2020-04-28,2020-04-28,Fuel purchase,REF93888233,334.6,0.0,300369.37
2020-04-30,2020-04-30,Payment from Roman-Gonzalez,REF46084830,0.0,1058.65,301428.02
2020-04-30,2020-04-30,Service payment - Abbott-Gomez,REF90082575,0.0,1501.21,302929.23
2020-04-30,2020-04-30,Service payment - Porter Inc,REF66481544,0.0,842.55,303771.78
2020-04-30,2020-04-30,"Payment from Mullins, Buckley and Hahn",REF95216448,0.0,1120.83,304892.61
2020-04-30,2020-04-30,"Payment from Nelson, Parks and Campbell",REF11488244,0.0,1249.29,306141.9
2020-05-04,2020-05-04,Equipment Rental expense,REF28843896,582.46,0.0,305559.44
2020-05-05,2020-05-05,Business materials,REF19807114,1261.3,0.0,304298.14
2020-05-06,2020-05-06,Business materials,REF72646247,1073.83,0.0,303224.31
2020-05-07,2020-05-07,Permits Licenses expense,REF36661097,84.37,0.0,303139.94
2020-05-10,2020-05-10,Equipment Rental expense,REF63980272,472.27,0.0,302667.67
2020-05-13,2020-05-13,Business materials,REF13211214,941.14,0.0,301726.53
2020-05-15,2020-05-15,Invoice payment - Roman-Gonzalez,REF64844354,0.0,1300.94,303027.47
2020-05-15,2020-05-15,Business materials,REF73326593,1080.54,0.0,301946.93
2020-05-15,2020-05-15,Project payment - Porter Inc,REF12979062,0.0,943.78,302890.71
2020-05-15,2020-05-15,Project payment - Abbott-Gomez,REF41660773,0.0,1608.81,304499.52
2020-05-15,2020-05-15,"Project payment - Nelson, Parks and Campbell",REF48922021,0.0,1172.72,305672.24
2020-05-15,2020-05-15,Business insurance premium,REF37660696,274.68,0.0,305397.56
2020-05-17,2020-05-17,Tools expense,REF25556980,149.99,0.0,305247.57
2020-05-18,2020-05-18,Permits Licenses expense,REF83207645,104.08,0.0,305143.49
2020-05-19,2020-05-19,Fuel purchase,REF70127980,486.95,0.0,304656.54
2020-05-20,2020-05-20,Fuel purchase,REF31339680,621.06,0.0,304035.48
2020-05-21,2020-05-21,Vehicle Maintenance expense,REF64818129,259.99,0.0,303775.49
2020-05-22,2020-05-22,Subcontractors expense,REF34482702,732.57,0.0,303042.92
2020-05-22,2020-05-22,Fuel purchase,REF32885505,272.78,0.0,302770.14
2020-05-22,2020-05-22,Tools expense,REF52742247,116.86,0.0,302653.28
2020-05-27,2020-05-27,Permits Licenses expense,REF87539115,68.5,0.0,302584.78
2020-05-29,2020-05-29,Tools expense,REF49397939,95.57,0.0,302489.21
2020-05-30,2020-05-30,"Payment from Mullins, Buckley and Hahn",REF11527739,0.0,1212.82,303702.03
2020-05-30,2020-05-30,Permits Licenses expense,REF18044551,93.54,0.0,303608.49
2020-05-30,2020-05-30,Invoice payment - Roman-Gonzalez,REF87179027,0.0,1254.24,304862.73
2020-05-30,2020-05-30,"Project payment - Nelson, Parks and Campbell",REF70728307,0.0,1725.49,306588.22
2020-05-30,2020-05-30,Service payment - Abbott-Gomez,REF76192148,0.0,1377.15,307965.37
2020-05-30,2020-05-30,Payment from Porter Inc,REF23006273,0.0,778.51,308743.88
2020-05-30,2020-05-30,Tools expense,REF97630784,101.98,0.0,308641.9
2020-05-31,2020-05-31,Vehicle Maintenance expense,REF80865709,203.58,0.0,308438.32
2020-06-10,2020-06-10,Tools expense,REF77772426,177.54,0.0,308260.78
2020-06-11,2020-06-11,Fuel purchase,REF23436736,264.68,0.0,307996.1
2020-06-15,2020-06-15,Business insurance premium,REF39652495,279.89,0.0,307716.21
2020-06-15,2020-06-15,"Invoice payment - Nelson, Parks and Campbell",REF36288528,0.0,1361.43,309077.64
2020-06-15,2020-06-15,Project payment - Abbott-Gomez,REF29483527,0.0,1367.46,310445.1
2020-06-15,2020-06-15,"Payment from Mullins, Buckley and Hahn",REF67009686,0.0,1190.77,311635.87
2020-06-15,2020-06-15,Payment from Porter Inc,REF64493514,0.0,676.52,312312.39
2020-06-15,2020-06-15,Service payment - Roman-Gonzalez,REF20018385,0.0,976.67,313289.06
2020-06-16,2020-06-16,Tools expense,REF43794288,94.37,0.0,313194.69
2020-06-22,2020-06-22,Subcontractors expense,REF90107702,1672.87,0.0,311521.82
2020-06-22,2020-06-22,Vehicle Maintenance expense,REF11570613,277.22,0.0,311244.6
2020-06-24,2020-06-24,Tools expense,REF36479879,167.63,0.0,311076.97
2020-06-30,2020-06-30,"Service payment - Mullins, Buckley and Hahn",REF61530240,0.0,1185.33,312262.3
2020-06-30,2020-06-30,Project payment - Abbott-Gomez,REF56952419,0.0,1316.42,313578.72
2020-06-30,2020-06-30,Invoice payment - Roman-Gonzalez,REF95583185,0.0,1014.49,314593.21
2020-06-30,2020-06-30,Service payment - Porter Inc,REF75208846,0.0,626.66,315219.87
2020-07-01,2020-07-01,Fuel purchase,REF13380888,383.21,0.0,314836.66
2020-07-02,2020-07-02,Business materials,REF80162320,923.43,0.0,313913.23
2020-07-07,2020-07-07,Business materials,REF85644611,499.47,0.0,313413.76
2020-07-09,2020-07-09,Subcontractors expense,REF44334884,1264.72,0.0,312149.04
2020-07-10,2020-07-10,Business materials,REF84266737,1106.37,0.0,311042.67
2020-07-12,2020-07-12,Fuel purchase,REF99265919,204.37,0.0,310838.3
2020-07-14,2020-07-14,Tools expense,REF21925497,158.8,0.0,310679.5
2020-07-15,2020-07-15,Service payment - Porter Inc,REF49084042,0.0,920.36,311599.86
2020-07-15,2020-07-15,Invoice payment - Roman-Gonzalez,REF65696647,0.0,1041.23,312641.09
2020-07-15,2020-07-15,Permits Licenses expense,REF29710114,92.18,0.0,312548.91
2020-07-15,2020-07-15,Business insurance premium,REF63035716,243.35,0.0,312305.56
2020-07-15,2020-07-15,"Project payment - Nelson, Parks and Campbell",REF88951834,0.0,1636.69,313942.25
2020-07-15,2020-07-15,"Invoice payment - Mullins, Buckley and Hahn",REF96943055,0.0,878.23,314820.48
2020-07-18,2020-07-18,Business materials,REF98681536,874.66,0.0,313945.82
2020-07-20,2020-07-20,Business materials,REF53434312,1382.0,0.0,312563.82
2020-07-23,2020-07-23,Tools expense,REF93561447,179.27,0.0,312384.55
2020-07-24,2020-07-24,Fuel purchase,REF15933486,408.84,0.0,311975.71
2020-07-24,2020-07-24,Safety Equipment expense,REF27483082,77.13,0.0,311898.58
2020-07-30,2020-07-30,Subcontractors expense,REF50014207,702.54,0.0,311196.04
2020-07-30,2020-07-30,"Invoice payment - Nelson, Parks and Campbell",REF81750621,0.0,1200.87,312396.91
2020-07-30,2020-07-30,Fuel purchase,REF40434938,497.78,0.0,311899.13
2020-07-30,2020-07-30,"Service payment - Mullins, Buckley and Hahn",REF45328078,0.0,965.59,312864.72
2020-07-30,2020-07-30,Payment from Abbott-Gomez,REF76598761,0.0,1320.06,314184.78
2020-07-30,2020-07-30,Service payment - Roman-Gonzalez,REF54783643,0.0,1050.32,315235.1
2020-07-30,2020-07-30,Payment from Porter Inc,REF82625403,0.0,808.43,316043.53
2020-07-31,2020-07-31,Fuel purchase,REF44166524,345.9,0.0,315697.63
2020-07-31,2020-07-31,Equipment Rental expense,REF40207558,418.93,0.0,315278.7
2020-08-04,2020-08-04,Business materials,REF15066913,949.39,0.0,314329.31
2020-08-04,2020-08-04,Permits Licenses expense,REF59618875,116.35,0.0,314212.96
2020-08-05,2020-08-05,Permits Licenses expense,REF28729697,73.71,0.0,314139.25
2020-08-08,2020-08-08,Tools expense,REF93829863,103.92,0.0,314035.33
2020-08-13,2020-08-13,Equipment Rental expense,REF71144872,588.72,0.0,313446.61
2020-08-14,2020-08-14,Vehicle Maintenance expense,REF27634543,133.57,0.0,313313.04
2020-08-15,2020-08-15,Business insurance premium,REF45972169,226.46,0.0,313086.58
2020-08-15,2020-08-15,"Invoice payment - Nelson, Parks and Campbell",REF71683222,0.0,1330.04,314416.62
2020-08-15,2020-08-15,Payment from Porter Inc,REF46444879,0.0,832.51,315249.13
2020-08-15,2020-08-15,Invoice payment - Abbott-Gomez,REF60957906,0.0,1223.15,316472.28
2020-08-15,2020-08-15,"Service payment - Mullins, Buckley and Hahn",REF11084762,0.0,803.43,317275.71
2020-08-17,2020-08-17,Permits Licenses expense,REF53309973,90.44,0.0,317185.27
2020-08-17,2020-08-17,Fuel purchase,REF22015991,428.81,0.0,316756.46
2020-08-19,2020-08-19,Vehicle Maintenance expense,REF39543781,152.24,0.0,316604.22
2020-08-21,2020-08-21,Subcontractors expense,REF43245550,805.56,0.0,315798.66
2020-08-26,2020-08-26,Subcontractors expense,REF27648906,1112.05,0.0,314686.61
2020-08-27,2020-08-27,Equipment Rental expense,REF51251692,560.81,0.0,314125.8
2020-08-29,2020-08-29,Vehicle Maintenance expense,REF77579728,168.76,0.0,313957.04
2020-08-29,2020-08-29,Fuel purchase,REF12521401,343.89,0.0,313613.15
2020-08-29,2020-08-29,Permits Licenses expense,REF55306198,65.76,0.0,313547.39
2020-08-30,2020-08-30,"Payment from Nelson, Parks and Campbell",REF39205492,0.0,1053.09,314600.48
2020-08-30,2020-08-30,"Invoice payment - Mullins, Buckley and Hahn",REF26141814,0.0,983.79,315584.27
2020-08-30,2020-08-30,Project payment - Abbott-Gomez,REF81926783,0.0,975.9,316560.17
2020-08-30,2020-08-30,Payment from Porter Inc,REF16193348,0.0,775.3,317335.47
2020-08-30,2020-08-30,Invoice payment - Roman-Gonzalez,REF63316896,0.0,1173.96,318509.43
2020-08-31,2020-08-31,Business materials,REF18899359,765.61,0.0,317743.82
2020-09-07,2020-09-07,Fuel purchase,REF98813415,501.25,0.0,317242.57
2020-09-12,2020-09-12,Vehicle Maintenance expense,REF93257845,169.23,0.0,317073.34
2020-09-13,2020-09-13,Subcontractors expense,REF70473053,251.8,0.0,316821.54
2020-09-15,2020-09-15,"Service payment - Mullins, Buckley and Hahn",REF41485138,0.0,537.67,317359.21
2020-09-15,2020-09-15,Project payment - Abbott-Gomez,REF46354177,0.0,940.63,318299.84
2020-09-15,2020-09-15,Business insurance premium,REF71456883,231.96,0.0,318067.88
2020-09-15,2020-09-15,"Payment from Nelson, Parks and Campbell",REF67777515,0.0,1607.87,319675.75
2020-09-15,2020-09-15,Payment from Roman-Gonzalez,REF71769494,0.0,1011.6,320687.35
2020-09-17,2020-09-17,Vehicle Maintenance expense,REF71710337,70.41,0.0,320616.94
2020-09-19,2020-09-19,Fuel purchase,REF40654096,367.91,0.0,320249.03
2020-09-22,2020-09-22,Business materials,REF84049200,774.15,0.0,319474.88
2020-09-26,2020-09-26,Fuel purchase,REF41385629,246.39,0.0,319228.49
2020-09-30,2020-09-30,"Payment from Nelson, Parks and Campbell",REF11287577,0.0,1418.92,320647.41
2020-09-30,2020-09-30,"Service payment - Mullins, Buckley and Hahn",REF58902087,0.0,982.12,321629.53
2020-09-30,2020-09-30,Payment from Roman-Gonzalez,REF87283928,0.0,924.02,322553.55
2020-09-30,2020-09-30,Payment from Abbott-Gomez,REF27755450,0.0,1264.78,323818.33
2020-09-30,2020-09-30,Invoice payment - Porter Inc,REF81448056,0.0,755.74,324574.07
2020-10-02,2020-10-02,Fuel purchase,REF93422030,249.46,0.0,324324.61
2020-10-05,2020-10-05,Fuel purchase,REF85563318,277.91,0.0,324046.7
2020-10-06,2020-10-06,Safety Equipment expense,REF51171665,71.77,0.0,323974.93
2020-10-09,2020-10-09,Subcontractors expense,REF61607128,942.39,0.0,323032.54
2020-10-11,2020-10-11,Safety Equipment expense,REF24475142,63.67,0.0,322968.87
2020-10-13,2020-10-13,Business materials,REF50292681,855.76,0.0,322113.11
2020-10-13,2020-10-13,Vehicle Maintenance expense,REF88169564,228.93,0.0,321884.18
2020-10-15,2020-10-15,Business insurance premium,REF69081528,189.48,0.0,321694.7
2020-10-15,2020-10-15,"Invoice payment - Nelson, Parks and Campbell",REF62206504,0.0,1045.69,322740.39
2020-10-15,2020-10-15,Invoice payment - Abbott-Gomez,REF27981225,0.0,1056.49,323796.88
2020-10-15,2020-10-15,Project payment - Roman-Gonzalez,REF23911381,0.0,854.06,324650.94
2020-10-15,2020-10-15,"Service payment - Mullins, Buckley and Hahn",REF20900000,0.0,924.92,325575.86
2020-10-15,2020-10-15,Service payment - Porter Inc,REF38374067,0.0,759.52,326335.38
2020-10-21,2020-10-21,Safety Equipment expense,REF80688239,121.86,0.0,326213.52
2020-10-24,2020-10-24,Business materials,REF14262835,507.23,0.0,325706.29
2020-10-26,2020-10-26,Permits Licenses expense,REF55306553,88.39,0.0,325617.9
2020-10-26,2020-10-26,Vehicle Maintenance expense,REF14420286,178.3,0.0,325439.6
2020-10-30,2020-10-30,"Service payment - Mullins, Buckley and Hahn",REF93017968,0.0,949.6,326389.2
2020-10-30,2020-10-30,Project payment - Roman-Gonzalez,REF70799929,0.0,958.55,327347.75
2020-10-30,2020-10-30,"Service payment - Nelson, Parks and Campbell",REF99534555,0.0,1258.53,328606.28
2020-10-30,2020-10-30,Payment from Abbott-Gomez,REF26263582,0.0,1261.24,329867.52
2020-11-04,2020-11-04,Business materials,REF55463389,469.09,0.0,329398.43
2020-11-07,2020-11-07,Business materials,REF15404483,807.98,0.0,328590.45
2020-11-10,2020-11-10,Permits Licenses expense,REF88049316,32.83,0.0,328557.62
2020-11-11,2020-11-11,Fuel purchase,REF53825280,289.22,0.0,328268.4
2020-11-14,2020-11-14,Business materials,REF89688220,579.59,0.0,327688.81
2020-11-15,2020-11-15,Business materials,REF84012920,509.93,0.0,327178.88
2020-11-15,2020-11-15,Project payment - Abbott-Gomez,REF25615139,0.0,790.63,327969.51
2020-11-15,2020-11-15,Invoice payment - Porter Inc,REF45573262,0.0,427.86,328397.37
2020-11-15,2020-11-15,Business insurance premium,REF47245881,149.85,0.0,328247.52
2020-11-15,2020-11-15,"Project payment - Nelson, Parks and Campbell",REF74017983,0.0,955.55,329203.07
2020-11-15,2020-11-15,Project payment - Roman-Gonzalez,REF90965135,0.0,658.73,329861.8
2020-11-17,2020-11-17,Permits Licenses expense,REF90530846,47.2,0.0,329814.6
2020-11-21,2020-11-21,Permits Licenses expense,REF19882137,64.09,0.0,329750.51
2020-11-26,2020-11-26,Tools expense,REF31154854,102.54,0.0,329647.97
2020-11-28,2020-11-28,Business materials,REF65644661,637.83,0.0,329010.14
2020-11-29,2020-11-29,Permits Licenses expense,REF27024964,71.9,0.0,328938.24
2020-11-30,2020-11-30,Business materials,REF21863977,792.89,0.0,328145.35
2020-11-30,2020-11-30,Invoice payment - Roman-Gonzalez,REF79097544,0.0,866.1,329011.45
2020-11-30,2020-11-30,Invoice payment - Porter Inc,REF70503349,0.0,472.32,329483.77
2020-11-30,2020-11-30,Fuel purchase,REF86026540,222.77,0.0,329261.0
2020-11-30,2020-11-30,Service payment - Abbott-Gomez,REF49968557,0.0,1063.88,330324.88
2020-11-30,2020-11-30,"Project payment - Nelson, Parks and Campbell",REF93814382,0.0,1019.48,331344.36
2020-11-30,2020-11-30,"Project payment - Mullins, Buckley and Hahn",REF58219373,0.0,702.42,332046.78
2020-12-01,2020-12-01,Business materials,REF93133747,374.64,0.0,331672.14
2020-12-04,2020-12-04,Fuel purchase,REF88867802,156.3,0.0,331515.84
2020-12-06,2020-12-06,Vehicle Maintenance expense,REF35411370,107.21,0.0,331408.63
2020-12-08,2020-12-08,Business materials,REF19476563,513.1,0.0,330895.53
2020-12-11,2020-12-11,Fuel purchase,REF37555061,230.4,0.0,330665.13
2020-12-11,2020-12-11,Safety Equipment expense,REF39162794,60.37,0.0,330604.76
2020-12-15,2020-12-15,"Project payment - Mullins, Buckley and Hahn",REF16011162,0.0,461.78,331066.54
2020-12-15,2020-12-15,Payment from Abbott-Gomez,REF77263002,0.0,629.35,331695.89
2020-12-15,2020-12-15,Service payment - Roman-Gonzalez,REF99735037,0.0,569.99,332265.88
2020-12-15,2020-12-15,Service payment - Porter Inc,REF95974480,0.0,485.98,332751.86
2020-12-15,2020-12-15,"Project payment - Nelson, Parks and Campbell",REF22031800,0.0,615.28,333367.14
2020-12-15,2020-12-15,Business insurance premium,REF43726550,118.9,0.0,333248.24
2020-12-16,2020-12-16,Subcontractors expense,REF84800911,421.7,0.0,332826.54
2020-12-16,2020-12-16,Fuel purchase,REF55668287,255.44,0.0,332571.1
2020-12-19,2020-12-19,Fuel purchase,REF49125596,204.21,0.0,332366.89
2020-12-22,2020-12-22,Business materials,REF18319407,622.72,0.0,331744.17
2020-12-25,2020-12-25,Safety Equipment expense,REF20533946,41.11,0.0,331703.06
2020-12-30,2020-12-30,Service payment - Abbott-Gomez,REF18738882,0.0,737.48,332440.54
2020-12-30,2020-12-30,"Service payment - Mullins, Buckley and Hahn",REF90916709,0.0,439.98,332880.52
2020-12-30,2020-12-30,"Payment from Nelson, Parks and Campbell",REF50975923,0.0,693.05,333573.57
2020-12-30,2020-12-30,Service payment - Roman-Gonzalez,REF69889171,0.0,414.26,333987.83
2020-12-30,2020-12-30,Project payment - Porter Inc,REF62585455,0.0,407.72,334395.55
2021-01-01,2021-01-01,Fuel purchase,REF28739803,326.97,0.0,334068.58
2021-01-03,2021-01-03,Business materials,REF17959461,436.22,0.0,333632.36
2021-01-04,2021-01-04,Fuel purchase,REF35021252,159.62,0.0,333472.74
2021-01-07,2021-01-07,Equipment Rental expense,REF38825748,257.68,0.0,333215.06
2021-01-08,2021-01-08,Fuel purchase,REF39635140,120.13,0.0,333094.93
2021-01-14,2021-01-14,Business materials,REF74150589,768.97,0.0,332325.96
2021-01-15,2021-01-15,"Invoice payment - Mullins, Buckley and Hahn",REF24799357,0.0,604.04,332930.0
2021-01-15,2021-01-15,Service payment - Porter Inc,REF90863440,0.0,540.06,333470.06
2021-01-15,2021-01-15,"Service payment - Nelson, Parks and Campbell",REF78105973,0.0,836.93,334306.99
2021-01-15,2021-01-15,Service payment - Abbott-Gomez,REF48407750,0.0,905.49,335212.48
2021-01-15,2021-01-15,Business insurance premium,REF32798187,140.44,0.0,335072.04
2021-01-16,2021-01-16,Fuel purchase,REF19616613,382.08,0.0,334689.96
2021-01-17,2021-01-17,Vehicle Maintenance expense,REF70227523,17.05,0.0,334672.91
2021-01-20,2021-01-20,Vehicle Maintenance expense,REF79974762,140.49,0.0,334532.42
2021-01-30,2021-01-30,Service payment - Porter Inc,REF65953594,0.0,544.37,335076.79
2021-01-30,2021-01-30,"Invoice payment - Nelson, Parks and Campbell",REF37044605,0.0,741.03,335817.82
2021-01-30,2021-01-30,Payment from Roman-Gonzalez,REF27524473,0.0,712.08,336529.9
2021-01-31,2021-01-31,Business materials,REF65669458,512.3,0.0,336017.6
2021-01-31,2021-01-31,Vehicle Maintenance expense,REF64998585,118.94,0.0,335898.66
2021-02-01,2021-02-01,Tools expense,REF73674975,79.89,0.0,335818.77
2021-02-02,2021-02-02,Vehicle Maintenance expense,REF79598244,145.18,0.0,335673.59
2021-02-02,2021-02-02,Safety Equipment expense,REF51913161,76.45,0.0,335597.14
2021-02-04,2021-02-04,Permits Licenses expense,REF12256482,53.19,0.0,335543.95
2021-02-05,2021-02-05,Fuel purchase,REF77964671,280.07,0.0,335263.88
2021-02-05,2021-02-05,Vehicle Maintenance expense,REF59372551,77.65,0.0,335186.23
2021-02-11,2021-02-11,Business materials,REF69589509,713.31,0.0,334472.92
2021-02-14,2021-02-14,Fuel purchase,REF97518641,283.75,0.0,334189.17
2021-02-15,2021-02-15,Service payment - Abbott-Gomez,REF58547955,0.0,735.63,334924.8
2021-02-15,2021-02-15,Payment from Roman-Gonzalez,REF61193975,0.0,599.24,335524.04
2021-02-15,2021-02-15,"Project payment - Mullins, Buckley and Hahn",REF85707417,0.0,777.55,336301.59
2021-02-15,2021-02-15,Project payment - Porter Inc,REF74094727,0.0,464.64,336766.23
2021-02-15,2021-02-15,"Service payment - Nelson, Parks and Campbell",REF64241602,0.0,799.75,337565.98
2021-02-15,2021-02-15,Business insurance premium,REF88287408,158.34,0.0,337407.64
2021-02-20,2021-02-20,Fuel purchase,REF23202872,324.92,0.0,337082.72
2021-02-21,2021-02-21,Tools expense,REF85495605,67.16,0.0,337015.56
2021-02-22,2021-02-22,Equipment Rental expense,REF75036728,220.27,0.0,336795.29
2021-02-28,2021-02-28,"Payment from Mullins, Buckley and Hahn",REF37968428,0.0,636.37,337431.66
2021-02-28,2021-02-28,"Payment from Nelson, Parks and Campbell",REF16667602,0.0,923.01,338354.67
2021-02-28,2021-02-28,Service payment - Porter Inc,REF29330133,0.0,616.79,338971.46
2021-02-28,2021-02-28,Project payment - Abbott-Gomez,REF31220303,0.0,817.2,339788.66
2021-03-01,2021-03-01,Business materials,REF48618801,640.32,0.0,339148.34
2021-03-04,2021-03-04,Subcontractors expense,REF35996907,663.59,0.0,338484.75
2021-03-07,2021-03-07,Fuel purchase,REF27355748,309.11,0.0,338175.64
2021-03-08,2021-03-08,Equipment Rental expense,REF55662246,701.81,0.0,337473.83
2021-03-10,2021-03-10,Vehicle Maintenance expense,REF83085284,154.53,0.0,337319.3
2021-03-15,2021-03-15,"Payment from Mullins, Buckley and Hahn",REF80095387,0.0,852.24,338171.54
2021-03-15,2021-03-15,Business insurance premium,REF73205923,202.07,0.0,337969.47
2021-03-15,2021-03-15,Project payment - Porter Inc,REF11833390,0.0,746.44,338715.91
2021-03-15,2021-03-15,Invoice payment - Abbott-Gomez,REF14121268,0.0,1071.61,339787.52
2021-03-15,2021-03-15,"Service payment - Nelson, Parks and Campbell",REF56535836,0.0,981.83,340769.35
2021-03-17,2021-03-17,Permits Licenses expense,REF51347901,69.69,0.0,340699.66
2021-03-25,2021-03-25,Equipment Rental expense,REF54727690,442.57,0.0,340257.09
2021-03-30,2021-03-30,Fuel purchase,REF23215532,342.27,0.0,339914.82
2021-03-30,2021-03-30,"Payment from Mullins, Buckley and Hahn",REF95909324,0.0,962.01,340876.83
2021-03-30,2021-03-30,"Service payment - Nelson, Parks and Campbell",REF85349041,0.0,1424.27,342301.1
2021-03-30,2021-03-30,Business materials,REF43344618,790.54,0.0,341510.56
2021-03-30,2021-03-30,Project payment - Roman-Gonzalez,REF37050359,0.0,933.33,342443.89
2021-03-30,2021-03-30,Project payment - Porter Inc,REF85386299,0.0,775.6,343219.49
2021-04-01,2021-04-01,Tools expense,REF85291090,32.16,0.0,343187.33
2021-04-02,2021-04-02,Tools expense,REF98109803,91.76,0.0,343095.57
2021-04-02,2021-04-02,Safety Equipment expense,REF44807689,31.8,0.0,343063.77
2021-04-03,2021-04-03,Tools expense,REF32421812,166.57,0.0,342897.2
2021-04-05,2021-04-05,Fuel purchase,REF46891667,358.31,0.0,342538.89
2021-04-07,2021-04-07,Business materials,REF41805487,1140.44,0.0,341398.45
2021-04-11,2021-04-11,Fuel purchase,REF78401272,341.13,0.0,341057.32
2021-04-15,2021-04-15,"Project payment - Nelson, Parks and Campbell",REF57551792,0.0,1613.46,342670.78
2021-04-15,2021-04-15,Project payment - Abbott-Gomez,REF91579255,0.0,1551.62,344222.4
2021-04-15,2021-04-15,"Service payment - Mullins, Buckley and Hahn",REF45549426,0.0,1178.41,345400.81
2021-04-15,2021-04-15,Business insurance premium,REF87616847,243.67,0.0,345157.14
2021-04-17,2021-04-17,Tools expense,REF81514058,84.88,0.0,345072.26
2021-04-22,2021-04-22,Business materials,REF70807036,528.18,0.0,344544.08
2021-04-22,2021-04-22,Tools expense,REF24240077,126.16,0.0,344417.92
2021-04-24,2021-04-24,Tools expense,REF75174065,76.48,0.0,344341.44
2021-04-30,2021-04-30,"Service payment - Nelson, Parks and Campbell",REF39735815,0.0,1378.23,345719.67
2021-04-30,2021-04-30,Service payment - Porter Inc,REF41639677,0.0,845.46,346565.13
2021-04-30,2021-04-30,"Payment from Mullins, Buckley and Hahn",REF97851768,0.0,1127.11,347692.24
2021-04-30,2021-04-30,Service payment - Abbott-Gomez,REF45027811,0.0,1536.46,349228.7
2021-05-02,2021-05-02,Fuel purchase,REF91907893,280.07,0.0,348948.63
2021-05-04,2021-05-04,Equipment Rental expense,REF12276684,431.24,0.0,348517.39
2021-05-04,2021-05-04,Fuel purchase,REF77663779,309.81,0.0,348207.58
2021-05-04,2021-05-04,Subcontractors expense,REF10631446,1865.4,0.0,346342.18
2021-05-05,2021-05-05,Business materials,REF41778468,715.93,0.0,345626.25
2021-05-14,2021-05-14,Tools expense,REF83858188,204.15,0.0,345422.1
2021-05-15,2021-05-15,Business materials,REF24525258,818.35,0.0,344603.75
2021-05-15,2021-05-15,Service payment - Roman-Gonzalez,REF39479852,0.0,1236.84,345840.59
2021-05-15,2021-05-15,"Service payment - Mullins, Buckley and Hahn",REF15136402,0.0,1177.29,347017.88
2021-05-15,2021-05-15,Business insurance premium,REF75616693,256.32,0.0,346761.56
2021-05-15,2021-05-15,Service payment - Porter Inc,REF90685019,0.0,1103.84,347865.4
2021-05-15,2021-05-15,Payment from Abbott-Gomez,REF36968344,0.0,1289.8,349155.2
2021-05-15,2021-05-15,"Invoice payment - Nelson, Parks and Campbell",REF58099851,0.0,1484.39,350639.59
2021-05-16,2021-05-16,Fuel purchase,REF28443075,181.48,0.0,350458.11
2021-05-18,2021-05-18,Fuel purchase,REF24483228,128.37,0.0,350329.74
2021-05-20,2021-05-20,Fuel purchase,REF62671966,500.76,0.0,349828.98
2021-05-22,2021-05-22,Tools expense,REF44325526,140.66,0.0,349688.32
2021-05-24,2021-05-24,Business materials,REF34114833,713.01,0.0,348975.31
2021-05-25,2021-05-25,Business materials,REF66010594,657.77,0.0,348317.54
2021-05-30,2021-05-30,Fuel purchase,REF18952023,282.04,0.0,348035.5
2021-05-30,2021-05-30,Payment from Abbott-Gomez,REF24165762,0.0,1383.21,349418.71
2021-05-30,2021-05-30,"Invoice payment - Mullins, Buckley and Hahn",REF28591337,0.0,1250.54,350669.25
2021-05-30,2021-05-30,"Project payment - Nelson, Parks and Campbell",REF10278110,0.0,1363.25,352032.5
2021-05-30,2021-05-30,Project payment - Roman-Gonzalez,REF83352282,0.0,954.84,352987.34
2021-06-04,2021-06-04,Subcontractors expense,REF78538800,1193.61,0.0,351793.73
2021-06-09,2021-06-09,Fuel purchase,REF47135186,365.15,0.0,351428.58
2021-06-11,2021-06-11,Business materials,REF33727154,1277.74,0.0,350150.84
2021-06-11,2021-06-11,Permits Licenses expense,REF33930934,64.28,0.0,350086.56
2021-06-13,2021-06-13,Business materials,REF78404456,1497.79,0.0,348588.77
2021-06-14,2021-06-14,Subcontractors expense,REF27276162,1015.49,0.0,347573.28
2021-06-15,2021-06-15,Service payment - Porter Inc,REF67598336,0.0,833.38,348406.66
2021-06-15,2021-06-15,"Invoice payment - Mullins, Buckley and Hahn",REF12728586,0.0,1018.39,349425.05
2021-06-15,2021-06-15,Service payment - Abbott-Gomez,REF30163705,0.0,1462.23,350887.28
2021-06-15,2021-06-15,Business insurance premium,REF67892278,277.02,0.0,350610.26
2021-06-18,2021-06-18,Business materials,REF61407254,666.46,0.0,349943.8
2021-06-19,2021-06-19,Vehicle Maintenance expense,REF70000938,201.16,0.0,349742.64
2021-06-21,2021-06-21,Subcontractors expense,REF39708878,1649.38,0.0,348093.26
2021-06-21,2021-06-21,Business materials,REF14177767,734.27,0.0,347358.99
2021-06-22,2021-06-22,Tools expense,REF87183558,186.39,0.0,347172.6
2021-06-22,2021-06-22,Vehicle Maintenance expense,REF88003524,230.48,0.0,346942.12
2021-06-22,2021-06-22,Safety Equipment expense,REF10630773,64.91,0.0,346877.21
2021-06-27,2021-06-27,Subcontractors expense,REF55575086,919.92,0.0,345957.29
2021-06-29,2021-06-29,Safety Equipment expense,REF70393008,132.88,0.0,345824.41
2021-06-30,2021-06-30,Project payment - Porter Inc,REF75130701,0.0,931.57,346755.98
2021-06-30,2021-06-30,Fuel purchase,REF24715715,498.15,0.0,346257.83
2021-06-30,2021-06-30,Invoice payment - Abbott-Gomez,REF27315294,0.0,1253.17,347511.0
2021-06-30,2021-06-30,"Service payment - Mullins, Buckley and Hahn",REF24505634,0.0,930.17,348441.17
2021-06-30,2021-06-30,Subcontractors expense,REF75763307,1686.03,0.0,346755.14
2021-07-01,2021-07-01,Business materials,REF33889447,1372.38,0.0,345382.76
2021-07-05,2021-07-05,Fuel purchase,REF11687345,297.95,0.0,345084.81
2021-07-14,2021-07-14,Permits Licenses expense,REF12529659,61.88,0.0,345022.93
2021-07-14,2021-07-14,Subcontractors expense,REF92851033,1206.71,0.0,343816.22
2021-07-15,2021-07-15,"Invoice payment - Mullins, Buckley and Hahn",REF34802065,0.0,1150.81,344967.03
2021-07-15,2021-07-15,Payment from Roman-Gonzalez,REF37607707,0.0,1133.0,346100.03
2021-07-15,2021-07-15,"Payment from Nelson, Parks and Campbell",REF98848697,0.0,1435.39,347535.42
2021-07-15,2021-07-15,Business insurance premium,REF76637847,235.81,0.0,347299.61
2021-07-15,2021-07-15,Payment from Abbott-Gomez,REF29097246,0.0,1356.99,348656.6
2021-07-15,2021-07-15,Invoice payment - Porter Inc,REF78574115,0.0,758.04,349414.64
2021-07-16,2021-07-16,Fuel purchase,REF56103546,412.49,0.0,349002.15
2021-07-23,2021-07-23,Business materials,REF80161317,1081.7,0.0,347920.45
2021-07-25,2021-07-25,Fuel purchase,REF80354040,517.12,0.0,347403.33
2021-07-26,2021-07-26,Fuel purchase,REF78121290,518.96,0.0,346884.37
2021-07-30,2021-07-30,Subcontractors expense,REF47582891,892.76,0.0,345991.61
2021-07-30,2021-07-30,Invoice payment - Roman-Gonzalez,REF97692582,0.0,1185.16,347176.77
2021-07-30,2021-07-30,Payment from Porter Inc,REF90144481,0.0,702.49,347879.26
2021-07-30,2021-07-30,"Payment from Nelson, Parks and Campbell",REF16812262,0.0,1475.2,349354.46
2021-07-30,2021-07-30,"Invoice payment - Mullins, Buckley and Hahn",REF91095856,0.0,1081.41,350435.87
2021-07-30,2021-07-30,Project payment - Abbott-Gomez,REF89270672,0.0,1340.8,351776.67
2021-07-31,2021-07-31,Equipment Rental expense,REF67831969,615.08,0.0,351161.59
2021-08-01,2021-08-01,Permits Licenses expense,REF13112641,65.92,0.0,351095.67
2021-08-06,2021-08-06,Equipment Rental expense,REF20428327,575.26,0.0,350520.41
2021-08-08,2021-08-08,Subcontractors expense,REF84099048,969.19,0.0,349551.22
2021-08-11,2021-08-11,Fuel purchase,REF72349440,365.98,0.0,349185.24
2021-08-15,2021-08-15,"Invoice payment - Nelson, Parks and Campbell",REF22960908,0.0,1325.16,350510.4
2021-08-15,2021-08-15,Business insurance premium,REF68607833,247.59,0.0,350262.81
2021-08-15,2021-08-15,Service payment - Roman-Gonzalez,REF87835034,0.0,1189.7,351452.51
2021-08-15,2021-08-15,Project payment - Porter Inc,REF84284803,0.0,792.71,352245.22
2021-08-15,2021-08-15,"Payment from Mullins, Buckley and Hahn",REF74634416,0.0,875.67,353120.89
2021-08-15,2021-08-15,Service payment - Abbott-Gomez,REF84438072,0.0,1292.73,354413.62
2021-08-18,2021-08-18,Business materials,REF21130338,1376.66,0.0,353036.96
2021-08-22,2021-08-22,Fuel purchase,REF88760944,340.27,0.0,352696.69
2021-08-23,2021-08-23,Fuel purchase,REF62407882,213.8,0.0,352482.89
2021-08-30,2021-08-30,"Project payment - Nelson, Parks and Campbell",REF32501121,0.0,1307.74,353790.63
2021-08-30,2021-08-30,Project payment - Abbott-Gomez,REF27112141,0.0,1122.28,354912.91
2021-08-30,2021-08-30,Service payment - Porter Inc,REF99203146,0.0,869.29,355782.2
2021-08-30,2021-08-30,Subcontractors expense,REF32564880,1164.08,0.0,354618.12
2021-08-30,2021-08-30,"Invoice payment - Mullins, Buckley and Hahn",REF40324264,0.0,1147.91,355766.03
2021-08-30,2021-08-30,Invoice payment - Roman-Gonzalez,REF79242903,0.0,730.72,356496.75
2021-09-03,2021-09-03,Business materials,REF36859591,1256.61,0.0,355240.14
2021-09-04,2021-09-04,Subcontractors expense,REF76612356,1518.81,0.0,353721.33
2021-09-06,2021-09-06,Vehicle Maintenance expense,REF96873501,152.81,0.0,353568.52
2021-09-06,2021-09-06,Business materials,REF30282856,1194.41,0.0,352374.11
2021-09-08,2021-09-08,Fuel purchase,REF79352161,426.92,0.0,351947.19
2021-09-10,2021-09-10,Business materials,REF25795930,423.62,0.0,351523.57
2021-09-11,2021-09-11,Subcontractors expense,REF91682283,651.55,0.0,350872.02
2021-09-11,2021-09-11,Business materials,REF84351233,680.98,0.0,350191.04
2021-09-15,2021-09-15,Business insurance premium,REF69207641,224.18,0.0,349966.86
2021-09-15,2021-09-15,Service payment - Abbott-Gomez,REF41195922,0.0,1412.7,351379.56
2021-09-15,2021-09-15,Service payment - Roman-Gonzalez,REF70064773,0.0,1070.12,352449.68
2021-09-15,2021-09-15,"Invoice payment - Mullins, Buckley and Hahn",REF47149172,0.0,910.45,353360.13
2021-09-15,2021-09-15,Project payment - Porter Inc,REF73230053,0.0,834.06,354194.19
2021-09-27,2021-09-27,Business materials,REF16605322,873.74,0.0,353320.45
2021-09-29,2021-09-29,Safety Equipment expense,REF68955829,63.99,0.0,353256.46
2021-09-30,2021-09-30,Safety Equipment expense,REF55448018,92.58,0.0,353163.88
2021-09-30,2021-09-30,Project payment - Porter Inc,REF93220771,0.0,713.54,353877.42
2021-09-30,2021-09-30,"Project payment - Mullins, Buckley and Hahn",REF32378189,0.0,698.99,354576.41
2021-09-30,2021-09-30,Invoice payment - Abbott-Gomez,REF18867597,0.0,1144.12,355720.53
2021-09-30,2021-09-30,"Project payment - Nelson, Parks and Campbell",REF70742133,0.0,1153.98,356874.51
2021-10-02,2021-10-02,Safety Equipment expense,REF56812762,52.33,0.0,356822.18
2021-10-05,2021-10-05,Fuel purchase,REF40275532,217.01,0.0,356605.17
2021-10-10,2021-10-10,Fuel purchase,REF34325044,138.86,0.0,356466.31
2021-10-12,2021-10-12,Safety Equipment expense,REF46428717,102.22,0.0,356364.09
2021-10-13,2021-10-13,Fuel purchase,REF28543152,363.83,0.0,356000.26
2021-10-15,2021-10-15,"Service payment - Mullins, Buckley and Hahn",REF11252220,0.0,890.41,356890.67
2021-10-15,2021-10-15,Payment from Porter Inc,REF96842484,0.0,624.64,357515.31
2021-10-15,2021-10-15,Project payment - Roman-Gonzalez,REF77879654,0.0,976.16,358491.47
2021-10-15,2021-10-15,Payment from Abbott-Gomez,REF31648079,0.0,1445.04,359936.51
2021-10-15,2021-10-15,Business insurance premium,REF15524417,205.62,0.0,359730.89
2021-10-17,2021-10-17,Business materials,REF27005459,1059.72,0.0,358671.17
2021-10-18,2021-10-18,Fuel purchase,REF38872664,177.11,0.0,358494.06
2021-10-18,2021-10-18,Equipment Rental expense,REF81633282,456.53,0.0,358037.53
2021-10-21,2021-10-21,Fuel purchase,REF56924237,172.78,0.0,357864.75
2021-10-26,2021-10-26,Fuel purchase,REF77018302,434.61,0.0,357430.14
2021-10-27,2021-10-27,Safety Equipment expense,REF34530581,105.29,0.0,357324.85
2021-10-27,2021-10-27,Business materials,REF85355028,1079.84,0.0,356245.01
2021-10-28,2021-10-28,Permits Licenses expense,REF67247517,42.39,0.0,356202.62
2021-10-29,2021-10-29,Fuel purchase,REF30602083,312.74,0.0,355889.88
2021-10-29,2021-10-29,Tools expense,REF20671686,91.56,0.0,355798.32
2021-10-30,2021-10-30,"Payment from Nelson, Parks and Campbell",REF15483402,0.0,992.08,356790.4
2021-10-30,2021-10-30,Service payment - Porter Inc,REF26865006,0.0,884.87,357675.27
2021-10-30,2021-10-30,Payment from Roman-Gonzalez,REF84477381,0.0,886.86,358562.13
2021-10-30,2021-10-30,"Payment from Mullins, Buckley and Hahn",REF68732262,0.0,905.06,359467.19
2021-10-30,2021-10-30,Invoice payment - Abbott-Gomez,REF31109925,0.0,1237.77,360704.96
2021-10-31,2021-10-31,Subcontractors expense,REF46390883,1197.41,0.0,359507.55
2021-11-01,2021-11-01,Fuel purchase,REF52899621,242.58,0.0,359264.97
2021-11-12,2021-11-12,Fuel purchase,REF99429290,187.86,0.0,359077.11
2021-11-13,2021-11-13,Subcontractors expense,REF85351876,569.04,0.0,358508.07
2021-11-15,2021-11-15,"Service payment - Nelson, Parks and Campbell",REF33094158,0.0,683.25,359191.32
2021-11-15,2021-11-15,Service payment - Abbott-Gomez,REF23571242,0.0,1155.41,360346.73
2021-11-15,2021-11-15,Invoice payment - Roman-Gonzalez,REF57640961,0.0,542.36,360889.09
2021-11-15,2021-11-15,Business insurance premium,REF40229040,161.22,0.0,360727.87
2021-11-15,2021-11-15,"Invoice payment - Mullins, Buckley and Hahn",REF78600953,0.0,447.67,361175.54
2021-11-15,2021-11-15,Service payment - Porter Inc,REF26992617,0.0,566.5,361742.04
2021-11-17,2021-11-17,Permits Licenses expense,REF36653978,48.05,0.0,361693.99
2021-11-21,2021-11-21,Business materials,REF20924076,675.09,0.0,361018.9
2021-11-23,2021-11-23,Tools expense,REF48932790,77.41,0.0,360941.49
2021-11-26,2021-11-26,Vehicle Maintenance expense,REF81058911,135.67,0.0,360805.82
2021-11-30,2021-11-30,Invoice payment - Roman-Gonzalez,REF39194367,0.0,788.6,361594.42
2021-11-30,2021-11-30,Payment from Abbott-Gomez,REF37669351,0.0,829.76,362424.18
2021-11-30,2021-11-30,"Invoice payment - Mullins, Buckley and Hahn",REF91888967,0.0,741.18,363165.36
2021-11-30,2021-11-30,"Project payment - Nelson, Parks and Campbell",REF58333876,0.0,816.09,363981.45
2021-11-30,2021-11-30,Permits Licenses expense,REF13927265,47.38,0.0,363934.07
2021-11-30,2021-11-30,Service payment - Porter Inc,REF30885842,0.0,682.62,364616.69
2021-12-01,2021-12-01,Permits Licenses expense,REF56349142,55.71,0.0,364560.98
2021-12-01,2021-12-01,Fuel purchase,REF42831764,208.22,0.0,364352.76
2021-12-02,2021-12-02,Safety Equipment expense,REF74943134,61.65,0.0,364291.11
2021-12-05,2021-12-05,Tools expense,REF52395047,93.35,0.0,364197.76
2021-12-06,2021-12-06,Subcontractors expense,REF77389650,649.76,0.0,363548.0
2021-12-07,2021-12-07,Fuel purchase,REF94032837,142.96,0.0,363405.04
2021-12-09,2021-12-09,Fuel purchase,REF62444958,154.63,0.0,363250.41
2021-12-10,2021-12-10,Business materials,REF53788818,383.58,0.0,362866.83
2021-12-11,2021-12-11,Business materials,REF65116413,578.78,0.0,362288.05
2021-12-12,2021-12-12,Fuel purchase,REF47845568,206.22,0.0,362081.83
2021-12-12,2021-12-12,Safety Equipment expense,REF94695782,29.78,0.0,362052.05
2021-12-12,2021-12-12,Business materials,REF70732466,443.56,0.0,361608.49
2021-12-13,2021-12-13,Fuel purchase,REF66292665,190.85,0.0,361417.64
2021-12-15,2021-12-15,Invoice payment - Porter Inc,REF87489728,0.0,534.47,361952.11
2021-12-15,2021-12-15,Payment from Roman-Gonzalez,REF88347508,0.0,490.23,362442.34
2021-12-15,2021-12-15,"Invoice payment - Mullins, Buckley and Hahn",REF66697362,0.0,567.52,363009.86
2021-12-15,2021-12-15,"Project payment - Nelson, Parks and Campbell",REF41549832,0.0,647.0,363656.86
2021-12-15,2021-12-15,Equipment Rental expense,REF80831482,244.3,0.0,363412.56
2021-12-15,2021-12-15,Service payment - Abbott-Gomez,REF76664571,0.0,842.22,364254.78
2021-12-15,2021-12-15,Business insurance premium,REF42850027,120.89,0.0,364133.89
2021-12-19,2021-12-19,Vehicle Maintenance expense,REF53372368,151.54,0.0,363982.35
2021-12-24,2021-12-24,Subcontractors expense,REF53724556,615.38,0.0,363366.97
2021-12-26,2021-12-26,Business materials,REF30996122,572.21,0.0,362794.76
2021-12-29,2021-12-29,Equipment Rental expense,REF79724892,189.04,0.0,362605.72
2021-12-30,2021-12-30,"Service payment - Mullins, Buckley and Hahn",REF58376833,0.0,558.52,363164.24
2021-12-30,2021-12-30,Payment from Abbott-Gomez,REF36099449,0.0,613.41,363777.65
2021-12-30,2021-12-30,Invoice payment - Porter Inc,REF76360427,0.0,456.21,364233.86
2021-12-30,2021-12-30,Project payment - Roman-Gonzalez,REF20120808,0.0,622.17,364856.03
2021-12-31,2021-12-31,Fuel purchase,REF70940637,198.34,0.0,364657.69
2021-12-31,2021-12-31,Safety Equipment expense,REF19879012,41.27,0.0,364616.42
2021-12-31,2021-12-31,Business materials,REF71720706,473.56,0.0,364142.86
2022-01-09,2022-01-09,Fuel purchase,REF64933352,236.45,0.0,363906.41
2022-01-10,2022-01-10,Permits Licenses expense,REF30646923,31.15,0.0,363875.26
2022-01-11,2022-01-11,Equipment Rental expense,REF55082179,288.81,0.0,363586.45
2022-01-14,2022-01-14,Vehicle Maintenance expense,REF34192933,104.36,0.0,363482.09
2022-01-15,2022-01-15,Project payment - Abbott-Gomez,REF65577439,0.0,789.17,364271.26
2022-01-15,2022-01-15,"Payment from Mullins, Buckley and Hahn",REF83364576,0.0,577.52,364848.78
2022-01-15,2022-01-15,Invoice payment - Porter Inc,REF80059417,0.0,446.32,365295.1
2022-01-15,2022-01-15,Service payment - Roman-Gonzalez,REF77072692,0.0,744.97,366040.07
2022-01-15,2022-01-15,"Service payment - Nelson, Parks and Campbell",REF32637596,0.0,794.46,366834.53
2022-01-15,2022-01-15,Business insurance premium,REF92979158,145.08,0.0,366689.45
2022-01-30,2022-01-30,"Service payment - Mullins, Buckley and Hahn",REF53560681,0.0,600.92,367290.37
2022-01-30,2022-01-30,"Project payment - Nelson, Parks and Campbell",REF12717814,0.0,780.89,368071.26
2022-01-30,2022-01-30,Payment from Abbott-Gomez,REF60993958,0.0,756.63,368827.89
2022-01-30,2022-01-30,Project payment - Porter Inc,REF66074639,0.0,639.18,369467.07
2022-02-04,2022-02-04,Business materials,REF83134502,857.65,0.0,368609.42
2022-02-06,2022-02-06,Equipment Rental expense,REF30789997,366.81,0.0,368242.61
2022-02-15,2022-02-15,Fuel purchase,REF21135720,217.79,0.0,368024.82
2022-02-15,2022-02-15,Business insurance premium,REF93264585,167.84,0.0,367856.98
2022-02-15,2022-02-15,Service payment - Abbott-Gomez,REF78598904,0.0,891.33,368748.31
2022-02-15,2022-02-15,"Project payment - Nelson, Parks and Campbell",REF60801724,0.0,837.08,369585.39
2022-02-15,2022-02-15,Invoice payment - Porter Inc,REF39407210,0.0,604.77,370190.16
2022-02-15,2022-02-15,"Payment from Mullins, Buckley and Hahn",REF55752630,0.0,667.84,370858.0
2022-02-15,2022-02-15,Payment from Roman-Gonzalez,REF56993268,0.0,828.64,371686.64
2022-02-18,2022-02-18,Fuel purchase,REF41584451,278.56,0.0,371408.08
2022-02-19,2022-02-19,Business materials,REF58706690,497.22,0.0,370910.86
2022-02-22,2022-02-22,Fuel purchase,REF91307890,252.73,0.0,370658.13
2022-02-24,2022-02-24,Subcontractors expense,REF40489641,773.44,0.0,369884.69
2022-02-25,2022-02-25,Vehicle Maintenance expense,REF93050590,58.54,0.0,369826.15
2022-02-28,2022-02-28,"Payment from Nelson, Parks and Campbell",REF98740822,0.0,1126.53,370952.68
2022-02-28,2022-02-28,"Project payment - Mullins, Buckley and Hahn",REF33259818,0.0,739.72,371692.4
2022-02-28,2022-02-28,Invoice payment - Roman-Gonzalez,REF55413419,0.0,730.23,372422.63
2022-02-28,2022-02-28,Payment from Abbott-Gomez,REF34398786,0.0,966.64,373389.27
2022-03-04,2022-03-04,Fuel purchase,REF41867715,456.54,0.0,372932.73
2022-03-09,2022-03-09,Permits Licenses expense,REF33173994,52.65,0.0,372880.08
2022-03-11,2022-03-11,Fuel purchase,REF27029482,298.73,0.0,372581.35
2022-03-14,2022-03-14,Subcontractors expense,REF36463765,794.72,0.0,371786.63
2022-03-14,2022-03-14,Fuel purchase,REF76111736,215.5,0.0,371571.13
2022-03-15,2022-03-15,Business insurance premium,REF56414680,207.54,0.0,371363.59
2022-03-15,2022-03-15,Project payment - Porter Inc,REF69879386,0.0,778.53,372142.12
2022-03-15,2022-03-15,Project payment - Abbott-Gomez,REF39017524,0.0,915.53,373057.65
2022-03-15,2022-03-15,"Payment from Mullins, Buckley and Hahn",REF83439013,0.0,871.35,373929.0
2022-03-15,2022-03-15,Invoice payment - Roman-Gonzalez,REF44232387,0.0,1045.06,374974.06
2022-03-15,2022-03-15,"Service payment - Nelson, Parks and Campbell",REF80880871,0.0,999.45,375973.51
2022-03-19,2022-03-19,Business materials,REF92204109,536.92,0.0,375436.59
2022-03-19,2022-03-19,Tools expense,REF43555137,134.42,0.0,375302.17
2022-03-21,2022-03-21,Business materials,REF16619348,541.86,0.0,374760.31
2022-03-24,2022-03-24,Vehicle Maintenance expense,REF55132073,114.33,0.0,374645.98
2022-03-26,2022-03-26,Tools expense,REF23653865,155.16,0.0,374490.82
2022-03-28,2022-03-28,Fuel purchase,REF71221243,314.31,0.0,374176.51
2022-03-30,2022-03-30,Payment from Abbott-Gomez,REF53610727,0.0,900.06,375076.57
2022-03-30,2022-03-30,"Payment from Nelson, Parks and Campbell",REF98976285,0.0,1285.45,376362.02
2022-03-30,2022-03-30,Project payment - Porter Inc,REF40326700,0.0,765.2,377127.22
2022-03-30,2022-03-30,Service payment - Roman-Gonzalez,REF97513192,0.0,1031.74,378158.96
2022-04-07,2022-04-07,Vehicle Maintenance expense,REF75015114,224.94,0.0,377934.02
2022-04-08,2022-04-08,Business materials,REF90177129,1286.1,0.0,376647.92
2022-04-15,2022-04-15,Invoice payment - Porter Inc,REF21799073,0.0,1011.4,377659.32
2022-04-15,2022-04-15,Business insurance premium,REF44383789,226.23,0.0,377433.09
2022-04-15,2022-04-15,"Invoice payment - Mullins, Buckley and Hahn",REF15682759,0.0,799.02,378232.11
2022-04-15,2022-04-15,Payment from Abbott-Gomez,REF60373294,0.0,1271.42,379503.53
2022-04-17,2022-04-17,Subcontractors expense,REF89800993,1203.75,0.0,378299.78
2022-04-20,2022-04-20,Business materials,REF14778132,1037.59,0.0,377262.19
2022-04-28,2022-04-28,Business materials,REF76741146,1201.18,0.0,376061.01
2022-04-29,2022-04-29,Business materials,REF17655156,460.13,0.0,375600.88
2022-04-30,2022-04-30,Business materials,REF99834201,1026.49,0.0,374574.39
2022-04-30,2022-04-30,Invoice payment - Abbott-Gomez,REF78569168,0.0,1412.22,375986.61
2022-04-30,2022-04-30,Project payment - Roman-Gonzalez,REF64539522,0.0,1070.32,377056.93
2022-04-30,2022-04-30,Project payment - Porter Inc,REF38310077,0.0,1063.74,378120.67
2022-04-30,2022-04-30,"Service payment - Nelson, Parks and Campbell",REF66726458,0.0,1400.87,379521.54
2022-05-01,2022-05-01,Business materials,REF39004518,879.45,0.0,378642.09
2022-05-01,2022-05-01,Equipment Rental expense,REF24536226,421.67,0.0,378220.42
2022-05-05,2022-05-05,Vehicle Maintenance expense,REF44296965,154.95,0.0,378065.47
2022-05-07,2022-05-07,Subcontractors expense,REF68001151,1203.69,0.0,376861.78
2022-05-15,2022-05-15,"Service payment - Mullins, Buckley and Hahn",REF91096063,0.0,769.12,377630.9
2022-05-15,2022-05-15,Payment from Porter Inc,REF25941233,0.0,1179.54,378810.44
2022-05-15,2022-05-15,Invoice payment - Abbott-Gomez,REF24296394,0.0,1375.86,380186.3
2022-05-15,2022-05-15,Service payment - Roman-Gonzalez,REF21479747,0.0,1458.75,381645.05
2022-05-15,2022-05-15,Business insurance premium,REF43990997,259.74,0.0,381385.31
2022-05-18,2022-05-18,Permits Licenses expense,REF95657410,88.86,0.0,381296.45
2022-05-18,2022-05-18,Fuel purchase,REF70423944,514.71,0.0,380781.74
2022-05-20,2022-05-20,Vehicle Maintenance expense,REF37261340,281.83,0.0,380499.91
2022-05-20,2022-05-20,Permits Licenses expense,REF74312343,123.38,0.0,380376.53
2022-05-21,2022-05-21,Fuel purchase,REF49987718,280.47,0.0,380096.06
2022-05-21,2022-05-21,Business materials,REF83095901,610.13,0.0,379485.93
2022-05-22,2022-05-22,Tools expense,REF56351122,103.33,0.0,379382.6
2022-05-26,2022-05-26,Fuel purchase,REF38018446,393.35,0.0,378989.25
2022-05-27,2022-05-27,Subcontractors expense,REF64531583,492.93,0.0,378496.32
2022-05-30,2022-05-30,Invoice payment - Porter Inc,REF58774254,0.0,795.41,379291.73
2022-05-30,2022-05-30,"Service payment - Mullins, Buckley and Hahn",REF93874860,0.0,1348.01,380639.74
2022-05-30,2022-05-30,Invoice payment - Roman-Gonzalez,REF58817552,0.0,1210.93,381850.67
2022-05-30,2022-05-30,Service payment - Abbott-Gomez,REF15899155,0.0,1528.97,383379.64
2022-05-30,2022-05-30,"Project payment - Nelson, Parks and Campbell",REF13265864,0.0,1797.14,385176.78
2022-05-31,2022-05-31,Business materials,REF12407212,973.45,0.0,384203.33
2022-05-31,2022-05-31,Safety Equipment expense,REF38710960,147.92,0.0,384055.41
2022-06-03,2022-06-03,Fuel purchase,REF23865506,404.82,0.0,383650.59
2022-06-09,2022-06-09,Business materials,REF57868373,1023.18,0.0,382627.41
2022-06-09,2022-06-09,Fuel purchase,REF81223772,367.16,0.0,382260.25
2022-06-13,2022-06-13,Equipment Rental expense,REF31202891,216.76,0.0,382043.49
2022-06-15,2022-06-15,Business insurance premium,REF93671625,258.27,0.0,381785.22
2022-06-15,2022-06-15,Payment from Porter Inc,REF44904565,0.0,1037.0,382822.22
2022-06-15,2022-06-15,"Project payment - Mullins, Buckley and Hahn",REF51343148,0.0,1125.04,383947.26
2022-06-15,2022-06-15,Service payment - Roman-Gonzalez,REF42849792,0.0,992.76,384940.02
2022-06-15,2022-06-15,Project payment - Abbott-Gomez,REF71899510,0.0,1515.24,386455.26
2022-06-15,2022-06-15,"Project payment - Nelson, Parks and Campbell",REF91399544,0.0,1697.12,388152.38
2022-06-19,2022-06-19,Equipment Rental expense,REF95673773,478.36,0.0,387674.02
2022-06-20,2022-06-20,Equipment Rental expense,REF86127319,535.44,0.0,387138.58
2022-06-28,2022-06-28,Vehicle Maintenance expense,REF46125404,142.57,0.0,386996.01
2022-06-30,2022-06-30,"Invoice payment - Nelson, Parks and Campbell",REF51145768,0.0,1463.09,388459.1
2022-06-30,2022-06-30,"Payment from Mullins, Buckley and Hahn",REF94139415,0.0,1071.08,389530.18
2022-06-30,2022-06-30,Project payment - Abbott-Gomez,REF83662099,0.0,1546.91,391077.09
2022-06-30,2022-06-30,Payment from Roman-Gonzalez,REF77274819,0.0,1107.51,392184.6
2022-06-30,2022-06-30,Project payment - Porter Inc,REF96712861,0.0,770.16,392954.76
2022-07-03,2022-07-03,Equipment Rental expense,REF68009780,514.93,0.0,392439.83
2022-07-04,2022-07-04,Fuel purchase,REF79408189,624.52,0.0,391815.31
2022-07-05,2022-07-05,Equipment Rental expense,REF16538928,616.82,0.0,391198.49
2022-07-05,2022-07-05,Safety Equipment expense,REF23435437,65.74,0.0,391132.75
2022-07-14,2022-07-14,Business materials,REF52359369,636.79,0.0,390495.96
2022-07-14,2022-07-14,Vehicle Maintenance expense,REF14618483,154.13,0.0,390341.83
2022-07-15,2022-07-15,Business insurance premium,REF14904742,242.88,0.0,390098.95
2022-07-15,2022-07-15,Invoice payment - Porter Inc,REF91850253,0.0,826.51,390925.46
2022-07-15,2022-07-15,"Invoice payment - Mullins, Buckley and Hahn",REF94366827,0.0,1189.99,392115.45
2022-07-15,2022-07-15,"Project payment - Nelson, Parks and Campbell",REF22362259,0.0,1142.84,393258.29
2022-07-15,2022-07-15,Project payment - Roman-Gonzalez,REF87721944,0.0,986.12,394244.41
2022-07-15,2022-07-15,Invoice payment - Abbott-Gomez,REF59756012,0.0,1430.68,395675.09
2022-07-17,2022-07-17,Tools expense,REF11531477,167.73,0.0,395507.36
2022-07-26,2022-07-26,Business materials,REF80289652,1294.23,0.0,394213.13
2022-07-27,2022-07-27,Permits Licenses expense,REF87348971,49.53,0.0,394163.6
2022-07-30,2022-07-30,Subcontractors expense,REF30476836,1054.61,0.0,393108.99
2022-07-30,2022-07-30,Payment from Porter Inc,REF99374918,0.0,1069.96,394178.95
2022-07-30,2022-07-30,Payment from Roman-Gonzalez,REF37594009,0.0,1149.3,395328.25
2022-07-30,2022-07-30,"Project payment - Nelson, Parks and Campbell",REF61733840,0.0,1304.14,396632.39
2022-07-30,2022-07-30,Invoice payment - Abbott-Gomez,REF58763535,0.0,1159.38,397791.77
2022-07-30,2022-07-30,"Project payment - Mullins, Buckley and Hahn",REF29154105,0.0,850.73,398642.5
2022-08-04,2022-08-04,Business materials,REF99308451,1278.24,0.0,397364.26
2022-08-07,2022-08-07,Tools expense,REF17733979,82.19,0.0,397282.07
2022-08-10,2022-08-10,Equipment Rental expense,REF71562467,428.21,0.0,396853.86
2022-08-13,2022-08-13,Business materials,REF64946003,1020.17,0.0,395833.69
2022-08-14,2022-08-14,Vehicle Maintenance expense,REF51592265,206.85,0.0,395626.84
2022-08-15,2022-08-15,Project payment - Abbott-Gomez,REF22183317,0.0,1178.23,396805.07
2022-08-15,2022-08-15,"Invoice payment - Nelson, Parks and Campbell",REF18636358,0.0,1800.35,398605.42
2022-08-15,2022-08-15,Invoice payment - Porter Inc,REF39661885,0.0,785.17,399390.59
2022-08-15,2022-08-15,Payment from Roman-Gonzalez,REF17430223,0.0,1084.12,400474.71
2022-08-15,2022-08-15,Business insurance premium,REF56306372,240.98,0.0,400233.73
2022-08-21,2022-08-21,Tools expense,REF96183118,166.17,0.0,400067.56
2022-08-21,2022-08-21,Fuel purchase,REF39502668,498.86,0.0,399568.7
2022-08-23,2022-08-23,Safety Equipment expense,REF58667973,87.12,0.0,399481.58
2022-08-25,2022-08-25,Fuel purchase,REF67592367,349.91,0.0,399131.67
2022-08-30,2022-08-30,"Service payment - Mullins, Buckley and Hahn",REF75629820,0.0,991.81,400123.48
2022-08-30,2022-08-30,Invoice payment - Porter Inc,REF26428779,0.0,776.25,400899.73
2022-08-30,2022-08-30,Tools expense,REF11207599,132.13,0.0,400767.6
2022-08-30,2022-08-30,"Invoice payment - Nelson, Parks and Campbell",REF20527658,0.0,1426.88,402194.48
2022-08-30,2022-08-30,Invoice payment - Roman-Gonzalez,REF51456601,0.0,1018.06,403212.54
2022-09-06,2022-09-06,Fuel purchase,REF65516268,307.4,0.0,402905.14
2022-09-11,2022-09-11,Permits Licenses expense,REF64054624,107.68,0.0,402797.46
2022-09-13,2022-09-13,Safety Equipment expense,REF85732212,41.37,0.0,402756.09
2022-09-15,2022-09-15,Business insurance premium,REF97823579,210.69,0.0,402545.4
2022-09-15,2022-09-15,Vehicle Maintenance expense,REF25559981,42.06,0.0,402503.34
2022-09-15,2022-09-15,Project payment - Porter Inc,REF62372695,0.0,814.51,403317.85
2022-09-15,2022-09-15,"Service payment - Nelson, Parks and Campbell",REF11803748,0.0,981.96,404299.81
2022-09-15,2022-09-15,Project payment - Abbott-Gomez,REF34656894,0.0,695.28,404995.09
2022-09-15,2022-09-15,"Payment from Mullins, Buckley and Hahn",REF70440984,0.0,951.72,405946.81
2022-09-15,2022-09-15,Invoice payment - Roman-Gonzalez,REF37542661,0.0,1187.54,407134.35
2022-09-22,2022-09-22,Safety Equipment expense,REF17749560,32.34,0.0,407102.01
2022-09-22,2022-09-22,Fuel purchase,REF24366531,330.96,0.0,406771.05
2022-09-24,2022-09-24,Fuel purchase,REF91411650,426.43,0.0,406344.62
2022-09-29,2022-09-29,Subcontractors expense,REF93481141,837.88,0.0,405506.74
2022-09-30,2022-09-30,Invoice payment - Porter Inc,REF98803182,0.0,794.38,406301.12
2022-09-30,2022-09-30,"Project payment - Mullins, Buckley and Hahn",REF34092164,0.0,986.45,407287.57
2022-09-30,2022-09-30,"Payment from Nelson, Parks and Campbell",REF98926356,0.0,1143.08,408430.65
2022-09-30,2022-09-30,Service payment - Roman-Gonzalez,REF50370120,0.0,1200.83,409631.48
2022-09-30,2022-09-30,Payment from Abbott-Gomez,REF10934901,0.0,1311.01,410942.49
2022-09-30,2022-09-30,Business materials,REF81575824,692.54,0.0,410249.95
2022-10-07,2022-10-07,Permits Licenses expense,REF62193895,74.74,0.0,410175.21
2022-10-10,2022-10-10,Vehicle Maintenance expense,REF75503451,197.41,0.0,409977.8
2022-10-15,2022-10-15,Subcontractors expense,REF13351783,1106.03,0.0,408871.77
2022-10-15,2022-10-15,Payment from Roman-Gonzalez,REF82298417,0.0,1001.46,409873.23
2022-10-15,2022-10-15,Service payment - Porter Inc,REF37826757,0.0,750.95,410624.18
2022-10-15,2022-10-15,Payment from Abbott-Gomez,REF67912859,0.0,1356.48,411980.66
2022-10-15,2022-10-15,"Payment from Nelson, Parks and Campbell",REF33925621,0.0,1204.35,413185.01
2022-10-15,2022-10-15,"Invoice payment - Mullins, Buckley and Hahn",REF55375408,0.0,920.2,414105.21
2022-10-15,2022-10-15,Business insurance premium,REF80163902,200.92,0.0,413904.29
2022-10-16,2022-10-16,Business materials,REF48679208,464.18,0.0,413440.11
2022-10-18,2022-10-18,Tools expense,REF11125106,62.68,0.0,413377.43
2022-10-24,2022-10-24,Subcontractors expense,REF53597392,1010.98,0.0,412366.45
2022-10-27,2022-10-27,Tools expense,REF59635433,154.95,0.0,412211.5
2022-10-30,2022-10-30,Business materials,REF62671978,680.17,0.0,411531.33
2022-10-30,2022-10-30,Project payment - Roman-Gonzalez,REF50642099,0.0,979.64,412510.97
2022-10-30,2022-10-30,Invoice payment - Porter Inc,REF61983094,0.0,667.57,413178.54
2022-10-30,2022-10-30,"Service payment - Mullins, Buckley and Hahn",REF62078235,0.0,1058.23,414236.77
2022-10-30,2022-10-30,Service payment - Abbott-Gomez,REF64122718,0.0,916.88,415153.65
2022-10-30,2022-10-30,"Project payment - Nelson, Parks and Campbell",REF26804139,0.0,991.83,416145.48
2022-11-05,2022-11-05,Permits Licenses expense,REF13511412,81.7,0.0,416063.78
2022-11-08,2022-11-08,Permits Licenses expense,REF65787416,81.82,0.0,415981.96
2022-11-09,2022-11-09,Fuel purchase,REF53822704,311.49,0.0,415670.47
2022-11-11,2022-11-11,Vehicle Maintenance expense,REF84226035,158.14,0.0,415512.33
2022-11-12,2022-11-12,Tools expense,REF37714852,49.59,0.0,415462.74
2022-11-13,2022-11-13,Business materials,REF55996230,662.3,0.0,414800.44
2022-11-14,2022-11-14,Safety Equipment expense,REF17910590,85.42,0.0,414715.02
2022-11-15,2022-11-15,"Service payment - Mullins, Buckley and Hahn",REF33221533,0.0,829.22,415544.24
2022-11-15,2022-11-15,Service payment - Porter Inc,REF48848550,0.0,463.73,416007.97
2022-11-15,2022-11-15,"Service payment - Nelson, Parks and Campbell",REF82614227,0.0,813.91,416821.88
2022-11-15,2022-11-15,Business insurance premium,REF67956697,155.0,0.0,416666.88
2022-11-15,2022-11-15,Project payment - Abbott-Gomez,REF85587022,0.0,939.3,417606.18
2022-11-15,2022-11-15,Project payment - Roman-Gonzalez,REF54782936,0.0,788.51,418394.69
2022-11-19,2022-11-19,Tools expense,REF11231656,61.64,0.0,418333.05
2022-11-19,2022-11-19,Vehicle Maintenance expense,REF91913545,119.81,0.0,418213.24
2022-11-24,2022-11-24,Subcontractors expense,REF44649867,629.89,0.0,417583.35
2022-11-25,2022-11-25,Fuel purchase,REF11537681,182.96,0.0,417400.39
2022-11-25,2022-11-25,Subcontractors expense,REF41068681,870.17,0.0,416530.22
2022-11-30,2022-11-30,Invoice payment - Abbott-Gomez,REF93063763,0.0,878.9,417409.12
2022-11-30,2022-11-30,Service payment - Roman-Gonzalez,REF41514731,0.0,687.89,418097.01
2022-11-30,2022-11-30,"Payment from Mullins, Buckley and Hahn",REF45680932,0.0,696.18,418793.19
2022-11-30,2022-11-30,"Payment from Nelson, Parks and Campbell",REF34407284,0.0,763.85,419557.04
2022-11-30,2022-11-30,Invoice payment - Porter Inc,REF29098623,0.0,481.91,420038.95
2022-12-05,2022-12-05,Permits Licenses expense,REF78736031,37.14,0.0,420001.81
2022-12-06,2022-12-06,Business materials,REF69231207,600.9,0.0,419400.91
2022-12-08,2022-12-08,Vehicle Maintenance expense,REF35573000,77.4,0.0,419323.51
2022-12-10,2022-12-10,Business materials,REF90029107,261.54,0.0,419061.97
2022-12-12,2022-12-12,Subcontractors expense,REF28931177,543.98,0.0,418517.99
2022-12-15,2022-12-15,Business insurance premium,REF65281170,118.2,0.0,418399.79
2022-12-15,2022-12-15,"Project payment - Mullins, Buckley and Hahn",REF35063149,0.0,530.02,418929.81
2022-12-15,2022-12-15,Invoice payment - Roman-Gonzalez,REF99040335,0.0,623.68,419553.49
2022-12-15,2022-12-15,"Invoice payment - Nelson, Parks and Campbell",REF96994336,0.0,861.64,420415.13
2022-12-15,2022-12-15,Project payment - Porter Inc,REF84387832,0.0,536.63,420951.76
2022-12-23,2022-12-23,Tools expense,REF17635363,55.17,0.0,420896.59
2022-12-30,2022-12-30,"Project payment - Mullins, Buckley and Hahn",REF27474633,0.0,561.16,421457.75
2022-12-30,2022-12-30,Service payment - Roman-Gonzalez,REF71988407,0.0,440.07,421897.82
2022-12-30,2022-12-30,Invoice payment - Abbott-Gomez,REF53328846,0.0,706.8,422604.62
2022-12-30,2022-12-30,Project payment - Porter Inc,REF76163548,0.0,424.84,423029.46
2022-12-30,2022-12-30,"Payment from Nelson, Parks and Campbell",REF47137853,0.0,668.6,423698.06
2022-12-31,2022-12-31,Business materials,REF10252455,381.61,0.0,423316.45
2023-01-01,2023-01-01,Fuel purchase,REF80693653,293.17,0.0,423023.28
2023-01-01,2023-01-01,Business materials,REF81725104,518.32,0.0,422504.96
2023-01-05,2023-01-05,Vehicle Maintenance expense,REF79965204,85.78,0.0,422419.18
2023-01-07,2023-01-07,Business materials,REF55848853,588.89,0.0,421830.29
2023-01-09,2023-01-09,Vehicle Maintenance expense,REF36962584,109.77,0.0,421720.52
2023-01-09,2023-01-09,Subcontractors expense,REF62971522,601.15,0.0,421119.37
2023-01-15,2023-01-15,Project payment - Abbott-Gomez,REF45634517,0.0,728.94,421848.31
2023-01-15,2023-01-15,Project payment - Porter Inc,REF68287196,0.0,437.28,422285.59
2023-01-15,2023-01-15,"Service payment - Nelson, Parks and Campbell",REF14600335,0.0,824.57,423110.16
2023-01-15,2023-01-15,"Invoice payment - Mullins, Buckley and Hahn",REF70896324,0.0,704.69,423814.85
2023-01-15,2023-01-15,Business insurance premium,REF11184929,136.78,0.0,423678.07
2023-01-15,2023-01-15,Service payment - Roman-Gonzalez,REF74969602,0.0,713.0,424391.07
2023-01-16,2023-01-16,Business materials,REF19302307,426.57,0.0,423964.5
2023-01-17,2023-01-17,Vehicle Maintenance expense,REF50953416,156.66,0.0,423807.84
2023-01-21,2023-01-21,Business materials,REF33356890,734.98,0.0,423072.86
2023-01-27,2023-01-27,Business materials,REF70859251,626.76,0.0,422446.1
2023-01-28,2023-01-28,Permits Licenses expense,REF92926009,57.15,0.0,422388.95
2023-01-29,2023-01-29,Subcontractors expense,REF21362472,1007.32,0.0,421381.63
2023-01-30,2023-01-30,"Payment from Mullins, Buckley and Hahn",REF66005319,0.0,581.85,421963.48
2023-01-30,2023-01-30,Service payment - Roman-Gonzalez,REF45607394,0.0,646.45,422609.93
2023-01-30,2023-01-30,"Invoice payment - Nelson, Parks and Campbell",REF26520138,0.0,791.84,423401.77
2023-01-30,2023-01-30,Service payment - Abbott-Gomez,REF74671584,0.0,853.92,424255.69
2023-01-30,2023-01-30,Payment from Porter Inc,REF13108332,0.0,481.96,424737.65
2023-02-03,2023-02-03,Business materials,REF99800074,672.55,0.0,424065.1
2023-02-09,2023-02-09,Permits Licenses expense,REF51930926,74.82,0.0,423990.28
2023-02-10,2023-02-10,Tools expense,REF41270902,117.11,0.0,423873.17
2023-02-11,2023-02-11,Fuel purchase,REF55216897,184.84,0.0,423688.33
2023-02-13,2023-02-13,Permits Licenses expense,REF51674076,65.62,0.0,423622.71
2023-02-15,2023-02-15,"Service payment - Mullins, Buckley and Hahn",REF65961806,0.0,598.59,424221.3
2023-02-15,2023-02-15,Business insurance premium,REF56054933,158.85,0.0,424062.45
2023-02-15,2023-02-15,"Service payment - Nelson, Parks and Campbell",REF38960481,0.0,1056.61,425119.06
2023-02-15,2023-02-15,Service payment - Roman-Gonzalez,REF21554905,0.0,818.27,425937.33
2023-02-15,2023-02-15,Payment from Porter Inc,REF19547622,0.0,520.19,426457.52
2023-02-15,2023-02-15,Service payment - Abbott-Gomez,REF22323292,0.0,873.96,427331.48
2023-02-20,2023-02-20,Tools expense,REF56984339,55.02,0.0,427276.46
2023-02-25,2023-02-25,Fuel purchase,REF26388400,176.07,0.0,427100.39
2023-02-26,2023-02-26,Tools expense,REF22476108,90.59,0.0,427009.8
2023-02-28,2023-02-28,Project payment - Roman-Gonzalez,REF81166806,0.0,680.38,427690.18
2023-02-28,2023-02-28,"Project payment - Mullins, Buckley and Hahn",REF45018480,0.0,808.1,428498.28
2023-02-28,2023-02-28,Invoice payment - Porter Inc,REF80129409,0.0,592.5,429090.78
2023-02-28,2023-02-28,Payment from Abbott-Gomez,REF43751491,0.0,879.62,429970.4
2023-02-28,2023-02-28,"Service payment - Nelson, Parks and Campbell",REF70695086,0.0,922.06,430892.46
2023-03-04,2023-03-04,Vehicle Maintenance expense,REF12387785,118.85,0.0,430773.61
2023-03-05,2023-03-05,Vehicle Maintenance expense,REF24611092,186.48,0.0,430587.13
2023-03-05,2023-03-05,Safety Equipment expense,REF75979779,90.64,0.0,430496.49
2023-03-09,2023-03-09,Tools expense,REF35497211,108.96,0.0,430387.53
2023-03-10,2023-03-10,Equipment Rental expense,REF10411102,204.77,0.0,430182.76
2023-03-15,2023-03-15,"Invoice payment - Nelson, Parks and Campbell",REF37133618,0.0,1366.61,431549.37
2023-03-15,2023-03-15,Project payment - Porter Inc,REF99222629,0.0,515.25,432064.62
2023-03-15,2023-03-15,"Service payment - Mullins, Buckley and Hahn",REF61734656,0.0,1059.18,433123.8
2023-03-15,2023-03-15,Project payment - Abbott-Gomez,REF88744346,0.0,1052.87,434176.67
2023-03-15,2023-03-15,Business insurance premium,REF95418536,189.69,0.0,433986.98
2023-03-15,2023-03-15,Invoice payment - Roman-Gonzalez,REF54641908,0.0,708.53,434695.51
2023-03-15,2023-03-15,Business materials,REF19081885,727.65,0.0,433967.86
2023-03-19,2023-03-19,Safety Equipment expense,REF16557360,74.1,0.0,433893.76
2023-03-20,2023-03-20,Fuel purchase,REF54340740,360.65,0.0,433533.11
2023-03-23,2023-03-23,Subcontractors expense,REF39376378,1082.97,0.0,432450.14
2023-03-26,2023-03-26,Fuel purchase,REF97212936,530.7,0.0,431919.44
2023-03-27,2023-03-27,Business materials,REF47859533,648.12,0.0,431271.32
2023-03-30,2023-03-30,Project payment - Abbott-Gomez,REF67074524,0.0,1102.03,432373.35
2023-03-30,2023-03-30,Invoice payment - Porter Inc,REF14569112,0.0,687.4,433060.75
2023-03-30,2023-03-30,Payment from Roman-Gonzalez,REF69625447,0.0,828.71,433889.46
2023-03-30,2023-03-30,"Project payment - Mullins, Buckley and Hahn",REF56042269,0.0,966.74,434856.2
2023-03-30,2023-03-30,"Project payment - Nelson, Parks and Campbell",REF46349870,0.0,945.29,435801.49
2023-04-07,2023-04-07,Vehicle Maintenance expense,REF56877494,171.65,0.0,435629.84
2023-04-07,2023-04-07,Tools expense,REF62387019,163.4,0.0,435466.44
2023-04-08,2023-04-08,Business materials,REF27645741,442.72,0.0,435023.72
2023-04-10,2023-04-10,Subcontractors expense,REF71520742,1575.94,0.0,433447.78
2023-04-12,2023-04-12,Fuel purchase,REF31103512,259.27,0.0,433188.51
2023-04-15,2023-04-15,"Project payment - Nelson, Parks and Campbell",REF41560793,0.0,1518.72,434707.23
2023-04-15,2023-04-15,Business insurance premium,REF86735916,241.79,0.0,434465.44
2023-04-15,2023-04-15,"Payment from Mullins, Buckley and Hahn",REF97035648,0.0,888.59,435354.03
2023-04-15,2023-04-15,Project payment - Roman-Gonzalez,REF40845041,0.0,974.93,436328.96
2023-04-15,2023-04-15,Project payment - Abbott-Gomez,REF46388874,0.0,1371.43,437700.39
2023-04-15,2023-04-15,Project payment - Porter Inc,REF48382212,0.0,1044.84,438745.23
2023-04-17,2023-04-17,Equipment Rental expense,REF95721620,494.66,0.0,438250.57
2023-04-29,2023-04-29,Business materials,REF46964823,1102.48,0.0,437148.09
2023-04-30,2023-04-30,Service payment - Abbott-Gomez,REF42503224,0.0,1473.98,438622.07
2023-04-30,2023-04-30,"Invoice payment - Nelson, Parks and Campbell",REF44798341,0.0,1788.57,440410.64
2023-04-30,2023-04-30,Project payment - Porter Inc,REF21201522,0.0,835.87,441246.51
2023-04-30,2023-04-30,"Project payment - Mullins, Buckley and Hahn",REF46907161,0.0,1200.02,442446.53
2023-04-30,2023-04-30,Payment from Roman-Gonzalez,REF83597820,0.0,961.23,443407.76
2023-05-03,2023-05-03,Business materials,REF13758954,769.15,0.0,442638.61
2023-05-08,2023-05-08,Business materials,REF85867915,1305.18,0.0,441333.43
2023-05-15,2023-05-15,Business insurance premium,REF38032834,262.13,0.0,441071.3
2023-05-15,2023-05-15,Invoice payment - Abbott-Gomez,REF71065023,0.0,1302.6,442373.9
2023-05-15,2023-05-15,"Service payment - Nelson, Parks and Campbell",REF29492369,0.0,1814.33,444188.23
2023-05-15,2023-05-15,Project payment - Roman-Gonzalez,REF32716976,0.0,1343.09,445531.32
2023-05-15,2023-05-15,Invoice payment - Porter Inc,REF61649751,0.0,868.12,446399.44
2023-05-16,2023-05-16,Subcontractors expense,REF69610381,967.96,0.0,445431.48
2023-05-16,2023-05-16,Safety Equipment expense,REF51237188,70.34,0.0,445361.14
2023-05-19,2023-05-19,Fuel purchase,REF76212102,376.08,0.0,444985.06
2023-05-28,2023-05-28,Permits Licenses expense,REF29879440,171.01,0.0,444814.05
2023-05-30,2023-05-30,Subcontractors expense,REF17594732,2024.95,0.0,442789.1
2023-05-30,2023-05-30,"Invoice payment - Mullins, Buckley and Hahn",REF94431116,0.0,815.04,443604.14
2023-05-30,2023-05-30,Service payment - Porter Inc,REF31884877,0.0,1061.33,444665.47
2023-05-30,2023-05-30,Business materials,REF53999172,1116.16,0.0,443549.31
2023-05-30,2023-05-30,Service payment - Abbott-Gomez,REF26111495,0.0,1401.53,444950.84
2023-05-30,2023-05-30,"Invoice payment - Nelson, Parks and Campbell",REF58721616,0.0,1640.32,446591.16
2023-05-30,2023-05-30,Invoice payment - Roman-Gonzalez,REF56448748,0.0,823.3,447414.46
2023-06-01,2023-06-01,Vehicle Maintenance expense,REF31687708,150.34,0.0,447264.12
2023-06-02,2023-06-02,Subcontractors expense,REF41625330,505.47,0.0,446758.65
2023-06-04,2023-06-04,Equipment Rental expense,REF21154866,487.44,0.0,446271.21
2023-06-05,2023-06-05,Fuel purchase,REF63628146,445.58,0.0,445825.63
2023-06-08,2023-06-08,Business materials,REF50501060,706.49,0.0,445119.14
2023-06-09,2023-06-09,Tools expense,REF54300978,113.06,0.0,445006.08
2023-06-11,2023-06-11,Fuel purchase,REF17018116,311.24,0.0,444694.84
2023-06-14,2023-06-14,Permits Licenses expense,REF23085552,99.82,0.0,444595.02
2023-06-15,2023-06-15,Business insurance premium,REF88480912,282.27,0.0,444312.75
2023-06-15,2023-06-15,Subcontractors expense,REF28829698,1154.97,0.0,443157.78
2023-06-15,2023-06-15,Invoice payment - Roman-Gonzalez,REF81876284,0.0,1487.96,444645.74
2023-06-15,2023-06-15,"Invoice payment - Nelson, Parks and Campbell",REF37705006,0.0,1387.3,446033.04
2023-06-15,2023-06-15,Invoice payment - Porter Inc,REF17812252,0.0,1182.67,447215.71
2023-06-15,2023-06-15,Payment from Abbott-Gomez,REF42534984,0.0,1606.63,448822.34
2023-06-15,2023-06-15,"Payment from Mullins, Buckley and Hahn",REF77129279,0.0,961.57,449783.91
2023-06-16,2023-06-16,Subcontractors expense,REF15632424,2106.12,0.0,447677.79
2023-06-18,2023-06-18,Business materials,REF97182553,980.86,0.0,446696.93
2023-06-19,2023-06-19,Business materials,REF17704203,1042.84,0.0,445654.09
2023-06-19,2023-06-19,Equipment Rental expense,REF69411485,683.49,0.0,444970.6
2023-06-22,2023-06-22,Equipment Rental expense,REF39890718,245.5,0.0,444725.1
2023-06-24,2023-06-24,Permits Licenses expense,REF56307381,105.2,0.0,444619.9
2023-06-28,2023-06-28,Subcontractors expense,REF22808736,1366.56,0.0,443253.34
2023-06-29,2023-06-29,Safety Equipment expense,REF11307947,77.76,0.0,443175.58
2023-06-30,2023-06-30,Subcontractors expense,REF12744194,1239.7,0.0,441935.88
2023-06-30,2023-06-30,Service payment - Roman-Gonzalez,REF15850295,0.0,1238.94,443174.82
2023-06-30,2023-06-30,"Payment from Mullins, Buckley and Hahn",REF48902303,0.0,1026.85,444201.67
2023-06-30,2023-06-30,Service payment - Porter Inc,REF89287137,0.0,934.68,445136.35
2023-06-30,2023-06-30,Fuel purchase,REF19572710,449.47,0.0,444686.88
2023-06-30,2023-06-30,"Project payment - Nelson, Parks and Campbell",REF99184197,0.0,1494.61,446181.49
2023-07-01,2023-07-01,Safety Equipment expense,REF31824371,133.02,0.0,446048.47
2023-07-04,2023-07-04,Permits Licenses expense,REF22294469,55.33,0.0,445993.14
2023-07-05,2023-07-05,Tools expense,REF44776496,99.5,0.0,445893.64
2023-07-07,2023-07-07,Equipment Rental expense,REF33020069,401.41,0.0,445492.23
2023-07-10,2023-07-10,Business materials,REF23020250,1318.42,0.0,444173.81
2023-07-15,2023-07-15,Business insurance premium,REF90225497,238.7,0.0,443935.11
2023-07-15,2023-07-15,"Invoice payment - Mullins, Buckley and Hahn",REF31012147,0.0,1184.09,445119.2
2023-07-15,2023-07-15,Payment from Abbott-Gomez,REF28579714,0.0,1460.38,446579.58
2023-07-15,2023-07-15,Service payment - Roman-Gonzalez,REF15572152,0.0,1097.6,447677.18
2023-07-15,2023-07-15,"Service payment - Nelson, Parks and Campbell",REF81497917,0.0,865.53,448542.71
2023-07-15,2023-07-15,Payment from Porter Inc,REF66980071,0.0,899.74,449442.45
2023-07-16,2023-07-16,Fuel purchase,REF37197996,366.04,0.0,449076.41
2023-07-17,2023-07-17,Subcontractors expense,REF14805752,912.31,0.0,448164.1
2023-07-20,2023-07-20,Tools expense,REF20269261,87.04,0.0,448077.06
2023-07-20,2023-07-20,Business materials,REF71756517,1113.06,0.0,446964.0
2023-07-26,2023-07-26,Fuel purchase,REF71800942,249.75,0.0,446714.25
2023-07-30,2023-07-30,Invoice payment - Porter Inc,REF57625728,0.0,937.96,447652.21
2023-07-30,2023-07-30,"Invoice payment - Mullins, Buckley and Hahn",REF58628932,0.0,1140.2,448792.41
2023-07-30,2023-07-30,"Service payment - Nelson, Parks and Campbell",REF59821941,0.0,1460.81,450253.22
2023-07-30,2023-07-30,Project payment - Roman-Gonzalez,REF22179748,0.0,1202.75,451455.97
2023-07-30,2023-07-30,Service payment - Abbott-Gomez,REF73298557,0.0,1599.96,453055.93
2023-08-10,2023-08-10,Subcontractors expense,REF77620962,664.51,0.0,452391.42
2023-08-11,2023-08-11,Tools expense,REF39190072,35.31,0.0,452356.11
2023-08-15,2023-08-15,Project payment - Porter Inc,REF37163438,0.0,902.14,453258.25
2023-08-15,2023-08-15,Payment from Roman-Gonzalez,REF49808387,0.0,1253.03,454511.28
2023-08-15,2023-08-15,"Service payment - Nelson, Parks and Campbell",REF59313605,0.0,1564.86,456076.14
2023-08-15,2023-08-15,"Invoice payment - Mullins, Buckley and Hahn",REF46194737,0.0,1057.26,457133.4
2023-08-15,2023-08-15,Business insurance premium,REF50466318,248.32,0.0,456885.08
2023-08-19,2023-08-19,Business materials,REF14551883,291.44,0.0,456593.64
2023-08-24,2023-08-24,Permits Licenses expense,REF10703171,81.77,0.0,456511.87
2023-08-25,2023-08-25,Business materials,REF75952800,1012.49,0.0,455499.38
2023-08-27,2023-08-27,Business materials,REF63153153,848.47,0.0,454650.91
2023-08-29,2023-08-29,Fuel purchase,REF49129514,291.93,0.0,454358.98
2023-08-30,2023-08-30,"Service payment - Nelson, Parks and Campbell",REF24786493,0.0,1337.89,455696.87
2023-08-30,2023-08-30,Invoice payment - Abbott-Gomez,REF40791216,0.0,1639.71,457336.58
2023-08-30,2023-08-30,Service payment - Porter Inc,REF97633517,0.0,863.82,458200.4
2023-08-30,2023-08-30,Invoice payment - Roman-Gonzalez,REF54688483,0.0,1173.7,459374.1
2023-08-30,2023-08-30,"Service payment - Mullins, Buckley and Hahn",REF25854694,0.0,1414.02,460788.12
2023-09-03,2023-09-03,Business materials,REF32426334,968.19,0.0,459819.93
2023-09-10,2023-09-10,Vehicle Maintenance expense,REF77564623,213.85,0.0,459606.08
2023-09-11,2023-09-11,Business materials,REF25303736,1207.32,0.0,458398.76
2023-09-11,2023-09-11,Equipment Rental expense,REF84239563,417.62,0.0,457981.14
2023-09-12,2023-09-12,Permits Licenses expense,REF18512977,95.33,0.0,457885.81
2023-09-15,2023-09-15,Service payment - Roman-Gonzalez,REF27985898,0.0,1108.52,458994.33
2023-09-15,2023-09-15,Service payment - Porter Inc,REF82162344,0.0,735.52,459729.85
2023-09-15,2023-09-15,"Service payment - Mullins, Buckley and Hahn",REF25608679,0.0,1020.64,460750.49
2023-09-15,2023-09-15,Service payment - Abbott-Gomez,REF92098703,0.0,1365.91,462116.4
2023-09-15,2023-09-15,Business insurance premium,REF95802420,236.15,0.0,461880.25
2023-09-15,2023-09-15,"Payment from Nelson, Parks and Campbell",REF82209075,0.0,1162.95,463043.2
2023-09-16,2023-09-16,Business materials,REF35446755,1250.77,0.0,461792.43
2023-09-18,2023-09-18,Tools expense,REF15390954,101.83,0.0,461690.6
2023-09-18,2023-09-18,Business materials,REF33895794,740.48,0.0,460950.12
2023-09-20,2023-09-20,Permits Licenses expense,REF55363809,48.09,0.0,460902.03
2023-09-30,2023-09-30,Payment from Abbott-Gomez,REF23270087,0.0,1040.79,461942.82
2023-09-30,2023-09-30,"Payment from Mullins, Buckley and Hahn",REF38261979,0.0,969.65,462912.47
2023-09-30,2023-09-30,Service payment - Porter Inc,REF30550306,0.0,861.8,463774.27
2023-09-30,2023-09-30,"Invoice payment - Nelson, Parks and Campbell",REF21026364,0.0,1342.42,465116.69
2023-09-30,2023-09-30,Payment from Roman-Gonzalez,REF37445343,0.0,819.52,465936.21
2023-10-02,2023-10-02,Safety Equipment expense,REF57729412,77.17,0.0,465859.04
2023-10-02,2023-10-02,Subcontractors expense,REF34452333,1085.95,0.0,464773.09
2023-10-02,2023-10-02,Equipment Rental expense,REF53902298,294.68,0.0,464478.41
2023-10-04,2023-10-04,Vehicle Maintenance expense,REF28796101,169.85,0.0,464308.56
2023-10-05,2023-10-05,Subcontractors expense,REF16129721,1691.31,0.0,462617.25
2023-10-08,2023-10-08,Subcontractors expense,REF71525038,12.55,0.0,462604.7
2023-10-08,2023-10-08,Tools expense,REF80223236,159.82,0.0,462444.88
2023-10-11,2023-10-11,Business materials,REF87273871,823.61,0.0,461621.27
2023-10-13,2023-10-13,Fuel purchase,REF41600456,273.98,0.0,461347.29
2023-10-14,2023-10-14,Business materials,REF34833186,518.94,0.0,460828.35
2023-10-15,2023-10-15,Business insurance premium,REF36951311,214.55,0.0,460613.8
2023-10-15,2023-10-15,"Project payment - Mullins, Buckley and Hahn",REF55454685,0.0,956.25,461570.05
2023-10-15,2023-10-15,Service payment - Abbott-Gomez,REF46540245,0.0,1075.66,462645.71
2023-10-15,2023-10-15,Business materials,REF26575014,878.74,0.0,461766.97
2023-10-15,2023-10-15,Invoice payment - Porter Inc,REF94271386,0.0,767.2,462534.17
2023-10-15,2023-10-15,Invoice payment - Roman-Gonzalez,REF95300363,0.0,894.82,463428.99
2023-10-18,2023-10-18,Fuel purchase,REF49061350,181.49,0.0,463247.5
2023-10-23,2023-10-23,Business materials,REF49336282,905.46,0.0,462342.04
2023-10-27,2023-10-27,Business materials,REF52914299,730.56,0.0,461611.48
2023-10-27,2023-10-27,Subcontractors expense,REF80424118,1036.1,0.0,460575.38
2023-10-30,2023-10-30,Project payment - Abbott-Gomez,REF58665276,0.0,1065.92,461641.3
2023-10-30,2023-10-30,"Payment from Mullins, Buckley and Hahn",REF78229669,0.0,1088.95,462730.25
2023-10-30,2023-10-30,Project payment - Porter Inc,REF39814389,0.0,936.42,463666.67
2023-10-30,2023-10-30,"Payment from Nelson, Parks and Campbell",REF24940162,0.0,819.46,464486.13
2023-10-30,2023-10-30,Payment from Roman-Gonzalez,REF27034324,0.0,878.41,465364.54
2023-11-01,2023-11-01,Fuel purchase,REF50568415,192.5,0.0,465172.04
2023-11-02,2023-11-02,Permits Licenses expense,REF99149619,58.45,0.0,465113.59
2023-11-05,2023-11-05,Tools expense,REF63835832,82.27,0.0,465031.32
2023-11-09,2023-11-09,Permits Licenses expense,REF77705123,68.76,0.0,464962.56
2023-11-13,2023-11-13,Tools expense,REF34768305,125.68,0.0,464836.88
2023-11-14,2023-11-14,Safety Equipment expense,REF97880698,53.54,0.0,464783.34
2023-11-15,2023-11-15,Project payment - Porter Inc,REF96856111,0.0,785.58,465568.92
2023-11-15,2023-11-15,Project payment - Roman-Gonzalez,REF36048499,0.0,831.58,466400.5
2023-11-15,2023-11-15,Invoice payment - Abbott-Gomez,REF40270692,0.0,1062.24,467462.74
2023-11-15,2023-11-15,"Service payment - Mullins, Buckley and Hahn",REF52803307,0.0,795.6,468258.34
2023-11-15,2023-11-15,Business insurance premium,REF48051554,150.52,0.0,468107.82
2023-11-15,2023-11-15,"Payment from Nelson, Parks and Campbell",REF73399318,0.0,639.41,468747.23
2023-11-18,2023-11-18,Permits Licenses expense,REF72410227,84.27,0.0,468662.96
2023-11-18,2023-11-18,Business materials,REF53608753,750.26,0.0,467912.7
2023-11-21,2023-11-21,Business materials,REF29431398,724.17,0.0,467188.53
2023-11-22,2023-11-22,Equipment Rental expense,REF27273952,174.83,0.0,467013.7
2023-11-24,2023-11-24,Permits Licenses expense,REF93655502,27.3,0.0,466986.4
2023-11-30,2023-11-30,Invoice payment - Porter Inc,REF35611556,0.0,570.72,467557.12
2023-11-30,2023-11-30,Service payment - Roman-Gonzalez,REF40338500,0.0,651.56,468208.68
2023-11-30,2023-11-30,"Invoice payment - Nelson, Parks and Campbell",REF35238872,0.0,959.45,469168.13
2023-11-30,2023-11-30,Project payment - Abbott-Gomez,REF39743619,0.0,1042.18,470210.31
2023-12-04,2023-12-04,Business materials,REF89923549,403.66,0.0,469806.65
2023-12-10,2023-12-10,Business materials,REF20510557,620.62,0.0,469186.03
2023-12-15,2023-12-15,Service payment - Porter Inc,REF54700609,0.0,466.18,469652.21
2023-12-15,2023-12-15,"Project payment - Mullins, Buckley and Hahn",REF14467183,0.0,610.42,470262.63
2023-12-15,2023-12-15,Service payment - Roman-Gonzalez,REF33010056,0.0,454.82,470717.45
2023-12-15,2023-12-15,Business insurance premium,REF53513497,116.22,0.0,470601.23
2023-12-15,2023-12-15,"Payment from Nelson, Parks and Campbell",REF32077685,0.0,695.17,471296.4
2023-12-15,2023-12-15,Service payment - Abbott-Gomez,REF74062113,0.0,641.77,471938.17
2023-12-16,2023-12-16,Equipment Rental expense,REF30001187,255.78,0.0,471682.39
2023-12-19,2023-12-19,Subcontractors expense,REF40138951,230.61,0.0,471451.78
2023-12-20,2023-12-20,Safety Equipment expense,REF97088731,43.12,0.0,471408.66
2023-12-20,2023-12-20,Business materials,REF44515325,481.89,0.0,470926.77
2023-12-29,2023-12-29,Business materials,REF42081738,518.48,0.0,470408.29
2023-12-30,2023-12-30,Tools expense,REF34349536,38.59,0.0,470369.7
2023-12-30,2023-12-30,"Payment from Nelson, Parks and Campbell",REF80736110,0.0,440.15,470809.85
2023-12-30,2023-12-30,Service payment - Roman-Gonzalez,REF50006133,0.0,494.21,471304.06
2023-12-30,2023-12-30,Payment from Abbott-Gomez,REF96198981,0.0,427.19,471731.25
2023-12-30,2023-12-30,Payment from Porter Inc,REF52037470,0.0,308.94,472040.19
2023-12-30,2023-12-30,"Service payment - Mullins, Buckley and Hahn",REF98247465,0.0,489.79,472529.98
2024-01-04,2024-01-04,Business materials,REF48272638,483.95,0.0,472046.03
2024-01-05,2024-01-05,Permits Licenses expense,REF58846387,69.43,0.0,471976.6
2024-01-06,2024-01-06,Subcontractors expense,REF58621874,618.6,0.0,471358.0
2024-01-06,2024-01-06,Business materials,REF70312257,767.46,0.0,470590.54
2024-01-12,2024-01-12,Business materials,REF57422050,391.16,0.0,470199.38
2024-01-13,2024-01-13,Permits Licenses expense,REF45688545,40.95,0.0,470158.43
2024-01-15,2024-01-15,Business insurance premium,REF87065715,136.03,0.0,470022.4
2024-01-15,2024-01-15,"Payment from Mullins, Buckley and Hahn",REF66828198,0.0,598.39,470620.79
2024-01-15,2024-01-15,Invoice payment - Abbott-Gomez,REF72641232,0.0,616.72,471237.51
2024-01-15,2024-01-15,"Invoice payment - Nelson, Parks and Campbell",REF58935869,0.0,796.3,472033.81
2024-01-15,2024-01-15,Project payment - Roman-Gonzalez,REF63571429,0.0,505.47,472539.28
2024-01-15,2024-01-15,Project payment - Porter Inc,REF59905137,0.0,519.42,473058.7
2024-01-16,2024-01-16,Fuel purchase,REF20517490,124.47,0.0,472934.23
2024-01-20,2024-01-20,Subcontractors expense,REF53087356,656.7,0.0,472277.53
2024-01-23,2024-01-23,Business materials,REF72866750,661.79,0.0,471615.74
2024-01-28,2024-01-28,Fuel purchase,REF23766236,126.76,0.0,471488.98
2024-01-29,2024-01-29,Business materials,REF25110315,429.72,0.0,471059.26
2024-01-30,2024-01-30,"Project payment - Mullins, Buckley and Hahn",REF51311628,0.0,771.46,471830.72
2024-01-30,2024-01-30,"Project payment - Nelson, Parks and Campbell",REF18647352,0.0,669.2,472499.92
2024-01-30,2024-01-30,Project payment - Porter Inc,REF39432287,0.0,540.03,473039.95
2024-01-30,2024-01-30,Business materials,REF19342742,653.65,0.0,472386.3
2024-01-30,2024-01-30,Invoice payment - Roman-Gonzalez,REF43926431,0.0,678.02,473064.32
2024-01-30,2024-01-30,Payment from Abbott-Gomez,REF81430022,0.0,861.91,473926.23
2024-02-01,2024-02-01,Tools expense,REF39515780,88.73,0.0,473837.5
2024-02-04,2024-02-04,Safety Equipment expense,REF34185399,28.46,0.0,473809.04
2024-02-06,2024-02-06,Business materials,REF18298923,858.41,0.0,472950.63
2024-02-07,2024-02-07,Fuel purchase,REF54197745,220.1,0.0,472730.53
2024-02-07,2024-02-07,Business materials,REF63557119,676.07,0.0,472054.46
2024-02-09,2024-02-09,Fuel purchase,REF70715619,293.84,0.0,471760.62
2024-02-13,2024-02-13,Fuel purchase,REF65185187,278.77,0.0,471481.85
2024-02-15,2024-02-15,Business insurance premium,REF84442117,163.79,0.0,471318.06
2024-02-15,2024-02-15,"Payment from Mullins, Buckley and Hahn",REF35860306,0.0,784.61,472102.67
2024-02-15,2024-02-15,Service payment - Abbott-Gomez,REF44983884,0.0,990.13,473092.8
2024-02-15,2024-02-15,Invoice payment - Roman-Gonzalez,REF96574234,0.0,762.58,473855.38
2024-02-15,2024-02-15,Invoice payment - Porter Inc,REF91262084,0.0,450.77,474306.15
2024-02-21,2024-02-21,Business materials,REF33515590,200.79,0.0,474105.36
2024-02-26,2024-02-26,Subcontractors expense,REF70508722,657.43,0.0,473447.93
2024-02-27,2024-02-27,Fuel purchase,REF45712202,357.47,0.0,473090.46
2024-02-28,2024-02-28,"Invoice payment - Mullins, Buckley and Hahn",REF53535128,0.0,661.27,473751.73
2024-02-28,2024-02-28,Invoice payment - Porter Inc,REF28634486,0.0,714.98,474466.71
2024-02-28,2024-02-28,Payment from Roman-Gonzalez,REF32965685,0.0,679.18,475145.89
2024-02-28,2024-02-28,Invoice payment - Abbott-Gomez,REF25160761,0.0,1172.59,476318.48
2024-02-28,2024-02-28,"Invoice payment - Nelson, Parks and Campbell",REF44821708,0.0,1018.71,477337.19
2024-02-29,2024-02-29,Permits Licenses expense,REF40010663,41.84,0.0,477295.35
2024-03-03,2024-03-03,Business materials,REF28037341,1034.42,0.0,476260.93
2024-03-03,2024-03-03,Fuel purchase,REF61191105,213.54,0.0,476047.39
2024-03-04,2024-03-04,Fuel purchase,REF65827036,217.64,0.0,475829.75
2024-03-05,2024-03-05,Fuel purchase,REF53011322,409.72,0.0,475420.03
2024-03-08,2024-03-08,Business materials,REF79612911,661.26,0.0,474758.77
2024-03-08,2024-03-08,Subcontractors expense,REF65744522,1454.24,0.0,473304.53
2024-03-09,2024-03-09,Tools expense,REF61883088,111.83,0.0,473192.7
2024-03-12,2024-03-12,Fuel purchase,REF23723529,280.49,0.0,472912.21
2024-03-15,2024-03-15,"Project payment - Mullins, Buckley and Hahn",REF18200130,0.0,932.61,473844.82
2024-03-15,2024-03-15,Project payment - Abbott-Gomez,REF47039627,0.0,999.88,474844.7
2024-03-15,2024-03-15,Business insurance premium,REF95145885,212.41,0.0,474632.29
2024-03-15,2024-03-15,"Payment from Nelson, Parks and Campbell",REF75479193,0.0,1210.93,475843.22
2024-03-15,2024-03-15,Invoice payment - Roman-Gonzalez,REF56105705,0.0,709.43,476552.65
2024-03-15,2024-03-15,Invoice payment - Porter Inc,REF54130385,0.0,837.67,477390.32
2024-03-17,2024-03-17,Vehicle Maintenance expense,REF17090624,115.76,0.0,477274.56
2024-03-18,2024-03-18,Business materials,REF62048045,901.73,0.0,476372.83
2024-03-20,2024-03-20,Business materials,REF34650573,1274.08,0.0,475098.75
2024-03-22,2024-03-22,Business materials,REF92947233,457.42,0.0,474641.33
2024-03-24,2024-03-24,Tools expense,REF26771544,121.94,0.0,474519.39
2024-03-25,2024-03-25,Tools expense,REF54955325,138.94,0.0,474380.45
2024-03-26,2024-03-26,Fuel purchase,REF60023297,222.92,0.0,474157.53
2024-03-27,2024-03-27,Business materials,REF39885565,997.53,0.0,473160.0
2024-03-28,2024-03-28,Fuel purchase,REF83080805,286.95,0.0,472873.05
2024-03-30,2024-03-30,Service payment - Abbott-Gomez,REF34865388,0.0,1104.04,473977.09
2024-03-30,2024-03-30,"Project payment - Mullins, Buckley and Hahn",REF70374824,0.0,982.37,474959.46
2024-03-30,2024-03-30,Invoice payment - Roman-Gonzalez,REF99261405,0.0,970.39,475929.85
2024-03-30,2024-03-30,"Invoice payment - Nelson, Parks and Campbell",REF82846798,0.0,836.02,476765.87
2024-04-03,2024-04-03,Subcontractors expense,REF74950275,1618.4,0.0,475147.47
2024-04-05,2024-04-05,Permits Licenses expense,REF31025466,66.7,0.0,475080.77
2024-04-05,2024-04-05,Business materials,REF56074882,876.58,0.0,474204.19
2024-04-06,2024-04-06,Fuel purchase,REF66801347,424.71,0.0,473779.48
2024-04-07,2024-04-07,Fuel purchase,REF55321035,355.87,0.0,473423.61
2024-04-07,2024-04-07,Business materials,REF44500072,1121.22,0.0,472302.39
2024-04-12,2024-04-12,Fuel purchase,REF59393943,480.63,0.0,471821.76
2024-04-15,2024-04-15,Payment from Porter Inc,REF67207876,0.0,861.85,472683.61
2024-04-15,2024-04-15,"Project payment - Nelson, Parks and Campbell",REF84605309,0.0,1231.32,473914.93
2024-04-15,2024-04-15,"Project payment - Mullins, Buckley and Hahn",REF91014311,0.0,1019.7,474934.63
2024-04-15,2024-04-15,Project payment - Roman-Gonzalez,REF78563648,0.0,1292.69,476227.32
2024-04-15,2024-04-15,Invoice payment - Abbott-Gomez,REF89415070,0.0,1568.39,477795.71
2024-04-15,2024-04-15,Fuel purchase,REF77613133,478.09,0.0,477317.62
2024-04-15,2024-04-15,Business insurance premium,REF27894911,247.35,0.0,477070.27
2024-04-20,2024-04-20,Safety Equipment expense,REF68177323,72.96,0.0,476997.31
2024-04-24,2024-04-24,Permits Licenses expense,REF14269319,100.53,0.0,476896.78
2024-04-24,2024-04-24,Subcontractors expense,REF75391092,721.99,0.0,476174.79
2024-04-27,2024-04-27,Fuel purchase,REF72600369,397.72,0.0,475777.07
2024-04-30,2024-04-30,"Project payment - Nelson, Parks and Campbell",REF52579601,0.0,1117.74,476894.81
2024-04-30,2024-04-30,"Service payment - Mullins, Buckley and Hahn",REF34001089,0.0,864.12,477758.93
2024-04-30,2024-04-30,Project payment - Roman-Gonzalez,REF26536549,0.0,1064.74,478823.67
2024-04-30,2024-04-30,Invoice payment - Abbott-Gomez,REF20523237,0.0,1720.42,480544.09
2024-04-30,2024-04-30,Service payment - Porter Inc,REF74307635,0.0,843.38,481387.47
2024-05-05,2024-05-05,Business materials,REF59749030,546.33,0.0,480841.14
2024-05-05,2024-05-05,Fuel purchase,REF23337296,438.85,0.0,480402.29
2024-05-08,2024-05-08,Business materials,REF61462918,1035.67,0.0,479366.62
2024-05-10,2024-05-10,Permits Licenses expense,REF28940436,92.89,0.0,479273.73
2024-05-11,2024-05-11,Equipment Rental expense,REF49173797,628.2,0.0,478645.53
2024-05-11,2024-05-11,Business materials,REF43961456,825.88,0.0,477819.65
2024-05-13,2024-05-13,Vehicle Maintenance expense,REF99883430,181.68,0.0,477637.97
2024-05-15,2024-05-15,Invoice payment - Porter Inc,REF93000776,0.0,986.06,478624.03
2024-05-15,2024-05-15,Business insurance premium,REF97672298,276.55,0.0,478347.48
2024-05-15,2024-05-15,Project payment - Abbott-Gomez,REF76946693,0.0,1616.66,479964.14
2024-05-15,2024-05-15,Project payment - Roman-Gonzalez,REF74071762,0.0,1265.56,481229.7
2024-05-15,2024-05-15,"Invoice payment - Mullins, Buckley and Hahn",REF71358417,0.0,1274.58,482504.28
2024-05-15,2024-05-15,"Payment from Nelson, Parks and Campbell",REF42851631,0.0,1429.38,483933.66
2024-05-18,2024-05-18,Vehicle Maintenance expense,REF41354232,188.99,0.0,483744.67
2024-05-19,2024-05-19,Business materials,REF84074567,1032.71,0.0,482711.96
2024-05-22,2024-05-22,Fuel purchase,REF41449488,515.95,0.0,482196.01
2024-05-23,2024-05-23,Business materials,REF29745604,1369.53,0.0,480826.48
2024-05-30,2024-05-30,"Service payment - Nelson, Parks and Campbell",REF91731292,0.0,1860.54,482687.02
2024-05-30,2024-05-30,Payment from Abbott-Gomez,REF35186873,0.0,1514.06,484201.08
2024-05-30,2024-05-30,"Project payment - Mullins, Buckley and Hahn",REF85545507,0.0,1210.0,485411.08
2024-05-30,2024-05-30,Permits Licenses expense,REF78620207,94.94,0.0,485316.14
2024-05-30,2024-05-30,Project payment - Roman-Gonzalez,REF90865185,0.0,1102.97,486419.11
2024-05-31,2024-05-31,Business materials,REF55709784,1550.37,0.0,484868.74
2024-06-01,2024-06-01,Permits Licenses expense,REF77356779,136.37,0.0,484732.37
2024-06-07,2024-06-07,Fuel purchase,REF24731398,310.59,0.0,484421.78
2024-06-09,2024-06-09,Fuel purchase,REF37944718,547.05,0.0,483874.73
2024-06-10,2024-06-10,Tools expense,REF72881901,157.34,0.0,483717.39
2024-06-13,2024-06-13,Subcontractors expense,REF98158823,174.78,0.0,483542.61
2024-06-15,2024-06-15,Business insurance premium,REF66493317,237.11,0.0,483305.5
2024-06-15,2024-06-15,Invoice payment - Abbott-Gomez,REF83213172,0.0,1485.07,484790.57
2024-06-15,2024-06-15,Service payment - Roman-Gonzalez,REF13668282,0.0,854.17,485644.74
2024-06-15,2024-06-15,Project payment - Porter Inc,REF46189810,0.0,1072.2,486716.94
2024-06-15,2024-06-15,"Service payment - Mullins, Buckley and Hahn",REF77932336,0.0,1455.9,488172.84
2024-06-15,2024-06-15,"Service payment - Nelson, Parks and Campbell",REF73849354,0.0,1480.64,489653.48
2024-06-18,2024-06-18,Fuel purchase,REF91513470,312.71,0.0,489340.77
2024-06-18,2024-06-18,Subcontractors expense,REF59686791,1165.92,0.0,488174.85
2024-06-22,2024-06-22,Business materials,REF18236888,1854.29,0.0,486320.56
2024-06-22,2024-06-22,Subcontractors expense,REF26862349,1335.36,0.0,484985.2
2024-06-23,2024-06-23,Permits Licenses expense,REF94785134,97.42,0.0,484887.78
2024-06-23,2024-06-23,Business materials,REF79208788,1566.34,0.0,483321.44
2024-06-24,2024-06-24,Permits Licenses expense,REF70059581,145.97,0.0,483175.47
2024-06-24,2024-06-24,Vehicle Maintenance expense,REF29389154,132.43,0.0,483043.04
2024-06-30,2024-06-30,Payment from Roman-Gonzalez,REF49994582,0.0,797.05,483840.09
2024-06-30,2024-06-30,"Invoice payment - Nelson, Parks and Campbell",REF79878783,0.0,1595.83,485435.92
2024-06-30,2024-06-30,"Project payment - Mullins, Buckley and Hahn",REF30506387,0.0,1159.4,486595.32
2024-06-30,2024-06-30,Project payment - Abbott-Gomez,REF56953425,0.0,1673.82,488269.14
2024-06-30,2024-06-30,Project payment - Porter Inc,REF16192872,0.0,926.74,489195.88
2024-07-01,2024-07-01,Business materials,REF95172941,597.58,0.0,488598.3
2024-07-03,2024-07-03,Fuel purchase,REF30422249,280.38,0.0,488317.92
2024-07-06,2024-07-06,Subcontractors expense,REF95706374,965.36,0.0,487352.56
2024-07-14,2024-07-14,Fuel purchase,REF70898331,232.2,0.0,487120.36
2024-07-15,2024-07-15,Business insurance premium,REF69776993,224.68,0.0,486895.68
2024-07-15,2024-07-15,"Service payment - Mullins, Buckley and Hahn",REF18881990,0.0,1079.78,487975.46
2024-07-15,2024-07-15,Invoice payment - Roman-Gonzalez,REF19909455,0.0,1170.94,489146.4
2024-07-15,2024-07-15,Equipment Rental expense,REF44798248,535.76,0.0,488610.64
2024-07-15,2024-07-15,Project payment - Porter Inc,REF67471631,0.0,924.13,489534.77
2024-07-15,2024-07-15,Project payment - Abbott-Gomez,REF80878029,0.0,1614.8,491149.57
2024-07-15,2024-07-15,"Project payment - Nelson, Parks and Campbell",REF34367852,0.0,1541.76,492691.33
2024-07-15,2024-07-15,Fuel purchase,REF25692759,451.53,0.0,492239.8
2024-07-16,2024-07-16,Tools expense,REF22605130,96.72,0.0,492143.08
2024-07-16,2024-07-16,Fuel purchase,REF39924666,477.62,0.0,491665.46
2024-07-21,2024-07-21,Fuel purchase,REF19365129,342.73,0.0,491322.73
2024-07-22,2024-07-22,Fuel purchase,REF31546391,410.77,0.0,490911.96
2024-07-22,2024-07-22,Tools expense,REF79056504,51.42,0.0,490860.54
2024-07-23,2024-07-23,Fuel purchase,REF46150728,237.07,0.0,490623.47
2024-07-29,2024-07-29,Equipment Rental expense,REF65012418,783.5,0.0,489839.97
2024-07-30,2024-07-30,Service payment - Porter Inc,REF89188077,0.0,768.56,490608.53
2024-07-30,2024-07-30,"Project payment - Mullins, Buckley and Hahn",REF76585142,0.0,1275.83,491884.36
2024-07-30,2024-07-30,Project payment - Roman-Gonzalez,REF33773034,0.0,1217.58,493101.94
2024-07-30,2024-07-30,"Service payment - Nelson, Parks and Campbell",REF32437022,0.0,1874.88,494976.82
2024-07-30,2024-07-30,Business materials,REF19597482,816.12,0.0,494160.7
2024-07-31,2024-07-31,Fuel purchase,REF15032832,442.9,0.0,493717.8
2024-08-01,2024-08-01,Subcontractors expense,REF42126682,1836.59,0.0,491881.21
2024-08-03,2024-08-03,Subcontractors expense,REF29865976,720.26,0.0,491160.95
2024-08-04,2024-08-04,Business materials,REF83893933,675.86,0.0,490485.09
2024-08-04,2024-08-04,Subcontractors expense,REF22746902,1787.19,0.0,488697.9
2024-08-06,2024-08-06,Business materials,REF64079037,890.25,0.0,487807.65
2024-08-06,2024-08-06,Equipment Rental expense,REF60345210,435.83,0.0,487371.82
2024-08-08,2024-08-08,Subcontractors expense,REF85189017,1561.95,0.0,485809.87
2024-08-08,2024-08-08,Business materials,REF92136458,737.48,0.0,485072.39
2024-08-09,2024-08-09,Fuel purchase,REF14593888,406.7,0.0,484665.69
2024-08-13,2024-08-13,Tools expense,REF30640502,106.05,0.0,484559.64
2024-08-15,2024-08-15,Business insurance premium,REF51332459,225.57,0.0,484334.07
2024-08-15,2024-08-15,"Payment from Nelson, Parks and Campbell",REF90059174,0.0,1677.49,486011.56
2024-08-15,2024-08-15,"Project payment - Mullins, Buckley and Hahn",REF97023945,0.0,1122.76,487134.32
2024-08-15,2024-08-15,Service payment - Abbott-Gomez,REF10411579,0.0,1154.4,488288.72
2024-08-15,2024-08-15,Payment from Roman-Gonzalez,REF32532379,0.0,896.13,489184.85
2014-08-23,2014-08-23,Business materials,REF84059527,1214.22,0.0,3878.62
2014-08-23,2014-08-23,Tools expense,REF89244865,151.17,0.0,3727.45
2014-08-25,2014-08-25,Business materials,REF82296972,1361.35,0.0,2366.1
2014-08-26,2014-08-26,Fuel purchase,REF25478089,169.34,0.0,2196.76
2014-08-28,2014-08-28,Permits Licenses expense,REF16319264,88.11,0.0,2108.65
2014-08-29,2014-08-29,Business materials,REF36404015,803.64,0.0,1305.01
2014-08-30,2014-08-30,Business materials,REF57629852,1454.97,0.0,-149.96
2014-08-30,2014-08-30,Project payment - Reynolds-Mckinney,REF37399295,0.0,1926.28,1776.32
2014-08-30,2014-08-30,Service payment - Horn and Sons,REF35714540,0.0,1878.47,3654.79
2014-08-30,2014-08-30,"Payment from Martin, Atkins and Khan",REF87186693,0.0,898.16,4552.95
2014-09-03,2014-09-03,Business materials,REF27518652,1426.15,0.0,3126.8
2014-09-03,2014-09-03,Fuel purchase,REF54008811,351.96,0.0,2774.84
2014-09-04,2014-09-04,Business materials,REF97725824,1206.23,0.0,1568.61
2014-09-06,2014-09-06,Vehicle Maintenance expense,REF69235048,189.52,0.0,1379.09
2014-09-12,2014-09-12,Fuel purchase,REF54151719,265.19,0.0,1113.9
2014-09-15,2014-09-15,Payment from Reynolds-Mckinney,REF46693287,0.0,2330.51,3444.41
2014-09-15,2014-09-15,"Project payment - Martin, Atkins and Khan",REF82148864,0.0,710.11,4154.52
2014-09-15,2014-09-15,Business insurance premium,REF79826697,227.19,0.0,3927.33
2014-09-15,2014-09-15,"Invoice payment - Martinez, Rose and Carter",REF47320798,0.0,1887.76,5815.09
2014-09-15,2014-09-15,Payment from Rogers Group,REF77208284,0.0,1375.38,7190.47
2014-09-15,2014-09-15,Invoice payment - Horn and Sons,REF47491538,0.0,1383.39,8573.86
2014-09-20,2014-09-20,Safety Equipment expense,REF53435854,74.71,0.0,8499.15
2014-09-21,2014-09-21,Permits Licenses expense,REF95239206,119.37,0.0,8379.78
2014-09-21,2014-09-21,Equipment Rental expense,REF79787444,409.89,0.0,7969.89
2014-09-27,2014-09-27,Tools expense,REF99395675,123.1,0.0,7846.79
2014-09-30,2014-09-30,"Payment from Martinez, Rose and Carter",REF15147415,0.0,2107.75,9954.54
2014-09-30,2014-09-30,Payment from Rogers Group,REF68522219,0.0,948.6,10903.14
2014-09-30,2014-09-30,Invoice payment - Horn and Sons,REF65838147,0.0,1564.14,12467.28
2014-09-30,2014-09-30,Payment from Reynolds-Mckinney,REF58427399,0.0,2138.95,14606.23
2014-09-30,2014-09-30,"Service payment - Martin, Atkins and Khan",REF59164548,0.0,727.61,15333.84
2014-10-02,2014-10-02,Business materials,REF81571775,577.87,0.0,14755.97
2014-10-04,2014-10-04,Business materials,REF11597355,1410.75,0.0,13345.22
2014-10-11,2014-10-11,Tools expense,REF13610959,104.57,0.0,13240.65
2014-10-11,2014-10-11,Fuel purchase,REF61397489,328.94,0.0,12911.71
2014-10-13,2014-10-13,Fuel purchase,REF98595083,309.29,0.0,12602.42
2014-10-15,2014-10-15,Business insurance premium,REF28361320,199.52,0.0,12402.9
2014-10-15,2014-10-15,Invoice payment - Horn and Sons,REF17673518,0.0,1896.78,14299.68
2014-10-15,2014-10-15,"Service payment - Martinez, Rose and Carter",REF37419450,0.0,1933.55,16233.23
2014-10-15,2014-10-15,"Payment from Martin, Atkins and Khan",REF83296682,0.0,979.17,17212.4
2014-10-15,2014-10-15,Service payment - Reynolds-Mckinney,REF49955067,0.0,1421.06,18633.46
2014-10-15,2014-10-15,Service payment - Rogers Group,REF18930026,0.0,888.63,19522.09
2014-10-17,2014-10-17,Fuel purchase,REF54008808,318.93,0.0,19203.16
2014-10-25,2014-10-25,Permits Licenses expense,REF28657692,60.38,0.0,19142.78
2014-10-26,2014-10-26,Subcontractors expense,REF23791150,984.97,0.0,18157.81
2014-10-28,2014-10-28,Permits Licenses expense,REF73409478,63.04,0.0,18094.77
2014-10-30,2014-10-30,Project payment - Horn and Sons,REF38549647,0.0,1586.2,19680.97
2014-10-30,2014-10-30,Service payment - Reynolds-Mckinney,REF22489965,0.0,1591.5,21272.47
2014-10-30,2014-10-30,Invoice payment - Rogers Group,REF61129704,0.0,1095.04,22367.51
2014-10-30,2014-10-30,"Service payment - Martinez, Rose and Carter",REF37921602,0.0,1624.95,23992.46
2014-10-31,2014-10-31,Tools expense,REF72718900,105.96,0.0,23886.5
2014-10-31,2014-10-31,Vehicle Maintenance expense,REF39651178,197.86,0.0,23688.64
2014-11-05,2014-11-05,Equipment Rental expense,REF20682161,497.45,0.0,23191.19
2014-11-11,2014-11-11,Safety Equipment expense,REF16309276,76.94,0.0,23114.25
2014-11-12,2014-11-12,Equipment Rental expense,REF42191260,436.09,0.0,22678.16
2014-11-13,2014-11-13,Fuel purchase,REF57282692,215.06,0.0,22463.1
2014-11-14,2014-11-14,Safety Equipment expense,REF12178830,84.01,0.0,22379.09
2014-11-15,2014-11-15,Service payment - Horn and Sons,REF14067631,0.0,892.37,23271.46
2014-11-15,2014-11-15,Service payment - Reynolds-Mckinney,REF54509722,0.0,1795.78,25067.24
2014-11-15,2014-11-15,Payment from Rogers Group,REF74973135,0.0,804.26,25871.5
2014-11-15,2014-11-15,"Invoice payment - Martin, Atkins and Khan",REF96291092,0.0,612.73,26484.23
2014-11-15,2014-11-15,Business insurance premium,REF50892526,158.11,0.0,26326.12
2014-11-15,2014-11-15,"Project payment - Martinez, Rose and Carter",REF43915168,0.0,1964.43,28290.55
2014-11-15,2014-11-15,Business materials,REF58989967,249.0,0.0,28041.55
2014-11-19,2014-11-19,Permits Licenses expense,REF56089696,75.94,0.0,27965.61
2014-11-20,2014-11-20,Business materials,REF93272542,344.32,0.0,27621.29
2014-11-21,2014-11-21,Equipment Rental expense,REF56547813,301.88,0.0,27319.41
2014-11-24,2014-11-24,Vehicle Maintenance expense,REF63462613,165.7,0.0,27153.71
2014-11-27,2014-11-27,Business materials,REF60353024,750.39,0.0,26403.32
2014-11-29,2014-11-29,Subcontractors expense,REF18985908,687.69,0.0,25715.63
2014-11-30,2014-11-30,Subcontractors expense,REF44295875,569.62,0.0,25146.01
2014-11-30,2014-11-30,"Project payment - Martin, Atkins and Khan",REF66447932,0.0,858.45,26004.46
2014-11-30,2014-11-30,Payment from Rogers Group,REF46446584,0.0,762.43,26766.89
2014-11-30,2014-11-30,"Invoice payment - Martinez, Rose and Carter",REF10769911,0.0,1467.32,28234.21
2014-11-30,2014-11-30,Payment from Horn and Sons,REF73469888,0.0,933.92,29168.13
2014-11-30,2014-11-30,Project payment - Reynolds-Mckinney,REF87553938,0.0,1512.95,30681.08
2014-12-01,2014-12-01,Business materials,REF95979368,549.61,0.0,30131.47
2014-12-07,2014-12-07,Fuel purchase,REF23153755,140.41,0.0,29991.06
2014-12-08,2014-12-08,Safety Equipment expense,REF94623345,52.82,0.0,29938.24
2014-12-10,2014-12-10,Permits Licenses expense,REF87214005,33.54,0.0,29904.7
2014-12-10,2014-12-10,Fuel purchase,REF23597170,217.67,0.0,29687.03
2014-12-15,2014-12-15,Service payment - Reynolds-Mckinney,REF78682296,0.0,1208.54,30895.57
2014-12-15,2014-12-15,Business insurance premium,REF44702930,123.53,0.0,30772.04
2014-12-15,2014-12-15,"Payment from Martinez, Rose and Carter",REF32384925,0.0,1176.09,31948.13
2014-12-15,2014-12-15,"Invoice payment - Martin, Atkins and Khan",REF78310243,0.0,473.77,32421.9
2014-12-16,2014-12-16,Fuel purchase,REF28793606,221.99,0.0,32199.91
2014-12-25,2014-12-25,Fuel purchase,REF16938200,141.53,0.0,32058.38
2014-12-26,2014-12-26,Vehicle Maintenance expense,REF27195546,102.3,0.0,31956.08
2014-12-30,2014-12-30,"Payment from Martinez, Rose and Carter",REF76090134,0.0,942.75,32898.83
2014-12-30,2014-12-30,"Invoice payment - Martin, Atkins and Khan",REF70010069,0.0,427.35,33326.18
2014-12-30,2014-12-30,Business materials,REF34917787,596.0,0.0,32730.18
2014-12-30,2014-12-30,Project payment - Rogers Group,REF34869151,0.0,626.6,33356.78
2014-12-30,2014-12-30,Permits Licenses expense,REF82283776,28.13,0.0,33328.65
2014-12-30,2014-12-30,Invoice payment - Reynolds-Mckinney,REF52540182,0.0,1094.77,34423.42
2014-12-31,2014-12-31,Fuel purchase,REF25597531,126.49,0.0,34296.93
2014-12-31,2014-12-31,Permits Licenses expense,REF74140616,54.84,0.0,34242.09
2015-01-06,2015-01-06,Fuel purchase,REF10164258,259.47,0.0,33982.62
2015-01-07,2015-01-07,Equipment Rental expense,REF60208312,360.53,0.0,33622.09
2015-01-09,2015-01-09,Business materials,REF30683623,676.48,0.0,32945.61
2015-01-11,2015-01-11,Fuel purchase,REF62809012,242.24,0.0,32703.37
2015-01-12,2015-01-12,Fuel purchase,REF96657375,305.52,0.0,32397.85
2015-01-13,2015-01-13,Business materials,REF15500485,547.44,0.0,31850.41
2015-01-13,2015-01-13,Fuel purchase,REF12476986,211.22,0.0,31639.19
2015-01-15,2015-01-15,Business insurance premium,REF75237595,134.23,0.0,31504.96
2015-01-15,2015-01-15,Payment from Horn and Sons,REF47403962,0.0,1099.77,32604.73
2015-01-15,2015-01-15,"Service payment - Martinez, Rose and Carter",REF57689905,0.0,1291.22,33895.95
2015-01-15,2015-01-15,"Service payment - Martin, Atkins and Khan",REF40403666,0.0,647.39,34543.34
2015-01-16,2015-01-16,Fuel purchase,REF25500545,190.65,0.0,34352.69
2015-01-17,2015-01-17,Fuel purchase,REF11594626,271.56,0.0,34081.13
2015-01-21,2015-01-21,Safety Equipment expense,REF87022163,23.62,0.0,34057.51
2015-01-23,2015-01-23,Business materials,REF46740684,438.08,0.0,33619.43
2015-01-26,2015-01-26,Permits Licenses expense,REF66338053,86.81,0.0,33532.62
2015-01-27,2015-01-27,Subcontractors expense,REF75728986,422.56,0.0,33110.06
2015-01-30,2015-01-30,Invoice payment - Horn and Sons,REF87915410,0.0,987.7,34097.76
2015-01-30,2015-01-30,"Project payment - Martin, Atkins and Khan",REF73355347,0.0,695.33,34793.09
2015-01-30,2015-01-30,Service payment - Reynolds-Mckinney,REF39810789,0.0,1028.81,35821.9
2015-01-30,2015-01-30,Invoice payment - Rogers Group,REF33695352,0.0,616.41,36438.31
2015-01-30,2015-01-30,"Project payment - Martinez, Rose and Carter",REF15430226,0.0,1049.18,37487.49
2015-02-03,2015-02-03,Tools expense,REF77461853,119.62,0.0,37367.87
2015-02-10,2015-02-10,Equipment Rental expense,REF11210564,484.91,0.0,36882.96
2015-02-12,2015-02-12,Subcontractors expense,REF79857991,1251.95,0.0,35631.01
2015-02-12,2015-02-12,Fuel purchase,REF23097415,228.85,0.0,35402.16
2015-02-13,2015-02-13,Equipment Rental expense,REF15142078,127.44,0.0,35274.72
2015-02-15,2015-02-15,Service payment - Rogers Group,REF22557980,0.0,915.98,36190.7
2015-02-15,2015-02-15,"Project payment - Martin, Atkins and Khan",REF45176902,0.0,612.87,36803.57
2015-02-15,2015-02-15,Payment from Horn and Sons,REF56245559,0.0,1009.07,37812.64
2015-02-15,2015-02-15,"Payment from Martinez, Rose and Carter",REF70313419,0.0,1369.24,39181.88
2015-02-15,2015-02-15,Payment from Reynolds-Mckinney,REF87823510,0.0,1707.54,40889.42
2015-02-15,2015-02-15,Business insurance premium,REF58762088,150.02,0.0,40739.4
2015-02-20,2015-02-20,Fuel purchase,REF21135261,373.96,0.0,40365.44
2015-02-24,2015-02-24,Permits Licenses expense,REF38658171,39.95,0.0,40325.49
2015-02-24,2015-02-24,Subcontractors expense,REF24105104,845.18,0.0,39480.31
2015-02-26,2015-02-26,Subcontractors expense,REF48167650,949.02,0.0,38531.29
2015-02-27,2015-02-27,Safety Equipment expense,REF76311444,74.53,0.0,38456.76
2015-02-28,2015-02-28,Payment from Horn and Sons,REF68579761,0.0,1175.09,39631.85
2015-02-28,2015-02-28,"Payment from Martin, Atkins and Khan",REF35035272,0.0,793.89,40425.74
2015-02-28,2015-02-28,Service payment - Rogers Group,REF51803409,0.0,800.29,41226.03
2015-02-28,2015-02-28,Payment from Reynolds-Mckinney,REF79618387,0.0,1427.69,42653.72
2015-02-28,2015-02-28,"Payment from Martinez, Rose and Carter",REF13914029,0.0,1562.53,44216.25
2015-03-05,2015-03-05,Tools expense,REF34415680,101.73,0.0,44114.52
2015-03-05,2015-03-05,Vehicle Maintenance expense,REF52169529,118.22,0.0,43996.3
2015-03-09,2015-03-09,Equipment Rental expense,REF20795172,388.77,0.0,43607.53
2015-03-12,2015-03-12,Subcontractors expense,REF49262126,840.53,0.0,42767.0
2015-03-15,2015-03-15,Equipment Rental expense,REF13289202,345.82,0.0,42421.18
2015-03-15,2015-03-15,Service payment - Horn and Sons,REF28464245,0.0,1355.52,43776.7
2015-03-15,2015-03-15,Business insurance premium,REF12800963,209.41,0.0,43567.29
2015-03-15,2015-03-15,Payment from Rogers Group,REF48578316,0.0,709.97,44277.26
2015-03-15,2015-03-15,"Invoice payment - Martinez, Rose and Carter",REF36262333,0.0,1230.84,45508.1
2015-03-15,2015-03-15,"Invoice payment - Martin, Atkins and Khan",REF62568814,0.0,814.51,46322.61
2015-03-17,2015-03-17,Subcontractors expense,REF78707436,1051.92,0.0,45270.69
2015-03-24,2015-03-24,Vehicle Maintenance expense,REF66058420,156.03,0.0,45114.66
2015-03-29,2015-03-29,Business materials,REF82242382,910.97,0.0,44203.69
2015-03-29,2015-03-29,Permits Licenses expense,REF21366268,88.43,0.0,44115.26
2015-03-30,2015-03-30,Service payment - Rogers Group,REF74483569,0.0,1318.64,45433.9
2015-03-30,2015-03-30,Vehicle Maintenance expense,REF35057667,174.07,0.0,45259.83
2015-03-30,2015-03-30,"Payment from Martinez, Rose and Carter",REF55415150,0.0,2019.88,47279.71
2015-03-30,2015-03-30,Project payment - Reynolds-Mckinney,REF17112225,0.0,1395.29,48675.0
2015-03-30,2015-03-30,Payment from Horn and Sons,REF79121451,0.0,1115.48,49790.48
2015-03-30,2015-03-30,"Project payment - Martin, Atkins and Khan",REF87728600,0.0,806.85,50597.33
2015-03-31,2015-03-31,Permits Licenses expense,REF28701403,56.56,0.0,50540.77
2015-04-02,2015-04-02,Business materials,REF75461950,586.34,0.0,49954.43
2015-04-05,2015-04-05,Fuel purchase,REF67433544,240.76,0.0,49713.67
2015-04-08,2015-04-08,Subcontractors expense,REF17612503,1694.79,0.0,48018.88
2015-04-09,2015-04-09,Tools expense,REF47810662,218.4,0.0,47800.48
2015-04-12,2015-04-12,Tools expense,REF97499158,108.8,0.0,47691.68
2015-04-12,2015-04-12,Subcontractors expense,REF28309811,1240.05,0.0,46451.63
2015-04-13,2015-04-13,Tools expense,REF57221728,146.66,0.0,46304.97
2015-04-14,2015-04-14,Fuel purchase,REF44419952,165.85,0.0,46139.12
2015-04-15,2015-04-15,Invoice payment - Rogers Group,REF72986827,0.0,1275.07,47414.19
2015-04-15,2015-04-15,"Invoice payment - Martinez, Rose and Carter",REF37850785,0.0,1567.43,48981.62
2015-04-15,2015-04-15,Payment from Reynolds-Mckinney,REF21864759,0.0,2369.05,51350.67
2015-04-15,2015-04-15,Business insurance premium,REF91068979,241.74,0.0,51108.93
2015-04-15,2015-04-15,"Project payment - Martin, Atkins and Khan",REF73550950,0.0,948.2,52057.13
2015-04-15,2015-04-15,Payment from Horn and Sons,REF61562007,0.0,1939.95,53997.08
2015-04-15,2015-04-15,Subcontractors expense,REF34180761,1388.83,0.0,52608.25
2015-04-18,2015-04-18,Business materials,REF93484495,652.76,0.0,51955.49
2015-04-20,2015-04-20,Subcontractors expense,REF28093689,1120.5,0.0,50834.99
2015-04-21,2015-04-21,Permits Licenses expense,REF56661439,125.63,0.0,50709.36
2015-04-22,2015-04-22,Business materials,REF41113177,1077.54,0.0,49631.82
2015-04-23,2015-04-23,Business materials,REF51214046,881.62,0.0,48750.2
2015-04-24,2015-04-24,Fuel purchase,REF98290822,225.96,0.0,48524.24
2015-04-26,2015-04-26,Vehicle Maintenance expense,REF44856747,200.58,0.0,48323.66
2015-04-27,2015-04-27,Safety Equipment expense,REF11015652,100.02,0.0,48223.64
2015-04-28,2015-04-28,Business materials,REF41098272,1003.55,0.0,47220.09
2015-04-29,2015-04-29,Safety Equipment expense,REF79228047,103.14,0.0,47116.95
2015-04-30,2015-04-30,Service payment - Rogers Group,REF55778658,0.0,1325.98,48442.93
2015-04-30,2015-04-30,Service payment - Horn and Sons,REF27979758,0.0,1661.58,50104.51
2015-04-30,2015-04-30,"Payment from Martinez, Rose and Carter",REF31792381,0.0,2021.68,52126.19
2015-04-30,2015-04-30,"Invoice payment - Martin, Atkins and Khan",REF41248709,0.0,1171.92,53298.11
2015-04-30,2015-04-30,Invoice payment - Reynolds-Mckinney,REF46846502,0.0,2238.67,55536.78
2015-05-01,2015-05-01,Subcontractors expense,REF54795933,1749.02,0.0,53787.76
2015-05-02,2015-05-02,Equipment Rental expense,REF35081587,608.5,0.0,53179.26
2015-05-05,2015-05-05,Equipment Rental expense,REF15484740,463.07,0.0,52716.19
2015-05-07,2015-05-07,Business materials,REF92030590,1620.31,0.0,51095.88
2015-05-08,2015-05-08,Fuel purchase,REF34346364,176.3,0.0,50919.58
2015-05-08,2015-05-08,Subcontractors expense,REF14545164,1243.88,0.0,49675.7
2015-05-08,2015-05-08,Vehicle Maintenance expense,REF79823774,187.86,0.0,49487.84
2015-05-10,2015-05-10,Subcontractors expense,REF28235657,1869.57,0.0,47618.27
2015-05-10,2015-05-10,Business materials,REF55205692,1090.47,0.0,46527.8
2015-05-10,2015-05-10,Equipment Rental expense,REF87715861,309.95,0.0,46217.85
2015-05-13,2015-05-13,Fuel purchase,REF84410967,443.29,0.0,45774.56
2015-05-15,2015-05-15,Business insurance premium,REF43236519,243.82,0.0,45530.74
2015-05-15,2015-05-15,Permits Licenses expense,REF20403258,130.59,0.0,45400.15
2015-05-15,2015-05-15,Project payment - Rogers Group,REF40896464,0.0,1601.28,47001.43
2015-05-15,2015-05-15,Invoice payment - Horn and Sons,REF77516456,0.0,1160.51,48161.94
2015-05-15,2015-05-15,"Project payment - Martinez, Rose and Carter",REF21633659,0.0,2302.65,50464.59
2015-05-15,2015-05-15,"Service payment - Martin, Atkins and Khan",REF49690382,0.0,983.48,51448.07
2015-05-15,2015-05-15,Project payment - Reynolds-Mckinney,REF88566050,0.0,2353.75,53801.82
2015-05-17,2015-05-17,Fuel purchase,REF28343824,515.85,0.0,53285.97
2015-05-22,2015-05-22,Fuel purchase,REF85626923,592.99,0.0,52692.98
2015-05-26,2015-05-26,Fuel purchase,REF37997769,253.99,0.0,52438.99
2015-05-28,2015-05-28,Fuel purchase,REF64072667,461.27,0.0,51977.72
2015-05-29,2015-05-29,Subcontractors expense,REF96856950,975.04,0.0,51002.68
2015-05-30,2015-05-30,Service payment - Rogers Group,REF88154923,0.0,1297.12,52299.8
2015-05-30,2015-05-30,"Invoice payment - Martinez, Rose and Carter",REF41045440,0.0,2057.19,54356.99
2015-05-30,2015-05-30,Payment from Horn and Sons,REF91642637,0.0,1884.79,56241.78
2015-05-30,2015-05-30,Service payment - Reynolds-Mckinney,REF15370039,0.0,2734.4,58976.18
2015-05-31,2015-05-31,Fuel purchase,REF74574694,361.41,0.0,58614.77
2015-06-01,2015-06-01,Safety Equipment expense,REF20656514,117.0,0.0,58497.77
2015-06-02,2015-06-02,Permits Licenses expense,REF57091481,133.49,0.0,58364.28
2015-06-05,2015-06-05,Business materials,REF27450899,577.71,0.0,57786.57
2015-06-06,2015-06-06,Fuel purchase,REF40486317,636.73,0.0,57149.84
2015-06-13,2015-06-13,Equipment Rental expense,REF24050397,471.27,0.0,56678.57
2015-06-13,2015-06-13,Business materials,REF87116688,1554.42,0.0,55124.15
2015-06-15,2015-06-15,Business insurance premium,REF55537837,257.77,0.0,54866.38
2015-06-15,2015-06-15,"Payment from Martinez, Rose and Carter",REF78562312,0.0,2750.5,57616.88
2015-06-15,2015-06-15,Payment from Horn and Sons,REF32478238,0.0,1866.04,59482.92
2015-06-15,2015-06-15,Fuel purchase,REF69781011,228.18,0.0,59254.74
2015-06-15,2015-06-15,Service payment - Rogers Group,REF55833794,0.0,1347.83,60602.57
2015-06-15,2015-06-15,"Payment from Martin, Atkins and Khan",REF65249575,0.0,1220.92,61823.49
2015-06-15,2015-06-15,Project payment - Reynolds-Mckinney,REF32046268,0.0,2757.9,64581.39
2015-06-18,2015-06-18,Business materials,REF84602642,1204.23,0.0,63377.16
2015-06-20,2015-06-20,Business materials,REF12778365,1232.46,0.0,62144.7
2015-06-21,2015-06-21,Fuel purchase,REF35452117,389.37,0.0,61755.33
2015-06-25,2015-06-25,Fuel purchase,REF32130123,267.27,0.0,61488.06
2015-06-25,2015-06-25,Business materials,REF31199998,1227.51,0.0,60260.55
2015-06-26,2015-06-26,Fuel purchase,REF24251250,258.6,0.0,60001.95
2015-06-26,2015-06-26,Business materials,REF74089475,888.13,0.0,59113.82
2015-06-29,2015-06-29,Fuel purchase,REF19865761,466.93,0.0,58646.89
2015-06-30,2015-06-30,Payment from Reynolds-Mckinney,REF81075793,0.0,2661.64,61308.53
2015-06-30,2015-06-30,"Payment from Martin, Atkins and Khan",REF13534153,0.0,1181.26,62489.79
2015-06-30,2015-06-30,Payment from Horn and Sons,REF44205551,0.0,2535.69,65025.48
2015-06-30,2015-06-30,"Project payment - Martinez, Rose and Carter",REF31026869,0.0,2663.77,67689.25
2015-06-30,2015-06-30,Invoice payment - Rogers Group,REF28581006,0.0,1631.92,69321.17
2015-07-01,2015-07-01,Business materials,REF29141731,453.11,0.0,68868.06
2015-07-04,2015-07-04,Permits Licenses expense,REF52531455,109.89,0.0,68758.17
2015-07-05,2015-07-05,Subcontractors expense,REF11595246,835.97,0.0,67922.2
2015-07-06,2015-07-06,Fuel purchase,REF49207373,341.9,0.0,67580.3
2015-07-06,2015-07-06,Business materials,REF79797642,1133.68,0.0,66446.62
2015-07-08,2015-07-08,Fuel purchase,REF38845208,392.28,0.0,66054.34
2015-07-09,2015-07-09,Subcontractors expense,REF48639975,1397.23,0.0,64657.11
2015-07-10,2015-07-10,Permits Licenses expense,REF40588351,142.84,0.0,64514.27
2015-07-10,2015-07-10,Tools expense,REF76991090,142.27,0.0,64372.0
2015-07-11,2015-07-11,Vehicle Maintenance expense,REF84674926,178.11,0.0,64193.89
2015-07-12,2015-07-12,Business materials,REF20462099,1385.94,0.0,62807.95
2015-07-15,2015-07-15,Service payment - Rogers Group,REF18074078,0.0,1345.44,64153.39
2015-07-15,2015-07-15,Invoice payment - Reynolds-Mckinney,REF61006762,0.0,1934.61,66088.0
2015-07-15,2015-07-15,Payment from Horn and Sons,REF23999729,0.0,1901.75,67989.75
2015-07-15,2015-07-15,Business insurance premium,REF47100338,238.68,0.0,67751.07
2015-07-15,2015-07-15,"Service payment - Martinez, Rose and Carter",REF70516448,0.0,1989.67,69740.74
2015-07-22,2015-07-22,Permits Licenses expense,REF78188661,128.95,0.0,69611.79
2015-07-24,2015-07-24,Equipment Rental expense,REF36598695,298.42,0.0,69313.37
2015-07-24,2015-07-24,Permits Licenses expense,REF13009616,127.44,0.0,69185.93
2015-07-25,2015-07-25,Business materials,REF91023592,1166.7,0.0,68019.23
2015-07-27,2015-07-27,Fuel purchase,REF89681259,350.7,0.0,67668.53
2015-07-30,2015-07-30,Service payment - Reynolds-Mckinney,REF16853483,0.0,1782.23,69450.76
2015-07-30,2015-07-30,Project payment - Rogers Group,REF14366312,0.0,1389.49,70840.25
2015-07-30,2015-07-30,Project payment - Horn and Sons,REF70205692,0.0,1846.79,72687.04
2015-07-30,2015-07-30,"Invoice payment - Martinez, Rose and Carter",REF16415811,0.0,2028.73,74715.77
2015-07-30,2015-07-30,"Payment from Martin, Atkins and Khan",REF24765283,0.0,953.52,75669.29
2015-07-31,2015-07-31,Permits Licenses expense,REF16371846,61.76,0.0,75607.53
2015-08-07,2015-08-07,Vehicle Maintenance expense,REF91158930,161.98,0.0,75445.55
2015-08-12,2015-08-12,Fuel purchase,REF68894373,500.49,0.0,74945.06
2015-08-15,2015-08-15,Business insurance premium,REF91136885,235.73,0.0,74709.33
2015-08-15,2015-08-15,Business materials,REF76446265,608.08,0.0,74101.25
2015-08-15,2015-08-15,"Service payment - Martinez, Rose and Carter",REF68200626,0.0,2052.58,76153.83
2015-08-15,2015-08-15,Payment from Horn and Sons,REF16616983,0.0,1924.43,78078.26
2015-08-15,2015-08-15,Payment from Rogers Group,REF28843350,0.0,1159.89,79238.15
2015-08-15,2015-08-15,"Invoice payment - Martin, Atkins and Khan",REF58285726,0.0,1262.74,80500.89
2015-08-15,2015-08-15,Payment from Reynolds-Mckinney,REF20353122,0.0,2070.89,82571.78
2015-08-17,2015-08-17,Permits Licenses expense,REF23381101,95.31,0.0,82476.47
2015-08-17,2015-08-17,Subcontractors expense,REF25816510,540.44,0.0,81936.03
2015-08-21,2015-08-21,Business materials,REF87663573,738.32,0.0,81197.71
2015-08-22,2015-08-22,Tools expense,REF13474331,161.84,0.0,81035.87
2015-08-26,2015-08-26,Tools expense,REF71607544,120.95,0.0,80914.92
2015-08-26,2015-08-26,Subcontractors expense,REF32010773,986.52,0.0,79928.4
2015-08-30,2015-08-30,Project payment - Reynolds-Mckinney,REF86353673,0.0,2323.66,82252.06
2015-08-30,2015-08-30,Payment from Rogers Group,REF85562308,0.0,1206.34,83458.4
2015-08-30,2015-08-30,"Service payment - Martin, Atkins and Khan",REF28668273,0.0,943.59,84401.99
2015-08-30,2015-08-30,"Project payment - Martinez, Rose and Carter",REF65830868,0.0,1788.14,86190.13
2015-08-30,2015-08-30,Vehicle Maintenance expense,REF13808103,247.55,0.0,85942.58
2015-08-30,2015-08-30,Invoice payment - Horn and Sons,REF78575801,0.0,1488.46,87431.04
2015-09-06,2015-09-06,Business materials,REF14747504,1268.91,0.0,86162.13
2015-09-15,2015-09-15,Business insurance premium,REF98825850,208.65,0.0,85953.48
2015-09-15,2015-09-15,Payment from Reynolds-Mckinney,REF44247086,0.0,1943.11,87896.59
2015-09-15,2015-09-15,Payment from Horn and Sons,REF70200950,0.0,1586.73,89483.32
2015-09-15,2015-09-15,"Service payment - Martin, Atkins and Khan",REF65702180,0.0,830.59,90313.91
2015-09-15,2015-09-15,Invoice payment - Rogers Group,REF18111748,0.0,1115.01,91428.92
2015-09-15,2015-09-15,"Project payment - Martinez, Rose and Carter",REF57872742,0.0,1812.48,93241.4
2015-09-16,2015-09-16,Fuel purchase,REF10904465,279.11,0.0,92962.29
2015-09-17,2015-09-17,Vehicle Maintenance expense,REF69967574,132.02,0.0,92830.27
2015-09-23,2015-09-23,Fuel purchase,REF21929384,403.1,0.0,92427.17
2015-09-23,2015-09-23,Business materials,REF46431235,902.7,0.0,91524.47
2015-09-25,2015-09-25,Permits Licenses expense,REF46694473,104.76,0.0,91419.71
2015-09-27,2015-09-27,Business materials,REF57860779,657.18,0.0,90762.53
2015-09-27,2015-09-27,Safety Equipment expense,REF83949884,52.8,0.0,90709.73
2015-09-28,2015-09-28,Business materials,REF43577779,851.34,0.0,89858.39
2015-09-30,2015-09-30,Project payment - Reynolds-Mckinney,REF26742815,0.0,1971.47,91829.86
2015-09-30,2015-09-30,"Service payment - Martin, Atkins and Khan",REF47154016,0.0,1011.38,92841.24
2015-09-30,2015-09-30,"Service payment - Martinez, Rose and Carter",REF23113473,0.0,2317.01,95158.25
2015-09-30,2015-09-30,Payment from Horn and Sons,REF90019918,0.0,1248.46,96406.71
2015-10-03,2015-10-03,Fuel purchase,REF53393060,276.07,0.0,96130.64
2015-10-04,2015-10-04,Business materials,REF15026212,734.32,0.0,95396.32
2015-10-06,2015-10-06,Fuel purchase,REF41874067,507.83,0.0,94888.49
2015-10-07,2015-10-07,Business materials,REF74977168,868.22,0.0,94020.27
2015-10-14,2015-10-14,Business materials,REF95981712,1209.06,0.0,92811.21
2015-10-15,2015-10-15,Payment from Horn and Sons,REF14443639,0.0,1644.48,94455.69
2015-10-15,2015-10-15,Business insurance premium,REF12775080,216.49,0.0,94239.2
2015-10-15,2015-10-15,Service payment - Rogers Group,REF97175778,0.0,1243.65,95482.85
2015-10-15,2015-10-15,Project payment - Reynolds-Mckinney,REF39515110,0.0,1929.62,97412.47
2015-10-15,2015-10-15,"Service payment - Martinez, Rose and Carter",REF85013221,0.0,1608.89,99021.36
2015-10-15,2015-10-15,"Service payment - Martin, Atkins and Khan",REF90327089,0.0,774.0,99795.36
2015-10-17,2015-10-17,Equipment Rental expense,REF89751781,631.83,0.0,99163.53
2015-10-20,2015-10-20,Fuel purchase,REF61528335,146.99,0.0,99016.54
2015-10-21,2015-10-21,Business materials,REF86940998,862.1,0.0,98154.44
2015-10-23,2015-10-23,Fuel purchase,REF18893882,284.57,0.0,97869.87
2015-10-24,2015-10-24,Subcontractors expense,REF34067602,950.43,0.0,96919.44
2015-10-26,2015-10-26,Business materials,REF28303841,624.16,0.0,96295.28
2015-10-30,2015-10-30,"Service payment - Martinez, Rose and Carter",REF54600325,0.0,1407.25,97702.53
2015-10-30,2015-10-30,Fuel purchase,REF93912613,296.63,0.0,97405.9
2015-10-30,2015-10-30,"Payment from Martin, Atkins and Khan",REF45879116,0.0,848.35,98254.25
2015-10-30,2015-10-30,Payment from Reynolds-Mckinney,REF72366416,0.0,1734.59,99988.84
2015-10-30,2015-10-30,Invoice payment - Horn and Sons,REF29166397,0.0,1604.8,101593.64
2015-11-04,2015-11-04,Subcontractors expense,REF57206917,315.12,0.0,101278.52
2015-11-08,2015-11-08,Business materials,REF64870618,704.25,0.0,100574.27
2015-11-09,2015-11-09,Business materials,REF18702301,888.33,0.0,99685.94
2015-11-11,2015-11-11,Permits Licenses expense,REF63822731,59.48,0.0,99626.46
2015-11-14,2015-11-14,Tools expense,REF81411652,74.64,0.0,99551.82
2015-11-15,2015-11-15,Service payment - Reynolds-Mckinney,REF31406147,0.0,1278.91,100830.73
2015-11-15,2015-11-15,"Payment from Martinez, Rose and Carter",REF98999470,0.0,1602.06,102432.79
2015-11-15,2015-11-15,Service payment - Horn and Sons,REF22352669,0.0,1146.12,103578.91
2015-11-15,2015-11-15,"Service payment - Martin, Atkins and Khan",REF37709902,0.0,651.75,104230.66
2015-11-15,2015-11-15,Business insurance premium,REF58117459,159.33,0.0,104071.33
2015-11-15,2015-11-15,Service payment - Rogers Group,REF51837122,0.0,921.47,104992.8
2015-11-18,2015-11-18,Business materials,REF89645590,832.35,0.0,104160.45
2015-11-19,2015-11-19,Fuel purchase,REF65085333,366.2,0.0,103794.25
2015-11-23,2015-11-23,Safety Equipment expense,REF57309955,72.85,0.0,103721.4
2015-11-25,2015-11-25,Equipment Rental expense,REF65840954,295.08,0.0,103426.32
2015-11-25,2015-11-25,Tools expense,REF80906460,90.7,0.0,103335.62
2015-11-27,2015-11-27,Vehicle Maintenance expense,REF35234937,121.13,0.0,103214.49
2015-11-30,2015-11-30,Service payment - Horn and Sons,REF25161998,0.0,1241.62,104456.11
2015-11-30,2015-11-30,Invoice payment - Reynolds-Mckinney,REF87013439,0.0,1286.77,105742.88
2015-11-30,2015-11-30,Service payment - Rogers Group,REF79338046,0.0,848.03,106590.91
2015-11-30,2015-11-30,"Invoice payment - Martin, Atkins and Khan",REF86891424,0.0,694.24,107285.15
2015-11-30,2015-11-30,"Payment from Martinez, Rose and Carter",REF76516222,0.0,1239.89,108525.04
2015-12-03,2015-12-03,Vehicle Maintenance expense,REF23042815,72.35,0.0,108452.69
2015-12-04,2015-12-04,Fuel purchase,REF71742569,192.96,0.0,108259.73
2015-12-04,2015-12-04,Subcontractors expense,REF96229750,578.46,0.0,107681.27
2015-12-05,2015-12-05,Business materials,REF37558418,809.37,0.0,106871.9
2015-12-07,2015-12-07,Fuel purchase,REF38304727,191.8,0.0,106680.1
2015-12-09,2015-12-09,Vehicle Maintenance expense,REF25181984,116.42,0.0,106563.68
2015-12-11,2015-12-11,Business materials,REF56875793,325.71,0.0,106237.97
2015-12-11,2015-12-11,Equipment Rental expense,REF22052032,249.0,0.0,105988.97
2015-12-14,2015-12-14,Tools expense,REF29711527,70.48,0.0,105918.49
2015-12-15,2015-12-15,"Payment from Martin, Atkins and Khan",REF96955524,0.0,505.0,106423.49
2015-12-15,2015-12-15,Payment from Reynolds-Mckinney,REF59433015,0.0,1181.2,107604.69
2015-12-15,2015-12-15,"Invoice payment - Martinez, Rose and Carter",REF91087790,0.0,1241.23,108845.92
2015-12-15,2015-12-15,Business insurance premium,REF91132497,117.0,0.0,108728.92
2015-12-15,2015-12-15,Invoice payment - Horn and Sons,REF56779791,0.0,953.14,109682.06
2015-12-15,2015-12-15,Project payment - Rogers Group,REF21889330,0.0,565.12,110247.18
2015-12-17,2015-12-17,Business materials,REF23627713,610.29,0.0,109636.89
2015-12-21,2015-12-21,Fuel purchase,REF37841829,184.29,0.0,109452.6
2015-12-21,2015-12-21,Subcontractors expense,REF32956922,318.87,0.0,109133.73
2015-12-23,2015-12-23,Business materials,REF40732683,389.1,0.0,108744.63
2015-12-27,2015-12-27,Fuel purchase,REF21579650,284.38,0.0,108460.25
2015-12-28,2015-12-28,Fuel purchase,REF45021162,288.28,0.0,108171.97
2015-12-30,2015-12-30,Service payment - Reynolds-Mckinney,REF14408133,0.0,1111.82,109283.79
2015-12-30,2015-12-30,Invoice payment - Rogers Group,REF96352925,0.0,629.45,109913.24
2015-12-30,2015-12-30,Payment from Horn and Sons,REF62111102,0.0,860.67,110773.91
2015-12-30,2015-12-30,"Invoice payment - Martinez, Rose and Carter",REF30609862,0.0,813.97,111587.88
2015-12-30,2015-12-30,"Invoice payment - Martin, Atkins and Khan",REF53618108,0.0,591.27,112179.15
2015-12-31,2015-12-31,Tools expense,REF82233294,17.64,0.0,112161.51
2016-01-07,2016-01-07,Permits Licenses expense,REF89684983,61.54,0.0,112099.97
2016-01-08,2016-01-08,Tools expense,REF74806442,63.76,0.0,112036.21
2016-01-08,2016-01-08,Business materials,REF36383039,737.23,0.0,111298.98
2016-01-10,2016-01-10,Permits Licenses expense,REF83089503,56.79,0.0,111242.19
2016-01-13,2016-01-13,Equipment Rental expense,REF71471991,381.28,0.0,110860.91
2016-01-13,2016-01-13,Fuel purchase,REF50224863,194.92,0.0,110665.99
2016-01-14,2016-01-14,Business materials,REF38535547,592.98,0.0,110073.01
2016-01-15,2016-01-15,Business insurance premium,REF17753381,124.79,0.0,109948.22
2016-01-15,2016-01-15,Payment from Rogers Group,REF17098772,0.0,843.11,110791.33
2016-01-15,2016-01-15,Payment from Horn and Sons,REF38472243,0.0,1144.35,111935.68
2016-01-15,2016-01-15,"Project payment - Martinez, Rose and Carter",REF37238227,0.0,1292.42,113228.1
2016-01-19,2016-01-19,Tools expense,REF46899234,53.24,0.0,113174.86
2016-01-21,2016-01-21,Subcontractors expense,REF82436165,394.43,0.0,112780.43
2016-01-21,2016-01-21,Fuel purchase,REF22004137,156.19,0.0,112624.24
2016-01-22,2016-01-22,Business materials,REF33494720,583.72,0.0,112040.52
2016-01-24,2016-01-24,Subcontractors expense,REF60755279,748.35,0.0,111292.17
2016-01-30,2016-01-30,"Invoice payment - Martinez, Rose and Carter",REF34722079,0.0,1213.24,112505.41
2016-01-30,2016-01-30,Invoice payment - Rogers Group,REF79385216,0.0,768.24,113273.65
2016-01-30,2016-01-30,Payment from Horn and Sons,REF42625987,0.0,975.69,114249.34
2016-01-30,2016-01-30,Service payment - Reynolds-Mckinney,REF89607402,0.0,1099.28,115348.62
2016-01-30,2016-01-30,"Project payment - Martin, Atkins and Khan",REF74215039,0.0,537.62,115886.24
2016-01-30,2016-01-30,Fuel purchase,REF23312608,126.14,0.0,115760.1
2016-02-03,2016-02-03,Fuel purchase,REF94860984,262.04,0.0,115498.06
2016-02-05,2016-02-05,Tools expense,REF98065991,83.9,0.0,115414.16
2016-02-06,2016-02-06,Business materials,REF84340766,643.84,0.0,114770.32
2016-02-09,2016-02-09,Business materials,REF60708024,293.29,0.0,114477.03
2016-02-10,2016-02-10,Fuel purchase,REF29603167,220.35,0.0,114256.68
2016-02-10,2016-02-10,Tools expense,REF33102380,71.35,0.0,114185.33
2016-02-11,2016-02-11,Business materials,REF86858423,980.53,0.0,113204.8
2016-02-12,2016-02-12,Vehicle Maintenance expense,REF34401604,97.77,0.0,113107.03
2016-02-15,2016-02-15,Business insurance premium,REF72768418,157.51,0.0,112949.52
2016-02-15,2016-02-15,Payment from Reynolds-Mckinney,REF85563994,0.0,1393.13,114342.65
2016-02-15,2016-02-15,Payment from Horn and Sons,REF35866372,0.0,1171.33,115513.98
2016-02-15,2016-02-15,"Payment from Martin, Atkins and Khan",REF37603025,0.0,651.7,116165.68
2016-02-15,2016-02-15,Service payment - Rogers Group,REF75418864,0.0,817.56,116983.24
2016-02-15,2016-02-15,"Project payment - Martinez, Rose and Carter",REF90734878,0.0,1639.69,118622.93
2016-02-16,2016-02-16,Subcontractors expense,REF17044392,887.73,0.0,117735.2
2016-02-19,2016-02-19,Business materials,REF74572509,649.15,0.0,117086.05
2016-02-20,2016-02-20,Subcontractors expense,REF64370099,516.73,0.0,116569.32
2016-02-23,2016-02-23,Subcontractors expense,REF40132235,983.41,0.0,115585.91
2016-02-24,2016-02-24,Fuel purchase,REF14632918,294.41,0.0,115291.5
2016-02-24,2016-02-24,Equipment Rental expense,REF95994111,237.04,0.0,115054.46
2016-02-27,2016-02-27,Tools expense,REF79403765,118.78,0.0,114935.68
2016-02-27,2016-02-27,Fuel purchase,REF25282159,213.42,0.0,114722.26
2016-02-28,2016-02-28,Service payment - Reynolds-Mckinney,REF25446136,0.0,1779.04,116501.3
2016-02-28,2016-02-28,"Service payment - Martinez, Rose and Carter",REF85289438,0.0,1500.88,118002.18
2016-02-28,2016-02-28,Business materials,REF34014757,391.89,0.0,117610.29
2016-02-28,2016-02-28,Project payment - Horn and Sons,REF44150940,0.0,832.18,118442.47
2016-02-28,2016-02-28,Service payment - Rogers Group,REF16850164,0.0,641.18,119083.65
2016-02-28,2016-02-28,"Project payment - Martin, Atkins and Khan",REF52456529,0.0,716.55,119800.2
2016-03-09,2016-03-09,Permits Licenses expense,REF31220988,88.04,0.0,119712.16
2016-03-11,2016-03-11,Business materials,REF64984701,895.41,0.0,118816.75
2016-03-14,2016-03-14,Equipment Rental expense,REF18950780,662.26,0.0,118154.49
2016-03-15,2016-03-15,Permits Licenses expense,REF74851128,71.72,0.0,118082.77
2016-03-15,2016-03-15,Service payment - Rogers Group,REF90156964,0.0,1192.69,119275.46
2016-03-15,2016-03-15,Business insurance premium,REF81123227,197.15,0.0,119078.31
2016-03-15,2016-03-15,Invoice payment - Horn and Sons,REF73486327,0.0,1511.31,120589.62
2016-03-15,2016-03-15,Payment from Reynolds-Mckinney,REF76342475,0.0,1459.61,122049.23
2016-03-15,2016-03-15,"Invoice payment - Martin, Atkins and Khan",REF91088890,0.0,1037.2,123086.43
2016-03-15,2016-03-15,"Payment from Martinez, Rose and Carter",REF25424652,0.0,1938.66,125025.09
2016-03-18,2016-03-18,Business materials,REF42946874,916.93,0.0,124108.16
2016-03-21,2016-03-21,Vehicle Maintenance expense,REF30453186,64.26,0.0,124043.9
2016-03-26,2016-03-26,Subcontractors expense,REF91651299,461.7,0.0,123582.2
2016-03-29,2016-03-29,Business materials,REF53347061,1071.99,0.0,122510.21
2016-03-30,2016-03-30,"Payment from Martin, Atkins and Khan",REF34610230,0.0,902.08,123412.29
2016-03-30,2016-03-30,Invoice payment - Horn and Sons,REF50205291,0.0,1204.96,124617.25
2016-03-30,2016-03-30,Invoice payment - Rogers Group,REF54231520,0.0,957.63,125574.88
2016-03-30,2016-03-30,Service payment - Reynolds-Mckinney,REF77649934,0.0,1568.62,127143.5
2016-04-05,2016-04-05,Fuel purchase,REF93864328,494.14,0.0,126649.36
2016-04-09,2016-04-09,Safety Equipment expense,REF96771744,72.52,0.0,126576.84
2016-04-11,2016-04-11,Safety Equipment expense,REF18236817,92.79,0.0,126484.05
2016-04-15,2016-04-15,Business insurance premium,REF67664877,220.17,0.0,126263.88
2016-04-15,2016-04-15,Payment from Reynolds-Mckinney,REF68705200,0.0,2633.83,128897.71
2016-04-15,2016-04-15,"Payment from Martin, Atkins and Khan",REF15131774,0.0,1073.03,129970.74
2016-04-15,2016-04-15,Payment from Rogers Group,REF36894424,0.0,857.4,130828.14
2016-04-15,2016-04-15,"Service payment - Martinez, Rose and Carter",REF79580863,0.0,1601.8,132429.94
2016-04-15,2016-04-15,Payment from Horn and Sons,REF62412886,0.0,1817.64,134247.58
2016-04-17,2016-04-17,Fuel purchase,REF84812184,317.13,0.0,133930.45
2016-04-19,2016-04-19,Vehicle Maintenance expense,REF35751157,71.95,0.0,133858.5
2016-04-26,2016-04-26,Vehicle Maintenance expense,REF53820782,104.96,0.0,133753.54
2016-04-27,2016-04-27,Business materials,REF96237505,723.17,0.0,133030.37
2016-04-27,2016-04-27,Subcontractors expense,REF92546594,1365.45,0.0,131664.92
2016-04-30,2016-04-30,Project payment - Reynolds-Mckinney,REF80316077,0.0,1760.95,133425.87
2016-04-30,2016-04-30,"Invoice payment - Martinez, Rose and Carter",REF49057917,0.0,1988.91,135414.78
2016-04-30,2016-04-30,Payment from Rogers Group,REF62027879,0.0,1205.69,136620.47
2016-04-30,2016-04-30,Service payment - Horn and Sons,REF62733754,0.0,1556.01,138176.48
2016-04-30,2016-04-30,"Project payment - Martin, Atkins and Khan",REF87744914,0.0,1053.58,139230.06
2016-05-02,2016-05-02,Business materials,REF10233714,1833.31,0.0,137396.75
2016-05-04,2016-05-04,Fuel purchase,REF12719217,435.21,0.0,136961.54
2016-05-06,2016-05-06,Business materials,REF71274342,1070.25,0.0,135891.29
2016-05-09,2016-05-09,Safety Equipment expense,REF96206698,67.78,0.0,135823.51
2016-05-11,2016-05-11,Subcontractors expense,REF12341977,1238.31,0.0,134585.2
2016-05-12,2016-05-12,Safety Equipment expense,REF43666729,65.03,0.0,134520.17
2016-05-14,2016-05-14,Business materials,REF31521744,1128.34,0.0,133391.83
2016-05-14,2016-05-14,Permits Licenses expense,REF47051167,102.21,0.0,133289.62
2016-05-14,2016-05-14,Fuel purchase,REF32909720,398.97,0.0,132890.65
2016-05-15,2016-05-15,Business insurance premium,REF31953192,275.23,0.0,132615.42
2016-05-15,2016-05-15,Payment from Rogers Group,REF24260511,0.0,1396.85,134012.27
2016-05-15,2016-05-15,Payment from Horn and Sons,REF88287423,0.0,1727.19,135739.46
2016-05-16,2016-05-16,Subcontractors expense,REF51603350,893.39,0.0,134846.07
2016-05-19,2016-05-19,Subcontractors expense,REF90868649,1157.55,0.0,133688.52
2016-05-28,2016-05-28,Permits Licenses expense,REF21274184,107.91,0.0,133580.61
2016-05-30,2016-05-30,Service payment - Rogers Group,REF35488196,0.0,1329.85,134910.46
2016-05-30,2016-05-30,"Service payment - Martin, Atkins and Khan",REF44237000,0.0,1323.37,136233.83
2016-05-30,2016-05-30,"Service payment - Martinez, Rose and Carter",REF60803982,0.0,1849.84,138083.67
2016-05-30,2016-05-30,Invoice payment - Horn and Sons,REF96768708,0.0,2133.31,140216.98
2016-05-30,2016-05-30,Project payment - Reynolds-Mckinney,REF77230667,0.0,2331.23,142548.21
2016-06-04,2016-06-04,Fuel purchase,REF84316740,260.39,0.0,142287.82
2016-06-09,2016-06-09,Business materials,REF69239132,1370.17,0.0,140917.65
2016-06-09,2016-06-09,Fuel purchase,REF27744689,281.16,0.0,140636.49
2016-06-10,2016-06-10,Safety Equipment expense,REF59198132,77.39,0.0,140559.1
2016-06-11,2016-06-11,Equipment Rental expense,REF98940029,281.46,0.0,140277.64
2016-06-13,2016-06-13,Vehicle Maintenance expense,REF69744664,228.03,0.0,140049.61
2016-06-15,2016-06-15,"Service payment - Martin, Atkins and Khan",REF46252181,0.0,1141.45,141191.06
2016-06-15,2016-06-15,Business insurance premium,REF99630936,271.22,0.0,140919.84
2016-06-15,2016-06-15,Service payment - Reynolds-Mckinney,REF15952486,0.0,1792.12,142711.96
2016-06-15,2016-06-15,Subcontractors expense,REF33105919,1000.66,0.0,141711.3
2016-06-15,2016-06-15,"Project payment - Martinez, Rose and Carter",REF35153207,0.0,2494.22,144205.52
2016-06-15,2016-06-15,Business materials,REF45599737,1823.51,0.0,142382.01
2016-06-15,2016-06-15,Project payment - Horn and Sons,REF44849860,0.0,1906.09,144288.1
2016-06-16,2016-06-16,Fuel purchase,REF78575342,431.95,0.0,143856.15
2016-06-26,2016-06-26,Subcontractors expense,REF36385462,2091.22,0.0,141764.93
2016-06-27,2016-06-27,Permits Licenses expense,REF83936284,97.57,0.0,141667.36
2016-06-30,2016-06-30,Project payment - Rogers Group,REF88632142,0.0,1547.65,143215.01
2016-06-30,2016-06-30,"Invoice payment - Martinez, Rose and Carter",REF30779487,0.0,2048.67,145263.68
2016-06-30,2016-06-30,Service payment - Reynolds-Mckinney,REF29146241,0.0,2560.24,147823.92
2016-06-30,2016-06-30,Invoice payment - Horn and Sons,REF53015199,0.0,1933.17,149757.09
2016-06-30,2016-06-30,Equipment Rental expense,REF32738602,634.76,0.0,149122.33
2016-06-30,2016-06-30,Safety Equipment expense,REF68507411,74.21,0.0,149048.12
2016-07-02,2016-07-02,Fuel purchase,REF42302293,369.5,0.0,148678.62
2016-07-04,2016-07-04,Safety Equipment expense,REF96550882,54.31,0.0,148624.31
2016-07-05,2016-07-05,Fuel purchase,REF55450706,379.07,0.0,148245.24
2016-07-07,2016-07-07,Fuel purchase,REF32868193,178.34,0.0,148066.9
2016-07-12,2016-07-12,Business materials,REF76978031,580.08,0.0,147486.82
2016-07-12,2016-07-12,Fuel purchase,REF22988810,546.78,0.0,146940.04
2016-07-13,2016-07-13,Business materials,REF95236786,1275.05,0.0,145664.99
2016-07-15,2016-07-15,Business insurance premium,REF46715857,250.57,0.0,145414.42
2016-07-15,2016-07-15,"Invoice payment - Martin, Atkins and Khan",REF57034950,0.0,1163.94,146578.36
2016-07-15,2016-07-15,Invoice payment - Reynolds-Mckinney,REF86105326,0.0,2655.9,149234.26
2016-07-15,2016-07-15,Invoice payment - Horn and Sons,REF12008254,0.0,1964.81,151199.07
2016-07-15,2016-07-15,"Project payment - Martinez, Rose and Carter",REF73263402,0.0,2810.4,154009.47
2016-07-15,2016-07-15,Invoice payment - Rogers Group,REF16004161,0.0,1490.11,155499.58
2016-07-18,2016-07-18,Fuel purchase,REF13243780,472.79,0.0,155026.79
2016-07-20,2016-07-20,Safety Equipment expense,REF23538745,64.27,0.0,154962.52
2016-07-25,2016-07-25,Permits Licenses expense,REF20703496,105.33,0.0,154857.19
2016-07-27,2016-07-27,Fuel purchase,REF95463127,424.14,0.0,154433.05
2016-07-28,2016-07-28,Business materials,REF51053368,481.03,0.0,153952.02
2016-07-30,2016-07-30,Payment from Horn and Sons,REF17776226,0.0,1792.53,155744.55
2016-07-30,2016-07-30,Invoice payment - Reynolds-Mckinney,REF83942352,0.0,2142.97,157887.52
2016-07-30,2016-07-30,Tools expense,REF13965192,104.4,0.0,157783.12
2016-07-30,2016-07-30,"Service payment - Martinez, Rose and Carter",REF61894566,0.0,2674.79,160457.91
2016-07-30,2016-07-30,Invoice payment - Rogers Group,REF82331208,0.0,1480.39,161938.3
2016-07-30,2016-07-30,"Invoice payment - Martin, Atkins and Khan",REF75064904,0.0,974.66,162912.96
2016-08-02,2016-08-02,Business materials,REF36645862,1010.76,0.0,161902.2
2016-08-02,2016-08-02,Safety Equipment expense,REF35257997,142.33,0.0,161759.87
2016-08-04,2016-08-04,Subcontractors expense,REF59973315,1096.09,0.0,160663.78
2016-08-04,2016-08-04,Permits Licenses expense,REF66545859,105.1,0.0,160558.68
2016-08-05,2016-08-05,Business materials,REF50792441,908.25,0.0,159650.43
2016-08-06,2016-08-06,Equipment Rental expense,REF41043415,559.65,0.0,159090.78
2016-08-08,2016-08-08,Fuel purchase,REF74282101,511.3,0.0,158579.48
2016-08-09,2016-08-09,Equipment Rental expense,REF80834409,716.6,0.0,157862.88
2016-08-10,2016-08-10,Business materials,REF19964920,945.18,0.0,156917.7
2016-08-10,2016-08-10,Tools expense,REF43085281,109.88,0.0,156807.82
2016-08-10,2016-08-10,Vehicle Maintenance expense,REF35281512,166.2,0.0,156641.62
2016-08-13,2016-08-13,Business materials,REF59870776,853.62,0.0,155788.0
2016-08-15,2016-08-15,"Service payment - Martinez, Rose and Carter",REF91263152,0.0,1942.96,157730.96
2016-08-15,2016-08-15,Invoice payment - Reynolds-Mckinney,REF10159808,0.0,2359.16,160090.12
2016-08-15,2016-08-15,Business insurance premium,REF10570791,251.89,0.0,159838.23
2016-08-15,2016-08-15,Invoice payment - Horn and Sons,REF95776360,0.0,1778.43,161616.66
2016-08-15,2016-08-15,Invoice payment - Rogers Group,REF40613393,0.0,1664.92,163281.58
2016-08-15,2016-08-15,"Invoice payment - Martin, Atkins and Khan",REF31406166,0.0,1282.32,164563.9
2016-08-18,2016-08-18,Permits Licenses expense,REF42453644,102.88,0.0,164461.02
2016-08-24,2016-08-24,Equipment Rental expense,REF29861223,429.33,0.0,164031.69
2016-08-25,2016-08-25,Subcontractors expense,REF88307148,970.94,0.0,163060.75
2016-08-25,2016-08-25,Fuel purchase,REF13172077,254.86,0.0,162805.89
2016-08-26,2016-08-26,Vehicle Maintenance expense,REF37555199,90.52,0.0,162715.37
2016-08-26,2016-08-26,Business materials,REF23265627,1500.86,0.0,161214.51
2016-08-27,2016-08-27,Tools expense,REF95599764,57.75,0.0,161156.76
2016-08-29,2016-08-29,Subcontractors expense,REF86696380,700.38,0.0,160456.38
2016-08-30,2016-08-30,"Service payment - Martinez, Rose and Carter",REF84072282,0.0,2224.11,162680.49
2016-08-30,2016-08-30,Payment from Horn and Sons,REF67575505,0.0,1388.01,164068.5
2016-08-30,2016-08-30,Service payment - Reynolds-Mckinney,REF40280448,0.0,1992.63,166061.13
2016-08-30,2016-08-30,"Project payment - Martin, Atkins and Khan",REF98953024,0.0,1052.69,167113.82
2016-08-30,2016-08-30,Invoice payment - Rogers Group,REF16648529,0.0,1124.59,168238.41
2016-08-31,2016-08-31,Business materials,REF46072216,1094.77,0.0,167143.64
2016-09-01,2016-09-01,Safety Equipment expense,REF42714673,77.64,0.0,167066.0
2016-09-05,2016-09-05,Business materials,REF17133071,761.77,0.0,166304.23
2016-09-09,2016-09-09,Business materials,REF79394963,738.45,0.0,165565.78
2016-09-11,2016-09-11,Tools expense,REF86312629,179.04,0.0,165386.74
2016-09-12,2016-09-12,Fuel purchase,REF87826727,399.45,0.0,164987.29
2016-09-15,2016-09-15,Business insurance premium,REF45469815,202.81,0.0,164784.48
2016-09-15,2016-09-15,"Invoice payment - Martinez, Rose and Carter",REF41781591,0.0,1642.97,166427.45
2016-09-15,2016-09-15,Subcontractors expense,REF22296896,1213.58,0.0,165213.87
2016-09-15,2016-09-15,Project payment - Horn and Sons,REF26559706,0.0,1122.35,166336.22
2016-09-15,2016-09-15,Service payment - Rogers Group,REF32805751,0.0,1196.33,167532.55
2016-09-15,2016-09-15,Service payment - Reynolds-Mckinney,REF27237242,0.0,2298.16,169830.71
2016-09-19,2016-09-19,Equipment Rental expense,REF13617876,310.1,0.0,169520.61
2016-09-19,2016-09-19,Business materials,REF31097788,601.96,0.0,168918.65
2016-09-19,2016-09-19,Tools expense,REF93023277,119.62,0.0,168799.03
2016-09-19,2016-09-19,Vehicle Maintenance expense,REF44240930,176.61,0.0,168622.42
2016-09-25,2016-09-25,Equipment Rental expense,REF39898656,291.63,0.0,168330.79
2016-09-26,2016-09-26,Business materials,REF17190208,1215.08,0.0,167115.71
2016-09-30,2016-09-30,"Invoice payment - Martin, Atkins and Khan",REF60969419,0.0,839.19,167954.9
2016-09-30,2016-09-30,"Invoice payment - Martinez, Rose and Carter",REF35376439,0.0,2392.36,170347.26
2016-09-30,2016-09-30,Payment from Rogers Group,REF17188795,0.0,1275.93,171623.19
2016-09-30,2016-09-30,Payment from Horn and Sons,REF72538776,0.0,1359.08,172982.27
2016-10-01,2016-10-01,Fuel purchase,REF58050547,327.54,0.0,172654.73
2016-10-02,2016-10-02,Fuel purchase,REF45063572,263.65,0.0,172391.08
2016-10-03,2016-10-03,Safety Equipment expense,REF45393986,28.29,0.0,172362.79
2016-10-09,2016-10-09,Fuel purchase,REF58514657,203.03,0.0,172159.76
2016-10-09,2016-10-09,Permits Licenses expense,REF61632471,66.42,0.0,172093.34
2016-10-11,2016-10-11,Business materials,REF30052156,781.73,0.0,171311.61
2016-10-13,2016-10-13,Fuel purchase,REF89006939,265.71,0.0,171045.9
2016-10-15,2016-10-15,Invoice payment - Reynolds-Mckinney,REF22237381,0.0,1887.96,172933.86
2016-10-15,2016-10-15,"Payment from Martinez, Rose and Carter",REF90508698,0.0,2296.31,175230.17
2016-10-15,2016-10-15,Business insurance premium,REF22186847,211.04,0.0,175019.13
2016-10-15,2016-10-15,"Invoice payment - Martin, Atkins and Khan",REF10753413,0.0,931.92,175951.05
2016-10-15,2016-10-15,Business materials,REF66271616,684.37,0.0,175266.68
2016-10-15,2016-10-15,Invoice payment - Horn and Sons,REF20326135,0.0,1080.31,176346.99
2016-10-15,2016-10-15,Service payment - Rogers Group,REF74371911,0.0,1155.47,177502.46
2016-10-27,2016-10-27,Vehicle Maintenance expense,REF78381422,112.09,0.0,177390.37
2016-10-30,2016-10-30,"Project payment - Martin, Atkins and Khan",REF94899403,0.0,717.88,178108.25
2016-10-30,2016-10-30,"Payment from Martinez, Rose and Carter",REF23426049,0.0,1360.84,179469.09
2016-10-30,2016-10-30,Invoice payment - Reynolds-Mckinney,REF81278784,0.0,1732.68,181201.77
2016-10-30,2016-10-30,Payment from Rogers Group,REF45567895,0.0,1022.65,182224.42
2016-10-30,2016-10-30,Payment from Horn and Sons,REF31790059,0.0,1692.1,183916.52
2016-11-01,2016-11-01,Subcontractors expense,REF17734729,615.55,0.0,183300.97
2016-11-04,2016-11-04,Permits Licenses expense,REF43250123,60.01,0.0,183240.96
2016-11-05,2016-11-05,Safety Equipment expense,REF40614261,55.84,0.0,183185.12
2016-11-05,2016-11-05,Fuel purchase,REF87189378,102.36,0.0,183082.76
2016-11-05,2016-11-05,Permits Licenses expense,REF45214909,73.4,0.0,183009.36
2016-11-06,2016-11-06,Business materials,REF25866806,625.65,0.0,182383.71
2016-11-09,2016-11-09,Business materials,REF36854170,1007.46,0.0,181376.25
2016-11-12,2016-11-12,Fuel purchase,REF13548122,287.75,0.0,181088.5
2016-11-12,2016-11-12,Vehicle Maintenance expense,REF60515421,91.32,0.0,180997.18
2016-11-15,2016-11-15,"Payment from Martinez, Rose and Carter",REF87112648,0.0,1050.3,182047.48
2016-11-15,2016-11-15,Business insurance premium,REF72498306,159.8,0.0,181887.68
2016-11-15,2016-11-15,Service payment - Rogers Group,REF25873552,0.0,817.08,182704.76
2016-11-15,2016-11-15,Project payment - Horn and Sons,REF15505355,0.0,1022.82,183727.58
2016-11-15,2016-11-15,Payment from Reynolds-Mckinney,REF71543530,0.0,1440.71,185168.29
2016-11-15,2016-11-15,"Invoice payment - Martin, Atkins and Khan",REF77489876,0.0,543.87,185712.16
2016-11-21,2016-11-21,Tools expense,REF50105340,75.67,0.0,185636.49
2016-11-26,2016-11-26,Business materials,REF85086099,663.54,0.0,184972.95
2016-11-30,2016-11-30,"Service payment - Martinez, Rose and Carter",REF23300032,0.0,1588.76,186561.71
2016-11-30,2016-11-30,"Payment from Martin, Atkins and Khan",REF16331733,0.0,830.08,187391.79
2016-11-30,2016-11-30,Invoice payment - Reynolds-Mckinney,REF70811459,0.0,1381.03,188772.82
2016-11-30,2016-11-30,Payment from Rogers Group,REF36352345,0.0,880.46,189653.28
2016-12-04,2016-12-04,Fuel purchase,REF81961938,132.57,0.0,189520.71
2016-12-04,2016-12-04,Subcontractors expense,REF12312921,511.09,0.0,189009.62
2016-12-06,2016-12-06,Fuel purchase,REF81835918,229.01,0.0,188780.61
2016-12-06,2016-12-06,Permits Licenses expense,REF15037377,53.84,0.0,188726.77
2016-12-07,2016-12-07,Fuel purchase,REF34723894,252.06,0.0,188474.71
2016-12-08,2016-12-08,Safety Equipment expense,REF32380149,59.65,0.0,188415.06
2016-12-09,2016-12-09,Fuel purchase,REF29847112,328.64,0.0,188086.42
2016-12-10,2016-12-10,Safety Equipment expense,REF56609611,42.84,0.0,188043.58
2016-12-10,2016-12-10,Fuel purchase,REF65135329,214.4,0.0,187829.18
2016-12-15,2016-12-15,Invoice payment - Rogers Group,REF45020717,0.0,699.44,188528.62
2016-12-15,2016-12-15,Fuel purchase,REF54877362,5.0,0.0,188523.62
2016-12-15,2016-12-15,Business insurance premium,REF37346897,118.72,0.0,188404.9
2016-12-15,2016-12-15,Invoice payment - Horn and Sons,REF61371540,0.0,764.15,189169.05
2016-12-15,2016-12-15,"Service payment - Martin, Atkins and Khan",REF46426478,0.0,521.47,189690.52
2016-12-15,2016-12-15,"Invoice payment - Martinez, Rose and Carter",REF28407928,0.0,1182.65,190873.17
2016-12-15,2016-12-15,Payment from Reynolds-Mckinney,REF36297377,0.0,1182.67,192055.84
2016-12-16,2016-12-16,Safety Equipment expense,REF85394751,67.33,0.0,191988.51
2016-12-21,2016-12-21,Vehicle Maintenance expense,REF77291825,78.96,0.0,191909.55
2016-12-22,2016-12-22,Business materials,REF65559593,396.96,0.0,191512.59
2016-12-27,2016-12-27,Safety Equipment expense,REF61473247,48.47,0.0,191464.12
2016-12-28,2016-12-28,Safety Equipment expense,REF64375695,43.19,0.0,191420.93
2016-12-28,2016-12-28,Business materials,REF45870860,457.54,0.0,190963.39
2016-12-30,2016-12-30,"Service payment - Martin, Atkins and Khan",REF31133552,0.0,558.33,191521.72
2016-12-30,2016-12-30,"Payment from Martinez, Rose and Carter",REF76008236,0.0,933.36,192455.08
2016-12-30,2016-12-30,Payment from Rogers Group,REF88559051,0.0,685.43,193140.51
2016-12-30,2016-12-30,Project payment - Reynolds-Mckinney,REF87981915,0.0,965.69,194106.2
2016-12-30,2016-12-30,Service payment - Horn and Sons,REF51333314,0.0,617.45,194723.65
2016-12-30,2016-12-30,Subcontractors expense,REF65310553,323.42,0.0,194400.23
2017-01-02,2017-01-02,Vehicle Maintenance expense,REF94746734,128.46,0.0,194271.77
2017-01-05,2017-01-05,Subcontractors expense,REF93631614,549.29,0.0,193722.48
2017-01-13,2017-01-13,Tools expense,REF49214270,83.66,0.0,193638.82
2017-01-14,2017-01-14,Vehicle Maintenance expense,REF57554528,131.43,0.0,193507.39
2017-01-15,2017-01-15,Project payment - Rogers Group,REF19228517,0.0,1076.06,194583.45
2017-01-15,2017-01-15,"Invoice payment - Martin, Atkins and Khan",REF30944833,0.0,597.14,195180.59
2017-01-15,2017-01-15,Project payment - Horn and Sons,REF59280743,0.0,1056.51,196237.1
2017-01-15,2017-01-15,Payment from Reynolds-Mckinney,REF74539738,0.0,1185.76,197422.86
2017-01-15,2017-01-15,Business insurance premium,REF75090822,141.86,0.0,197281.0
2017-01-19,2017-01-19,Safety Equipment expense,REF20075780,61.99,0.0,197219.01
2017-01-19,2017-01-19,Fuel purchase,REF23816364,166.43,0.0,197052.58
2017-01-22,2017-01-22,Fuel purchase,REF92992291,108.23,0.0,196944.35
2017-01-23,2017-01-23,Safety Equipment expense,REF57862415,63.85,0.0,196880.5
2017-01-30,2017-01-30,Invoice payment - Reynolds-Mckinney,REF24808727,0.0,1059.65,197940.15
2017-01-30,2017-01-30,"Invoice payment - Martinez, Rose and Carter",REF15746934,0.0,1364.91,199305.06
2017-01-30,2017-01-30,"Service payment - Martin, Atkins and Khan",REF92558277,0.0,612.08,199917.14
2017-01-30,2017-01-30,Fuel purchase,REF16091022,220.56,0.0,199696.58
2017-01-30,2017-01-30,Payment from Horn and Sons,REF32571480,0.0,1134.09,200830.67
2017-01-30,2017-01-30,Invoice payment - Rogers Group,REF13881406,0.0,728.96,201559.63
2017-02-02,2017-02-02,Permits Licenses expense,REF72788991,44.85,0.0,201514.78
2017-02-03,2017-02-03,Tools expense,REF90457317,106.21,0.0,201408.57
2017-02-05,2017-02-05,Business materials,REF66973862,465.96,0.0,200942.61
2017-02-06,2017-02-06,Business materials,REF13943158,505.21,0.0,200437.4
2017-02-07,2017-02-07,Safety Equipment expense,REF12138217,53.55,0.0,200383.85
2017-02-07,2017-02-07,Fuel purchase,REF63320893,205.14,0.0,200178.71
2017-02-08,2017-02-08,Subcontractors expense,REF12058015,616.69,0.0,199562.02
2017-02-09,2017-02-09,Tools expense,REF46750758,74.26,0.0,199487.76
2017-02-11,2017-02-11,Safety Equipment expense,REF86320610,60.35,0.0,199427.41
2017-02-12,2017-02-12,Fuel purchase,REF22721659,349.89,0.0,199077.52
2017-02-15,2017-02-15,Invoice payment - Reynolds-Mckinney,REF32171259,0.0,1434.2,200511.72
2017-02-15,2017-02-15,"Payment from Martinez, Rose and Carter",REF43097372,0.0,1067.11,201578.83
2017-02-15,2017-02-15,"Invoice payment - Martin, Atkins and Khan",REF85912982,0.0,595.27,202174.1
2017-02-15,2017-02-15,Project payment - Rogers Group,REF89972858,0.0,808.68,202982.78
2017-02-15,2017-02-15,Service payment - Horn and Sons,REF11199767,0.0,1219.15,204201.93
2017-02-15,2017-02-15,Business insurance premium,REF32354958,162.19,0.0,204039.74
2017-02-19,2017-02-19,Subcontractors expense,REF94364714,952.09,0.0,203087.65
2017-02-19,2017-02-19,Business materials,REF79535219,375.48,0.0,202712.17
2017-02-20,2017-02-20,Safety Equipment expense,REF29150936,92.4,0.0,202619.77
2017-02-24,2017-02-24,Business materials,REF12175689,348.26,0.0,202271.51
2017-02-27,2017-02-27,Tools expense,REF60374463,16.6,0.0,202254.91
2017-02-27,2017-02-27,Equipment Rental expense,REF73900011,341.49,0.0,201913.42
2017-02-28,2017-02-28,"Project payment - Martinez, Rose and Carter",REF19498652,0.0,1547.5,203460.92
2017-02-28,2017-02-28,"Project payment - Martin, Atkins and Khan",REF18528131,0.0,757.91,204218.83
2017-02-28,2017-02-28,Service payment - Rogers Group,REF32878081,0.0,621.95,204840.78
2017-02-28,2017-02-28,Service payment - Horn and Sons,REF18407009,0.0,898.2,205738.98
2017-03-02,2017-03-02,Fuel purchase,REF74681366,344.11,0.0,205394.87
2017-03-02,2017-03-02,Business materials,REF36687664,563.32,0.0,204831.55
2017-03-05,2017-03-05,Vehicle Maintenance expense,REF48053280,269.72,0.0,204561.83
2017-03-05,2017-03-05,Safety Equipment expense,REF58212943,50.68,0.0,204511.15
2017-03-09,2017-03-09,Subcontractors expense,REF77543981,1201.34,0.0,203309.81
2017-03-09,2017-03-09,Business materials,REF33826749,776.41,0.0,202533.4
2017-03-09,2017-03-09,Fuel purchase,REF72085779,278.44,0.0,202254.96
2017-03-10,2017-03-10,Business materials,REF30342619,304.25,0.0,201950.71
2017-03-14,2017-03-14,Equipment Rental expense,REF44491528,254.06,0.0,201696.65
2017-03-14,2017-03-14,Fuel purchase,REF47732588,293.36,0.0,201403.29
2017-03-15,2017-03-15,Invoice payment - Horn and Sons,REF61133970,0.0,1239.01,202642.3
2017-03-15,2017-03-15,"Project payment - Martinez, Rose and Carter",REF98563734,0.0,1919.75,204562.05
2017-03-15,2017-03-15,Project payment - Rogers Group,REF21600305,0.0,966.84,205528.89
2017-03-15,2017-03-15,"Invoice payment - Martin, Atkins and Khan",REF29249130,0.0,949.61,206478.5
2017-03-15,2017-03-15,Payment from Reynolds-Mckinney,REF10205553,0.0,2009.18,208487.68
2017-03-15,2017-03-15,Business insurance premium,REF57219438,204.53,0.0,208283.15
2017-03-15,2017-03-15,Equipment Rental expense,REF14592396,513.46,0.0,207769.69
2017-03-16,2017-03-16,Fuel purchase,REF51891118,226.41,0.0,207543.28
2017-03-23,2017-03-23,Safety Equipment expense,REF88626240,44.09,0.0,207499.19
2017-03-27,2017-03-27,Fuel purchase,REF58323670,223.48,0.0,207275.71
2017-03-28,2017-03-28,Permits Licenses expense,REF45563036,64.46,0.0,207211.25
2017-03-30,2017-03-30,Service payment - Reynolds-Mckinney,REF82490304,0.0,2266.35,209477.6
2017-03-30,2017-03-30,"Invoice payment - Martin, Atkins and Khan",REF14733718,0.0,740.66,210218.26
2017-03-30,2017-03-30,Payment from Rogers Group,REF32378734,0.0,1180.86,211399.12
2017-03-30,2017-03-30,Payment from Horn and Sons,REF18994059,0.0,1166.33,212565.45
2017-03-30,2017-03-30,"Payment from Martinez, Rose and Carter",REF16668770,0.0,1701.19,214266.64
2017-04-01,2017-04-01,Business materials,REF37841140,1023.79,0.0,213242.85
2017-04-02,2017-04-02,Business materials,REF15767508,1020.55,0.0,212222.3
2017-04-06,2017-04-06,Fuel purchase,REF37601525,409.08,0.0,211813.22
2017-04-07,2017-04-07,Vehicle Maintenance expense,REF84221378,159.09,0.0,211654.13
2017-04-08,2017-04-08,Permits Licenses expense,REF53962260,115.24,0.0,211538.89
2017-04-11,2017-04-11,Vehicle Maintenance expense,REF69220141,139.1,0.0,211399.79
2017-04-12,2017-04-12,Business materials,REF33610712,289.11,0.0,211110.68
2017-04-15,2017-04-15,Service payment - Horn and Sons,REF77554528,0.0,2011.17,213121.85
2017-04-15,2017-04-15,"Project payment - Martinez, Rose and Carter",REF22306166,0.0,2296.34,215418.19
2017-04-15,2017-04-15,Business insurance premium,REF33481140,254.44,0.0,215163.75
2017-04-16,2017-04-16,Equipment Rental expense,REF91092617,737.91,0.0,214425.84
2017-04-18,2017-04-18,Tools expense,REF27001431,155.83,0.0,214270.01
2017-04-19,2017-04-19,Business materials,REF98821531,575.26,0.0,213694.75
2017-04-23,2017-04-23,Fuel purchase,REF20898423,590.09,0.0,213104.66
2017-04-27,2017-04-27,Fuel purchase,REF82548351,323.28,0.0,212781.38
2017-04-28,2017-04-28,Business materials,REF53707120,1049.91,0.0,211731.47
2017-04-30,2017-04-30,Service payment - Horn and Sons,REF20554450,0.0,1510.41,213241.88
2017-04-30,2017-04-30,Payment from Reynolds-Mckinney,REF36482432,0.0,1970.33,215212.21
2017-04-30,2017-04-30,"Payment from Martin, Atkins and Khan",REF95856137,0.0,1187.64,216399.85
2017-04-30,2017-04-30,Project payment - Rogers Group,REF25368714,0.0,1044.92,217444.77
2017-04-30,2017-04-30,"Invoice payment - Martinez, Rose and Carter",REF35812731,0.0,2034.34,219479.11
2017-05-02,2017-05-02,Tools expense,REF72434155,96.37,0.0,219382.74
2017-05-03,2017-05-03,Business materials,REF79337965,608.04,0.0,218774.7
2017-05-13,2017-05-13,Subcontractors expense,REF32131114,578.47,0.0,218196.23
2017-05-15,2017-05-15,"Service payment - Martinez, Rose and Carter",REF34356585,0.0,1753.5,219949.73
2017-05-15,2017-05-15,Project payment - Horn and Sons,REF60779611,0.0,1663.85,221613.58
2017-05-15,2017-05-15,"Project payment - Martin, Atkins and Khan",REF63576477,0.0,1080.77,222694.35
2017-05-15,2017-05-15,Business insurance premium,REF27637876,273.31,0.0,222421.04
2017-05-15,2017-05-15,Invoice payment - Reynolds-Mckinney,REF79888454,0.0,2104.25,224525.29
2017-05-15,2017-05-15,Project payment - Rogers Group,REF71494019,0.0,1386.45,225911.74
2017-05-20,2017-05-20,Business materials,REF53798946,619.7,0.0,225292.04
2017-05-25,2017-05-25,Business materials,REF82955270,1197.4,0.0,224094.64
2017-05-30,2017-05-30,"Service payment - Martin, Atkins and Khan",REF72269548,0.0,1309.33,225403.97
2017-05-30,2017-05-30,Invoice payment - Reynolds-Mckinney,REF85039942,0.0,2995.23,228399.2
2017-05-30,2017-05-30,"Project payment - Martinez, Rose and Carter",REF16362975,0.0,2726.84,231126.04
2017-05-30,2017-05-30,Project payment - Horn and Sons,REF51568332,0.0,1858.14,232984.18
2017-05-30,2017-05-30,Service payment - Rogers Group,REF29609740,0.0,1314.94,234299.12
2017-06-04,2017-06-04,Equipment Rental expense,REF45340957,648.05,0.0,233651.07
2017-06-08,2017-06-08,Subcontractors expense,REF17690262,1604.15,0.0,232046.92
2017-06-15,2017-06-15,Business insurance premium,REF84604263,265.46,0.0,231781.46
2017-06-15,2017-06-15,"Project payment - Martin, Atkins and Khan",REF89972339,0.0,1205.58,232987.04
2017-06-15,2017-06-15,Service payment - Rogers Group,REF76957631,0.0,1078.36,234065.4
2017-06-16,2017-06-16,Business materials,REF97847149,420.8,0.0,233644.6
2017-06-16,2017-06-16,Vehicle Maintenance expense,REF73067745,151.96,0.0,233492.64
2017-06-17,2017-06-17,Tools expense,REF96313131,157.8,0.0,233334.84
2017-06-22,2017-06-22,Business materials,REF47662729,1299.32,0.0,232035.52
2017-06-22,2017-06-22,Fuel purchase,REF99711123,477.77,0.0,231557.75
2017-06-23,2017-06-23,Fuel purchase,REF71762227,424.98,0.0,231132.77
2017-06-25,2017-06-25,Fuel purchase,REF62084795,320.59,0.0,230812.18
2017-06-27,2017-06-27,Tools expense,REF14769096,146.3,0.0,230665.88
2017-06-30,2017-06-30,"Service payment - Martinez, Rose and Carter",REF36346140,0.0,2037.49,232703.37
2017-06-30,2017-06-30,Service payment - Horn and Sons,REF73929736,0.0,1904.59,234607.96
2017-06-30,2017-06-30,Invoice payment - Rogers Group,REF26700828,0.0,1426.61,236034.57
2017-06-30,2017-06-30,"Invoice payment - Martin, Atkins and Khan",REF37162801,0.0,1058.35,237092.92
2017-06-30,2017-06-30,Project payment - Reynolds-Mckinney,REF35539158,0.0,2275.34,239368.26
2017-07-02,2017-07-02,Business materials,REF22216657,164.66,0.0,239203.6
2017-07-06,2017-07-06,Vehicle Maintenance expense,REF86592133,169.17,0.0,239034.43
2017-07-07,2017-07-07,Fuel purchase,REF48456909,354.62,0.0,238679.81
2017-07-07,2017-07-07,Subcontractors expense,REF56856153,352.28,0.0,238327.53
2017-07-08,2017-07-08,Business materials,REF56523549,744.48,0.0,237583.05
2017-07-08,2017-07-08,Subcontractors expense,REF30930483,1754.06,0.0,235828.99
2017-07-15,2017-07-15,Invoice payment - Reynolds-Mckinney,REF54164332,0.0,2632.86,238461.85
2017-07-15,2017-07-15,Business insurance premium,REF44038652,243.63,0.0,238218.22
2017-07-15,2017-07-15,"Service payment - Martin, Atkins and Khan",REF49716998,0.0,1265.44,239483.66
2017-07-15,2017-07-15,"Invoice payment - Martinez, Rose and Carter",REF45732083,0.0,2297.45,241781.11
2017-07-15,2017-07-15,Payment from Horn and Sons,REF85377984,0.0,1440.89,243222.0
2017-07-15,2017-07-15,Invoice payment - Rogers Group,REF31226792,0.0,981.48,244203.48
2017-07-17,2017-07-17,Fuel purchase,REF12907637,387.2,0.0,243816.28
2017-07-17,2017-07-17,Tools expense,REF22125761,146.91,0.0,243669.37
2017-07-18,2017-07-18,Business materials,REF83164852,984.1,0.0,242685.27
2017-07-20,2017-07-20,Tools expense,REF77147764,127.65,0.0,242557.62
2017-07-24,2017-07-24,Business materials,REF19592677,785.55,0.0,241772.07
2017-07-30,2017-07-30,Service payment - Horn and Sons,REF24197110,0.0,1544.19,243316.26
2017-07-30,2017-07-30,"Invoice payment - Martin, Atkins and Khan",REF48708206,0.0,1180.4,244496.66
2017-07-30,2017-07-30,Project payment - Rogers Group,REF75517303,0.0,1165.47,245662.13
2017-07-30,2017-07-30,"Invoice payment - Martinez, Rose and Carter",REF14575936,0.0,2708.46,248370.59
2017-07-30,2017-07-30,Project payment - Reynolds-Mckinney,REF32647588,0.0,2418.46,250789.05
2017-07-31,2017-07-31,Permits Licenses expense,REF75842222,87.93,0.0,250701.12
2017-08-03,2017-08-03,Business materials,REF96617771,650.95,0.0,250050.17
2017-08-12,2017-08-12,Subcontractors expense,REF15751455,1612.54,0.0,248437.63
2017-08-12,2017-08-12,Fuel purchase,REF24968972,399.08,0.0,248038.55
2017-08-14,2017-08-14,Business materials,REF81138873,1438.53,0.0,246600.02
2017-08-15,2017-08-15,Business insurance premium,REF55676266,220.86,0.0,246379.16
2017-08-15,2017-08-15,Payment from Horn and Sons,REF96031608,0.0,1948.2,248327.36
2017-08-15,2017-08-15,Payment from Rogers Group,REF41610338,0.0,1293.23,249620.59
2017-08-15,2017-08-15,"Payment from Martin, Atkins and Khan",REF89049287,0.0,1036.58,250657.17
2017-08-15,2017-08-15,Project payment - Reynolds-Mckinney,REF87461806,0.0,2630.48,253287.65
2017-08-15,2017-08-15,"Payment from Martinez, Rose and Carter",REF43401181,0.0,2141.86,255429.51
2017-08-15,2017-08-15,Permits Licenses expense,REF78576964,55.13,0.0,255374.38
2017-08-21,2017-08-21,Business materials,REF87087124,695.22,0.0,254679.16
2017-08-26,2017-08-26,Business materials,REF34200598,1107.39,0.0,253571.77
2017-08-27,2017-08-27,Safety Equipment expense,REF71991494,136.89,0.0,253434.88
2017-08-30,2017-08-30,Project payment - Horn and Sons,REF43132352,0.0,1940.78,255375.66
2017-08-30,2017-08-30,Equipment Rental expense,REF60372053,215.2,0.0,255160.46
2017-08-30,2017-08-30,"Payment from Martinez, Rose and Carter",REF82379779,0.0,2532.01,257692.47
2017-08-30,2017-08-30,Service payment - Reynolds-Mckinney,REF33814584,0.0,1723.52,259415.99
2017-08-30,2017-08-30,Project payment - Rogers Group,REF47082105,0.0,1137.65,260553.64
2017-08-30,2017-08-30,"Project payment - Martin, Atkins and Khan",REF62425415,0.0,821.16,261374.8
2017-09-01,2017-09-01,Tools expense,REF70321242,102.71,0.0,261272.09
2017-09-03,2017-09-03,Vehicle Maintenance expense,REF98079905,145.23,0.0,261126.86
2017-09-04,2017-09-04,Business materials,REF34701123,912.37,0.0,260214.49
2017-09-08,2017-09-08,Business materials,REF33042643,844.05,0.0,259370.44
2017-09-10,2017-09-10,Fuel purchase,REF79422751,450.95,0.0,258919.49
2017-09-15,2017-09-15,"Payment from Martinez, Rose and Carter",REF96085018,0.0,2317.36,261236.85
2017-09-15,2017-09-15,Project payment - Rogers Group,REF85817502,0.0,1059.06,262295.91
2017-09-15,2017-09-15,Invoice payment - Horn and Sons,REF53285985,0.0,1919.32,264215.23
2017-09-15,2017-09-15,Business insurance premium,REF35955687,222.83,0.0,263992.4
2017-09-15,2017-09-15,"Project payment - Martin, Atkins and Khan",REF81779009,0.0,839.15,264831.55
2017-09-15,2017-09-15,Payment from Reynolds-Mckinney,REF24870805,0.0,1869.15,266700.7
2017-09-18,2017-09-18,Business materials,REF67635838,1054.66,0.0,265646.04
2017-09-29,2017-09-29,Safety Equipment expense,REF68018735,112.61,0.0,265533.43
2017-09-30,2017-09-30,"Service payment - Martinez, Rose and Carter",REF97412980,0.0,2196.1,267729.53
2017-09-30,2017-09-30,Service payment - Reynolds-Mckinney,REF77723236,0.0,2051.52,269781.05
2017-09-30,2017-09-30,Project payment - Horn and Sons,REF13907956,0.0,1558.75,271339.8
2017-09-30,2017-09-30,"Invoice payment - Martin, Atkins and Khan",REF65223395,0.0,1049.28,272389.08
2017-09-30,2017-09-30,Payment from Rogers Group,REF90892359,0.0,1124.23,273513.31
2017-10-03,2017-10-03,Fuel purchase,REF70332536,215.38,0.0,273297.93
2017-10-05,2017-10-05,Tools expense,REF42106469,83.44,0.0,273214.49
2017-10-05,2017-10-05,Business materials,REF84128096,681.44,0.0,272533.05
2017-10-06,2017-10-06,Business materials,REF36711894,849.02,0.0,271684.03
2017-10-07,2017-10-07,Safety Equipment expense,REF47736658,116.52,0.0,271567.51
2017-10-07,2017-10-07,Equipment Rental expense,REF29874157,472.05,0.0,271095.46
2017-10-11,2017-10-11,Fuel purchase,REF46087391,110.5,0.0,270984.96
2017-10-15,2017-10-15,Service payment - Rogers Group,REF49253894,0.0,1051.33,272036.29
2017-10-15,2017-10-15,Business insurance premium,REF14073638,212.34,0.0,271823.95
2017-10-15,2017-10-15,Payment from Horn and Sons,REF97396598,0.0,1486.9,273310.85
2017-10-15,2017-10-15,Invoice payment - Reynolds-Mckinney,REF63432285,0.0,1567.99,274878.84
2017-10-15,2017-10-15,"Payment from Martin, Atkins and Khan",REF29178401,0.0,699.44,275578.28
2017-10-15,2017-10-15,Business materials,REF33199787,749.48,0.0,274828.8
2017-10-15,2017-10-15,"Payment from Martinez, Rose and Carter",REF51237023,0.0,1747.22,276576.02
2017-10-17,2017-10-17,Vehicle Maintenance expense,REF65093321,128.04,0.0,276447.98
2017-10-24,2017-10-24,Equipment Rental expense,REF51014858,406.64,0.0,276041.34
2017-10-25,2017-10-25,Safety Equipment expense,REF73982828,5.0,0.0,276036.34
2017-10-29,2017-10-29,Subcontractors expense,REF32811203,1314.34,0.0,274722.0
2017-10-30,2017-10-30,"Payment from Martinez, Rose and Carter",REF11103250,0.0,1443.49,276165.49
2017-10-30,2017-10-30,Payment from Reynolds-Mckinney,REF36704793,0.0,1727.84,277893.33
2017-10-30,2017-10-30,Payment from Rogers Group,REF26870466,0.0,890.02,278783.35
2017-10-30,2017-10-30,Payment from Horn and Sons,REF12643084,0.0,1342.19,280125.54
2017-10-30,2017-10-30,"Payment from Martin, Atkins and Khan",REF88684153,0.0,879.93,281005.47
2017-11-06,2017-11-06,Equipment Rental expense,REF47026859,368.92,0.0,280636.55
2017-11-06,2017-11-06,Vehicle Maintenance expense,REF48352046,127.93,0.0,280508.62
2017-11-07,2017-11-07,Fuel purchase,REF81431306,179.59,0.0,280329.03
2017-11-13,2017-11-13,Fuel purchase,REF31374463,359.28,0.0,279969.75
2017-11-14,2017-11-14,Safety Equipment expense,REF34232550,51.48,0.0,279918.27
2017-11-15,2017-11-15,Permits Licenses expense,REF54442919,78.75,0.0,279839.52
2017-11-15,2017-11-15,Subcontractors expense,REF72444084,795.13,0.0,279044.39
2017-11-15,2017-11-15,Project payment - Reynolds-Mckinney,REF57451447,0.0,1650.37,280694.76
2017-11-15,2017-11-15,Invoice payment - Rogers Group,REF78266596,0.0,818.98,281513.74
2017-11-15,2017-11-15,Service payment - Horn and Sons,REF55232564,0.0,1106.42,282620.16
2017-11-15,2017-11-15,"Invoice payment - Martinez, Rose and Carter",REF63300274,0.0,1613.22,284233.38
2017-11-15,2017-11-15,Business insurance premium,REF12085956,149.85,0.0,284083.53
2017-11-15,2017-11-15,"Invoice payment - Martin, Atkins and Khan",REF52842652,0.0,806.67,284890.2
2017-11-21,2017-11-21,Fuel purchase,REF72476701,297.48,0.0,284592.72
2017-11-22,2017-11-22,Subcontractors expense,REF42913420,1060.34,0.0,283532.38
2017-11-24,2017-11-24,Fuel purchase,REF29581457,206.57,0.0,283325.81
2017-11-25,2017-11-25,Fuel purchase,REF42897078,318.21,0.0,283007.6
2017-11-26,2017-11-26,Business materials,REF33943023,461.52,0.0,282546.08
2017-11-26,2017-11-26,Subcontractors expense,REF51780920,813.84,0.0,281732.24
2017-11-27,2017-11-27,Fuel purchase,REF93369719,273.72,0.0,281458.52
2017-11-28,2017-11-28,Permits Licenses expense,REF34712855,82.97,0.0,281375.55
2017-11-29,2017-11-29,Fuel purchase,REF67620916,332.39,0.0,281043.16
2017-11-30,2017-11-30,"Service payment - Martin, Atkins and Khan",REF34610542,0.0,496.07,281539.23
2017-11-30,2017-11-30,Payment from Rogers Group,REF96310788,0.0,917.55,282456.78
2017-11-30,2017-11-30,Subcontractors expense,REF49150389,1039.1,0.0,281417.68
2017-11-30,2017-11-30,Invoice payment - Horn and Sons,REF87384533,0.0,1352.17,282769.85
2017-11-30,2017-11-30,"Project payment - Martinez, Rose and Carter",REF64989030,0.0,1370.15,284140.0
2017-11-30,2017-11-30,Invoice payment - Reynolds-Mckinney,REF51073522,0.0,1488.12,285628.12
2017-12-02,2017-12-02,Fuel purchase,REF84560341,140.31,0.0,285487.81
2017-12-03,2017-12-03,Business materials,REF97527071,733.24,0.0,284754.57
2017-12-08,2017-12-08,Business materials,REF52009839,493.43,0.0,284261.14
2017-12-12,2017-12-12,Fuel purchase,REF63784468,219.61,0.0,284041.53
2017-12-12,2017-12-12,Vehicle Maintenance expense,REF14031348,122.94,0.0,283918.59
2017-12-13,2017-12-13,Business materials,REF85706929,689.32,0.0,283229.27
2017-12-15,2017-12-15,Business insurance premium,REF53860208,115.79,0.0,283113.48
2017-12-15,2017-12-15,"Project payment - Martinez, Rose and Carter",REF16787650,0.0,966.26,284079.74
2017-12-15,2017-12-15,Service payment - Rogers Group,REF29527441,0.0,660.38,284740.12
2017-12-15,2017-12-15,Service payment - Reynolds-Mckinney,REF12628649,0.0,1103.83,285843.95
2017-12-15,2017-12-15,Service payment - Horn and Sons,REF90863657,0.0,784.38,286628.33
2017-12-15,2017-12-15,"Invoice payment - Martin, Atkins and Khan",REF83326083,0.0,516.85,287145.18
2017-12-15,2017-12-15,Business materials,REF30590361,879.28,0.0,286265.9
2017-12-18,2017-12-18,Fuel purchase,REF87649939,256.5,0.0,286009.4
2017-12-21,2017-12-21,Tools expense,REF50871575,80.77,0.0,285928.63
2017-12-27,2017-12-27,Business materials,REF80251644,624.13,0.0,285304.5
2017-12-30,2017-12-30,"Payment from Martin, Atkins and Khan",REF78391895,0.0,487.75,285792.25
2017-12-30,2017-12-30,Service payment - Horn and Sons,REF35167823,0.0,764.87,286557.12
2017-12-30,2017-12-30,"Payment from Martinez, Rose and Carter",REF55260469,0.0,1238.1,287795.22
2017-12-30,2017-12-30,Equipment Rental expense,REF48966619,256.6,0.0,287538.62
2017-12-30,2017-12-30,Service payment - Rogers Group,REF25945579,0.0,613.49,288152.11
2017-12-30,2017-12-30,Payment from Reynolds-Mckinney,REF17626732,0.0,924.91,289077.02
2018-01-03,2018-01-03,Fuel purchase,REF18691321,144.29,0.0,288932.73
2018-01-04,2018-01-04,Equipment Rental expense,REF71258940,478.46,0.0,288454.27
2018-01-04,2018-01-04,Permits Licenses expense,REF27010587,81.69,0.0,288372.58
2018-01-06,2018-01-06,Equipment Rental expense,REF96326771,354.24,0.0,288018.34
2018-01-12,2018-01-12,Business materials,REF13526838,357.25,0.0,287661.09
2018-01-13,2018-01-13,Business materials,REF59384468,522.43,0.0,287138.66
2018-01-14,2018-01-14,Business materials,REF33649554,458.45,0.0,286680.21
2018-01-15,2018-01-15,Business insurance premium,REF74227779,127.91,0.0,286552.3
2018-01-15,2018-01-15,Project payment - Horn and Sons,REF56197831,0.0,1013.2,287565.5
2018-01-15,2018-01-15,Service payment - Rogers Group,REF60902105,0.0,587.78,288153.28
2018-01-15,2018-01-15,"Project payment - Martin, Atkins and Khan",REF50031754,0.0,674.33,288827.61
2018-01-15,2018-01-15,Project payment - Reynolds-Mckinney,REF99822802,0.0,1056.78,289884.39
2018-01-15,2018-01-15,"Service payment - Martinez, Rose and Carter",REF83186570,0.0,1301.17,291185.56
2018-01-15,2018-01-15,Business materials,REF50443683,679.54,0.0,290506.02
2018-01-15,2018-01-15,Fuel purchase,REF32819975,174.85,0.0,290331.17
2018-01-16,2018-01-16,Vehicle Maintenance expense,REF70693459,92.81,0.0,290238.36
2018-01-17,2018-01-17,Permits Licenses expense,REF72934669,49.68,0.0,290188.68
2018-01-20,2018-01-20,Fuel purchase,REF50498170,78.2,0.0,290110.48
2018-01-21,2018-01-21,Equipment Rental expense,REF39716385,373.66,0.0,289736.82
2018-01-22,2018-01-22,Vehicle Maintenance expense,REF32068266,79.38,0.0,289657.44
2018-01-23,2018-01-23,Vehicle Maintenance expense,REF76842060,160.94,0.0,289496.5
2018-01-28,2018-01-28,Subcontractors expense,REF40319338,1008.61,0.0,288487.89
2018-01-30,2018-01-30,"Payment from Martin, Atkins and Khan",REF55608858,0.0,470.59,288958.48
2018-01-30,2018-01-30,Fuel purchase,REF18119146,156.11,0.0,288802.37
2018-01-30,2018-01-30,Project payment - Rogers Group,REF71914396,0.0,575.88,289378.25
2018-01-30,2018-01-30,"Invoice payment - Martinez, Rose and Carter",REF40058359,0.0,1444.47,290822.72
2018-01-30,2018-01-30,Project payment - Reynolds-Mckinney,REF39382535,0.0,1020.5,291843.22
2018-01-30,2018-01-30,Payment from Horn and Sons,REF35007726,0.0,953.82,292797.04
2018-01-31,2018-01-31,Vehicle Maintenance expense,REF17583092,159.69,0.0,292637.35
2018-02-01,2018-02-01,Fuel purchase,REF41484193,389.94,0.0,292247.41
2018-02-03,2018-02-03,Business materials,REF97083132,873.31,0.0,291374.1
2018-02-04,2018-02-04,Fuel purchase,REF32348217,263.28,0.0,291110.82
2018-02-07,2018-02-07,Vehicle Maintenance expense,REF84342709,141.42,0.0,290969.4
2018-02-15,2018-02-15,"Payment from Martin, Atkins and Khan",REF82977705,0.0,634.68,291604.08
2018-02-15,2018-02-15,Project payment - Horn and Sons,REF88074777,0.0,1191.44,292795.52
2018-02-15,2018-02-15,"Service payment - Martinez, Rose and Carter",REF15783351,0.0,1643.62,294439.14
2018-02-15,2018-02-15,Business insurance premium,REF61432221,159.77,0.0,294279.37
2018-02-15,2018-02-15,Payment from Rogers Group,REF19286983,0.0,867.1,295146.47
2018-02-19,2018-02-19,Business materials,REF67766024,15.29,0.0,295131.18
2018-02-23,2018-02-23,Permits Licenses expense,REF10155009,88.56,0.0,295042.62
2018-02-23,2018-02-23,Safety Equipment expense,REF95806538,74.7,0.0,294967.92
2018-02-25,2018-02-25,Business materials,REF47376680,415.52,0.0,294552.4
2018-02-26,2018-02-26,Vehicle Maintenance expense,REF27917800,143.45,0.0,294408.95
2018-02-26,2018-02-26,Equipment Rental expense,REF64663742,244.7,0.0,294164.25
2018-02-28,2018-02-28,"Project payment - Martin, Atkins and Khan",REF57777831,0.0,457.52,294621.77
2018-02-28,2018-02-28,Project payment - Horn and Sons,REF84060918,0.0,1267.61,295889.38
2018-02-28,2018-02-28,"Invoice payment - Martinez, Rose and Carter",REF84443237,0.0,1656.84,297546.22
2018-02-28,2018-02-28,Service payment - Rogers Group,REF14461834,0.0,800.11,298346.33
2018-02-28,2018-02-28,Invoice payment - Reynolds-Mckinney,REF64343471,0.0,1179.71,299526.04
2018-03-06,2018-03-06,Tools expense,REF20050201,62.37,0.0,299463.67
2018-03-07,2018-03-07,Business materials,REF95765745,939.18,0.0,298524.49
2018-03-15,2018-03-15,Permits Licenses expense,REF14027161,69.62,0.0,298454.87
2018-03-15,2018-03-15,Invoice payment - Reynolds-Mckinney,REF42307537,0.0,2152.37,300607.24
2018-03-15,2018-03-15,"Invoice payment - Martin, Atkins and Khan",REF96172204,0.0,996.67,301603.91
2018-03-15,2018-03-15,"Project payment - Martinez, Rose and Carter",REF22141096,0.0,1781.63,303385.54
2018-03-15,2018-03-15,Business insurance premium,REF74289601,194.86,0.0,303190.68
2018-03-15,2018-03-15,Service payment - Rogers Group,REF41101707,0.0,1047.54,304238.22
2018-03-15,2018-03-15,Invoice payment - Horn and Sons,REF69276304,0.0,1733.52,305971.74
2018-03-16,2018-03-16,Vehicle Maintenance expense,REF92264727,166.15,0.0,305805.59
2018-03-18,2018-03-18,Business materials,REF64709483,1343.42,0.0,304462.17
2018-03-20,2018-03-20,Tools expense,REF47824240,136.23,0.0,304325.94
2018-03-26,2018-03-26,Business materials,REF50405680,972.76,0.0,303353.18
2018-03-27,2018-03-27,Safety Equipment expense,REF96816809,92.9,0.0,303260.28
2018-03-29,2018-03-29,Equipment Rental expense,REF44065427,393.98,0.0,302866.3
2018-03-29,2018-03-29,Fuel purchase,REF72359316,291.58,0.0,302574.72
2018-03-30,2018-03-30,Invoice payment - Horn and Sons,REF56581584,0.0,1437.74,304012.46
2018-03-30,2018-03-30,"Service payment - Martin, Atkins and Khan",REF49432988,0.0,826.1,304838.56
2018-03-30,2018-03-30,"Payment from Martinez, Rose and Carter",REF97166050,0.0,1272.17,306110.73
2018-03-30,2018-03-30,Payment from Rogers Group,REF24985094,0.0,1286.72,307397.45
2018-03-30,2018-03-30,Payment from Reynolds-Mckinney,REF26530185,0.0,2152.45,309549.9
2018-03-30,2018-03-30,Equipment Rental expense,REF48378948,472.53,0.0,309077.37
2018-04-03,2018-04-03,Permits Licenses expense,REF56652300,101.31,0.0,308976.06
2018-04-05,2018-04-05,Fuel purchase,REF16336556,444.3,0.0,308531.76
2018-04-06,2018-04-06,Fuel purchase,REF94953966,375.87,0.0,308155.89
2018-04-06,2018-04-06,Permits Licenses expense,REF42069512,105.65,0.0,308050.24
2018-04-08,2018-04-08,Permits Licenses expense,REF49087474,90.16,0.0,307960.08
2018-04-10,2018-04-10,Fuel purchase,REF44036641,234.0,0.0,307726.08
2018-04-11,2018-04-11,Fuel purchase,REF15908378,367.76,0.0,307358.32
2018-04-11,2018-04-11,Business materials,REF96612769,1034.94,0.0,306323.38
2018-04-12,2018-04-12,Fuel purchase,REF65576989,361.23,0.0,305962.15
2018-04-15,2018-04-15,Business insurance premium,REF80376243,226.19,0.0,305735.96
2018-04-15,2018-04-15,Service payment - Horn and Sons,REF86388537,0.0,1786.93,307522.89
2018-04-15,2018-04-15,"Invoice payment - Martinez, Rose and Carter",REF75451674,0.0,1463.91,308986.8
2018-04-15,2018-04-15,Project payment - Rogers Group,REF68955475,0.0,1054.65,310041.45
2018-04-15,2018-04-15,"Project payment - Martin, Atkins and Khan",REF28122941,0.0,1002.11,311043.56
2018-04-16,2018-04-16,Subcontractors expense,REF71617742,1461.89,0.0,309581.67
2018-04-21,2018-04-21,Fuel purchase,REF84096572,402.55,0.0,309179.12
2018-04-25,2018-04-25,Equipment Rental expense,REF78175213,609.23,0.0,308569.89
2018-04-25,2018-04-25,Fuel purchase,REF30894840,283.09,0.0,308286.8
2018-04-30,2018-04-30,Payment from Rogers Group,REF43250593,0.0,1625.14,309911.94
2018-04-30,2018-04-30,"Project payment - Martin, Atkins and Khan",REF28468230,0.0,986.98,310898.92
2018-04-30,2018-04-30,Service payment - Reynolds-Mckinney,REF45092047,0.0,2532.34,313431.26
2018-04-30,2018-04-30,Project payment - Horn and Sons,REF90718821,0.0,1947.75,315379.01
2018-05-01,2018-05-01,Safety Equipment expense,REF89830432,133.2,0.0,315245.81
2018-05-02,2018-05-02,Fuel purchase,REF26982136,377.17,0.0,314868.64
2018-05-02,2018-05-02,Vehicle Maintenance expense,REF39974317,184.38,0.0,314684.26
2018-05-02,2018-05-02,Safety Equipment expense,REF92283511,140.88,0.0,314543.38
2018-05-05,2018-05-05,Business materials,REF50604545,714.18,0.0,313829.2
2018-05-07,2018-05-07,Fuel purchase,REF52774874,366.94,0.0,313462.26
2018-05-08,2018-05-08,Safety Equipment expense,REF42663323,103.13,0.0,313359.13
2018-05-10,2018-05-10,Permits Licenses expense,REF72314375,107.15,0.0,313251.98
2018-05-10,2018-05-10,Safety Equipment expense,REF72466027,124.37,0.0,313127.61
2018-05-15,2018-05-15,Business insurance premium,REF74850607,298.12,0.0,312829.49
2018-05-15,2018-05-15,"Invoice payment - Martin, Atkins and Khan",REF83428998,0.0,1209.6,314039.09
2018-05-15,2018-05-15,Payment from Rogers Group,REF83077862,0.0,1442.26,315481.35
2018-05-15,2018-05-15,"Payment from Martinez, Rose and Carter",REF41332611,0.0,2202.78,317684.13
2018-05-15,2018-05-15,Tools expense,REF61829953,107.22,0.0,317576.91
2018-05-15,2018-05-15,Project payment - Reynolds-Mckinney,REF47285971,0.0,2343.49,319920.4
2018-05-15,2018-05-15,Invoice payment - Horn and Sons,REF16698994,0.0,1512.59,321432.99
2018-05-16,2018-05-16,Equipment Rental expense,REF16429393,387.47,0.0,321045.52
2018-05-17,2018-05-17,Business materials,REF95563843,1263.41,0.0,319782.11
2018-05-18,2018-05-18,Business materials,REF40506809,992.24,0.0,318789.87
2018-05-20,2018-05-20,Fuel purchase,REF66973250,535.05,0.0,318254.82
2018-05-26,2018-05-26,Permits Licenses expense,REF52448582,99.26,0.0,318155.56
2018-05-27,2018-05-27,Subcontractors expense,REF77177717,1301.44,0.0,316854.12
2018-05-30,2018-05-30,"Project payment - Martin, Atkins and Khan",REF96060606,0.0,1238.6,318092.72
2018-05-30,2018-05-30,Service payment - Reynolds-Mckinney,REF96683737,0.0,3038.07,321130.79
2018-05-30,2018-05-30,"Project payment - Martinez, Rose and Carter",REF34989066,0.0,1871.49,323002.28
2018-05-30,2018-05-30,Payment from Rogers Group,REF96696616,0.0,1596.71,324598.99
2018-05-30,2018-05-30,Invoice payment - Horn and Sons,REF10993008,0.0,1988.83,326587.82
2018-05-31,2018-05-31,Business materials,REF39018402,561.7,0.0,326026.12
2018-05-31,2018-05-31,Fuel purchase,REF26200563,602.88,0.0,325423.24
2018-06-02,2018-06-02,Fuel purchase,REF31909491,357.89,0.0,325065.35
2018-06-05,2018-06-05,Safety Equipment expense,REF29603807,117.95,0.0,324947.4
2018-06-07,2018-06-07,Vehicle Maintenance expense,REF12237606,224.77,0.0,324722.63
2018-06-07,2018-06-07,Permits Licenses expense,REF55140627,185.51,0.0,324537.12
2018-06-08,2018-06-08,Fuel purchase,REF54095388,229.67,0.0,324307.45
2018-06-15,2018-06-15,Fuel purchase,REF15136852,351.46,0.0,323955.99
2018-06-15,2018-06-15,Project payment - Horn and Sons,REF65075697,0.0,1313.65,325269.64
2018-06-15,2018-06-15,"Service payment - Martin, Atkins and Khan",REF48726232,0.0,1113.4,326383.04
2018-06-15,2018-06-15,"Service payment - Martinez, Rose and Carter",REF48664268,0.0,1823.07,328206.11
2018-06-15,2018-06-15,Business insurance premium,REF55578567,251.65,0.0,327954.46
2018-06-18,2018-06-18,Business materials,REF31147029,795.64,0.0,327158.82
2018-06-22,2018-06-22,Business materials,REF25148871,1020.53,0.0,326138.29
2018-06-26,2018-06-26,Permits Licenses expense,REF55882050,98.16,0.0,326040.13
2018-06-30,2018-06-30,Invoice payment - Rogers Group,REF62070107,0.0,1628.77,327668.9
2018-06-30,2018-06-30,"Project payment - Martin, Atkins and Khan",REF17067350,0.0,1040.49,328709.39
2018-06-30,2018-06-30,Project payment - Reynolds-Mckinney,REF32548197,0.0,1991.59,330700.98
2018-06-30,2018-06-30,Project payment - Horn and Sons,REF43848116,0.0,1656.44,332357.42
2018-07-01,2018-07-01,Business materials,REF38503902,443.39,0.0,331914.03
2018-07-02,2018-07-02,Equipment Rental expense,REF73460628,310.91,0.0,331603.12
2018-07-06,2018-07-06,Business materials,REF21137298,1186.32,0.0,330416.8
2018-07-06,2018-07-06,Subcontractors expense,REF40465737,1635.93,0.0,328780.87
2018-07-08,2018-07-08,Fuel purchase,REF47313364,303.01,0.0,328477.86
2018-07-09,2018-07-09,Business materials,REF22278993,1376.74,0.0,327101.12
2018-07-10,2018-07-10,Fuel purchase,REF78842338,501.94,0.0,326599.18
2018-07-14,2018-07-14,Subcontractors expense,REF55604153,1190.35,0.0,325408.83
2018-07-15,2018-07-15,Business insurance premium,REF74198329,267.2,0.0,325141.63
2018-07-15,2018-07-15,"Project payment - Martinez, Rose and Carter",REF98548252,0.0,1648.81,326790.44
2018-07-15,2018-07-15,Invoice payment - Rogers Group,REF80304149,0.0,1142.97,327933.41
2018-07-15,2018-07-15,Service payment - Reynolds-Mckinney,REF96322811,0.0,1235.47,329168.88
2018-07-15,2018-07-15,"Payment from Martin, Atkins and Khan",REF40678754,0.0,1166.4,330335.28
2018-07-15,2018-07-15,Business materials,REF15772323,784.28,0.0,329551.0
2018-07-15,2018-07-15,Invoice payment - Horn and Sons,REF47819984,0.0,1900.12,331451.12
2018-07-17,2018-07-17,Subcontractors expense,REF60561781,1021.47,0.0,330429.65
2018-07-18,2018-07-18,Fuel purchase,REF68490652,569.33,0.0,329860.32
2018-07-19,2018-07-19,Business materials,REF95017463,1302.28,0.0,328558.04
2018-07-25,2018-07-25,Business materials,REF25189127,880.31,0.0,327677.73
2018-07-26,2018-07-26,Fuel purchase,REF88742137,330.02,0.0,327347.71
2018-07-27,2018-07-27,Subcontractors expense,REF89665238,1195.37,0.0,326152.34
2018-07-30,2018-07-30,Safety Equipment expense,REF28605626,158.46,0.0,325993.88
2018-07-30,2018-07-30,"Service payment - Martin, Atkins and Khan",REF26098994,0.0,927.98,326921.86
2018-07-30,2018-07-30,Project payment - Rogers Group,REF67947359,0.0,1179.11,328100.97
2018-07-30,2018-07-30,Service payment - Reynolds-Mckinney,REF61163533,0.0,2514.77,330615.74
2018-07-30,2018-07-30,"Invoice payment - Martinez, Rose and Carter",REF49503048,0.0,1732.49,332348.23
2018-08-01,2018-08-01,Business materials,REF34801417,1320.05,0.0,331028.18
2018-08-03,2018-08-03,Business materials,REF84205125,1182.86,0.0,329845.32
2018-08-05,2018-08-05,Fuel purchase,REF43809175,417.77,0.0,329427.55
2018-08-09,2018-08-09,Safety Equipment expense,REF30612812,43.21,0.0,329384.34
2018-08-09,2018-08-09,Business materials,REF17934486,1216.52,0.0,328167.82
2018-08-11,2018-08-11,Equipment Rental expense,REF39936414,490.64,0.0,327677.18
2018-08-15,2018-08-15,"Service payment - Martinez, Rose and Carter",REF98567777,0.0,2220.1,329897.28
2018-08-15,2018-08-15,Invoice payment - Reynolds-Mckinney,REF16938522,0.0,1760.39,331657.67
2018-08-15,2018-08-15,Service payment - Rogers Group,REF28515226,0.0,832.84,332490.51
2018-08-15,2018-08-15,Business insurance premium,REF60634888,238.61,0.0,332251.9
2018-08-15,2018-08-15,"Invoice payment - Martin, Atkins and Khan",REF40303844,0.0,1049.53,333301.43
2018-08-15,2018-08-15,Service payment - Horn and Sons,REF37231626,0.0,1834.81,335136.24
2018-08-19,2018-08-19,Fuel purchase,REF54055721,222.46,0.0,334913.78
2018-08-20,2018-08-20,Business materials,REF18231140,865.88,0.0,334047.9
2018-08-22,2018-08-22,Fuel purchase,REF66891849,480.35,0.0,333567.55
2018-08-22,2018-08-22,Tools expense,REF84882348,201.4,0.0,333366.15
2018-08-30,2018-08-30,Fuel purchase,REF97860697,309.91,0.0,333056.24
2018-08-30,2018-08-30,"Invoice payment - Martin, Atkins and Khan",REF47413830,0.0,1153.29,334209.53
2018-08-30,2018-08-30,Invoice payment - Rogers Group,REF89731762,0.0,1090.18,335299.71
2018-08-30,2018-08-30,"Invoice payment - Martinez, Rose and Carter",REF47840832,0.0,2107.16,337406.87
2018-08-30,2018-08-30,Invoice payment - Reynolds-Mckinney,REF92844002,0.0,2519.32,339926.19
2018-08-30,2018-08-30,Invoice payment - Horn and Sons,REF15110078,0.0,1336.99,341263.18
2018-09-01,2018-09-01,Fuel purchase,REF55544500,248.57,0.0,341014.61
2018-09-02,2018-09-02,Business materials,REF80295437,804.87,0.0,340209.74
2018-09-07,2018-09-07,Tools expense,REF93226239,72.64,0.0,340137.1
2018-09-10,2018-09-10,Fuel purchase,REF21156000,363.03,0.0,339774.07
2018-09-12,2018-09-12,Fuel purchase,REF59325886,353.6,0.0,339420.47
2018-09-15,2018-09-15,Project payment - Horn and Sons,REF67440561,0.0,1339.44,340759.91
2018-09-15,2018-09-15,Project payment - Rogers Group,REF95308603,0.0,981.13,341741.04
2018-09-15,2018-09-15,"Service payment - Martin, Atkins and Khan",REF34033731,0.0,941.18,342682.22
2018-09-15,2018-09-15,"Service payment - Martinez, Rose and Carter",REF18976454,0.0,2079.75,344761.97
2018-09-15,2018-09-15,Invoice payment - Reynolds-Mckinney,REF42051327,0.0,1877.43,346639.4
2018-09-15,2018-09-15,Business insurance premium,REF24956040,218.52,0.0,346420.88
2018-09-16,2018-09-16,Subcontractors expense,REF32681801,518.88,0.0,345902.0
2018-09-16,2018-09-16,Fuel purchase,REF16392510,196.57,0.0,345705.43
2018-09-23,2018-09-23,Fuel purchase,REF37914516,438.61,0.0,345266.82
2018-09-26,2018-09-26,Tools expense,REF25168168,111.0,0.0,345155.82
2018-09-26,2018-09-26,Equipment Rental expense,REF83536699,623.94,0.0,344531.88
2018-09-30,2018-09-30,"Project payment - Martinez, Rose and Carter",REF34107469,0.0,1641.34,346173.22
2018-09-30,2018-09-30,"Invoice payment - Martin, Atkins and Khan",REF70600131,0.0,868.78,347042.0
2018-09-30,2018-09-30,Invoice payment - Rogers Group,REF31190028,0.0,1390.6,348432.6
2018-09-30,2018-09-30,Service payment - Reynolds-Mckinney,REF15126581,0.0,1935.46,350368.06
2018-09-30,2018-09-30,Payment from Horn and Sons,REF63942325,0.0,1613.92,351981.98
2018-10-06,2018-10-06,Business materials,REF44045475,405.57,0.0,351576.41
2018-10-09,2018-10-09,Safety Equipment expense,REF54789152,70.01,0.0,351506.4
2018-10-11,2018-10-11,Fuel purchase,REF69717362,410.65,0.0,351095.75
2018-10-13,2018-10-13,Business materials,REF85999375,874.02,0.0,350221.73
2018-10-14,2018-10-14,Business materials,REF14404401,1485.0,0.0,348736.73
2018-10-14,2018-10-14,Fuel purchase,REF14822936,299.99,0.0,348436.74
2018-10-15,2018-10-15,Business insurance premium,REF76067846,211.33,0.0,348225.41
2018-10-15,2018-10-15,Payment from Rogers Group,REF57665635,0.0,1061.05,349286.46
2018-10-15,2018-10-15,"Payment from Martin, Atkins and Khan",REF90727594,0.0,932.98,350219.44
2018-10-15,2018-10-15,Invoice payment - Horn and Sons,REF20825142,0.0,1449.06,351668.5
2018-10-15,2018-10-15,"Invoice payment - Martinez, Rose and Carter",REF93204253,0.0,2478.19,354146.69
2018-10-15,2018-10-15,Project payment - Reynolds-Mckinney,REF18124441,0.0,2042.21,356188.9
2018-10-18,2018-10-18,Business materials,REF96097081,744.24,0.0,355444.66
2018-10-19,2018-10-19,Vehicle Maintenance expense,REF48008740,169.28,0.0,355275.38
2018-10-20,2018-10-20,Equipment Rental expense,REF59005448,481.5,0.0,354793.88
2018-10-22,2018-10-22,Business materials,REF10385719,622.33,0.0,354171.55
2018-10-29,2018-10-29,Business materials,REF52361512,535.02,0.0,353636.53
2018-10-30,2018-10-30,"Project payment - Martinez, Rose and Carter",REF26402012,0.0,1806.18,355442.71
2018-10-30,2018-10-30,Project payment - Rogers Group,REF41533016,0.0,1049.18,356491.89
2018-10-30,2018-10-30,Permits Licenses expense,REF53679347,86.82,0.0,356405.07
2018-10-30,2018-10-30,"Payment from Martin, Atkins and Khan",REF66470982,0.0,902.95,357308.02
2018-10-30,2018-10-30,Payment from Reynolds-Mckinney,REF27501963,0.0,1855.95,359163.97
2018-10-30,2018-10-30,Payment from Horn and Sons,REF28742743,0.0,1419.55,360583.52
2018-11-01,2018-11-01,Business materials,REF63100313,395.49,0.0,360188.03
2018-11-08,2018-11-08,Safety Equipment expense,REF16854672,89.65,0.0,360098.38
2018-11-10,2018-11-10,Business materials,REF21436208,538.9,0.0,359559.48
2018-11-14,2018-11-14,Fuel purchase,REF34540157,211.64,0.0,359347.84
2018-11-15,2018-11-15,"Project payment - Martin, Atkins and Khan",REF20644153,0.0,826.39,360174.23
2018-11-15,2018-11-15,"Payment from Martinez, Rose and Carter",REF77683518,0.0,1507.89,361682.12
2018-11-15,2018-11-15,Project payment - Rogers Group,REF18271851,0.0,828.51,362510.63
2018-11-15,2018-11-15,Project payment - Reynolds-Mckinney,REF69771705,0.0,1178.96,363689.59
2018-11-15,2018-11-15,Business insurance premium,REF52185093,158.05,0.0,363531.54
2018-11-15,2018-11-15,Payment from Horn and Sons,REF14530894,0.0,1094.28,364625.82
2018-11-18,2018-11-18,Vehicle Maintenance expense,REF89840783,126.52,0.0,364499.3
2018-11-18,2018-11-18,Tools expense,REF92120177,102.82,0.0,364396.48
2018-11-23,2018-11-23,Equipment Rental expense,REF59094129,284.9,0.0,364111.58
2018-11-24,2018-11-24,Fuel purchase,REF53750767,244.73,0.0,363866.85
2018-11-25,2018-11-25,Tools expense,REF68554126,88.42,0.0,363778.43
2018-11-30,2018-11-30,Service payment - Horn and Sons,REF95929647,0.0,1087.53,364865.96
2018-11-30,2018-11-30,Payment from Reynolds-Mckinney,REF19252973,0.0,1898.58,366764.54
2018-11-30,2018-11-30,"Payment from Martin, Atkins and Khan",REF64470892,0.0,772.25,367536.79
2018-11-30,2018-11-30,"Project payment - Martinez, Rose and Carter",REF60577208,0.0,1519.03,369055.82
2018-11-30,2018-11-30,Service payment - Rogers Group,REF30827749,0.0,1038.84,370094.66
2018-12-05,2018-12-05,Fuel purchase,REF34150236,176.93,0.0,369917.73
2018-12-06,2018-12-06,Equipment Rental expense,REF30722975,286.14,0.0,369631.59
2018-12-11,2018-12-11,Safety Equipment expense,REF70210133,32.07,0.0,369599.52
2018-12-11,2018-12-11,Vehicle Maintenance expense,REF57915419,112.25,0.0,369487.27
2018-12-12,2018-12-12,Safety Equipment expense,REF91392280,44.95,0.0,369442.32
2018-12-13,2018-12-13,Business materials,REF26621154,496.21,0.0,368946.11
2018-12-15,2018-12-15,Invoice payment - Horn and Sons,REF88285867,0.0,641.9,369588.01
2018-12-15,2018-12-15,Business insurance premium,REF54166512,119.45,0.0,369468.56
2018-12-15,2018-12-15,Service payment - Rogers Group,REF91683283,0.0,596.77,370065.33
2018-12-15,2018-12-15,Business materials,REF66918478,628.14,0.0,369437.19
2018-12-15,2018-12-15,"Service payment - Martin, Atkins and Khan",REF62147909,0.0,527.7,369964.89
2018-12-15,2018-12-15,"Project payment - Martinez, Rose and Carter",REF26292641,0.0,856.46,370821.35
2018-12-15,2018-12-15,Project payment - Reynolds-Mckinney,REF80357118,0.0,1185.69,372007.04
2018-12-18,2018-12-18,Fuel purchase,REF13204926,159.56,0.0,371847.48
2018-12-19,2018-12-19,Vehicle Maintenance expense,REF94608349,97.12,0.0,371750.36
2018-12-20,2018-12-20,Fuel purchase,REF51938892,60.28,0.0,371690.08
2018-12-21,2018-12-21,Permits Licenses expense,REF75458561,76.23,0.0,371613.85
2018-12-22,2018-12-22,Equipment Rental expense,REF97853846,283.35,0.0,371330.5
2018-12-27,2018-12-27,Fuel purchase,REF63687022,129.52,0.0,371200.98
2018-12-29,2018-12-29,Fuel purchase,REF33193038,108.01,0.0,371092.97
2018-12-30,2018-12-30,Subcontractors expense,REF51865773,400.79,0.0,370692.18
2018-12-30,2018-12-30,"Project payment - Martin, Atkins and Khan",REF52365252,0.0,410.27,371102.45
2018-12-30,2018-12-30,Fuel purchase,REF94971453,149.78,0.0,370952.67
2018-12-30,2018-12-30,Payment from Horn and Sons,REF88487824,0.0,947.28,371899.95
2018-12-30,2018-12-30,"Service payment - Martinez, Rose and Carter",REF98152090,0.0,910.64,372810.59
2019-01-02,2019-01-02,Vehicle Maintenance expense,REF69188066,159.14,0.0,372651.45
2019-01-02,2019-01-02,Business materials,REF74113046,755.26,0.0,371896.19
2019-01-07,2019-01-07,Vehicle Maintenance expense,REF65266143,128.75,0.0,371767.44
2019-01-07,2019-01-07,Tools expense,REF71683177,52.34,0.0,371715.1
2019-01-08,2019-01-08,Subcontractors expense,REF84268859,435.19,0.0,371279.91
2019-01-08,2019-01-08,Equipment Rental expense,REF93797989,157.44,0.0,371122.47
2019-01-12,2019-01-12,Equipment Rental expense,REF75534305,252.78,0.0,370869.69
2019-01-12,2019-01-12,Tools expense,REF19946755,73.77,0.0,370795.92
2019-01-15,2019-01-15,Invoice payment - Horn and Sons,REF18013976,0.0,1215.46,372011.38
2019-01-15,2019-01-15,Service payment - Reynolds-Mckinney,REF64236720,0.0,1168.47,373179.85
2019-01-15,2019-01-15,"Invoice payment - Martinez, Rose and Carter",REF99952362,0.0,1248.6,374428.45
2019-01-15,2019-01-15,Invoice payment - Rogers Group,REF17041814,0.0,683.42,375111.87
2019-01-15,2019-01-15,"Project payment - Martin, Atkins and Khan",REF21467712,0.0,795.33,375907.2
2019-01-15,2019-01-15,Business insurance premium,REF48060271,131.54,0.0,375775.66
2019-01-18,2019-01-18,Tools expense,REF56045658,78.04,0.0,375697.62
2019-01-19,2019-01-19,Permits Licenses expense,REF31508107,73.47,0.0,375624.15
2019-01-20,2019-01-20,Equipment Rental expense,REF68492060,125.12,0.0,375499.03
2019-01-21,2019-01-21,Vehicle Maintenance expense,REF89873771,75.08,0.0,375423.95
2019-01-22,2019-01-22,Safety Equipment expense,REF49523579,63.89,0.0,375360.06
2019-01-27,2019-01-27,Subcontractors expense,REF44539633,606.81,0.0,374753.25
2019-01-29,2019-01-29,Fuel purchase,REF86024671,306.03,0.0,374447.22
2019-01-30,2019-01-30,Service payment - Horn and Sons,REF65698360,0.0,935.77,375382.99
2019-01-30,2019-01-30,Project payment - Reynolds-Mckinney,REF71886285,0.0,1266.96,376649.95
2019-01-30,2019-01-30,"Project payment - Martin, Atkins and Khan",REF65469568,0.0,607.76,377257.71
2019-01-30,2019-01-30,Service payment - Rogers Group,REF98581292,0.0,826.09,378083.8
2019-01-30,2019-01-30,"Payment from Martinez, Rose and Carter",REF25264807,0.0,1040.57,379124.37
2019-02-03,2019-02-03,Business materials,REF36626069,862.45,0.0,378261.92
2019-02-07,2019-02-07,Equipment Rental expense,REF83765275,305.14,0.0,377956.78
2019-02-10,2019-02-10,Fuel purchase,REF90972995,172.94,0.0,377783.84
2019-02-14,2019-02-14,Fuel purchase,REF56298368,442.36,0.0,377341.48
2019-02-15,2019-02-15,Tools expense,REF96113906,70.71,0.0,377270.77
2019-02-15,2019-02-15,Service payment - Rogers Group,REF78293496,0.0,774.69,378045.46
2019-02-15,2019-02-15,"Service payment - Martin, Atkins and Khan",REF38198154,0.0,786.36,378831.82
2019-02-15,2019-02-15,Vehicle Maintenance expense,REF67873176,126.47,0.0,378705.35
2019-02-15,2019-02-15,Business insurance premium,REF64956710,155.17,0.0,378550.18
2019-02-15,2019-02-15,Payment from Reynolds-Mckinney,REF26693669,0.0,1213.08,379763.26
2019-02-15,2019-02-15,Service payment - Horn and Sons,REF70239961,0.0,1132.81,380896.07
2019-02-15,2019-02-15,"Project payment - Martinez, Rose and Carter",REF34816216,0.0,1565.3,382461.37
2019-02-19,2019-02-19,Tools expense,REF62830207,79.82,0.0,382381.55
2019-02-20,2019-02-20,Business materials,REF56761819,783.94,0.0,381597.61
2019-02-25,2019-02-25,Fuel purchase,REF32997859,234.27,0.0,381363.34
2019-02-27,2019-02-27,Subcontractors expense,REF94513383,606.3,0.0,380757.04
2019-02-28,2019-02-28,"Project payment - Martin, Atkins and Khan",REF66497596,0.0,739.52,381496.56
2019-02-28,2019-02-28,Invoice payment - Reynolds-Mckinney,REF30185851,0.0,1814.89,383311.45
2019-02-28,2019-02-28,Project payment - Rogers Group,REF75928096,0.0,974.58,384286.03
2019-02-28,2019-02-28,"Service payment - Martinez, Rose and Carter",REF99944420,0.0,1393.59,385679.62
2019-02-28,2019-02-28,Service payment - Horn and Sons,REF19197226,0.0,1107.4,386787.02
2019-03-03,2019-03-03,Safety Equipment expense,REF25525204,38.31,0.0,386748.71
2019-03-04,2019-03-04,Tools expense,REF43748807,128.48,0.0,386620.23
2019-03-11,2019-03-11,Permits Licenses expense,REF80036730,55.38,0.0,386564.85
2019-03-12,2019-03-12,Permits Licenses expense,REF43590968,70.96,0.0,386493.89
2019-03-13,2019-03-13,Business materials,REF68236679,1068.5,0.0,385425.39
2019-03-13,2019-03-13,Safety Equipment expense,REF95010337,48.26,0.0,385377.13
2019-03-13,2019-03-13,Permits Licenses expense,REF43763371,103.18,0.0,385273.95
2019-03-15,2019-03-15,Business insurance premium,REF15337099,179.25,0.0,385094.7
2019-03-15,2019-03-15,Payment from Reynolds-Mckinney,REF73167557,0.0,1513.93,386608.63
2019-03-15,2019-03-15,Project payment - Rogers Group,REF62504625,0.0,1070.67,387679.3
2019-03-15,2019-03-15,"Service payment - Martinez, Rose and Carter",REF42538669,0.0,1636.45,389315.75
2019-03-15,2019-03-15,Payment from Horn and Sons,REF32733804,0.0,1564.92,390880.67
2019-03-15,2019-03-15,"Payment from Martin, Atkins and Khan",REF63727010,0.0,994.59,391875.26
2019-03-17,2019-03-17,Business materials,REF35690121,716.11,0.0,391159.15
2019-03-19,2019-03-19,Equipment Rental expense,REF69426070,242.22,0.0,390916.93
2019-03-19,2019-03-19,Subcontractors expense,REF59956440,928.96,0.0,389987.97
2019-03-20,2019-03-20,Fuel purchase,REF90734879,358.85,0.0,389629.12
2019-03-24,2019-03-24,Business materials,REF96588667,720.78,0.0,388908.34
2019-03-26,2019-03-26,Tools expense,REF85995238,78.2,0.0,388830.14
2019-03-27,2019-03-27,Fuel purchase,REF99085249,281.85,0.0,388548.29
2019-03-30,2019-03-30,Project payment - Rogers Group,REF43108845,0.0,1163.57,389711.86
2019-03-30,2019-03-30,"Invoice payment - Martinez, Rose and Carter",REF23636187,0.0,1522.48,391234.34
2019-03-30,2019-03-30,"Service payment - Martin, Atkins and Khan",REF82131023,0.0,864.06,392098.4
2019-03-31,2019-03-31,Business materials,REF61152029,1087.21,0.0,391011.19
2019-04-03,2019-04-03,Fuel purchase,REF39993349,532.59,0.0,390478.6
2019-04-03,2019-04-03,Business materials,REF65643083,1070.5,0.0,389408.1
2019-04-04,2019-04-04,Fuel purchase,REF70884686,350.43,0.0,389057.67
2019-04-09,2019-04-09,Equipment Rental expense,REF33630339,526.33,0.0,388531.34
2019-04-15,2019-04-15,Invoice payment - Rogers Group,REF71669479,0.0,1220.01,389751.35
2019-04-15,2019-04-15,Business materials,REF97112463,1120.15,0.0,388631.2
2019-04-15,2019-04-15,Business insurance premium,REF73954341,262.0,0.0,388369.2
2019-04-15,2019-04-15,Project payment - Reynolds-Mckinney,REF48533158,0.0,2333.13,390702.33
2019-04-15,2019-04-15,Project payment - Horn and Sons,REF84518229,0.0,2159.67,392862.0
2019-04-15,2019-04-15,"Project payment - Martin, Atkins and Khan",REF55134565,0.0,1122.72,393984.72
2019-04-16,2019-04-16,Business materials,REF65715208,993.47,0.0,392991.25
2019-04-18,2019-04-18,Vehicle Maintenance expense,REF32497180,170.62,0.0,392820.63
2019-04-20,2019-04-20,Subcontractors expense,REF55516823,1468.18,0.0,391352.45
2019-04-24,2019-04-24,Fuel purchase,REF23086477,411.46,0.0,390940.99
2019-04-29,2019-04-29,Business materials,REF71401531,1178.01,0.0,389762.98
2019-04-30,2019-04-30,"Invoice payment - Martin, Atkins and Khan",REF87485558,0.0,969.9,390732.88
2019-04-30,2019-04-30,Payment from Horn and Sons,REF62765838,0.0,1530.94,392263.82
2019-04-30,2019-04-30,Service payment - Rogers Group,REF28044143,0.0,1363.72,393627.54
2019-04-30,2019-04-30,Service payment - Reynolds-Mckinney,REF46206489,0.0,2422.62,396050.16
2019-04-30,2019-04-30,"Payment from Martinez, Rose and Carter",REF65255858,0.0,2399.06,398449.22
2019-05-01,2019-05-01,Vehicle Maintenance expense,REF22110431,193.13,0.0,398256.09
2019-05-03,2019-05-03,Business materials,REF16019982,1087.37,0.0,397168.72
2019-05-09,2019-05-09,Vehicle Maintenance expense,REF65513442,251.81,0.0,396916.91
2019-05-09,2019-05-09,Fuel purchase,REF97527476,514.57,0.0,396402.34
2019-05-12,2019-05-12,Permits Licenses expense,REF72300654,84.29,0.0,396318.05
2019-05-14,2019-05-14,Business materials,REF81407327,1119.69,0.0,395198.36
2019-05-15,2019-05-15,"Project payment - Martinez, Rose and Carter",REF52332519,0.0,1995.12,397193.48
2019-05-15,2019-05-15,Payment from Reynolds-Mckinney,REF19916954,0.0,2361.8,399555.28
2019-05-15,2019-05-15,"Service payment - Martin, Atkins and Khan",REF41971045,0.0,1109.53,400664.81
2019-05-15,2019-05-15,Invoice payment - Rogers Group,REF71983379,0.0,1303.65,401968.46
2019-05-15,2019-05-15,Business insurance premium,REF12195654,254.36,0.0,401714.1
2019-05-16,2019-05-16,Permits Licenses expense,REF51980954,105.09,0.0,401609.01
2019-05-20,2019-05-20,Fuel purchase,REF79695283,471.27,0.0,401137.74
2019-05-23,2019-05-23,Subcontractors expense,REF22634577,1422.49,0.0,399715.25
2019-05-23,2019-05-23,Business materials,REF59067278,1365.15,0.0,398350.1
2019-05-30,2019-05-30,Fuel purchase,REF79499096,396.03,0.0,397954.07
2019-05-30,2019-05-30,Service payment - Reynolds-Mckinney,REF33084970,0.0,2747.67,400701.74
2019-05-30,2019-05-30,"Payment from Martin, Atkins and Khan",REF46990920,0.0,1191.21,401892.95
2019-05-30,2019-05-30,"Project payment - Martinez, Rose and Carter",REF49512892,0.0,2387.11,404280.06
2019-05-30,2019-05-30,Service payment - Horn and Sons,REF73580880,0.0,1690.11,405970.17
2019-06-07,2019-06-07,Fuel purchase,REF56871838,612.14,0.0,405358.03
2019-06-10,2019-06-10,Business materials,REF86281383,1072.63,0.0,404285.4
2019-06-12,2019-06-12,Permits Licenses expense,REF91357868,115.99,0.0,404169.41
2019-06-13,2019-06-13,Fuel purchase,REF38407112,403.85,0.0,403765.56
2019-06-13,2019-06-13,Permits Licenses expense,REF85879418,92.85,0.0,403672.71
2019-06-15,2019-06-15,Service payment - Reynolds-Mckinney,REF90729949,0.0,2800.91,406473.62
2019-06-15,2019-06-15,"Payment from Martin, Atkins and Khan",REF64583613,0.0,992.23,407465.85
2019-06-15,2019-06-15,"Payment from Martinez, Rose and Carter",REF58926454,0.0,2620.19,410086.04
2019-06-15,2019-06-15,Project payment - Rogers Group,REF22737079,0.0,1410.44,411496.48
2019-06-15,2019-06-15,Business insurance premium,REF14447732,265.7,0.0,411230.78
2019-06-18,2019-06-18,Fuel purchase,REF59013897,405.34,0.0,410825.44
2019-06-20,2019-06-20,Permits Licenses expense,REF90470658,89.26,0.0,410736.18
2019-06-21,2019-06-21,Subcontractors expense,REF23842085,1383.05,0.0,409353.13
2019-06-22,2019-06-22,Fuel purchase,REF38949986,448.46,0.0,408904.67
2019-06-22,2019-06-22,Business materials,REF22509969,663.39,0.0,408241.28
2019-06-28,2019-06-28,Permits Licenses expense,REF74453094,65.27,0.0,408176.01
2019-06-30,2019-06-30,Subcontractors expense,REF50930680,891.98,0.0,407284.03
2019-06-30,2019-06-30,"Service payment - Martin, Atkins and Khan",REF98576176,0.0,1117.2,408401.23
2019-06-30,2019-06-30,Project payment - Reynolds-Mckinney,REF32897021,0.0,2155.0,410556.23
2019-06-30,2019-06-30,Service payment - Horn and Sons,REF13963029,0.0,2058.72,412614.95
2019-06-30,2019-06-30,"Invoice payment - Martinez, Rose and Carter",REF36802426,0.0,2044.69,414659.64
2019-06-30,2019-06-30,Service payment - Rogers Group,REF81138979,0.0,1180.24,415839.88
2019-07-02,2019-07-02,Fuel purchase,REF95651856,367.56,0.0,415472.32
2019-07-05,2019-07-05,Fuel purchase,REF12606673,529.21,0.0,414943.11
2019-07-09,2019-07-09,Safety Equipment expense,REF22377607,97.7,0.0,414845.41
2019-07-09,2019-07-09,Business materials,REF51982749,769.54,0.0,414075.87
2019-07-09,2019-07-09,Permits Licenses expense,REF86414761,67.91,0.0,414007.96
2019-07-11,2019-07-11,Fuel purchase,REF80335864,435.87,0.0,413572.09
2019-07-14,2019-07-14,Subcontractors expense,REF97440054,1216.93,0.0,412355.16
2019-07-15,2019-07-15,Fuel purchase,REF33894810,468.85,0.0,411886.31
2019-07-15,2019-07-15,Business insurance premium,REF98971564,237.9,0.0,411648.41
2019-07-15,2019-07-15,Invoice payment - Rogers Group,REF60831422,0.0,1280.08,412928.49
2019-07-15,2019-07-15,Invoice payment - Reynolds-Mckinney,REF42418305,0.0,2710.96,415639.45
2019-07-15,2019-07-15,Service payment - Horn and Sons,REF99619335,0.0,1745.74,417385.19
2019-07-15,2019-07-15,"Payment from Martin, Atkins and Khan",REF49773678,0.0,928.87,418314.06
2019-07-15,2019-07-15,"Payment from Martinez, Rose and Carter",REF58489868,0.0,2017.25,420331.31
2019-07-15,2019-07-15,Safety Equipment expense,REF94570426,68.52,0.0,420262.79
2019-07-16,2019-07-16,Safety Equipment expense,REF32383446,80.08,0.0,420182.71
2019-07-22,2019-07-22,Fuel purchase,REF47493882,351.73,0.0,419830.98
2019-07-27,2019-07-27,Business materials,REF66525020,1038.51,0.0,418792.47
2019-07-30,2019-07-30,"Payment from Martin, Atkins and Khan",REF82654064,0.0,968.06,419760.53
2019-07-30,2019-07-30,Invoice payment - Horn and Sons,REF50305626,0.0,1654.41,421414.94
2019-07-30,2019-07-30,Invoice payment - Rogers Group,REF76816468,0.0,730.14,422145.08
2019-07-30,2019-07-30,"Project payment - Martinez, Rose and Carter",REF92233823,0.0,1949.78,424094.86
2019-07-30,2019-07-30,Invoice payment - Reynolds-Mckinney,REF71486199,0.0,1799.28,425894.14
2019-07-30,2019-07-30,Business materials,REF15884603,1260.33,0.0,424633.81
2019-08-02,2019-08-02,Permits Licenses expense,REF76092631,55.42,0.0,424578.39
2019-08-06,2019-08-06,Fuel purchase,REF61053674,321.47,0.0,424256.92
2019-08-09,2019-08-09,Fuel purchase,REF44551533,379.76,0.0,423877.16
2019-08-12,2019-08-12,Vehicle Maintenance expense,REF13530766,188.25,0.0,423688.91
2019-08-15,2019-08-15,Invoice payment - Rogers Group,REF50989756,0.0,1184.95,424873.86
2019-08-15,2019-08-15,Payment from Horn and Sons,REF59689204,0.0,1873.0,426746.86
2019-08-15,2019-08-15,Business insurance premium,REF19805203,216.67,0.0,426530.19
2019-08-15,2019-08-15,"Payment from Martin, Atkins and Khan",REF84701626,0.0,1196.87,427727.06
2019-08-15,2019-08-15,"Payment from Martinez, Rose and Carter",REF18623246,0.0,1645.0,429372.06
2019-08-15,2019-08-15,Payment from Reynolds-Mckinney,REF74564705,0.0,2768.42,432140.48
2019-08-20,2019-08-20,Safety Equipment expense,REF91789726,128.48,0.0,432012.0
2019-08-21,2019-08-21,Business materials,REF19063970,1110.49,0.0,430901.51
2019-08-21,2019-08-21,Fuel purchase,REF78530782,617.54,0.0,430283.97
2019-08-22,2019-08-22,Subcontractors expense,REF24310289,1261.74,0.0,429022.23
2019-08-24,2019-08-24,Business materials,REF45618894,1063.37,0.0,427958.86
2019-08-24,2019-08-24,Permits Licenses expense,REF20877286,128.53,0.0,427830.33
2019-08-25,2019-08-25,Subcontractors expense,REF48866787,927.78,0.0,426902.55
2019-08-28,2019-08-28,Subcontractors expense,REF79562316,996.08,0.0,425906.47
2019-08-30,2019-08-30,Payment from Reynolds-Mckinney,REF10266784,0.0,1996.09,427902.56
2019-08-30,2019-08-30,"Project payment - Martinez, Rose and Carter",REF97158971,0.0,1525.48,429428.04
2019-08-30,2019-08-30,Service payment - Rogers Group,REF13189048,0.0,1414.24,430842.28
2019-08-30,2019-08-30,Service payment - Horn and Sons,REF38274280,0.0,1810.87,432653.15
2019-09-05,2019-09-05,Business materials,REF47480779,658.38,0.0,431994.77
2019-09-05,2019-09-05,Fuel purchase,REF62843632,350.76,0.0,431644.01
2019-09-15,2019-09-15,"Project payment - Martinez, Rose and Carter",REF55359258,0.0,1432.08,433076.09
2019-09-15,2019-09-15,Business insurance premium,REF26515645,210.81,0.0,432865.28
2019-09-15,2019-09-15,Service payment - Rogers Group,REF52495143,0.0,1242.43,434107.71
2019-09-15,2019-09-15,"Project payment - Martin, Atkins and Khan",REF21815369,0.0,1178.85,435286.56
2019-09-15,2019-09-15,Invoice payment - Horn and Sons,REF49268495,0.0,1784.49,437071.05
2019-09-15,2019-09-15,Payment from Reynolds-Mckinney,REF71524487,0.0,1691.05,438762.1
2019-09-17,2019-09-17,Equipment Rental expense,REF13514273,533.31,0.0,438228.79
2019-09-18,2019-09-18,Fuel purchase,REF13430914,206.3,0.0,438022.49
2019-09-20,2019-09-20,Business materials,REF33924876,578.91,0.0,437443.58
2019-09-20,2019-09-20,Vehicle Maintenance expense,REF57724144,195.92,0.0,437247.66
2019-09-21,2019-09-21,Safety Equipment expense,REF24641394,61.56,0.0,437186.1
2019-09-22,2019-09-22,Fuel purchase,REF87367076,257.14,0.0,436928.96
2019-09-27,2019-09-27,Tools expense,REF62371290,106.19,0.0,436822.77
2019-09-30,2019-09-30,Project payment - Horn and Sons,REF37555229,0.0,1841.38,438664.15
2019-09-30,2019-09-30,"Payment from Martinez, Rose and Carter",REF39695264,0.0,1798.57,440462.72
2019-09-30,2019-09-30,Invoice payment - Rogers Group,REF50333674,0.0,927.95,441390.67
2019-09-30,2019-09-30,Permits Licenses expense,REF11609660,50.04,0.0,441340.63
2019-09-30,2019-09-30,Payment from Reynolds-Mckinney,REF50993422,0.0,1583.24,442923.87
2019-10-01,2019-10-01,Fuel purchase,REF16089530,275.2,0.0,442648.67
2019-10-02,2019-10-02,Vehicle Maintenance expense,REF27045076,112.01,0.0,442536.66
2019-10-04,2019-10-04,Business materials,REF64608577,1113.37,0.0,441423.29
2019-10-06,2019-10-06,Subcontractors expense,REF21877922,771.51,0.0,440651.78
2019-10-09,2019-10-09,Business materials,REF71709898,607.76,0.0,440044.02
2019-10-09,2019-10-09,Fuel purchase,REF94380381,268.67,0.0,439775.35
2019-10-11,2019-10-11,Fuel purchase,REF84891404,200.69,0.0,439574.66
2019-10-12,2019-10-12,Subcontractors expense,REF77109809,1346.78,0.0,438227.88
2019-10-12,2019-10-12,Fuel purchase,REF27423089,422.07,0.0,437805.81
2019-10-12,2019-10-12,Business materials,REF37101501,786.2,0.0,437019.61
2019-10-13,2019-10-13,Permits Licenses expense,REF37441554,37.12,0.0,436982.49
2019-10-15,2019-10-15,"Service payment - Martinez, Rose and Carter",REF11705402,0.0,1874.82,438857.31
2019-10-15,2019-10-15,Service payment - Rogers Group,REF47446729,0.0,1062.9,439920.21
2019-10-15,2019-10-15,"Service payment - Martin, Atkins and Khan",REF86248304,0.0,960.02,440880.23
2019-10-15,2019-10-15,Invoice payment - Reynolds-Mckinney,REF88983765,0.0,1833.69,442713.92
2019-10-15,2019-10-15,Payment from Horn and Sons,REF56340442,0.0,1893.66,444607.58
2019-10-15,2019-10-15,Business insurance premium,REF84971118,202.75,0.0,444404.83
2019-10-18,2019-10-18,Business materials,REF95853293,919.31,0.0,443485.52
2019-10-19,2019-10-19,Business materials,REF65431562,454.15,0.0,443031.37
2019-10-23,2019-10-23,Fuel purchase,REF76459945,403.96,0.0,442627.41
2019-10-25,2019-10-25,Safety Equipment expense,REF20262883,20.05,0.0,442607.36
2019-10-26,2019-10-26,Fuel purchase,REF96796007,245.51,0.0,442361.85
2019-10-27,2019-10-27,Fuel purchase,REF46445470,268.27,0.0,442093.58
2019-10-28,2019-10-28,Safety Equipment expense,REF55801855,77.82,0.0,442015.76
2019-10-30,2019-10-30,Project payment - Rogers Group,REF72726364,0.0,1130.81,443146.57
2019-10-30,2019-10-30,Payment from Reynolds-Mckinney,REF27242829,0.0,1605.67,444752.24
2019-10-30,2019-10-30,Service payment - Horn and Sons,REF99586437,0.0,1292.3,446044.54
2019-10-30,2019-10-30,"Payment from Martinez, Rose and Carter",REF20208819,0.0,1952.18,447996.72
2019-10-30,2019-10-30,"Payment from Martin, Atkins and Khan",REF36045390,0.0,934.46,448931.18
2019-10-31,2019-10-31,Equipment Rental expense,REF30902656,559.74,0.0,448371.44
2019-11-02,2019-11-02,Fuel purchase,REF74491462,338.94,0.0,448032.5
2019-11-05,2019-11-05,Business materials,REF48607270,445.58,0.0,447586.92
2019-11-07,2019-11-07,Permits Licenses expense,REF89514206,57.57,0.0,447529.35
2019-11-09,2019-11-09,Fuel purchase,REF90116573,184.64,0.0,447344.71
2019-11-09,2019-11-09,Business materials,REF71514570,735.84,0.0,446608.87
2019-11-14,2019-11-14,Permits Licenses expense,REF70509638,42.63,0.0,446566.24
2019-11-15,2019-11-15,Business insurance premium,REF98046170,154.6,0.0,446411.64
2019-11-15,2019-11-15,Service payment - Reynolds-Mckinney,REF71293637,0.0,1450.89,447862.53
2019-11-15,2019-11-15,Service payment - Rogers Group,REF73212489,0.0,751.71,448614.24
2019-11-15,2019-11-15,"Project payment - Martin, Atkins and Khan",REF71964965,0.0,604.35,449218.59
2019-11-15,2019-11-15,"Service payment - Martinez, Rose and Carter",REF15577348,0.0,1741.25,450959.84
2019-11-16,2019-11-16,Fuel purchase,REF14611715,193.6,0.0,450766.24
2019-11-17,2019-11-17,Tools expense,REF40836762,88.73,0.0,450677.51
2019-11-19,2019-11-19,Fuel purchase,REF62511957,286.03,0.0,450391.48
2019-11-22,2019-11-22,Tools expense,REF87342174,75.63,0.0,450315.85
2019-11-23,2019-11-23,Business materials,REF92005139,487.58,0.0,449828.27
2019-11-24,2019-11-24,Business materials,REF82743484,669.73,0.0,449158.54
2019-11-25,2019-11-25,Fuel purchase,REF96267519,122.56,0.0,449035.98
2019-11-25,2019-11-25,Subcontractors expense,REF60164957,486.41,0.0,448549.57
2019-11-26,2019-11-26,Fuel purchase,REF27039936,164.84,0.0,448384.73
2019-11-29,2019-11-29,Business materials,REF91085537,448.79,0.0,447935.94
2019-11-30,2019-11-30,"Service payment - Martinez, Rose and Carter",REF44404339,0.0,1574.36,449510.3
2019-11-30,2019-11-30,Project payment - Horn and Sons,REF94486303,0.0,1224.21,450734.51
2019-11-30,2019-11-30,"Service payment - Martin, Atkins and Khan",REF15370268,0.0,498.53,451233.04
2019-11-30,2019-11-30,Payment from Rogers Group,REF76240635,0.0,848.39,452081.43
2019-11-30,2019-11-30,Payment from Reynolds-Mckinney,REF88660836,0.0,1282.32,453363.75
2019-12-02,2019-12-02,Business materials,REF88799035,607.23,0.0,452756.52
2019-12-03,2019-12-03,Fuel purchase,REF53912923,122.11,0.0,452634.41
2019-12-04,2019-12-04,Business materials,REF24983681,397.47,0.0,452236.94
2019-12-06,2019-12-06,Fuel purchase,REF30251558,226.73,0.0,452010.21
2019-12-09,2019-12-09,Safety Equipment expense,REF60514773,42.22,0.0,451967.99
2019-12-09,2019-12-09,Business materials,REF21204970,683.89,0.0,451284.1
2019-12-10,2019-12-10,Equipment Rental expense,REF59495918,296.01,0.0,450988.09
2019-12-11,2019-12-11,Fuel purchase,REF11843968,215.27,0.0,450772.82
2019-12-14,2019-12-14,Fuel purchase,REF93531295,249.51,0.0,450523.31
2019-12-14,2019-12-14,Permits Licenses expense,REF74541609,51.05,0.0,450472.26
2019-12-15,2019-12-15,Invoice payment - Horn and Sons,REF55424437,0.0,664.1,451136.36
2019-12-15,2019-12-15,Business insurance premium,REF86482710,110.25,0.0,451026.11
2019-12-15,2019-12-15,Payment from Rogers Group,REF84857728,0.0,527.8,451553.91
2019-12-15,2019-12-15,"Service payment - Martinez, Rose and Carter",REF50322350,0.0,1039.41,452593.32
2019-12-15,2019-12-15,"Project payment - Martin, Atkins and Khan",REF72550088,0.0,581.7,453175.02
2019-12-20,2019-12-20,Business materials,REF92098314,447.58,0.0,452727.44
2019-12-24,2019-12-24,Vehicle Maintenance expense,REF11817614,99.58,0.0,452627.86
2019-12-26,2019-12-26,Fuel purchase,REF48977979,215.47,0.0,452412.39
2019-12-30,2019-12-30,"Invoice payment - Martinez, Rose and Carter",REF39814338,0.0,882.08,453294.47
2019-12-30,2019-12-30,"Invoice payment - Martin, Atkins and Khan",REF59119168,0.0,538.91,453833.38
2019-12-30,2019-12-30,Project payment - Rogers Group,REF69306557,0.0,556.58,454389.96
2019-12-30,2019-12-30,Project payment - Reynolds-Mckinney,REF50364699,0.0,959.73,455349.69
2019-12-30,2019-12-30,Payment from Horn and Sons,REF69488283,0.0,1058.35,456408.04
2019-12-31,2019-12-31,Business materials,REF31969179,455.98,0.0,455952.06
2020-01-04,2020-01-04,Business materials,REF91072041,717.58,0.0,455234.48
2020-01-12,2020-01-12,Fuel purchase,REF17173579,220.0,0.0,455014.48
2020-01-12,2020-01-12,Subcontractors expense,REF90105741,206.63,0.0,454807.85
2020-01-15,2020-01-15,Business insurance premium,REF45920984,138.12,0.0,454669.73
2020-01-15,2020-01-15,"Payment from Martin, Atkins and Khan",REF45005494,0.0,514.06,455183.79
2020-01-15,2020-01-15,Invoice payment - Horn and Sons,REF52249657,0.0,797.06,455980.85
2020-01-15,2020-01-15,"Project payment - Martinez, Rose and Carter",REF60996058,0.0,1394.42,457375.27
2020-01-15,2020-01-15,Payment from Reynolds-Mckinney,REF12089827,0.0,1288.33,458663.6
2020-01-15,2020-01-15,Invoice payment - Rogers Group,REF47965018,0.0,912.33,459575.93
2020-01-20,2020-01-20,Vehicle Maintenance expense,REF58997505,120.34,0.0,459455.59
2020-01-22,2020-01-22,Permits Licenses expense,REF53921594,14.7,0.0,459440.89
2020-01-23,2020-01-23,Tools expense,REF93357140,107.22,0.0,459333.67
2020-01-26,2020-01-26,Business materials,REF94805765,688.38,0.0,458645.29
2020-01-26,2020-01-26,Fuel purchase,REF52391649,111.55,0.0,458533.74
2020-01-30,2020-01-30,Project payment - Horn and Sons,REF47021099,0.0,976.39,459510.13
2020-01-30,2020-01-30,"Invoice payment - Martin, Atkins and Khan",REF86013590,0.0,645.57,460155.7
2020-01-30,2020-01-30,Project payment - Reynolds-Mckinney,REF97522440,0.0,1528.42,461684.12
2020-01-30,2020-01-30,Invoice payment - Rogers Group,REF65916219,0.0,1022.24,462706.36
2020-01-30,2020-01-30,"Payment from Martinez, Rose and Carter",REF71458898,0.0,1298.15,464004.51
2020-01-31,2020-01-31,Business materials,REF48417828,655.74,0.0,463348.77
2020-02-04,2020-02-04,Fuel purchase,REF99669805,299.62,0.0,463049.15
2020-02-10,2020-02-10,Fuel purchase,REF73789377,249.21,0.0,462799.94
2020-02-12,2020-02-12,Vehicle Maintenance expense,REF48506200,157.35,0.0,462642.59
2020-02-15,2020-02-15,Business insurance premium,REF13078769,165.76,0.0,462476.83
2020-02-15,2020-02-15,Project payment - Horn and Sons,REF49119721,0.0,1448.16,463924.99
2020-02-15,2020-02-15,"Invoice payment - Martin, Atkins and Khan",REF96361754,0.0,611.21,464536.2
2020-02-15,2020-02-15,"Service payment - Martinez, Rose and Carter",REF35929146,0.0,1714.25,466250.45
2020-02-15,2020-02-15,Payment from Rogers Group,REF25844075,0.0,804.66,467055.11
2020-02-15,2020-02-15,Invoice payment - Reynolds-Mckinney,REF92133349,0.0,1371.98,468427.09
2020-02-24,2020-02-24,Fuel purchase,REF41931048,248.94,0.0,468178.15
2020-02-26,2020-02-26,Fuel purchase,REF20245860,336.07,0.0,467842.08
2020-02-28,2020-02-28,Business materials,REF22036755,458.54,0.0,467383.54
2020-02-28,2020-02-28,Service payment - Rogers Group,REF99506879,0.0,857.27,468240.81
2020-02-28,2020-02-28,Fuel purchase,REF10736535,127.72,0.0,468113.09
2020-02-28,2020-02-28,"Service payment - Martinez, Rose and Carter",REF50519891,0.0,1226.79,469339.88
2020-02-28,2020-02-28,Payment from Horn and Sons,REF92668660,0.0,862.24,470202.12
2020-02-28,2020-02-28,"Project payment - Martin, Atkins and Khan",REF23922642,0.0,792.23,470994.35
2020-02-28,2020-02-28,Invoice payment - Reynolds-Mckinney,REF17146443,0.0,1567.4,472561.75
2020-02-29,2020-02-29,Business materials,REF79375107,660.35,0.0,471901.4
2020-03-02,2020-03-02,Fuel purchase,REF26535555,429.07,0.0,471472.33
2020-03-03,2020-03-03,Fuel purchase,REF61012191,122.42,0.0,471349.91
2020-03-05,2020-03-05,Fuel purchase,REF52693987,414.48,0.0,470935.43
2020-03-07,2020-03-07,Fuel purchase,REF21909673,289.15,0.0,470646.28
2020-03-09,2020-03-09,Fuel purchase,REF65270111,241.21,0.0,470405.07
2020-03-10,2020-03-10,Fuel purchase,REF82848433,293.11,0.0,470111.96
2020-03-11,2020-03-11,Fuel purchase,REF55118292,236.96,0.0,469875.0
2020-03-12,2020-03-12,Safety Equipment expense,REF63196965,53.81,0.0,469821.19
2020-03-13,2020-03-13,Vehicle Maintenance expense,REF41464609,157.14,0.0,469664.05
2020-03-14,2020-03-14,Safety Equipment expense,REF79714456,100.72,0.0,469563.33
2020-03-15,2020-03-15,Business insurance premium,REF82289877,199.9,0.0,469363.43
2020-03-15,2020-03-15,"Payment from Martin, Atkins and Khan",REF50031217,0.0,939.59,470303.02
2020-03-15,2020-03-15,Service payment - Horn and Sons,REF23005268,0.0,1133.08,471436.1
2020-03-15,2020-03-15,"Project payment - Martinez, Rose and Carter",REF20285741,0.0,1607.88,473043.98
2020-03-15,2020-03-15,Payment from Rogers Group,REF56789317,0.0,1360.93,474404.91
2020-03-16,2020-03-16,Fuel purchase,REF31211911,332.46,0.0,474072.45
2020-03-19,2020-03-19,Equipment Rental expense,REF10148267,184.18,0.0,473888.27
2020-03-23,2020-03-23,Equipment Rental expense,REF28209256,422.33,0.0,473465.94
2020-03-28,2020-03-28,Permits Licenses expense,REF14790195,103.71,0.0,473362.23
2020-03-30,2020-03-30,Fuel purchase,REF33287378,322.31,0.0,473039.92
2020-03-30,2020-03-30,Payment from Horn and Sons,REF58938983,0.0,1715.87,474755.79
2020-03-30,2020-03-30,"Project payment - Martinez, Rose and Carter",REF72815804,0.0,2173.95,476929.74
2020-03-30,2020-03-30,Project payment - Rogers Group,REF72288949,0.0,850.09,477779.83
2020-03-30,2020-03-30,"Project payment - Martin, Atkins and Khan",REF25233842,0.0,1042.76,478822.59
2020-03-30,2020-03-30,Service payment - Reynolds-Mckinney,REF73289556,0.0,1701.6,480524.19
2020-04-07,2020-04-07,Tools expense,REF56732376,122.21,0.0,480401.98
2020-04-13,2020-04-13,Tools expense,REF69123767,121.46,0.0,480280.52
2020-04-14,2020-04-14,Permits Licenses expense,REF56866631,76.44,0.0,480204.08
2020-04-15,2020-04-15,Business insurance premium,REF39394205,252.54,0.0,479951.54
2020-04-15,2020-04-15,"Payment from Martinez, Rose and Carter",REF70981291,0.0,1924.9,481876.44
2020-04-15,2020-04-15,"Invoice payment - Martin, Atkins and Khan",REF49937993,0.0,972.52,482848.96
2020-04-15,2020-04-15,Invoice payment - Horn and Sons,REF77404442,0.0,2133.89,484982.85
2020-04-15,2020-04-15,Service payment - Rogers Group,REF20763080,0.0,1356.53,486339.38
2020-04-21,2020-04-21,Permits Licenses expense,REF69178218,70.06,0.0,486269.32
2020-04-27,2020-04-27,Vehicle Maintenance expense,REF68509547,198.46,0.0,486070.86
2020-04-27,2020-04-27,Subcontractors expense,REF24750735,1047.48,0.0,485023.38
2020-04-28,2020-04-28,Fuel purchase,REF99223010,441.93,0.0,484581.45
2020-04-29,2020-04-29,Subcontractors expense,REF27654363,995.98,0.0,483585.47
2020-04-30,2020-04-30,"Project payment - Martinez, Rose and Carter",REF91550950,0.0,2121.28,485706.75
2020-04-30,2020-04-30,Payment from Rogers Group,REF38385175,0.0,1170.54,486877.29
2020-04-30,2020-04-30,"Payment from Martin, Atkins and Khan",REF91138821,0.0,877.75,487755.04
2020-04-30,2020-04-30,Project payment - Horn and Sons,REF15669392,0.0,2002.57,489757.61
2020-05-05,2020-05-05,Business materials,REF61944783,689.32,0.0,489068.29
2020-05-06,2020-05-06,Vehicle Maintenance expense,REF12593778,172.62,0.0,488895.67
2020-05-07,2020-05-07,Fuel purchase,REF96607740,397.62,0.0,488498.05
2020-05-08,2020-05-08,Permits Licenses expense,REF93451605,148.17,0.0,488349.88
2020-05-15,2020-05-15,Service payment - Reynolds-Mckinney,REF36804953,0.0,1961.22,490311.1
2020-05-15,2020-05-15,"Service payment - Martin, Atkins and Khan",REF18068482,0.0,1448.36,491759.46
2020-05-15,2020-05-15,Invoice payment - Rogers Group,REF59980638,0.0,1562.06,493321.52
2020-05-15,2020-05-15,Business insurance premium,REF40709986,252.21,0.0,493069.31
2020-05-15,2020-05-15,"Service payment - Martinez, Rose and Carter",REF26939852,0.0,2460.85,495530.16
2020-05-15,2020-05-15,Service payment - Horn and Sons,REF34788636,0.0,1941.39,497471.55
2020-05-22,2020-05-22,Tools expense,REF99130080,83.71,0.0,497387.84
2020-05-26,2020-05-26,Tools expense,REF96955070,119.67,0.0,497268.17
2020-05-27,2020-05-27,Business materials,REF12469227,1253.47,0.0,496014.7
2020-05-28,2020-05-28,Vehicle Maintenance expense,REF43847994,175.86,0.0,495838.84
2020-05-28,2020-05-28,Fuel purchase,REF99401785,290.87,0.0,495547.97
2020-05-30,2020-05-30,Service payment - Reynolds-Mckinney,REF73118759,0.0,2401.61,497949.58
2020-05-30,2020-05-30,Invoice payment - Rogers Group,REF33682279,0.0,1213.06,499162.64
2020-05-30,2020-05-30,"Project payment - Martinez, Rose and Carter",REF99033768,0.0,1775.55,500938.19
2020-05-31,2020-05-31,Business materials,REF58754075,896.1,0.0,500042.09
2020-06-02,2020-06-02,Fuel purchase,REF86722372,502.63,0.0,499539.46
2020-06-03,2020-06-03,Tools expense,REF49803480,102.96,0.0,499436.5
2020-06-03,2020-06-03,Fuel purchase,REF83568787,407.57,0.0,499028.93
2020-06-05,2020-06-05,Business materials,REF73978720,632.63,0.0,498396.3
2020-06-08,2020-06-08,Business materials,REF83839336,975.53,0.0,497420.77
2020-06-15,2020-06-15,"Service payment - Martinez, Rose and Carter",REF92936178,0.0,1931.63,499352.4
2020-06-15,2020-06-15,Project payment - Rogers Group,REF29824879,0.0,1469.63,500822.03
2020-06-15,2020-06-15,Business insurance premium,REF73762267,259.22,0.0,500562.81
2020-06-15,2020-06-15,Subcontractors expense,REF19031511,1375.69,0.0,499187.12
2020-06-15,2020-06-15,"Invoice payment - Martin, Atkins and Khan",REF51561616,0.0,1040.2,500227.32
2020-06-15,2020-06-15,Invoice payment - Reynolds-Mckinney,REF40311592,0.0,2314.09,502541.41
2020-06-15,2020-06-15,Service payment - Horn and Sons,REF87166018,0.0,2000.87,504542.28
2020-06-16,2020-06-16,Tools expense,REF59540173,97.75,0.0,504444.53
2020-06-17,2020-06-17,Vehicle Maintenance expense,REF25405999,240.38,0.0,504204.15
2020-06-18,2020-06-18,Business materials,REF50941889,1275.69,0.0,502928.46
2020-06-21,2020-06-21,Fuel purchase,REF84225259,288.91,0.0,502639.55
2020-06-25,2020-06-25,Fuel purchase,REF95179063,360.78,0.0,502278.77
2020-06-27,2020-06-27,Fuel purchase,REF25541034,267.48,0.0,502011.29
2020-06-28,2020-06-28,Permits Licenses expense,REF89298324,96.41,0.0,501914.88
2020-06-30,2020-06-30,Project payment - Reynolds-Mckinney,REF50111779,0.0,2338.91,504253.79
2020-06-30,2020-06-30,"Invoice payment - Martinez, Rose and Carter",REF90763177,0.0,2124.09,506377.88
2020-06-30,2020-06-30,"Service payment - Martin, Atkins and Khan",REF34291992,0.0,1315.28,507693.16
2020-06-30,2020-06-30,Invoice payment - Rogers Group,REF41586836,0.0,1508.46,509201.62
2020-06-30,2020-06-30,Payment from Horn and Sons,REF67552834,0.0,1445.53,510647.15
2020-07-02,2020-07-02,Subcontractors expense,REF18049364,1419.56,0.0,509227.59
2020-07-04,2020-07-04,Vehicle Maintenance expense,REF15690135,208.99,0.0,509018.6
2020-07-05,2020-07-05,Fuel purchase,REF60279780,406.47,0.0,508612.13
2020-07-06,2020-07-06,Fuel purchase,REF88716442,290.43,0.0,508321.7
2020-07-09,2020-07-09,Business materials,REF78643572,1426.54,0.0,506895.16
2020-07-13,2020-07-13,Tools expense,REF25431619,137.2,0.0,506757.96
2020-07-15,2020-07-15,Service payment - Reynolds-Mckinney,REF89245761,0.0,2499.22,509257.18
2020-07-15,2020-07-15,Business insurance premium,REF72085217,218.29,0.0,509038.89
2020-07-15,2020-07-15,"Project payment - Martinez, Rose and Carter",REF96169133,0.0,2393.64,511432.53
2020-07-15,2020-07-15,"Service payment - Martin, Atkins and Khan",REF30235627,0.0,1103.49,512536.02
2020-07-15,2020-07-15,Invoice payment - Rogers Group,REF38479283,0.0,1193.39,513729.41
2020-07-15,2020-07-15,Invoice payment - Horn and Sons,REF75301228,0.0,1680.55,515409.96
2020-07-17,2020-07-17,Business materials,REF50740617,793.92,0.0,514616.04
2020-07-18,2020-07-18,Business materials,REF47335148,1185.19,0.0,513430.85
2020-07-19,2020-07-19,Permits Licenses expense,REF95105693,82.66,0.0,513348.19
2020-07-22,2020-07-22,Business materials,REF40958876,914.81,0.0,512433.38
2020-07-23,2020-07-23,Permits Licenses expense,REF77056098,138.77,0.0,512294.61
2020-07-29,2020-07-29,Fuel purchase,REF83914893,358.66,0.0,511935.95
2020-07-30,2020-07-30,"Invoice payment - Martin, Atkins and Khan",REF65217914,0.0,1228.53,513164.48
2020-07-30,2020-07-30,Project payment - Reynolds-Mckinney,REF85321209,0.0,2069.01,515233.49
2020-07-30,2020-07-30,Payment from Rogers Group,REF71605666,0.0,1372.49,516605.98
2020-07-30,2020-07-30,"Payment from Martinez, Rose and Carter",REF72711862,0.0,1854.0,518459.98
2020-07-31,2020-07-31,Fuel purchase,REF78116501,387.18,0.0,518072.8
2020-08-07,2020-08-07,Fuel purchase,REF67491273,351.26,0.0,517721.54
2020-08-11,2020-08-11,Business materials,REF58209540,1151.88,0.0,516569.66
2020-08-15,2020-08-15,"Payment from Martin, Atkins and Khan",REF37947318,0.0,938.26,517507.92
2020-08-15,2020-08-15,Payment from Horn and Sons,REF38418004,0.0,1809.49,519317.41
2020-08-15,2020-08-15,"Invoice payment - Martinez, Rose and Carter",REF47551159,0.0,1893.3,521210.71
2020-08-15,2020-08-15,Business insurance premium,REF40259875,241.24,0.0,520969.47
2020-08-15,2020-08-15,Service payment - Reynolds-Mckinney,REF99920343,0.0,2216.28,523185.75
2020-08-15,2020-08-15,Project payment - Rogers Group,REF84605124,0.0,1172.54,524358.29
2020-08-17,2020-08-17,Tools expense,REF56686145,128.74,0.0,524229.55
2020-08-19,2020-08-19,Safety Equipment expense,REF68128333,85.58,0.0,524143.97
2020-08-29,2020-08-29,Business materials,REF51984014,732.65,0.0,523411.32
2020-08-30,2020-08-30,Service payment - Reynolds-Mckinney,REF45260921,0.0,1874.58,525285.9
2020-08-30,2020-08-30,Project payment - Horn and Sons,REF42481890,0.0,1631.74,526917.64
2020-08-30,2020-08-30,"Service payment - Martin, Atkins and Khan",REF59025951,0.0,912.51,527830.15
2020-08-30,2020-08-30,Service payment - Rogers Group,REF69935626,0.0,1360.99,529191.14
2020-08-31,2020-08-31,Tools expense,REF52743614,89.25,0.0,529101.89
2020-09-02,2020-09-02,Fuel purchase,REF57438898,448.13,0.0,528653.76
2020-09-02,2020-09-02,Business materials,REF21227735,650.02,0.0,528003.74
2020-09-03,2020-09-03,Equipment Rental expense,REF72968891,553.34,0.0,527450.4
2020-09-08,2020-09-08,Vehicle Maintenance expense,REF12761064,230.78,0.0,527219.62
2020-09-09,2020-09-09,Fuel purchase,REF23996862,325.66,0.0,526893.96
2020-09-10,2020-09-10,Business materials,REF40190486,253.11,0.0,526640.85
2020-09-13,2020-09-13,Business materials,REF78115021,1017.49,0.0,525623.36
2020-09-15,2020-09-15,Business insurance premium,REF33021680,202.66,0.0,525420.7
2020-09-15,2020-09-15,Permits Licenses expense,REF73094541,108.7,0.0,525312.0
2020-09-15,2020-09-15,Service payment - Horn and Sons,REF83323767,0.0,2043.16,527355.16
2020-09-15,2020-09-15,Project payment - Rogers Group,REF37348961,0.0,1046.6,528401.76
2020-09-15,2020-09-15,Invoice payment - Reynolds-Mckinney,REF83929346,0.0,1649.2,530050.96
2020-09-15,2020-09-15,"Payment from Martinez, Rose and Carter",REF46359933,0.0,1850.99,531901.95
2020-09-15,2020-09-15,"Service payment - Martin, Atkins and Khan",REF38245475,0.0,1210.77,533112.72
2020-09-16,2020-09-16,Business materials,REF44840628,643.0,0.0,532469.72
2020-09-17,2020-09-17,Fuel purchase,REF86357751,348.52,0.0,532121.2
2020-09-20,2020-09-20,Fuel purchase,REF15128633,403.47,0.0,531717.73
2020-09-24,2020-09-24,Subcontractors expense,REF65516450,1238.29,0.0,530479.44
2020-09-26,2020-09-26,Vehicle Maintenance expense,REF83362177,223.65,0.0,530255.79
2020-09-30,2020-09-30,Payment from Horn and Sons,REF76660091,0.0,1561.7,531817.49
2020-09-30,2020-09-30,Service payment - Reynolds-Mckinney,REF18322665,0.0,2114.04,533931.53
2020-09-30,2020-09-30,"Payment from Martin, Atkins and Khan",REF67883982,0.0,1022.24,534953.77
2020-10-01,2020-10-01,Fuel purchase,REF30080821,371.28,0.0,534582.49
2020-10-04,2020-10-04,Business materials,REF10107914,529.23,0.0,534053.26
2020-10-06,2020-10-06,Fuel purchase,REF63192171,342.93,0.0,533710.33
2020-10-09,2020-10-09,Tools expense,REF46115930,109.18,0.0,533601.15
2020-10-11,2020-10-11,Equipment Rental expense,REF11699227,371.27,0.0,533229.88
2020-10-13,2020-10-13,Equipment Rental expense,REF52780215,436.21,0.0,532793.67
2020-10-15,2020-10-15,Invoice payment - Reynolds-Mckinney,REF59805459,0.0,1838.33,534632.0
2020-10-15,2020-10-15,"Project payment - Martinez, Rose and Carter",REF25246588,0.0,2063.88,536695.88
2020-10-15,2020-10-15,Service payment - Horn and Sons,REF97446257,0.0,1288.42,537984.3
2020-10-15,2020-10-15,Payment from Rogers Group,REF93088011,0.0,1290.55,539274.85
2020-10-15,2020-10-15,"Project payment - Martin, Atkins and Khan",REF63178407,0.0,763.05,540037.9
2020-10-15,2020-10-15,Business insurance premium,REF93269138,191.46,0.0,539846.44
2020-10-16,2020-10-16,Permits Licenses expense,REF78314590,86.64,0.0,539759.8
2020-10-18,2020-10-18,Fuel purchase,REF43483355,356.94,0.0,539402.86
2020-10-21,2020-10-21,Equipment Rental expense,REF15847618,471.4,0.0,538931.46
2020-10-28,2020-10-28,Equipment Rental expense,REF70538058,324.98,0.0,538606.48
2020-10-29,2020-10-29,Business materials,REF27245736,510.08,0.0,538096.4
2020-10-30,2020-10-30,Invoice payment - Rogers Group,REF58029305,0.0,896.26,538992.66
2020-10-30,2020-10-30,Service payment - Reynolds-Mckinney,REF69894668,0.0,1948.9,540941.56
2020-10-30,2020-10-30,"Payment from Martinez, Rose and Carter",REF21471542,0.0,1917.13,542858.69
2020-10-30,2020-10-30,"Project payment - Martin, Atkins and Khan",REF26893503,0.0,1107.45,543966.14
2020-11-02,2020-11-02,Subcontractors expense,REF79180716,969.68,0.0,542996.46
2020-11-03,2020-11-03,Tools expense,REF30126903,86.29,0.0,542910.17
2020-11-04,2020-11-04,Safety Equipment expense,REF68807203,84.27,0.0,542825.9
2020-11-04,2020-11-04,Equipment Rental expense,REF37378217,348.83,0.0,542477.07
2020-11-06,2020-11-06,Business materials,REF18822482,800.21,0.0,541676.86
2020-11-07,2020-11-07,Fuel purchase,REF25179289,182.94,0.0,541493.92
2020-11-07,2020-11-07,Vehicle Maintenance expense,REF53918370,160.24,0.0,541333.68
2020-11-08,2020-11-08,Fuel purchase,REF49594181,223.58,0.0,541110.1
2020-11-12,2020-11-12,Business materials,REF13053003,572.04,0.0,540538.06
2020-11-15,2020-11-15,Business insurance premium,REF56344163,160.79,0.0,540377.27
2020-11-15,2020-11-15,Invoice payment - Rogers Group,REF66140489,0.0,934.98,541312.25
2020-11-15,2020-11-15,"Payment from Martin, Atkins and Khan",REF77139353,0.0,717.78,542030.03
2020-11-15,2020-11-15,Fuel purchase,REF46387824,277.48,0.0,541752.55
2020-11-15,2020-11-15,Project payment - Reynolds-Mckinney,REF57189108,0.0,1627.96,543380.51
2020-11-15,2020-11-15,"Service payment - Martinez, Rose and Carter",REF65724043,0.0,1059.06,544439.57
2020-11-15,2020-11-15,Service payment - Horn and Sons,REF77393727,0.0,1089.13,545528.7
2020-11-17,2020-11-17,Fuel purchase,REF32923035,230.94,0.0,545297.76
2020-11-22,2020-11-22,Subcontractors expense,REF96511841,1162.25,0.0,544135.51
2020-11-26,2020-11-26,Business materials,REF65611089,342.66,0.0,543792.85
2020-11-29,2020-11-29,Tools expense,REF21100729,57.2,0.0,543735.65
2020-11-30,2020-11-30,Project payment - Reynolds-Mckinney,REF72824505,0.0,1916.2,545651.85
2020-11-30,2020-11-30,"Payment from Martinez, Rose and Carter",REF50227624,0.0,1373.8,547025.65
2020-11-30,2020-11-30,Payment from Rogers Group,REF83812942,0.0,725.36,547751.01
2020-11-30,2020-11-30,Invoice payment - Horn and Sons,REF35266935,0.0,1108.11,548859.12
2020-11-30,2020-11-30,"Project payment - Martin, Atkins and Khan",REF38160292,0.0,643.88,549503.0
2020-12-06,2020-12-06,Tools expense,REF76650256,56.49,0.0,549446.51
2020-12-08,2020-12-08,Fuel purchase,REF87516050,157.73,0.0,549288.78
2020-12-11,2020-12-11,Equipment Rental expense,REF84120812,270.99,0.0,549017.79
2020-12-14,2020-12-14,Tools expense,REF87853892,49.54,0.0,548968.25
2020-12-15,2020-12-15,Business insurance premium,REF45731867,123.38,0.0,548844.87
2020-12-15,2020-12-15,Service payment - Rogers Group,REF18308504,0.0,707.24,549552.11
2020-12-15,2020-12-15,Project payment - Horn and Sons,REF62212959,0.0,781.66,550333.77
2020-12-15,2020-12-15,"Service payment - Martin, Atkins and Khan",REF21572235,0.0,614.45,550948.22
2020-12-15,2020-12-15,Payment from Reynolds-Mckinney,REF30075293,0.0,953.6,551901.82
2020-12-16,2020-12-16,Business materials,REF42544668,524.7,0.0,551377.12
2020-12-19,2020-12-19,Safety Equipment expense,REF66104624,27.88,0.0,551349.24
2020-12-21,2020-12-21,Safety Equipment expense,REF23086246,5.0,0.0,551344.24
2020-12-23,2020-12-23,Business materials,REF77892839,577.29,0.0,550766.95
2020-12-30,2020-12-30,Service payment - Rogers Group,REF65083012,0.0,605.22,551372.17
2020-12-30,2020-12-30,Service payment - Horn and Sons,REF11927444,0.0,675.28,552047.45
2020-12-30,2020-12-30,Project payment - Reynolds-Mckinney,REF80254971,0.0,1294.44,553341.89
2020-12-30,2020-12-30,"Service payment - Martin, Atkins and Khan",REF59055841,0.0,541.23,553883.12
2021-01-04,2021-01-04,Fuel purchase,REF73738781,82.92,0.0,553800.2
2021-01-05,2021-01-05,Business materials,REF62176915,563.32,0.0,553236.88
2021-01-06,2021-01-06,Business materials,REF33804353,478.51,0.0,552758.37
2021-01-10,2021-01-10,Business materials,REF68503903,697.12,0.0,552061.25
2021-01-11,2021-01-11,Permits Licenses expense,REF72958189,40.22,0.0,552021.03
2021-01-11,2021-01-11,Tools expense,REF18865440,12.32,0.0,552008.71
2021-01-12,2021-01-12,Subcontractors expense,REF71621066,961.76,0.0,551046.95
2021-01-14,2021-01-14,Fuel purchase,REF98639228,205.1,0.0,550841.85
2021-01-15,2021-01-15,Service payment - Reynolds-Mckinney,REF90943364,0.0,900.16,551742.01
2021-01-15,2021-01-15,Invoice payment - Rogers Group,REF24785689,0.0,776.99,552519.0
2021-01-15,2021-01-15,Service payment - Horn and Sons,REF46699185,0.0,970.44,553489.44
2021-01-15,2021-01-15,"Invoice payment - Martin, Atkins and Khan",REF35716612,0.0,714.95,554204.39
2021-01-15,2021-01-15,"Project payment - Martinez, Rose and Carter",REF75222778,0.0,1180.35,555384.74
2021-01-15,2021-01-15,Business insurance premium,REF94233777,144.81,0.0,555239.93
2021-01-18,2021-01-18,Tools expense,REF32764870,62.89,0.0,555177.04
2021-01-19,2021-01-19,Business materials,REF83151713,405.85,0.0,554771.19
2021-01-20,2021-01-20,Fuel purchase,REF65889941,184.96,0.0,554586.23
2021-01-20,2021-01-20,Tools expense,REF20545648,60.39,0.0,554525.84
2021-01-21,2021-01-21,Fuel purchase,REF44574353,217.5,0.0,554308.34
2021-01-23,2021-01-23,Permits Licenses expense,REF79497086,49.5,0.0,554258.84
2021-01-24,2021-01-24,Subcontractors expense,REF44949705,738.48,0.0,553520.36
2021-01-27,2021-01-27,Equipment Rental expense,REF38029126,308.22,0.0,553212.14
2021-01-28,2021-01-28,Business materials,REF24639456,507.32,0.0,552704.82
2021-01-30,2021-01-30,Business materials,REF24014061,299.54,0.0,552405.28
2021-01-30,2021-01-30,Invoice payment - Rogers Group,REF38523101,0.0,677.01,553082.29
2021-01-30,2021-01-30,"Project payment - Martin, Atkins and Khan",REF79980004,0.0,691.11,553773.4
2021-01-30,2021-01-30,Invoice payment - Horn and Sons,REF87242777,0.0,900.12,554673.52
2021-01-30,2021-01-30,Service payment - Reynolds-Mckinney,REF29547149,0.0,1178.78,555852.3
2021-01-30,2021-01-30,"Project payment - Martinez, Rose and Carter",REF10955818,0.0,1410.04,557262.34
2021-02-02,2021-02-02,Equipment Rental expense,REF92915620,212.77,0.0,557049.57
2021-02-05,2021-02-05,Tools expense,REF57819211,107.69,0.0,556941.88
2021-02-06,2021-02-06,Subcontractors expense,REF19628902,732.39,0.0,556209.49
2021-02-13,2021-02-13,Permits Licenses expense,REF44734131,70.64,0.0,556138.85
2021-02-14,2021-02-14,Business materials,REF30911833,807.27,0.0,555331.58
2021-02-14,2021-02-14,Fuel purchase,REF95575511,273.28,0.0,555058.3
2021-02-15,2021-02-15,"Project payment - Martin, Atkins and Khan",REF14982293,0.0,669.6,555727.9
2021-02-15,2021-02-15,Business insurance premium,REF67250470,171.46,0.0,555556.44
2021-02-15,2021-02-15,Service payment - Reynolds-Mckinney,REF18239833,0.0,1392.95,556949.39
2021-02-15,2021-02-15,"Payment from Martinez, Rose and Carter",REF65644915,0.0,1430.2,558379.59
2021-02-15,2021-02-15,Project payment - Horn and Sons,REF98835853,0.0,1185.56,559565.15
2021-02-15,2021-02-15,Service payment - Rogers Group,REF13570940,0.0,859.0,560424.15
2021-02-17,2021-02-17,Equipment Rental expense,REF56442722,279.63,0.0,560144.52
2021-02-18,2021-02-18,Business materials,REF28048203,573.32,0.0,559571.2
2021-02-19,2021-02-19,Subcontractors expense,REF39653624,543.72,0.0,559027.48
2021-02-19,2021-02-19,Business materials,REF97591394,603.35,0.0,558424.13
2021-02-25,2021-02-25,Business materials,REF28474442,677.47,0.0,557746.66
2021-02-28,2021-02-28,Payment from Reynolds-Mckinney,REF62047507,0.0,1283.68,559030.34
2021-02-28,2021-02-28,"Payment from Martin, Atkins and Khan",REF31009161,0.0,878.12,559908.46
2021-02-28,2021-02-28,"Service payment - Martinez, Rose and Carter",REF35886562,0.0,1468.97,561377.43
2021-02-28,2021-02-28,Project payment - Horn and Sons,REF46044250,0.0,1087.76,562465.19
2021-03-01,2021-03-01,Safety Equipment expense,REF54488070,61.92,0.0,562403.27
2021-03-03,2021-03-03,Fuel purchase,REF56255888,245.42,0.0,562157.85
2021-03-04,2021-03-04,Safety Equipment expense,REF42802067,119.98,0.0,562037.87
2021-03-08,2021-03-08,Business materials,REF67590196,540.19,0.0,561497.68
2021-03-12,2021-03-12,Business materials,REF56114963,1089.61,0.0,560408.07
2021-03-15,2021-03-15,Service payment - Reynolds-Mckinney,REF25248848,0.0,1553.47,561961.54
2021-03-15,2021-03-15,"Service payment - Martinez, Rose and Carter",REF98572490,0.0,1411.81,563373.35
2021-03-15,2021-03-15,Invoice payment - Horn and Sons,REF87613674,0.0,1396.37,564769.72
2021-03-15,2021-03-15,Subcontractors expense,REF38486545,1187.04,0.0,563582.68
2021-03-15,2021-03-15,Project payment - Rogers Group,REF18733562,0.0,1112.44,564695.12
2021-03-15,2021-03-15,"Payment from Martin, Atkins and Khan",REF10844230,0.0,917.24,565612.36
2021-03-15,2021-03-15,Business insurance premium,REF54860915,199.31,0.0,565413.05
2021-03-17,2021-03-17,Fuel purchase,REF68414126,450.03,0.0,564963.02
2021-03-18,2021-03-18,Permits Licenses expense,REF77629545,67.42,0.0,564895.6
2021-03-21,2021-03-21,Vehicle Maintenance expense,REF68294453,197.92,0.0,564697.68
2021-03-22,2021-03-22,Fuel purchase,REF35014831,197.73,0.0,564499.95
2021-03-27,2021-03-27,Business materials,REF62407698,1375.6,0.0,563124.35
2021-03-29,2021-03-29,Business materials,REF57056257,846.12,0.0,562278.23
2021-03-30,2021-03-30,Permits Licenses expense,REF42603488,69.91,0.0,562208.32
2021-03-30,2021-03-30,Payment from Reynolds-Mckinney,REF62889874,0.0,1981.52,564189.84
2021-03-30,2021-03-30,"Project payment - Martin, Atkins and Khan",REF42296715,0.0,1082.07,565271.91
2021-03-30,2021-03-30,"Payment from Martinez, Rose and Carter",REF78266963,0.0,1907.87,567179.78
2021-03-30,2021-03-30,Project payment - Rogers Group,REF83872113,0.0,984.77,568164.55
2021-03-30,2021-03-30,Service payment - Horn and Sons,REF94513855,0.0,1544.43,569708.98
2021-03-31,2021-03-31,Tools expense,REF97373859,89.25,0.0,569619.73
2021-04-05,2021-04-05,Business materials,REF22712810,884.45,0.0,568735.28
2021-04-07,2021-04-07,Fuel purchase,REF72993970,259.25,0.0,568476.03
2021-04-08,2021-04-08,Subcontractors expense,REF74322080,1341.85,0.0,567134.18
2021-04-10,2021-04-10,Tools expense,REF32705005,125.88,0.0,567008.3
2021-04-13,2021-04-13,Permits Licenses expense,REF12813568,141.34,0.0,566866.96
2021-04-15,2021-04-15,"Payment from Martin, Atkins and Khan",REF10568532,0.0,1060.35,567927.31
2021-04-15,2021-04-15,"Project payment - Martinez, Rose and Carter",REF10173950,0.0,1669.59,569596.9
2021-04-15,2021-04-15,Business insurance premium,REF99723275,237.95,0.0,569358.95
2021-04-15,2021-04-15,Payment from Reynolds-Mckinney,REF50308014,0.0,2655.57,572014.52
2021-04-15,2021-04-15,Service payment - Horn and Sons,REF37477950,0.0,1860.74,573875.26
2021-04-18,2021-04-18,Fuel purchase,REF90262965,394.49,0.0,573480.77
2021-04-18,2021-04-18,Tools expense,REF53861259,151.26,0.0,573329.51
2021-04-22,2021-04-22,Equipment Rental expense,REF23139314,302.63,0.0,573026.88
2021-04-29,2021-04-29,Subcontractors expense,REF46465955,1016.09,0.0,572010.79
2021-04-30,2021-04-30,Payment from Rogers Group,REF17767298,0.0,1385.15,573395.94
2021-04-30,2021-04-30,"Service payment - Martin, Atkins and Khan",REF69434611,0.0,976.32,574372.26
2021-04-30,2021-04-30,"Project payment - Martinez, Rose and Carter",REF28356876,0.0,2320.0,576692.26
2021-04-30,2021-04-30,Service payment - Horn and Sons,REF25016804,0.0,2186.28,578878.54
2021-04-30,2021-04-30,Service payment - Reynolds-Mckinney,REF81818114,0.0,1961.5,580840.04
2021-05-07,2021-05-07,Fuel purchase,REF26235060,444.33,0.0,580395.71
2021-05-09,2021-05-09,Subcontractors expense,REF75858581,1580.62,0.0,578815.09
2021-05-10,2021-05-10,Fuel purchase,REF73752404,473.84,0.0,578341.25
2021-05-13,2021-05-13,Subcontractors expense,REF10227521,1353.87,0.0,576987.38
2021-05-15,2021-05-15,Service payment - Horn and Sons,REF96893137,0.0,1819.63,578807.01
2021-05-15,2021-05-15,"Service payment - Martin, Atkins and Khan",REF85983063,0.0,1048.7,579855.71
2021-05-15,2021-05-15,Payment from Rogers Group,REF18685525,0.0,1095.72,580951.43
2021-05-15,2021-05-15,Service payment - Reynolds-Mckinney,REF33501030,0.0,2466.18,583417.61
2021-05-15,2021-05-15,Business insurance premium,REF14451461,233.53,0.0,583184.08
2021-05-16,2021-05-16,Safety Equipment expense,REF90796597,114.44,0.0,583069.64
2021-05-22,2021-05-22,Safety Equipment expense,REF51137905,79.98,0.0,582989.66
2021-05-27,2021-05-27,Permits Licenses expense,REF79468698,111.17,0.0,582878.49
2021-05-27,2021-05-27,Safety Equipment expense,REF75427640,74.46,0.0,582804.03
2021-05-27,2021-05-27,Equipment Rental expense,REF26632027,245.39,0.0,582558.64
2021-05-30,2021-05-30,Vehicle Maintenance expense,REF95565889,114.27,0.0,582444.37
2021-05-30,2021-05-30,"Invoice payment - Martinez, Rose and Carter",REF34685078,0.0,2725.61,585169.98
2021-05-30,2021-05-30,Payment from Rogers Group,REF14203538,0.0,1616.42,586786.4
2021-05-30,2021-05-30,"Invoice payment - Martin, Atkins and Khan",REF19764637,0.0,1071.03,587857.43
2021-05-30,2021-05-30,Service payment - Horn and Sons,REF30731155,0.0,1668.02,589525.45
2021-05-30,2021-05-30,Service payment - Reynolds-Mckinney,REF11045106,0.0,2475.38,592000.83
2021-06-02,2021-06-02,Vehicle Maintenance expense,REF16694026,264.16,0.0,591736.67
2021-06-04,2021-06-04,Safety Equipment expense,REF43449619,88.39,0.0,591648.28
2021-06-11,2021-06-11,Business materials,REF84472007,1190.13,0.0,590458.15
2021-06-13,2021-06-13,Vehicle Maintenance expense,REF57975683,254.76,0.0,590203.39
2021-06-15,2021-06-15,"Payment from Martin, Atkins and Khan",REF20769463,0.0,1165.21,591368.6
2021-06-15,2021-06-15,Service payment - Horn and Sons,REF70969683,0.0,2267.68,593636.28
2021-06-15,2021-06-15,Payment from Rogers Group,REF88253427,0.0,1576.66,595212.94
2021-06-15,2021-06-15,Invoice payment - Reynolds-Mckinney,REF70128628,0.0,2467.55,597680.49
2021-06-15,2021-06-15,Business insurance premium,REF76877400,267.35,0.0,597413.14
2021-06-19,2021-06-19,Fuel purchase,REF36534451,307.59,0.0,597105.55
2021-06-23,2021-06-23,Tools expense,REF82262373,109.05,0.0,596996.5
2021-06-27,2021-06-27,Business materials,REF81780754,1284.68,0.0,595711.82
2021-06-30,2021-06-30,Service payment - Horn and Sons,REF21614974,0.0,1209.93,596921.75
2021-06-30,2021-06-30,Payment from Rogers Group,REF32250037,0.0,1420.84,598342.59
2021-06-30,2021-06-30,"Payment from Martin, Atkins and Khan",REF62546622,0.0,1095.68,599438.27
2021-07-04,2021-07-04,Permits Licenses expense,REF81716249,92.78,0.0,599345.49
2021-07-06,2021-07-06,Business materials,REF22969721,1177.19,0.0,598168.3
2021-07-06,2021-07-06,Fuel purchase,REF76629310,505.09,0.0,597663.21
2021-07-06,2021-07-06,Subcontractors expense,REF27594144,676.53,0.0,596986.68
2021-07-10,2021-07-10,Business materials,REF22413148,870.74,0.0,596115.94
2021-07-15,2021-07-15,Business insurance premium,REF23434098,209.13,0.0,595906.81
2021-07-15,2021-07-15,"Invoice payment - Martinez, Rose and Carter",REF93578619,0.0,1985.59,597892.4
2021-07-15,2021-07-15,Equipment Rental expense,REF81594638,295.05,0.0,597597.35
2021-07-15,2021-07-15,Payment from Horn and Sons,REF75444799,0.0,1623.27,599220.62
2021-07-15,2021-07-15,Invoice payment - Reynolds-Mckinney,REF38156751,0.0,1735.14,600955.76
2021-07-15,2021-07-15,Payment from Rogers Group,REF96630326,0.0,1073.38,602029.14
2021-07-15,2021-07-15,"Project payment - Martin, Atkins and Khan",REF56509255,0.0,871.1,602900.24
2021-07-20,2021-07-20,Business materials,REF60693696,296.36,0.0,602603.88
2021-07-23,2021-07-23,Subcontractors expense,REF52471877,644.22,0.0,601959.66
2021-07-24,2021-07-24,Fuel purchase,REF61546783,369.98,0.0,601589.68
2021-07-26,2021-07-26,Equipment Rental expense,REF55586039,393.89,0.0,601195.79
2021-07-28,2021-07-28,Fuel purchase,REF24012530,475.43,0.0,600720.36
2021-07-29,2021-07-29,Safety Equipment expense,REF80914627,71.04,0.0,600649.32
2021-07-30,2021-07-30,"Project payment - Martin, Atkins and Khan",REF55215456,0.0,1270.78,601920.1
2021-07-30,2021-07-30,Payment from Rogers Group,REF84010042,0.0,987.32,602907.42
2021-07-30,2021-07-30,Project payment - Horn and Sons,REF99720859,0.0,2059.46,604966.88
2021-07-30,2021-07-30,"Payment from Martinez, Rose and Carter",REF32406635,0.0,1862.46,606829.34
2021-07-30,2021-07-30,Service payment - Reynolds-Mckinney,REF71738304,0.0,2081.03,608910.37
2021-08-01,2021-08-01,Business materials,REF45577586,1566.78,0.0,607343.59
2021-08-01,2021-08-01,Permits Licenses expense,REF22959951,146.15,0.0,607197.44
2021-08-02,2021-08-02,Business materials,REF86438622,434.37,0.0,606763.07
2021-08-05,2021-08-05,Vehicle Maintenance expense,REF88404413,152.0,0.0,606611.07
2021-08-06,2021-08-06,Business materials,REF16708021,972.91,0.0,605638.16
2021-08-09,2021-08-09,Safety Equipment expense,REF30024399,52.11,0.0,605586.05
2021-08-11,2021-08-11,Subcontractors expense,REF18717662,1847.54,0.0,603738.51
2021-08-12,2021-08-12,Fuel purchase,REF65976893,201.53,0.0,603536.98
2021-08-14,2021-08-14,Equipment Rental expense,REF87504391,666.03,0.0,602870.95
2021-08-15,2021-08-15,Business insurance premium,REF34796493,225.38,0.0,602645.57
2021-08-15,2021-08-15,Project payment - Horn and Sons,REF62988828,0.0,2169.4,604814.97
2021-08-15,2021-08-15,Service payment - Reynolds-Mckinney,REF26744593,0.0,2254.26,607069.23
2021-08-15,2021-08-15,"Project payment - Martinez, Rose and Carter",REF70795927,0.0,1547.31,608616.54
2021-08-15,2021-08-15,Payment from Rogers Group,REF88195793,0.0,967.91,609584.45
2021-08-15,2021-08-15,"Project payment - Martin, Atkins and Khan",REF50661265,0.0,1284.4,610868.85
2021-08-16,2021-08-16,Vehicle Maintenance expense,REF33648334,200.45,0.0,610668.4
2021-08-17,2021-08-17,Business materials,REF60566136,770.41,0.0,609897.99
2021-08-19,2021-08-19,Fuel purchase,REF53196118,325.27,0.0,609572.72
2021-08-20,2021-08-20,Equipment Rental expense,REF63002635,350.14,0.0,609222.58
2021-08-22,2021-08-22,Business materials,REF46217916,1219.2,0.0,608003.38
2021-08-26,2021-08-26,Fuel purchase,REF88864669,493.53,0.0,607509.85
2021-08-27,2021-08-27,Business materials,REF11117862,999.06,0.0,606510.79
2021-08-30,2021-08-30,Service payment - Rogers Group,REF35324332,0.0,1307.17,607817.96
2021-08-30,2021-08-30,"Project payment - Martinez, Rose and Carter",REF28604493,0.0,2115.49,609933.45
2021-08-30,2021-08-30,Invoice payment - Horn and Sons,REF29810406,0.0,1683.92,611617.37
2021-08-30,2021-08-30,Fuel purchase,REF10713296,118.39,0.0,611498.98
2021-08-30,2021-08-30,"Project payment - Martin, Atkins and Khan",REF53775969,0.0,788.81,612287.79
2021-08-30,2021-08-30,Payment from Reynolds-Mckinney,REF39559216,0.0,2172.1,614459.89
2021-09-02,2021-09-02,Tools expense,REF99265681,112.86,0.0,614347.03
2021-09-07,2021-09-07,Business materials,REF66233762,742.39,0.0,613604.64
2021-09-12,2021-09-12,Business materials,REF15781081,923.13,0.0,612681.51
2021-09-12,2021-09-12,Fuel purchase,REF39492677,417.07,0.0,612264.44
2021-09-15,2021-09-15,Business insurance premium,REF16798331,223.94,0.0,612040.5
2021-09-15,2021-09-15,Service payment - Rogers Group,REF95256537,0.0,1114.86,613155.36
2021-09-15,2021-09-15,"Invoice payment - Martinez, Rose and Carter",REF75112290,0.0,1870.81,615026.17
2021-09-15,2021-09-15,Invoice payment - Horn and Sons,REF17435413,0.0,1624.42,616650.59
2021-09-15,2021-09-15,"Project payment - Martin, Atkins and Khan",REF32558658,0.0,1132.32,617782.91
2021-09-16,2021-09-16,Subcontractors expense,REF47049023,1570.18,0.0,616212.73
2021-09-16,2021-09-16,Equipment Rental expense,REF48723410,458.86,0.0,615753.87
2021-09-18,2021-09-18,Subcontractors expense,REF12846729,860.17,0.0,614893.7
2021-09-20,2021-09-20,Tools expense,REF90503624,130.79,0.0,614762.91
2021-09-21,2021-09-21,Fuel purchase,REF86034163,296.35,0.0,614466.56
2021-09-26,2021-09-26,Tools expense,REF79958557,103.03,0.0,614363.53
2021-09-28,2021-09-28,Vehicle Maintenance expense,REF45629387,142.52,0.0,614221.01
2021-09-29,2021-09-29,Fuel purchase,REF99140624,306.38,0.0,613914.63
2021-09-29,2021-09-29,Business materials,REF57173777,706.23,0.0,613208.4
2021-09-30,2021-09-30,"Payment from Martinez, Rose and Carter",REF44937758,0.0,2357.45,615565.85
2021-09-30,2021-09-30,Project payment - Reynolds-Mckinney,REF44876295,0.0,1795.42,617361.27
2021-09-30,2021-09-30,"Payment from Martin, Atkins and Khan",REF65252576,0.0,930.26,618291.53
2021-09-30,2021-09-30,Invoice payment - Horn and Sons,REF62408980,0.0,1732.37,620023.9
2021-09-30,2021-09-30,Payment from Rogers Group,REF30839657,0.0,1092.98,621116.88
2021-09-30,2021-09-30,Tools expense,REF31783926,176.42,0.0,620940.46
2021-10-02,2021-10-02,Business materials,REF72061993,1240.77,0.0,619699.69
2021-10-02,2021-10-02,Fuel purchase,REF45934234,287.44,0.0,619412.25
2021-10-04,2021-10-04,Subcontractors expense,REF82985982,1480.64,0.0,617931.61
2021-10-04,2021-10-04,Fuel purchase,REF18589820,347.12,0.0,617584.49
2021-10-06,2021-10-06,Fuel purchase,REF30642534,299.97,0.0,617284.52
2021-10-11,2021-10-11,Fuel purchase,REF44620177,211.56,0.0,617072.96
2021-10-13,2021-10-13,Subcontractors expense,REF76979973,1119.59,0.0,615953.37
2021-10-15,2021-10-15,Business insurance premium,REF33895970,195.96,0.0,615757.41
2021-10-15,2021-10-15,Business materials,REF74194415,884.49,0.0,614872.92
2021-10-15,2021-10-15,"Invoice payment - Martin, Atkins and Khan",REF85324465,0.0,918.74,615791.66
2021-10-15,2021-10-15,Project payment - Horn and Sons,REF93635722,0.0,1746.15,617537.81
2021-10-16,2021-10-16,Business materials,REF90864930,957.02,0.0,616580.79
2021-10-20,2021-10-20,Business materials,REF92987075,1019.91,0.0,615560.88
2021-10-22,2021-10-22,Tools expense,REF30913371,111.17,0.0,615449.71
2021-10-23,2021-10-23,Subcontractors expense,REF42893574,769.71,0.0,614680.0
2021-10-24,2021-10-24,Fuel purchase,REF77800856,244.79,0.0,614435.21
2021-10-30,2021-10-30,"Project payment - Martin, Atkins and Khan",REF10173801,0.0,725.8,615161.01
2021-10-30,2021-10-30,Project payment - Reynolds-Mckinney,REF13198107,0.0,1681.74,616842.75
2021-10-30,2021-10-30,Invoice payment - Horn and Sons,REF31475049,0.0,1109.54,617952.29
2021-10-30,2021-10-30,"Payment from Martinez, Rose and Carter",REF73862586,0.0,2159.8,620112.09
2021-10-30,2021-10-30,Invoice payment - Rogers Group,REF75562343,0.0,1529.97,621642.06
2021-11-03,2021-11-03,Permits Licenses expense,REF16262370,32.92,0.0,621609.14
2021-11-03,2021-11-03,Equipment Rental expense,REF28051010,193.16,0.0,621415.98
2021-11-06,2021-11-06,Permits Licenses expense,REF98053743,74.05,0.0,621341.93
2021-11-07,2021-11-07,Subcontractors expense,REF48594199,776.7,0.0,620565.23
2021-11-08,2021-11-08,Business materials,REF27535604,444.36,0.0,620120.87
2021-11-13,2021-11-13,Permits Licenses expense,REF69159775,59.46,0.0,620061.41
2021-11-15,2021-11-15,Business insurance premium,REF30278874,142.31,0.0,619919.1
2021-11-15,2021-11-15,Project payment - Horn and Sons,REF63045312,0.0,1040.05,620959.15
2021-11-15,2021-11-15,"Project payment - Martin, Atkins and Khan",REF76709845,0.0,780.85,621740.0
2021-11-15,2021-11-15,Invoice payment - Rogers Group,REF97094256,0.0,713.68,622453.68
2021-11-15,2021-11-15,Payment from Reynolds-Mckinney,REF46898469,0.0,1080.58,623534.26
2021-11-17,2021-11-17,Equipment Rental expense,REF58441365,369.22,0.0,623165.04
2021-11-18,2021-11-18,Business materials,REF94658427,859.16,0.0,622305.88
2021-11-27,2021-11-27,Equipment Rental expense,REF66950078,235.18,0.0,622070.7
2021-11-30,2021-11-30,"Service payment - Martin, Atkins and Khan",REF33589980,0.0,556.01,622626.71
2021-11-30,2021-11-30,Service payment - Horn and Sons,REF22597731,0.0,1214.77,623841.48
2021-11-30,2021-11-30,Payment from Reynolds-Mckinney,REF33369884,0.0,1415.89,625257.37
2021-11-30,2021-11-30,Fuel purchase,REF68331863,199.71,0.0,625057.66
2021-11-30,2021-11-30,"Service payment - Martinez, Rose and Carter",REF65369072,0.0,1779.94,626837.6
2021-11-30,2021-11-30,Service payment - Rogers Group,REF16068866,0.0,790.34,627627.94
2021-12-01,2021-12-01,Vehicle Maintenance expense,REF87835151,94.34,0.0,627533.6
2021-12-01,2021-12-01,Permits Licenses expense,REF52734024,60.16,0.0,627473.44
2021-12-05,2021-12-05,Business materials,REF27817774,788.1,0.0,626685.34
2021-12-09,2021-12-09,Business materials,REF81406439,361.3,0.0,626324.04
2021-12-09,2021-12-09,Tools expense,REF40106400,42.97,0.0,626281.07
2021-12-11,2021-12-11,Tools expense,REF58182185,69.49,0.0,626211.58
2021-12-11,2021-12-11,Permits Licenses expense,REF60490809,49.58,0.0,626162.0
2021-12-11,2021-12-11,Fuel purchase,REF28342194,197.4,0.0,625964.6
2021-12-15,2021-12-15,Business insurance premium,REF40579398,113.75,0.0,625850.85
2021-12-15,2021-12-15,"Project payment - Martin, Atkins and Khan",REF36019446,0.0,552.59,626403.44
2021-12-15,2021-12-15,Service payment - Horn and Sons,REF82174613,0.0,878.25,627281.69
2021-12-15,2021-12-15,Business materials,REF55793315,193.67,0.0,627088.02
2021-12-15,2021-12-15,"Service payment - Martinez, Rose and Carter",REF21491944,0.0,1157.19,628245.21
2021-12-15,2021-12-15,Project payment - Reynolds-Mckinney,REF74457578,0.0,909.89,629155.1
2021-12-15,2021-12-15,Project payment - Rogers Group,REF60252478,0.0,610.79,629765.89
2021-12-16,2021-12-16,Business materials,REF12277579,442.39,0.0,629323.5
2021-12-21,2021-12-21,Fuel purchase,REF32133779,215.7,0.0,629107.8
2021-12-22,2021-12-22,Business materials,REF43284345,412.08,0.0,628695.72
2021-12-25,2021-12-25,Equipment Rental expense,REF35016961,286.66,0.0,628409.06
2021-12-28,2021-12-28,Fuel purchase,REF50284613,258.19,0.0,628150.87
2021-12-30,2021-12-30,"Invoice payment - Martinez, Rose and Carter",REF35228963,0.0,1173.18,629324.05
2021-12-30,2021-12-30,Project payment - Rogers Group,REF96316406,0.0,760.88,630084.93
2021-12-30,2021-12-30,Service payment - Horn and Sons,REF40620873,0.0,871.0,630955.93
2021-12-30,2021-12-30,"Payment from Martin, Atkins and Khan",REF41794552,0.0,439.3,631395.23
2021-12-30,2021-12-30,Project payment - Reynolds-Mckinney,REF25633193,0.0,1056.33,632451.56
2022-01-01,2022-01-01,Vehicle Maintenance expense,REF44635280,80.77,0.0,632370.79
2022-01-02,2022-01-02,Permits Licenses expense,REF86724805,39.08,0.0,632331.71
2022-01-03,2022-01-03,Safety Equipment expense,REF83147739,61.38,0.0,632270.33
2022-01-04,2022-01-04,Vehicle Maintenance expense,REF92880780,109.38,0.0,632160.95
2022-01-04,2022-01-04,Fuel purchase,REF49099310,263.3,0.0,631897.65
2022-01-06,2022-01-06,Tools expense,REF22091202,32.91,0.0,631864.74
2022-01-06,2022-01-06,Fuel purchase,REF96140713,243.0,0.0,631621.74
2022-01-12,2022-01-12,Vehicle Maintenance expense,REF79193034,99.88,0.0,631521.86
2022-01-14,2022-01-14,Tools expense,REF15275753,48.62,0.0,631473.24
2022-01-15,2022-01-15,Service payment - Rogers Group,REF41977963,0.0,680.14,632153.38
2022-01-15,2022-01-15,"Payment from Martin, Atkins and Khan",REF59425728,0.0,727.81,632881.19
2022-01-15,2022-01-15,"Service payment - Martinez, Rose and Carter",REF35660918,0.0,1382.69,634263.88
2022-01-15,2022-01-15,Service payment - Reynolds-Mckinney,REF21229161,0.0,1342.31,635606.19
2022-01-15,2022-01-15,Business insurance premium,REF43063294,138.15,0.0,635468.04
2022-01-15,2022-01-15,Vehicle Maintenance expense,REF38448275,94.5,0.0,635373.54
2022-01-20,2022-01-20,Business materials,REF67332479,688.8,0.0,634684.74
2022-01-21,2022-01-21,Safety Equipment expense,REF38321358,84.72,0.0,634600.02
2022-01-23,2022-01-23,Fuel purchase,REF80076461,193.25,0.0,634406.77
2022-01-23,2022-01-23,Tools expense,REF61861850,68.34,0.0,634338.43
2022-01-26,2022-01-26,Fuel purchase,REF58684827,271.7,0.0,634066.73
2022-01-27,2022-01-27,Fuel purchase,REF22673404,177.67,0.0,633889.06
2022-01-29,2022-01-29,Equipment Rental expense,REF39324241,254.77,0.0,633634.29
2022-01-30,2022-01-30,"Invoice payment - Martin, Atkins and Khan",REF25277524,0.0,756.6,634390.89
2022-01-30,2022-01-30,"Invoice payment - Martinez, Rose and Carter",REF20962905,0.0,1143.94,635534.83
2022-01-30,2022-01-30,Invoice payment - Horn and Sons,REF18677566,0.0,866.76,636401.59
2022-01-30,2022-01-30,Project payment - Reynolds-Mckinney,REF81966177,0.0,1321.42,637723.01
2022-02-01,2022-02-01,Fuel purchase,REF68095544,256.88,0.0,637466.13
2022-02-06,2022-02-06,Equipment Rental expense,REF81542924,372.65,0.0,637093.48
2022-02-07,2022-02-07,Business materials,REF13960055,905.21,0.0,636188.27
2022-02-09,2022-02-09,Permits Licenses expense,REF28869890,60.89,0.0,636127.38
2022-02-10,2022-02-10,Business materials,REF17149679,519.21,0.0,635608.17
2022-02-13,2022-02-13,Business materials,REF55822282,847.38,0.0,634760.79
2022-02-15,2022-02-15,Service payment - Horn and Sons,REF59112133,0.0,1275.06,636035.85
2022-02-15,2022-02-15,Project payment - Reynolds-Mckinney,REF92769754,0.0,1100.94,637136.79
2022-02-15,2022-02-15,"Payment from Martin, Atkins and Khan",REF87926331,0.0,929.58,638066.37
2022-02-15,2022-02-15,Business insurance premium,REF55220935,147.67,0.0,637918.7
2022-02-15,2022-02-15,"Payment from Martinez, Rose and Carter",REF75747630,0.0,1414.4,639333.1
2022-02-15,2022-02-15,Service payment - Rogers Group,REF89977046,0.0,900.08,640233.18
2022-02-17,2022-02-17,Tools expense,REF89481337,95.02,0.0,640138.16
2022-02-26,2022-02-26,Vehicle Maintenance expense,REF68653382,210.92,0.0,639927.24
2022-02-28,2022-02-28,Service payment - Rogers Group,REF29510105,0.0,926.39,640853.63
2022-02-28,2022-02-28,"Payment from Martinez, Rose and Carter",REF27460901,0.0,1593.64,642447.27
2022-02-28,2022-02-28,"Project payment - Martin, Atkins and Khan",REF86899299,0.0,750.72,643197.99
2022-02-28,2022-02-28,Project payment - Horn and Sons,REF74906532,0.0,1153.63,644351.62
2022-02-28,2022-02-28,Invoice payment - Reynolds-Mckinney,REF23638414,0.0,1179.3,645530.92
2022-03-03,2022-03-03,Equipment Rental expense,REF70094679,570.08,0.0,644960.84
2022-03-08,2022-03-08,Tools expense,REF37195721,205.83,0.0,644755.01
2022-03-08,2022-03-08,Safety Equipment expense,REF50048033,75.46,0.0,644679.55
2022-03-09,2022-03-09,Subcontractors expense,REF53625511,753.53,0.0,643926.02
2022-03-15,2022-03-15,Service payment - Reynolds-Mckinney,REF63053360,0.0,2147.92,646073.94
2022-03-15,2022-03-15,Project payment - Horn and Sons,REF50432963,0.0,1481.84,647555.78
2022-03-15,2022-03-15,"Payment from Martinez, Rose and Carter",REF76521648,0.0,1557.03,649112.81
2022-03-15,2022-03-15,"Payment from Martin, Atkins and Khan",REF87963822,0.0,931.44,650044.25
2022-03-15,2022-03-15,Invoice payment - Rogers Group,REF28206230,0.0,1093.21,651137.46
2022-03-15,2022-03-15,Business insurance premium,REF50761341,203.9,0.0,650933.56
2022-03-25,2022-03-25,Business materials,REF17546249,1315.89,0.0,649617.67
2022-03-26,2022-03-26,Subcontractors expense,REF58810765,1106.06,0.0,648511.61
2022-03-30,2022-03-30,Permits Licenses expense,REF18289897,82.14,0.0,648429.47
2022-03-30,2022-03-30,Project payment - Reynolds-Mckinney,REF19915438,0.0,1932.92,650362.39
2022-03-30,2022-03-30,"Invoice payment - Martin, Atkins and Khan",REF21147781,0.0,790.45,651152.84
2022-03-30,2022-03-30,Invoice payment - Rogers Group,REF62750791,0.0,994.49,652147.33
2022-03-30,2022-03-30,"Project payment - Martinez, Rose and Carter",REF81999638,0.0,1885.14,654032.47
2022-04-02,2022-04-02,Tools expense,REF43777220,160.1,0.0,653872.37
2022-04-03,2022-04-03,Safety Equipment expense,REF43090529,163.98,0.0,653708.39
2022-04-05,2022-04-05,Subcontractors expense,REF71613728,901.11,0.0,652807.28
2022-04-08,2022-04-08,Tools expense,REF10829524,106.29,0.0,652700.99
2022-04-10,2022-04-10,Vehicle Maintenance expense,REF73065087,166.81,0.0,652534.18
2022-04-15,2022-04-15,Project payment - Horn and Sons,REF69941655,0.0,1781.54,654315.72
2022-04-15,2022-04-15,Service payment - Reynolds-Mckinney,REF57633067,0.0,1653.93,655969.65
2022-04-15,2022-04-15,"Service payment - Martin, Atkins and Khan",REF86587833,0.0,961.32,656930.97
2022-04-15,2022-04-15,Business insurance premium,REF67947578,228.7,0.0,656702.27
2022-04-21,2022-04-21,Fuel purchase,REF20037841,453.7,0.0,656248.57
2022-04-22,2022-04-22,Business materials,REF72045883,1149.23,0.0,655099.34
2022-04-24,2022-04-24,Business materials,REF58022513,564.34,0.0,654535.0
2022-04-25,2022-04-25,Vehicle Maintenance expense,REF18323994,237.89,0.0,654297.11
2022-04-26,2022-04-26,Business materials,REF71941514,557.87,0.0,653739.24
2022-04-30,2022-04-30,Project payment - Horn and Sons,REF69726897,0.0,1611.78,655351.02
2022-04-30,2022-04-30,Invoice payment - Rogers Group,REF85014906,0.0,1651.53,657002.55
2022-04-30,2022-04-30,Invoice payment - Reynolds-Mckinney,REF95499662,0.0,2140.11,659142.66
2022-04-30,2022-04-30,"Invoice payment - Martinez, Rose and Carter",REF95599989,0.0,2108.73,661251.39
2022-04-30,2022-04-30,Safety Equipment expense,REF56449217,86.55,0.0,661164.84
2022-05-06,2022-05-06,Business materials,REF53142279,1244.67,0.0,659920.17
2022-05-07,2022-05-07,Permits Licenses expense,REF63556572,113.25,0.0,659806.92
2022-05-08,2022-05-08,Subcontractors expense,REF88458672,667.83,0.0,659139.09
2022-05-08,2022-05-08,Permits Licenses expense,REF71105553,99.68,0.0,659039.41
2022-05-12,2022-05-12,Fuel purchase,REF97642283,179.34,0.0,658860.07
2022-05-15,2022-05-15,Business insurance premium,REF44384906,263.94,0.0,658596.13
2022-05-15,2022-05-15,"Service payment - Martinez, Rose and Carter",REF26679422,0.0,2533.39,661129.52
2022-05-15,2022-05-15,Invoice payment - Reynolds-Mckinney,REF51237291,0.0,2505.23,663634.75
2022-05-15,2022-05-15,Project payment - Horn and Sons,REF36663823,0.0,1800.36,665435.11
2022-05-15,2022-05-15,"Invoice payment - Martin, Atkins and Khan",REF84777986,0.0,1303.58,666738.69
2022-05-17,2022-05-17,Business materials,REF34567918,1326.67,0.0,665412.02
2022-05-19,2022-05-19,Business materials,REF62064480,769.98,0.0,664642.04
2022-05-20,2022-05-20,Subcontractors expense,REF62230673,1369.09,0.0,663272.95
2022-05-22,2022-05-22,Subcontractors expense,REF20122909,1055.06,0.0,662217.89
2022-05-25,2022-05-25,Equipment Rental expense,REF80363053,249.41,0.0,661968.48
2022-05-25,2022-05-25,Business materials,REF27517743,1334.79,0.0,660633.69
2022-05-26,2022-05-26,Permits Licenses expense,REF73887982,112.68,0.0,660521.01
2022-05-27,2022-05-27,Equipment Rental expense,REF18501883,417.88,0.0,660103.13
2022-05-29,2022-05-29,Permits Licenses expense,REF99652063,56.41,0.0,660046.72
2022-05-30,2022-05-30,"Service payment - Martinez, Rose and Carter",REF49979288,0.0,3127.58,663174.3
2022-05-30,2022-05-30,Project payment - Reynolds-Mckinney,REF57967233,0.0,2576.14,665750.44
2022-05-30,2022-05-30,Service payment - Horn and Sons,REF91193512,0.0,1187.39,666937.83
2022-05-30,2022-05-30,Fuel purchase,REF53829478,318.64,0.0,666619.19
2022-05-30,2022-05-30,"Payment from Martin, Atkins and Khan",REF41219733,0.0,1247.85,667867.04
2022-06-01,2022-06-01,Business materials,REF46417578,1188.51,0.0,666678.53
2022-06-03,2022-06-03,Business materials,REF74328053,939.52,0.0,665739.01
2022-06-03,2022-06-03,Safety Equipment expense,REF91454913,90.44,0.0,665648.57
2022-06-07,2022-06-07,Business materials,REF47855368,1257.21,0.0,664391.36
2022-06-08,2022-06-08,Equipment Rental expense,REF81881841,340.05,0.0,664051.31
2022-06-10,2022-06-10,Business materials,REF60816156,1163.42,0.0,662887.89
2022-06-11,2022-06-11,Vehicle Maintenance expense,REF28510682,224.06,0.0,662663.83
2022-06-12,2022-06-12,Business materials,REF87323983,1442.3,0.0,661221.53
2022-06-14,2022-06-14,Equipment Rental expense,REF75475411,371.68,0.0,660849.85
2022-06-15,2022-06-15,Service payment - Reynolds-Mckinney,REF19688784,0.0,2721.59,663571.44
2022-06-15,2022-06-15,"Project payment - Martinez, Rose and Carter",REF16953543,0.0,2612.99,666184.43
2022-06-15,2022-06-15,Service payment - Rogers Group,REF89853428,0.0,1232.24,667416.67
2022-06-15,2022-06-15,Project payment - Horn and Sons,REF99426202,0.0,2283.69,669700.36
2022-06-15,2022-06-15,"Payment from Martin, Atkins and Khan",REF83565878,0.0,1341.02,671041.38
2022-06-15,2022-06-15,Business insurance premium,REF74263535,244.71,0.0,670796.67
2022-06-16,2022-06-16,Equipment Rental expense,REF10565018,488.3,0.0,670308.37
2022-06-26,2022-06-26,Business materials,REF51573040,1284.28,0.0,669024.09
2022-06-29,2022-06-29,Subcontractors expense,REF72855488,978.24,0.0,668045.85
2022-06-30,2022-06-30,"Service payment - Martin, Atkins and Khan",REF25620399,0.0,1280.48,669326.33
2022-06-30,2022-06-30,Project payment - Reynolds-Mckinney,REF54136266,0.0,2341.31,671667.64
2022-06-30,2022-06-30,"Project payment - Martinez, Rose and Carter",REF54942922,0.0,2576.27,674243.91
2022-06-30,2022-06-30,Payment from Horn and Sons,REF90429546,0.0,1974.92,676218.83
2022-07-09,2022-07-09,Business materials,REF76983968,946.93,0.0,675271.9
2022-07-11,2022-07-11,Business materials,REF72698264,1264.26,0.0,674007.64
2022-07-12,2022-07-12,Business materials,REF25970307,1351.16,0.0,672656.48
2022-07-13,2022-07-13,Business materials,REF43792918,1062.13,0.0,671594.35
2022-07-13,2022-07-13,Subcontractors expense,REF53273661,997.69,0.0,670596.66
2022-07-15,2022-07-15,Business insurance premium,REF19324480,225.83,0.0,670370.83
2022-07-15,2022-07-15,Project payment - Horn and Sons,REF83657755,0.0,1778.1,672148.93
2022-07-15,2022-07-15,Invoice payment - Reynolds-Mckinney,REF41575565,0.0,2083.94,674232.87
2022-07-15,2022-07-15,"Service payment - Martin, Atkins and Khan",REF80754066,0.0,984.54,675217.41
2022-07-15,2022-07-15,Fuel purchase,REF49221604,418.22,0.0,674799.19
2022-07-18,2022-07-18,Fuel purchase,REF60098118,394.83,0.0,674404.36
2022-07-19,2022-07-19,Safety Equipment expense,REF56670037,124.55,0.0,674279.81
2022-07-24,2022-07-24,Fuel purchase,REF97543244,351.06,0.0,673928.75
2022-07-29,2022-07-29,Fuel purchase,REF54498885,494.82,0.0,673433.93
2022-07-30,2022-07-30,Service payment - Horn and Sons,REF96344697,0.0,1782.93,675216.86
2022-07-30,2022-07-30,Invoice payment - Rogers Group,REF39996985,0.0,1404.96,676621.82
2022-07-30,2022-07-30,"Project payment - Martin, Atkins and Khan",REF11765248,0.0,968.35,677590.17
2022-07-30,2022-07-30,"Service payment - Martinez, Rose and Carter",REF39694840,0.0,2236.14,679826.31
2022-07-30,2022-07-30,Service payment - Reynolds-Mckinney,REF39225193,0.0,1456.14,681282.45
2022-08-02,2022-08-02,Tools expense,REF29142251,103.63,0.0,681178.82
2022-08-07,2022-08-07,Subcontractors expense,REF75704060,1776.35,0.0,679402.47
2022-08-08,2022-08-08,Permits Licenses expense,REF23535116,145.45,0.0,679257.02
2022-08-11,2022-08-11,Fuel purchase,REF55825820,424.92,0.0,678832.1
2022-08-15,2022-08-15,Business insurance premium,REF60502271,247.18,0.0,678584.92
2022-08-15,2022-08-15,Service payment - Reynolds-Mckinney,REF82743747,0.0,1908.67,680493.59
2022-08-15,2022-08-15,"Service payment - Martin, Atkins and Khan",REF33007285,0.0,1180.74,681674.33
2022-08-15,2022-08-15,Service payment - Horn and Sons,REF98221217,0.0,1612.05,683286.38
2022-08-15,2022-08-15,"Payment from Martinez, Rose and Carter",REF22128326,0.0,2338.99,685625.37
2022-08-17,2022-08-17,Fuel purchase,REF97996481,326.09,0.0,685299.28
2022-08-18,2022-08-18,Business materials,REF23302262,893.92,0.0,684405.36
2022-08-18,2022-08-18,Fuel purchase,REF88436090,434.63,0.0,683970.73
2022-08-29,2022-08-29,Fuel purchase,REF68656628,445.86,0.0,683524.87
2022-08-30,2022-08-30,"Service payment - Martin, Atkins and Khan",REF76520990,0.0,1176.33,684701.2
2022-08-30,2022-08-30,Payment from Reynolds-Mckinney,REF64381141,0.0,2170.16,686871.36
2022-08-30,2022-08-30,Service payment - Horn and Sons,REF90043139,0.0,1738.14,688609.5
2022-08-30,2022-08-30,Project payment - Rogers Group,REF48607325,0.0,1216.16,689825.66
2022-08-30,2022-08-30,Permits Licenses expense,REF71549342,124.18,0.0,689701.48
2022-08-31,2022-08-31,Permits Licenses expense,REF78778917,146.1,0.0,689555.38
2022-08-31,2022-08-31,Business materials,REF87304554,904.59,0.0,688650.79
2022-09-02,2022-09-02,Fuel purchase,REF75934855,310.32,0.0,688340.47
2022-09-02,2022-09-02,Business materials,REF13601080,929.09,0.0,687411.38
2022-09-05,2022-09-05,Business materials,REF61356857,1157.75,0.0,686253.63
2022-09-13,2022-09-13,Business materials,REF32354086,606.32,0.0,685647.31
2022-09-15,2022-09-15,Fuel purchase,REF44499402,246.91,0.0,685400.4
2022-09-15,2022-09-15,Project payment - Horn and Sons,REF39725016,0.0,1395.39,686795.79
2022-09-15,2022-09-15,"Payment from Martinez, Rose and Carter",REF37110442,0.0,1742.85,688538.64
2022-09-15,2022-09-15,Business insurance premium,REF13357170,214.25,0.0,688324.39
2022-09-15,2022-09-15,Service payment - Reynolds-Mckinney,REF30452450,0.0,1808.1,690132.49
2022-09-15,2022-09-15,Service payment - Rogers Group,REF65189318,0.0,1363.24,691495.73
2022-09-15,2022-09-15,Subcontractors expense,REF15846434,1391.27,0.0,690104.46
2022-09-16,2022-09-16,Business materials,REF94433662,335.35,0.0,689769.11
2022-09-19,2022-09-19,Fuel purchase,REF41344906,337.23,0.0,689431.88
2022-09-20,2022-09-20,Tools expense,REF53130750,164.45,0.0,689267.43
2022-09-21,2022-09-21,Business materials,REF26368848,937.58,0.0,688329.85
2022-09-24,2022-09-24,Fuel purchase,REF18627810,312.44,0.0,688017.41
2022-09-30,2022-09-30,Invoice payment - Horn and Sons,REF23742991,0.0,1444.52,689461.93
2022-09-30,2022-09-30,"Project payment - Martin, Atkins and Khan",REF32033719,0.0,843.72,690305.65
2022-09-30,2022-09-30,"Project payment - Martinez, Rose and Carter",REF38909045,0.0,1682.38,691988.03
2022-09-30,2022-09-30,Service payment - Rogers Group,REF84003860,0.0,1043.32,693031.35
2022-10-02,2022-10-02,Permits Licenses expense,REF89706233,46.19,0.0,692985.16
2022-10-04,2022-10-04,Business materials,REF80555565,570.71,0.0,692414.45
2022-10-06,2022-10-06,Vehicle Maintenance expense,REF50993727,100.1,0.0,692314.35
2022-10-06,2022-10-06,Business materials,REF13502270,350.73,0.0,691963.62
2022-10-07,2022-10-07,Subcontractors expense,REF15680048,713.13,0.0,691250.49
2022-10-09,2022-10-09,Safety Equipment expense,REF41878381,42.95,0.0,691207.54
2022-10-09,2022-10-09,Equipment Rental expense,REF90325715,457.68,0.0,690749.86
2022-10-14,2022-10-14,Permits Licenses expense,REF21582031,103.54,0.0,690646.32
2022-10-15,2022-10-15,Business insurance premium,REF16136913,212.56,0.0,690433.76
2022-10-15,2022-10-15,"Project payment - Martinez, Rose and Carter",REF83296115,0.0,1599.34,692033.1
2022-10-15,2022-10-15,Invoice payment - Horn and Sons,REF49483446,0.0,1616.18,693649.28
2022-10-15,2022-10-15,Invoice payment - Rogers Group,REF25775605,0.0,1280.84,694930.12
2022-10-15,2022-10-15,"Project payment - Martin, Atkins and Khan",REF17040547,0.0,972.16,695902.28
2022-10-15,2022-10-15,Payment from Reynolds-Mckinney,REF28683783,0.0,1742.73,697645.01
2022-10-17,2022-10-17,Permits Licenses expense,REF97037763,83.88,0.0,697561.13
2022-10-19,2022-10-19,Safety Equipment expense,REF56268447,91.4,0.0,697469.73
2022-10-20,2022-10-20,Business materials,REF12872920,921.77,0.0,696547.96
2022-10-27,2022-10-27,Tools expense,REF47843689,118.73,0.0,696429.23
2022-10-29,2022-10-29,Fuel purchase,REF33757399,245.93,0.0,696183.3
2022-10-30,2022-10-30,Service payment - Reynolds-Mckinney,REF10277402,0.0,1868.35,698051.65
2022-10-30,2022-10-30,"Service payment - Martin, Atkins and Khan",REF29723128,0.0,919.55,698971.2
2022-10-30,2022-10-30,Service payment - Horn and Sons,REF56401902,0.0,1804.29,700775.49
2022-10-30,2022-10-30,Tools expense,REF52268974,146.11,0.0,700629.38
2022-10-30,2022-10-30,"Payment from Martinez, Rose and Carter",REF89128709,0.0,1769.01,702398.39
2022-11-13,2022-11-13,Fuel purchase,REF63992557,225.81,0.0,702172.58
2022-11-15,2022-11-15,Business insurance premium,REF91338381,159.31,0.0,702013.27
2022-11-15,2022-11-15,Service payment - Rogers Group,REF85279108,0.0,703.14,702716.41
2022-11-15,2022-11-15,"Service payment - Martin, Atkins and Khan",REF15336559,0.0,582.7,703299.11
2022-11-15,2022-11-15,"Project payment - Martinez, Rose and Carter",REF45526326,0.0,1529.83,704828.94
2022-11-16,2022-11-16,Safety Equipment expense,REF88856622,79.46,0.0,704749.48
2022-11-17,2022-11-17,Business materials,REF82877951,443.59,0.0,704305.89
2022-11-19,2022-11-19,Subcontractors expense,REF90803100,702.67,0.0,703603.22
2022-11-21,2022-11-21,Permits Licenses expense,REF71336580,96.69,0.0,703506.53
2022-11-22,2022-11-22,Fuel purchase,REF85621589,290.33,0.0,703216.2
2022-11-24,2022-11-24,Business materials,REF18890911,531.7,0.0,702684.5
2022-11-27,2022-11-27,Subcontractors expense,REF23920211,879.25,0.0,701805.25
2022-11-28,2022-11-28,Business materials,REF94334227,657.43,0.0,701147.82
2022-11-30,2022-11-30,"Payment from Martin, Atkins and Khan",REF71348487,0.0,686.03,701833.85
2022-11-30,2022-11-30,Service payment - Rogers Group,REF80698466,0.0,1004.45,702838.3
2022-11-30,2022-11-30,"Payment from Martinez, Rose and Carter",REF50761423,0.0,1433.29,704271.59
2022-11-30,2022-11-30,Invoice payment - Reynolds-Mckinney,REF49386534,0.0,1746.25,706017.84
2022-11-30,2022-11-30,Business materials,REF70584554,716.31,0.0,705301.53
2022-11-30,2022-11-30,Payment from Horn and Sons,REF52002687,0.0,1403.2,706704.73
2022-12-04,2022-12-04,Business materials,REF64466701,243.52,0.0,706461.21
2022-12-05,2022-12-05,Tools expense,REF12457208,75.8,0.0,706385.41
2022-12-09,2022-12-09,Business materials,REF47514201,458.81,0.0,705926.6
2022-12-12,2022-12-12,Business materials,REF87717235,389.16,0.0,705537.44
2022-12-13,2022-12-13,Subcontractors expense,REF90231522,753.64,0.0,704783.8
2022-12-14,2022-12-14,Fuel purchase,REF94828088,73.23,0.0,704710.57
2022-12-15,2022-12-15,"Project payment - Martin, Atkins and Khan",REF75148964,0.0,607.35,705317.92
2022-12-15,2022-12-15,Payment from Rogers Group,REF73566435,0.0,685.4,706003.32
2022-12-15,2022-12-15,Payment from Horn and Sons,REF64943021,0.0,933.43,706936.75
2022-12-15,2022-12-15,Payment from Reynolds-Mckinney,REF19502037,0.0,1045.86,707982.61
2022-12-15,2022-12-15,Business insurance premium,REF17305005,123.6,0.0,707859.01
2022-12-16,2022-12-16,Subcontractors expense,REF36544429,934.34,0.0,706924.67
2022-12-18,2022-12-18,Fuel purchase,REF80154760,228.21,0.0,706696.46
2022-12-21,2022-12-21,Business materials,REF70865735,322.14,0.0,706374.32
2022-12-22,2022-12-22,Fuel purchase,REF33570342,210.09,0.0,706164.23
2022-12-24,2022-12-24,Fuel purchase,REF75500966,201.75,0.0,705962.48
2022-12-25,2022-12-25,Fuel purchase,REF46111124,277.25,0.0,705685.23
2022-12-25,2022-12-25,Vehicle Maintenance expense,REF50479440,104.87,0.0,705580.36
2022-12-25,2022-12-25,Permits Licenses expense,REF65598500,54.53,0.0,705525.83
2022-12-27,2022-12-27,Business materials,REF48732592,522.96,0.0,705002.87
2022-12-27,2022-12-27,Fuel purchase,REF58268400,195.89,0.0,704806.98
2022-12-27,2022-12-27,Equipment Rental expense,REF12808087,136.39,0.0,704670.59
2022-12-30,2022-12-30,"Invoice payment - Martinez, Rose and Carter",REF85596163,0.0,1243.99,705914.58
2022-12-30,2022-12-30,"Payment from Martin, Atkins and Khan",REF38564134,0.0,687.16,706601.74
2022-12-30,2022-12-30,Invoice payment - Horn and Sons,REF25951838,0.0,738.95,707340.69
2023-01-01,2023-01-01,Permits Licenses expense,REF53072973,70.82,0.0,707269.87
2023-01-04,2023-01-04,Safety Equipment expense,REF26311666,46.1,0.0,707223.77
2023-01-05,2023-01-05,Fuel purchase,REF69088134,162.94,0.0,707060.83
2023-01-06,2023-01-06,Business materials,REF44019192,455.09,0.0,706605.74
2023-01-15,2023-01-15,Service payment - Reynolds-Mckinney,REF27582906,0.0,1181.18,707786.92
2023-01-15,2023-01-15,"Payment from Martin, Atkins and Khan",REF64589123,0.0,719.88,708506.8
2023-01-15,2023-01-15,Project payment - Horn and Sons,REF37332788,0.0,1055.08,709561.88
2023-01-15,2023-01-15,Business insurance premium,REF61388074,133.16,0.0,709428.72
2023-01-15,2023-01-15,"Invoice payment - Martinez, Rose and Carter",REF43752125,0.0,1383.84,710812.56
2023-01-18,2023-01-18,Vehicle Maintenance expense,REF17764027,104.93,0.0,710707.63
2023-01-21,2023-01-21,Vehicle Maintenance expense,REF57223808,77.54,0.0,710630.09
2023-01-21,2023-01-21,Safety Equipment expense,REF80231601,30.48,0.0,710599.61
2023-01-23,2023-01-23,Business materials,REF68870056,424.82,0.0,710174.79
2023-01-29,2023-01-29,Tools expense,REF83522933,62.93,0.0,710111.86
2023-01-30,2023-01-30,Safety Equipment expense,REF77254152,36.92,0.0,710074.94
2023-01-30,2023-01-30,"Project payment - Martinez, Rose and Carter",REF95225661,0.0,1292.88,711367.82
2023-01-30,2023-01-30,Invoice payment - Rogers Group,REF13402577,0.0,935.64,712303.46
2023-01-30,2023-01-30,"Project payment - Martin, Atkins and Khan",REF13930378,0.0,494.29,712797.75
2023-01-30,2023-01-30,Service payment - Horn and Sons,REF61558016,0.0,1088.5,713886.25
2023-01-30,2023-01-30,Service payment - Reynolds-Mckinney,REF24565295,0.0,1226.7,715112.95
2023-02-03,2023-02-03,Permits Licenses expense,REF49247692,50.98,0.0,715061.97
2023-02-11,2023-02-11,Business materials,REF54198031,705.27,0.0,714356.7
2023-02-12,2023-02-12,Fuel purchase,REF29406510,163.25,0.0,714193.45
2023-02-15,2023-02-15,Business insurance premium,REF41037426,158.14,0.0,714035.31
2023-02-15,2023-02-15,Permits Licenses expense,REF73708252,90.45,0.0,713944.86
2023-02-15,2023-02-15,Project payment - Horn and Sons,REF85899011,0.0,853.44,714798.3
2023-02-15,2023-02-15,Service payment - Reynolds-Mckinney,REF59391132,0.0,1247.39,716045.69
2023-02-15,2023-02-15,"Service payment - Martinez, Rose and Carter",REF19924639,0.0,1115.19,717160.88
2023-02-15,2023-02-15,"Payment from Martin, Atkins and Khan",REF72925980,0.0,670.29,717831.17
2023-02-19,2023-02-19,Subcontractors expense,REF78599526,927.71,0.0,716903.46
2023-02-22,2023-02-22,Subcontractors expense,REF43764049,1133.55,0.0,715769.91
2023-02-25,2023-02-25,Vehicle Maintenance expense,REF86288009,122.32,0.0,715647.59
2023-02-25,2023-02-25,Permits Licenses expense,REF27050269,57.39,0.0,715590.2
2023-02-28,2023-02-28,"Project payment - Martinez, Rose and Carter",REF44465354,0.0,1199.79,716789.99
2023-02-28,2023-02-28,"Payment from Martin, Atkins and Khan",REF23305297,0.0,650.19,717440.18
2023-02-28,2023-02-28,Service payment - Reynolds-Mckinney,REF75082154,0.0,1842.0,719282.18
2023-02-28,2023-02-28,Service payment - Horn and Sons,REF72984564,0.0,1412.87,720695.05
2023-02-28,2023-02-28,Project payment - Rogers Group,REF71170193,0.0,822.1,721517.15
2023-03-04,2023-03-04,Business materials,REF99541199,699.69,0.0,720817.46
2023-03-06,2023-03-06,Equipment Rental expense,REF51776461,408.42,0.0,720409.04
2023-03-07,2023-03-07,Tools expense,REF34898034,76.62,0.0,720332.42
2023-03-08,2023-03-08,Equipment Rental expense,REF63538940,432.67,0.0,719899.75
2023-03-10,2023-03-10,Fuel purchase,REF16812325,357.1,0.0,719542.65
2023-03-11,2023-03-11,Safety Equipment expense,REF79057171,53.7,0.0,719488.95
2023-03-13,2023-03-13,Fuel purchase,REF35631858,259.88,0.0,719229.07
2023-03-15,2023-03-15,Business insurance premium,REF71243024,194.69,0.0,719034.38
2023-03-15,2023-03-15,Invoice payment - Rogers Group,REF69116420,0.0,995.03,720029.41
2023-03-15,2023-03-15,Invoice payment - Horn and Sons,REF59072439,0.0,1266.73,721296.14
2023-03-15,2023-03-15,"Project payment - Martin, Atkins and Khan",REF87813881,0.0,833.41,722129.55
2023-03-15,2023-03-15,Service payment - Reynolds-Mckinney,REF16800989,0.0,1739.64,723869.19
2023-03-15,2023-03-15,"Service payment - Martinez, Rose and Carter",REF94836026,0.0,1848.37,725717.56
2023-03-18,2023-03-18,Vehicle Maintenance expense,REF27197072,166.26,0.0,725551.3
2023-03-20,2023-03-20,Permits Licenses expense,REF34765386,93.62,0.0,725457.68
2023-03-27,2023-03-27,Business materials,REF32451803,584.05,0.0,724873.63
2023-03-28,2023-03-28,Fuel purchase,REF24729951,257.71,0.0,724615.92
2023-03-28,2023-03-28,Business materials,REF34104195,817.24,0.0,723798.68
2023-03-30,2023-03-30,Invoice payment - Rogers Group,REF69142257,0.0,1347.96,725146.64
2023-03-30,2023-03-30,"Payment from Martin, Atkins and Khan",REF63961578,0.0,907.99,726054.63
2023-03-30,2023-03-30,Project payment - Horn and Sons,REF60941798,0.0,1687.14,727741.77
2023-03-30,2023-03-30,Service payment - Reynolds-Mckinney,REF82603504,0.0,1787.53,729529.3
2023-03-30,2023-03-30,"Invoice payment - Martinez, Rose and Carter",REF33549563,0.0,1953.58,731482.88
2023-04-01,2023-04-01,Subcontractors expense,REF99243870,1153.87,0.0,730329.01
2023-04-05,2023-04-05,Fuel purchase,REF80385318,351.41,0.0,729977.6
2023-04-08,2023-04-08,Tools expense,REF11330162,146.47,0.0,729831.13
2023-04-11,2023-04-11,Equipment Rental expense,REF97453010,405.97,0.0,729425.16
2023-04-14,2023-04-14,Subcontractors expense,REF89185684,1636.41,0.0,727788.75
2023-04-15,2023-04-15,Business insurance premium,REF64835161,226.0,0.0,727562.75
2023-04-15,2023-04-15,Project payment - Rogers Group,REF45441352,0.0,1201.16,728763.91
2023-04-15,2023-04-15,Service payment - Reynolds-Mckinney,REF27032978,0.0,1171.22,729935.13
2023-04-15,2023-04-15,"Invoice payment - Martinez, Rose and Carter",REF73166788,0.0,2360.46,732295.59
2023-04-15,2023-04-15,Service payment - Horn and Sons,REF52619919,0.0,1806.43,734102.02
2023-04-15,2023-04-15,"Invoice payment - Martin, Atkins and Khan",REF26699814,0.0,1253.15,735355.17
2023-04-24,2023-04-24,Safety Equipment expense,REF44171370,118.14,0.0,735237.03
2023-04-26,2023-04-26,Tools expense,REF62998849,192.3,0.0,735044.73
2023-04-29,2023-04-29,Fuel purchase,REF55983385,425.59,0.0,734619.14
2023-04-30,2023-04-30,"Invoice payment - Martinez, Rose and Carter",REF47248337,0.0,2055.48,736674.62
2023-04-30,2023-04-30,Invoice payment - Rogers Group,REF63314968,0.0,1295.95,737970.57
2023-04-30,2023-04-30,"Payment from Martin, Atkins and Khan",REF37294888,0.0,1176.42,739146.99
2023-04-30,2023-04-30,Service payment - Horn and Sons,REF48929326,0.0,1840.72,740987.71
2023-04-30,2023-04-30,Invoice payment - Reynolds-Mckinney,REF97609569,0.0,2070.97,743058.68
2023-05-01,2023-05-01,Fuel purchase,REF73033640,371.21,0.0,742687.47
2023-05-02,2023-05-02,Fuel purchase,REF17055532,393.66,0.0,742293.81
2023-05-03,2023-05-03,Business materials,REF56036281,726.7,0.0,741567.11
2023-05-07,2023-05-07,Subcontractors expense,REF12908980,586.15,0.0,740980.96
2023-05-10,2023-05-10,Fuel purchase,REF50541310,183.48,0.0,740797.48
2023-05-12,2023-05-12,Permits Licenses expense,REF70338794,72.6,0.0,740724.88
2023-05-14,2023-05-14,Fuel purchase,REF69044122,270.39,0.0,740454.49
2023-05-15,2023-05-15,"Payment from Martinez, Rose and Carter",REF14522117,0.0,3070.96,743525.45
2023-05-15,2023-05-15,Project payment - Reynolds-Mckinney,REF30763701,0.0,2200.52,745725.97
2023-05-15,2023-05-15,"Payment from Martin, Atkins and Khan",REF55679877,0.0,853.78,746579.75
2023-05-15,2023-05-15,Business insurance premium,REF73608387,264.22,0.0,746315.53
2023-05-15,2023-05-15,Invoice payment - Rogers Group,REF92700191,0.0,1229.21,747544.74
2023-05-15,2023-05-15,Invoice payment - Horn and Sons,REF17148402,0.0,1689.22,749233.96
2023-05-20,2023-05-20,Safety Equipment expense,REF36362875,63.87,0.0,749170.09
2023-05-25,2023-05-25,Equipment Rental expense,REF11263291,830.53,0.0,748339.56
2023-05-29,2023-05-29,Business materials,REF88255906,903.61,0.0,747435.95
2023-05-30,2023-05-30,Service payment - Rogers Group,REF26264579,0.0,1286.62,748722.57
2023-05-30,2023-05-30,"Project payment - Martinez, Rose and Carter",REF20773723,0.0,2320.63,751043.2
2023-05-30,2023-05-30,Service payment - Horn and Sons,REF98245671,0.0,1699.56,752742.76
2023-05-30,2023-05-30,"Payment from Martin, Atkins and Khan",REF71942079,0.0,1481.19,754223.95
2023-05-30,2023-05-30,Project payment - Reynolds-Mckinney,REF32780746,0.0,2146.81,756370.76
2023-05-31,2023-05-31,Permits Licenses expense,REF57896788,152.45,0.0,756218.31
2023-05-31,2023-05-31,Fuel purchase,REF12829298,414.16,0.0,755804.15
2023-06-04,2023-06-04,Vehicle Maintenance expense,REF10231443,236.8,0.0,755567.35
2023-06-08,2023-06-08,Safety Equipment expense,REF96146589,113.7,0.0,755453.65
2023-06-09,2023-06-09,Equipment Rental expense,REF83605525,671.82,0.0,754781.83
2023-06-13,2023-06-13,Fuel purchase,REF62798435,158.19,0.0,754623.64
2023-06-15,2023-06-15,Business insurance premium,REF75391797,280.55,0.0,754343.09
2023-06-15,2023-06-15,Fuel purchase,REF49831733,489.19,0.0,753853.9
2023-06-15,2023-06-15,"Invoice payment - Martinez, Rose and Carter",REF22023156,0.0,2357.29,756211.19
2023-06-15,2023-06-15,Tools expense,REF76382472,178.92,0.0,756032.27
2023-06-15,2023-06-15,Invoice payment - Horn and Sons,REF16853099,0.0,1565.62,757597.89
2023-06-15,2023-06-15,"Payment from Martin, Atkins and Khan",REF37845339,0.0,1218.16,758816.05
2023-06-15,2023-06-15,Safety Equipment expense,REF53048387,96.9,0.0,758719.15
2023-06-15,2023-06-15,Project payment - Reynolds-Mckinney,REF84145633,0.0,2896.42,761615.57
2023-06-15,2023-06-15,Service payment - Rogers Group,REF20146376,0.0,1084.86,762700.43
2023-06-17,2023-06-17,Safety Equipment expense,REF73327202,102.18,0.0,762598.25
2023-06-17,2023-06-17,Permits Licenses expense,REF87243153,15.86,0.0,762582.39
2023-06-19,2023-06-19,Subcontractors expense,REF47640487,885.94,0.0,761696.45
2023-06-24,2023-06-24,Business materials,REF64889903,1490.67,0.0,760205.78
2023-06-26,2023-06-26,Fuel purchase,REF62392620,436.4,0.0,759769.38
2023-06-27,2023-06-27,Business materials,REF32902081,1155.99,0.0,758613.39
2023-06-29,2023-06-29,Fuel purchase,REF67889485,392.32,0.0,758221.07
2023-06-30,2023-06-30,"Payment from Martinez, Rose and Carter",REF84159282,0.0,2351.5,760572.57
2023-06-30,2023-06-30,Project payment - Horn and Sons,REF13575570,0.0,1557.58,762130.15
2023-06-30,2023-06-30,Invoice payment - Reynolds-Mckinney,REF20500952,0.0,2089.69,764219.84
2023-06-30,2023-06-30,Payment from Rogers Group,REF49401526,0.0,1471.24,765691.08
2023-07-02,2023-07-02,Fuel purchase,REF51170363,498.48,0.0,765192.6
2023-07-03,2023-07-03,Fuel purchase,REF16639664,382.78,0.0,764809.82
2023-07-07,2023-07-07,Fuel purchase,REF35535311,263.78,0.0,764546.04
2023-07-08,2023-07-08,Tools expense,REF32469415,145.48,0.0,764400.56
2023-07-09,2023-07-09,Business materials,REF71960292,1017.53,0.0,763383.03
2023-07-12,2023-07-12,Tools expense,REF52555735,73.42,0.0,763309.61
2023-07-12,2023-07-12,Fuel purchase,REF20523053,327.23,0.0,762982.38
2023-07-13,2023-07-13,Business materials,REF86442694,1065.34,0.0,761917.04
2023-07-15,2023-07-15,Invoice payment - Rogers Group,REF52862686,0.0,1213.99,763131.03
2023-07-15,2023-07-15,"Project payment - Martin, Atkins and Khan",REF18759048,0.0,1131.55,764262.58
2023-07-15,2023-07-15,Business insurance premium,REF42524762,234.43,0.0,764028.15
2023-07-15,2023-07-15,Project payment - Horn and Sons,REF64329018,0.0,1709.57,765737.72
2023-07-15,2023-07-15,Project payment - Reynolds-Mckinney,REF66008488,0.0,1770.09,767507.81
2023-07-15,2023-07-15,"Service payment - Martinez, Rose and Carter",REF34723422,0.0,1836.82,769344.63
2023-07-16,2023-07-16,Vehicle Maintenance expense,REF27491817,151.39,0.0,769193.24
2023-07-16,2023-07-16,Tools expense,REF23552707,125.87,0.0,769067.37
2023-07-22,2023-07-22,Safety Equipment expense,REF14395668,68.46,0.0,768998.91
2023-07-22,2023-07-22,Fuel purchase,REF67774877,453.07,0.0,768545.84
2023-07-28,2023-07-28,Fuel purchase,REF97971384,349.29,0.0,768196.55
2023-07-29,2023-07-29,Tools expense,REF13957334,109.09,0.0,768087.46
2023-07-30,2023-07-30,"Service payment - Martin, Atkins and Khan",REF11177582,0.0,1099.31,769186.77
2023-07-30,2023-07-30,"Payment from Martinez, Rose and Carter",REF46579432,0.0,1775.0,770961.77
2023-07-30,2023-07-30,Service payment - Rogers Group,REF94846799,0.0,1193.9,772155.67
2023-07-30,2023-07-30,Payment from Reynolds-Mckinney,REF69789260,0.0,1845.62,774001.29
2023-07-30,2023-07-30,Service payment - Horn and Sons,REF59035807,0.0,2091.1,776092.39
2023-08-04,2023-08-04,Business materials,REF35413433,802.36,0.0,775290.03
2023-08-07,2023-08-07,Fuel purchase,REF94707169,308.82,0.0,774981.21
2023-08-08,2023-08-08,Fuel purchase,REF99706694,294.41,0.0,774686.8
2023-08-10,2023-08-10,Tools expense,REF68251463,166.97,0.0,774519.83
2023-08-14,2023-08-14,Business materials,REF79336526,1093.7,0.0,773426.13
2023-08-15,2023-08-15,Payment from Horn and Sons,REF89986182,0.0,1205.55,774631.68
2023-08-15,2023-08-15,Business insurance premium,REF52021769,247.83,0.0,774383.85
2023-08-15,2023-08-15,"Service payment - Martin, Atkins and Khan",REF35151047,0.0,1082.51,775466.36
2023-08-15,2023-08-15,"Invoice payment - Martinez, Rose and Carter",REF92711135,0.0,2126.18,777592.54
2023-08-15,2023-08-15,Payment from Reynolds-Mckinney,REF20538655,0.0,2103.57,779696.11
2023-08-15,2023-08-15,Project payment - Rogers Group,REF34312818,0.0,1218.59,780914.7
2023-08-16,2023-08-16,Business materials,REF43819979,937.38,0.0,779977.32
2023-08-17,2023-08-17,Tools expense,REF58487639,83.12,0.0,779894.2
2023-08-20,2023-08-20,Fuel purchase,REF27882606,505.39,0.0,779388.81
2023-08-30,2023-08-30,Invoice payment - Reynolds-Mckinney,REF88232794,0.0,2456.95,781845.76
2023-08-30,2023-08-30,Payment from Horn and Sons,REF82923904,0.0,1535.97,783381.73
2023-08-30,2023-08-30,"Payment from Martinez, Rose and Carter",REF71393429,0.0,2051.01,785432.74
2023-08-30,2023-08-30,"Invoice payment - Martin, Atkins and Khan",REF30449135,0.0,947.66,786380.4
2023-08-30,2023-08-30,Project payment - Rogers Group,REF95230107,0.0,1129.52,787509.92
2023-08-31,2023-08-31,Fuel purchase,REF37047448,343.48,0.0,787166.44
2023-09-01,2023-09-01,Business materials,REF68988940,931.35,0.0,786235.09
2023-09-02,2023-09-02,Subcontractors expense,REF55216554,1269.15,0.0,784965.94
2023-09-04,2023-09-04,Equipment Rental expense,REF43731389,493.02,0.0,784472.92
2023-09-15,2023-09-15,Subcontractors expense,REF28060814,398.1,0.0,784074.82
2023-09-15,2023-09-15,Service payment - Reynolds-Mckinney,REF56019132,0.0,2527.62,786602.44
2023-09-15,2023-09-15,"Service payment - Martin, Atkins and Khan",REF91289393,0.0,1049.93,787652.37
2023-09-15,2023-09-15,Invoice payment - Horn and Sons,REF88171495,0.0,1433.25,789085.62
2023-09-15,2023-09-15,"Service payment - Martinez, Rose and Carter",REF59184893,0.0,1747.79,790833.41
2023-09-15,2023-09-15,Invoice payment - Rogers Group,REF91794875,0.0,1068.03,791901.44
2023-09-15,2023-09-15,Business insurance premium,REF18480036,224.94,0.0,791676.5
2023-09-17,2023-09-17,Business materials,REF83698970,1112.44,0.0,790564.06
2023-09-26,2023-09-26,Safety Equipment expense,REF25246759,70.27,0.0,790493.79
2023-09-28,2023-09-28,Business materials,REF67778143,367.07,0.0,790126.72
2023-09-30,2023-09-30,Invoice payment - Horn and Sons,REF35111225,0.0,1506.65,791633.37
2023-09-30,2023-09-30,"Service payment - Martinez, Rose and Carter",REF77592752,0.0,1424.07,793057.44
2023-09-30,2023-09-30,"Invoice payment - Martin, Atkins and Khan",REF67735072,0.0,1128.34,794185.78
2023-09-30,2023-09-30,Invoice payment - Reynolds-Mckinney,REF66946657,0.0,1677.98,795863.76
2023-09-30,2023-09-30,Service payment - Rogers Group,REF61326470,0.0,1281.22,797144.98
2023-10-01,2023-10-01,Business materials,REF30474042,1048.14,0.0,796096.84
2023-10-04,2023-10-04,Fuel purchase,REF95629394,364.81,0.0,795732.03
2023-10-05,2023-10-05,Vehicle Maintenance expense,REF44511248,211.21,0.0,795520.82
2023-10-06,2023-10-06,Business materials,REF68213122,648.77,0.0,794872.05
2023-10-09,2023-10-09,Business materials,REF12472149,958.01,0.0,793914.04
2023-10-09,2023-10-09,Fuel purchase,REF46397271,295.04,0.0,793619.0
2023-10-10,2023-10-10,Fuel purchase,REF29446453,344.35,0.0,793274.65
2023-10-12,2023-10-12,Equipment Rental expense,REF84047466,306.48,0.0,792968.17
2023-10-12,2023-10-12,Business materials,REF56409800,903.66,0.0,792064.51
2023-10-15,2023-10-15,Business materials,REF82897412,830.08,0.0,791234.43
2023-10-15,2023-10-15,Business insurance premium,REF76246842,214.88,0.0,791019.55
2023-10-15,2023-10-15,Tools expense,REF12139255,111.07,0.0,790908.48
2023-10-15,2023-10-15,"Project payment - Martinez, Rose and Carter",REF58150193,0.0,1507.12,792415.6
2023-10-15,2023-10-15,Payment from Horn and Sons,REF25004926,0.0,1856.38,794271.98
2023-10-15,2023-10-15,"Project payment - Martin, Atkins and Khan",REF35563006,0.0,1057.33,795329.31
2023-10-15,2023-10-15,Project payment - Rogers Group,REF35646216,0.0,1056.5,796385.81
2023-10-15,2023-10-15,Service payment - Reynolds-Mckinney,REF70359475,0.0,1933.52,798319.33
2023-10-18,2023-10-18,Equipment Rental expense,REF72553188,320.57,0.0,797998.76
2023-10-22,2023-10-22,Permits Licenses expense,REF46534295,89.18,0.0,797909.58
2023-10-27,2023-10-27,Business materials,REF11751714,865.38,0.0,797044.2
2023-10-30,2023-10-30,Payment from Rogers Group,REF52258617,0.0,1225.93,798270.13
2023-10-30,2023-10-30,"Payment from Martinez, Rose and Carter",REF22605509,0.0,1545.77,799815.9
2023-10-30,2023-10-30,Service payment - Horn and Sons,REF24780680,0.0,1304.43,801120.33
2023-10-30,2023-10-30,Fuel purchase,REF17708024,269.63,0.0,800850.7
2023-11-03,2023-11-03,Subcontractors expense,REF55493188,1005.76,0.0,799844.94
2023-11-08,2023-11-08,Vehicle Maintenance expense,REF26874239,165.8,0.0,799679.14
2023-11-09,2023-11-09,Business materials,REF96335309,220.13,0.0,799459.01
2023-11-09,2023-11-09,Safety Equipment expense,REF71723923,63.88,0.0,799395.13
2023-11-10,2023-11-10,Permits Licenses expense,REF67563970,72.79,0.0,799322.34
2023-11-10,2023-11-10,Vehicle Maintenance expense,REF33409238,97.9,0.0,799224.44
2023-11-12,2023-11-12,Vehicle Maintenance expense,REF39844934,119.1,0.0,799105.34
2023-11-14,2023-11-14,Fuel purchase,REF39271911,294.3,0.0,798811.04
2023-11-14,2023-11-14,Permits Licenses expense,REF71064930,72.61,0.0,798738.43
2023-11-15,2023-11-15,Business insurance premium,REF15118691,153.37,0.0,798585.06
2023-11-15,2023-11-15,Business materials,REF64767847,737.47,0.0,797847.59
2023-11-15,2023-11-15,Project payment - Rogers Group,REF38800150,0.0,762.68,798610.27
2023-11-15,2023-11-15,Invoice payment - Horn and Sons,REF61014051,0.0,1009.6,799619.87
2023-11-15,2023-11-15,"Service payment - Martinez, Rose and Carter",REF37998429,0.0,1482.97,801102.84
2023-11-15,2023-11-15,"Service payment - Martin, Atkins and Khan",REF40275514,0.0,731.89,801834.73
2023-11-15,2023-11-15,Payment from Reynolds-Mckinney,REF20582556,0.0,1256.63,803091.36
2023-11-18,2023-11-18,Vehicle Maintenance expense,REF24397432,108.67,0.0,802982.69
2023-11-18,2023-11-18,Fuel purchase,REF85336513,204.79,0.0,802777.9
2023-11-23,2023-11-23,Business materials,REF94391258,1149.75,0.0,801628.15
2023-11-28,2023-11-28,Business materials,REF67447797,882.91,0.0,800745.24
2023-11-30,2023-11-30,Invoice payment - Reynolds-Mckinney,REF82458152,0.0,1301.15,802046.39
2023-11-30,2023-11-30,"Payment from Martin, Atkins and Khan",REF32379460,0.0,705.93,802752.32
2023-11-30,2023-11-30,Payment from Horn and Sons,REF62990137,0.0,1098.42,803850.74
2023-12-01,2023-12-01,Equipment Rental expense,REF72057423,162.32,0.0,803688.42
2023-12-03,2023-12-03,Business materials,REF95177724,281.8,0.0,803406.62
2023-12-04,2023-12-04,Tools expense,REF24328803,48.97,0.0,803357.65
2023-12-06,2023-12-06,Tools expense,REF96221131,52.84,0.0,803304.81
2023-12-07,2023-12-07,Business materials,REF92370217,586.75,0.0,802718.06
2023-12-09,2023-12-09,Equipment Rental expense,REF84150661,251.8,0.0,802466.26
2023-12-12,2023-12-12,Permits Licenses expense,REF11924353,26.45,0.0,802439.81
2023-12-14,2023-12-14,Business materials,REF63772854,530.8,0.0,801909.01
2023-12-15,2023-12-15,Business insurance premium,REF10557422,131.24,0.0,801777.77
2023-12-15,2023-12-15,"Project payment - Martinez, Rose and Carter",REF57525969,0.0,941.82,802719.59
2023-12-15,2023-12-15,"Payment from Martin, Atkins and Khan",REF83546223,0.0,501.2,803220.79
2023-12-15,2023-12-15,Invoice payment - Horn and Sons,REF58402655,0.0,1096.12,804316.91
2023-12-15,2023-12-15,Payment from Rogers Group,REF36500064,0.0,689.14,805006.05
2023-12-15,2023-12-15,Project payment - Reynolds-Mckinney,REF24724513,0.0,888.54,805894.59
2023-12-16,2023-12-16,Fuel purchase,REF77963627,177.74,0.0,805716.85
2023-12-21,2023-12-21,Business materials,REF25581680,196.75,0.0,805520.1
2023-12-23,2023-12-23,Tools expense,REF57021600,69.11,0.0,805450.99
2023-12-26,2023-12-26,Business materials,REF62761709,454.24,0.0,804996.75
2023-12-27,2023-12-27,Equipment Rental expense,REF99707854,226.71,0.0,804770.04
2023-12-28,2023-12-28,Subcontractors expense,REF84684593,736.1,0.0,804033.94
2023-12-30,2023-12-30,"Payment from Martinez, Rose and Carter",REF63375498,0.0,1080.87,805114.81
2023-12-30,2023-12-30,"Invoice payment - Martin, Atkins and Khan",REF54302422,0.0,526.31,805641.12
2023-12-30,2023-12-30,Invoice payment - Reynolds-Mckinney,REF46344201,0.0,1293.65,806934.77
2023-12-30,2023-12-30,Invoice payment - Rogers Group,REF88689761,0.0,769.59,807704.36
2024-01-06,2024-01-06,Fuel purchase,REF98752034,222.95,0.0,807481.41
2024-01-12,2024-01-12,Equipment Rental expense,REF13175883,301.29,0.0,807180.12
2024-01-12,2024-01-12,Permits Licenses expense,REF81963480,58.19,0.0,807121.93
2024-01-14,2024-01-14,Subcontractors expense,REF85833854,7.74,0.0,807114.19
2024-01-14,2024-01-14,Safety Equipment expense,REF63911025,65.11,0.0,807049.08
2024-01-14,2024-01-14,Fuel purchase,REF76232169,308.44,0.0,806740.64
2024-01-15,2024-01-15,Business insurance premium,REF90823614,135.47,0.0,806605.17
2024-01-15,2024-01-15,Tools expense,REF63764955,80.97,0.0,806524.2
2024-01-15,2024-01-15,"Service payment - Martinez, Rose and Carter",REF50497919,0.0,912.84,807437.04
2024-01-15,2024-01-15,Payment from Horn and Sons,REF74141053,0.0,1087.08,808524.12
2024-01-15,2024-01-15,"Service payment - Martin, Atkins and Khan",REF96867749,0.0,556.35,809080.47
2024-01-15,2024-01-15,Service payment - Reynolds-Mckinney,REF14861569,0.0,1520.8,810601.27
2024-01-15,2024-01-15,Fuel purchase,REF96497684,212.31,0.0,810388.96
2024-01-16,2024-01-16,Fuel purchase,REF32507647,312.4,0.0,810076.56
2024-01-26,2024-01-26,Business materials,REF51801907,315.39,0.0,809761.17
2024-01-30,2024-01-30,"Service payment - Martin, Atkins and Khan",REF69563473,0.0,609.79,810370.96
2024-01-30,2024-01-30,"Service payment - Martinez, Rose and Carter",REF95061432,0.0,1092.99,811463.95
2024-01-30,2024-01-30,Invoice payment - Horn and Sons,REF65308194,0.0,1094.38,812558.33
2024-01-30,2024-01-30,Invoice payment - Rogers Group,REF81645257,0.0,678.3,813236.63
2024-01-30,2024-01-30,Payment from Reynolds-Mckinney,REF72521523,0.0,1065.59,814302.22
2024-02-02,2024-02-02,Business materials,REF29787368,449.03,0.0,813853.19
2024-02-02,2024-02-02,Equipment Rental expense,REF60792851,348.32,0.0,813504.87
2024-02-03,2024-02-03,Equipment Rental expense,REF63045066,351.84,0.0,813153.03
2024-02-04,2024-02-04,Fuel purchase,REF19683124,152.59,0.0,813000.44
2024-02-08,2024-02-08,Vehicle Maintenance expense,REF82034310,94.6,0.0,812905.84
2024-02-09,2024-02-09,Permits Licenses expense,REF24310372,51.35,0.0,812854.49
2024-02-11,2024-02-11,Business materials,REF10032751,1057.55,0.0,811796.94
2024-02-15,2024-02-15,Safety Equipment expense,REF20857971,64.17,0.0,811732.77
2024-02-15,2024-02-15,"Service payment - Martin, Atkins and Khan",REF90189851,0.0,656.55,812389.32
2024-02-15,2024-02-15,Business insurance premium,REF74938432,142.63,0.0,812246.69
2024-02-15,2024-02-15,"Service payment - Martinez, Rose and Carter",REF47997571,0.0,1264.45,813511.14
2024-02-15,2024-02-15,Service payment - Horn and Sons,REF48830650,0.0,1306.83,814817.97
2024-02-15,2024-02-15,Payment from Reynolds-Mckinney,REF60352988,0.0,1030.58,815848.55
2024-02-15,2024-02-15,Invoice payment - Rogers Group,REF77128277,0.0,990.76,816839.31
2024-02-16,2024-02-16,Business materials,REF24541301,763.4,0.0,816075.91
2024-02-16,2024-02-16,Permits Licenses expense,REF22315464,86.29,0.0,815989.62
2024-02-19,2024-02-19,Permits Licenses expense,REF10211479,94.83,0.0,815894.79
2024-02-19,2024-02-19,Business materials,REF79009669,421.67,0.0,815473.12
2024-02-19,2024-02-19,Fuel purchase,REF83656607,154.71,0.0,815318.41
2024-02-20,2024-02-20,Permits Licenses expense,REF18802523,57.32,0.0,815261.09
2024-02-24,2024-02-24,Fuel purchase,REF43562634,175.87,0.0,815085.22
2024-02-26,2024-02-26,Fuel purchase,REF85950542,305.98,0.0,814779.24
2024-02-27,2024-02-27,Business materials,REF76125750,843.55,0.0,813935.69
2024-02-28,2024-02-28,Project payment - Horn and Sons,REF73796254,0.0,1322.62,815258.31
2024-02-28,2024-02-28,"Payment from Martin, Atkins and Khan",REF14504811,0.0,610.44,815868.75
2024-02-28,2024-02-28,Project payment - Reynolds-Mckinney,REF42275794,0.0,1144.77,817013.52
2024-02-28,2024-02-28,"Payment from Martinez, Rose and Carter",REF20635621,0.0,1280.23,818293.75
2024-03-01,2024-03-01,Tools expense,REF69865857,137.85,0.0,818155.9
2024-03-05,2024-03-05,Business materials,REF62126837,818.52,0.0,817337.38
2024-03-08,2024-03-08,Business materials,REF59937621,485.71,0.0,816851.67
2024-03-11,2024-03-11,Safety Equipment expense,REF27293918,80.03,0.0,816771.64
2024-03-12,2024-03-12,Tools expense,REF75162197,113.52,0.0,816658.12
2024-03-13,2024-03-13,Fuel purchase,REF48329201,281.84,0.0,816376.28
2024-03-15,2024-03-15,Business materials,REF30383012,576.25,0.0,815800.03
2024-03-15,2024-03-15,Equipment Rental expense,REF22289633,427.66,0.0,815372.37
2024-03-15,2024-03-15,"Project payment - Martin, Atkins and Khan",REF72462534,0.0,881.3,816253.67
2024-03-15,2024-03-15,"Payment from Martinez, Rose and Carter",REF72206794,0.0,1864.89,818118.56
2024-03-15,2024-03-15,Service payment - Rogers Group,REF72699898,0.0,982.92,819101.48
2024-03-15,2024-03-15,Business insurance premium,REF35720281,211.49,0.0,818889.99
2024-03-15,2024-03-15,Invoice payment - Horn and Sons,REF65305563,0.0,1303.59,820193.58
2024-03-16,2024-03-16,Equipment Rental expense,REF41022963,589.35,0.0,819604.23
2024-03-16,2024-03-16,Fuel purchase,REF19352190,355.82,0.0,819248.41
2024-03-21,2024-03-21,Permits Licenses expense,REF44013553,85.27,0.0,819163.14
2024-03-22,2024-03-22,Vehicle Maintenance expense,REF19267769,125.19,0.0,819037.95
2024-03-27,2024-03-27,Fuel purchase,REF99535839,429.05,0.0,818608.9
2024-03-28,2024-03-28,Permits Licenses expense,REF17051513,79.62,0.0,818529.28
2024-03-29,2024-03-29,Vehicle Maintenance expense,REF57953539,92.54,0.0,818436.74
2024-03-30,2024-03-30,"Project payment - Martinez, Rose and Carter",REF69170221,0.0,2014.22,820450.96
2024-03-30,2024-03-30,Payment from Reynolds-Mckinney,REF84050093,0.0,1860.74,822311.7
2024-03-30,2024-03-30,Project payment - Horn and Sons,REF77240523,0.0,1135.5,823447.2
2024-03-30,2024-03-30,Invoice payment - Rogers Group,REF49338498,0.0,1107.63,824554.83
2024-03-30,2024-03-30,"Service payment - Martin, Atkins and Khan",REF93794677,0.0,782.06,825336.89
2024-04-05,2024-04-05,Fuel purchase,REF99905122,334.14,0.0,825002.75
2024-04-09,2024-04-09,Fuel purchase,REF88921616,378.49,0.0,824624.26
2024-04-15,2024-04-15,Project payment - Horn and Sons,REF86837500,0.0,1761.63,826385.89
2024-04-15,2024-04-15,Invoice payment - Reynolds-Mckinney,REF14854727,0.0,1775.0,828160.89
2024-04-15,2024-04-15,"Project payment - Martinez, Rose and Carter",REF23806664,0.0,1552.11,829713.0
2024-04-15,2024-04-15,Business insurance premium,REF19734004,235.31,0.0,829477.69
2024-04-15,2024-04-15,"Service payment - Martin, Atkins and Khan",REF82899333,0.0,1072.11,830549.8
2024-04-19,2024-04-19,Fuel purchase,REF43232975,326.02,0.0,830223.78
2024-04-20,2024-04-20,Subcontractors expense,REF19928221,583.35,0.0,829640.43
2024-04-22,2024-04-22,Tools expense,REF69546134,144.58,0.0,829495.85
2024-04-22,2024-04-22,Fuel purchase,REF55936491,340.75,0.0,829155.1
2024-04-23,2024-04-23,Vehicle Maintenance expense,REF30879797,131.98,0.0,829023.12
2024-04-29,2024-04-29,Permits Licenses expense,REF50332976,119.08,0.0,828904.04
2024-04-30,2024-04-30,"Invoice payment - Martin, Atkins and Khan",REF80229184,0.0,1318.69,830222.73
2024-04-30,2024-04-30,"Invoice payment - Martinez, Rose and Carter",REF98017735,0.0,2093.85,832316.58
2024-04-30,2024-04-30,Invoice payment - Horn and Sons,REF70267044,0.0,1667.6,833984.18
2024-05-02,2024-05-02,Fuel purchase,REF74451242,362.14,0.0,833622.04
2024-05-02,2024-05-02,Business materials,REF34639358,602.01,0.0,833020.03
2024-05-03,2024-05-03,Fuel purchase,REF21033903,506.8,0.0,832513.23
2024-05-05,2024-05-05,Tools expense,REF74494419,81.61,0.0,832431.62
2024-05-08,2024-05-08,Safety Equipment expense,REF83029545,101.23,0.0,832330.39
2024-05-09,2024-05-09,Business materials,REF20190879,1303.39,0.0,831027.0
2024-05-15,2024-05-15,Business insurance premium,REF45294061,258.54,0.0,830768.46
2024-05-15,2024-05-15,"Service payment - Martinez, Rose and Carter",REF14893801,0.0,2152.47,832920.93
2024-05-15,2024-05-15,"Payment from Martin, Atkins and Khan",REF13999626,0.0,1124.17,834045.1
2024-05-15,2024-05-15,Payment from Horn and Sons,REF50311974,0.0,2052.34,836097.44
2024-05-15,2024-05-15,Invoice payment - Rogers Group,REF87326113,0.0,1160.5,837257.94
2024-05-16,2024-05-16,Subcontractors expense,REF45900003,686.31,0.0,836571.63
2024-05-19,2024-05-19,Fuel purchase,REF70014995,265.29,0.0,836306.34
2024-05-29,2024-05-29,Business materials,REF26796431,1528.03,0.0,834778.31
2024-05-30,2024-05-30,"Service payment - Martin, Atkins and Khan",REF60579714,0.0,1395.67,836173.98
2024-05-30,2024-05-30,Invoice payment - Reynolds-Mckinney,REF10133996,0.0,1392.35,837566.33
2024-05-30,2024-05-30,"Payment from Martinez, Rose and Carter",REF26564413,0.0,1764.17,839330.5
2024-05-30,2024-05-30,Project payment - Horn and Sons,REF37958706,0.0,1988.03,841318.53
2024-05-30,2024-05-30,Payment from Rogers Group,REF85029583,0.0,1406.68,842725.21
2024-05-31,2024-05-31,Tools expense,REF73662149,116.13,0.0,842609.08
2024-05-31,2024-05-31,Subcontractors expense,REF10969310,1021.49,0.0,841587.59
2024-06-01,2024-06-01,Fuel purchase,REF20952449,242.78,0.0,841344.81
2024-06-01,2024-06-01,Business materials,REF87523387,914.61,0.0,840430.2
2024-06-02,2024-06-02,Subcontractors expense,REF16799603,1262.1,0.0,839168.1
2024-06-03,2024-06-03,Permits Licenses expense,REF76351963,123.05,0.0,839045.05
2024-06-04,2024-06-04,Business materials,REF56822394,1285.82,0.0,837759.23
2024-06-07,2024-06-07,Fuel purchase,REF20327064,429.78,0.0,837329.45
2024-06-09,2024-06-09,Fuel purchase,REF63517040,270.38,0.0,837059.07
2024-06-15,2024-06-15,Payment from Reynolds-Mckinney,REF25484085,0.0,2439.75,839498.82
2024-06-15,2024-06-15,"Invoice payment - Martinez, Rose and Carter",REF76612508,0.0,2574.66,842073.48
2024-06-15,2024-06-15,Payment from Horn and Sons,REF75234976,0.0,1931.39,844004.87
2024-06-15,2024-06-15,"Service payment - Martin, Atkins and Khan",REF65095753,0.0,1271.85,845276.72
2024-06-15,2024-06-15,Service payment - Rogers Group,REF31710763,0.0,918.54,846195.26
2024-06-15,2024-06-15,Business insurance premium,REF11776340,244.57,0.0,845950.69
2024-06-18,2024-06-18,Fuel purchase,REF11729794,473.51,0.0,845477.18
2024-06-21,2024-06-21,Business materials,REF53767149,1015.79,0.0,844461.39
2024-06-22,2024-06-22,Subcontractors expense,REF61880867,1385.69,0.0,843075.7
2024-06-26,2024-06-26,Equipment Rental expense,REF94621251,596.96,0.0,842478.74
2024-06-26,2024-06-26,Subcontractors expense,REF51311203,1621.61,0.0,840857.13
2024-06-29,2024-06-29,Business materials,REF64236369,1515.17,0.0,839341.96
2024-06-30,2024-06-30,Project payment - Rogers Group,REF82920958,0.0,1310.84,840652.8
2024-06-30,2024-06-30,"Service payment - Martinez, Rose and Carter",REF35145317,0.0,2048.29,842701.09
2024-07-01,2024-07-01,Business materials,REF20620379,900.45,0.0,841800.64
2024-07-04,2024-07-04,Permits Licenses expense,REF84086528,75.94,0.0,841724.7
2024-07-04,2024-07-04,Fuel purchase,REF74308719,415.88,0.0,841308.82
2024-07-08,2024-07-08,Business materials,REF19303332,799.59,0.0,840509.23
2024-07-14,2024-07-14,Fuel purchase,REF67563599,463.86,0.0,840045.37
2024-07-15,2024-07-15,Business insurance premium,REF52638965,216.68,0.0,839828.69
2024-07-15,2024-07-15,Project payment - Horn and Sons,REF23704844,0.0,1258.47,841087.16
2024-07-15,2024-07-15,"Service payment - Martin, Atkins and Khan",REF72409437,0.0,787.06,841874.22
2024-07-15,2024-07-15,Project payment - Reynolds-Mckinney,REF91556805,0.0,2407.35,844281.57
2024-07-15,2024-07-15,"Payment from Martinez, Rose and Carter",REF26770556,0.0,2085.63,846367.2
2024-07-15,2024-07-15,Invoice payment - Rogers Group,REF41701911,0.0,782.66,847149.86
2024-07-17,2024-07-17,Vehicle Maintenance expense,REF91937939,213.83,0.0,846936.03
2024-07-17,2024-07-17,Fuel purchase,REF91167109,380.47,0.0,846555.56
2024-07-26,2024-07-26,Tools expense,REF27105810,161.1,0.0,846394.46
2024-07-27,2024-07-27,Business materials,REF51033359,889.07,0.0,845505.39
2024-07-27,2024-07-27,Vehicle Maintenance expense,REF10214791,177.02,0.0,845328.37
2024-07-28,2024-07-28,Vehicle Maintenance expense,REF11510601,266.13,0.0,845062.24
2024-07-29,2024-07-29,Equipment Rental expense,REF67827087,448.23,0.0,844614.01
2024-07-30,2024-07-30,Vehicle Maintenance expense,REF19599201,207.12,0.0,844406.89
2024-07-30,2024-07-30,"Invoice payment - Martin, Atkins and Khan",REF48869623,0.0,975.39,845382.28
2024-07-30,2024-07-30,Invoice payment - Rogers Group,REF94845347,0.0,1328.02,846710.3
2024-07-30,2024-07-30,Payment from Reynolds-Mckinney,REF46811428,0.0,1755.3,848465.6
2024-07-30,2024-07-30,"Invoice payment - Martinez, Rose and Carter",REF37024976,0.0,2323.37,850788.97
2024-07-30,2024-07-30,Invoice payment - Horn and Sons,REF77343566,0.0,1642.77,852431.74
2024-08-07,2024-08-07,Fuel purchase,REF50813849,439.0,0.0,851992.74
2024-08-07,2024-08-07,Subcontractors expense,REF65564541,1522.86,0.0,850469.88
2024-08-08,2024-08-08,Subcontractors expense,REF75501459,789.06,0.0,849680.82
2024-08-08,2024-08-08,Equipment Rental expense,REF64583200,509.77,0.0,849171.05
2024-08-15,2024-08-15,"Service payment - Martin, Atkins and Khan",REF42263113,0.0,1089.84,850260.89
2024-08-15,2024-08-15,Business insurance premium,REF29898968,256.92,0.0,850003.97
2024-08-15,2024-08-15,Service payment - Horn and Sons,REF77859377,0.0,1585.52,851589.49
2024-08-15,2024-08-15,Project payment - Rogers Group,REF82733137,0.0,1452.82,853042.31
2024-08-15,2024-08-15,"Invoice payment - Martinez, Rose and Carter",REF65415760,0.0,2652.83,855695.14
2024-08-15,2024-08-15,Payment from Reynolds-Mckinney,REF40279031,0.0,1819.26,857514.4
2024-08-16,2024-08-16,Business materials,REF42665570,1363.66,0.0,856150.74
2015-08-20,2015-08-20,Tools expense,REF59133521,121.0,0.0,6261.39
2015-08-20,2015-08-20,Business materials,REF28550321,826.71,0.0,5434.68
2015-08-21,2015-08-21,Fuel purchase,REF79009243,362.78,0.0,5071.9
2015-08-22,2015-08-22,Business materials,REF79054580,925.32,0.0,4146.58
2015-08-23,2015-08-23,Business materials,REF88304665,659.92,0.0,3486.66
2015-08-24,2015-08-24,Permits Licenses expense,REF51413099,126.45,0.0,3360.21
2015-08-25,2015-08-25,Fuel purchase,REF16173802,423.18,0.0,2937.03
2015-08-27,2015-08-27,Business materials,REF13209238,811.55,0.0,2125.48
2015-08-30,2015-08-30,"Payment from Leon, Jones and Jackson",REF88588578,0.0,457.48,2582.96
2015-08-30,2015-08-30,"Project payment - Parsons, Diaz and Jackson",REF49792635,0.0,610.28,3193.24
2015-08-30,2015-08-30,Project payment - Burns PLC,REF29925188,0.0,1071.58,4264.82
2015-08-30,2015-08-30,"Project payment - Brown, Ray and Torres",REF22159893,0.0,2102.6,6367.42
2015-09-04,2015-09-04,Permits Licenses expense,REF99446203,111.73,0.0,6255.69
2015-09-08,2015-09-08,Equipment Rental expense,REF65379578,530.83,0.0,5724.86
2015-09-09,2015-09-09,Vehicle Maintenance expense,REF55280375,214.99,0.0,5509.87
2015-09-11,2015-09-11,Fuel purchase,REF34960997,383.32,0.0,5126.55
2015-09-12,2015-09-12,Permits Licenses expense,REF99449741,53.98,0.0,5072.57
2015-09-12,2015-09-12,Safety Equipment expense,REF29527211,75.33,0.0,4997.24
2015-09-15,2015-09-15,Business materials,REF13212799,401.95,0.0,4595.29
2015-09-15,2015-09-15,"Payment from Leon, Jones and Jackson",REF97322526,0.0,548.16,5143.45
2015-09-15,2015-09-15,"Project payment - Brown, Ray and Torres",REF13447468,0.0,1224.64,6368.09
2015-09-15,2015-09-15,Payment from Cooper-Dean,REF10621677,0.0,1035.09,7403.18
2015-09-15,2015-09-15,Payment from Burns PLC,REF27269020,0.0,1200.13,8603.31
2015-09-15,2015-09-15,Business insurance premium,REF53625028,212.93,0.0,8390.38
2015-09-17,2015-09-17,Fuel purchase,REF72102886,281.94,0.0,8108.44
2015-09-19,2015-09-19,Vehicle Maintenance expense,REF42478505,202.84,0.0,7905.6
2015-09-21,2015-09-21,Permits Licenses expense,REF55398742,119.19,0.0,7786.41
2015-09-22,2015-09-22,Equipment Rental expense,REF17027554,291.23,0.0,7495.18
2015-09-23,2015-09-23,Vehicle Maintenance expense,REF69712664,171.45,0.0,7323.73
2015-09-24,2015-09-24,Business materials,REF10921658,1153.2,0.0,6170.53
2015-09-30,2015-09-30,Project payment - Burns PLC,REF25830637,0.0,886.06,7056.59
2015-09-30,2015-09-30,Payment from Cooper-Dean,REF29942062,0.0,804.4,7860.99
2015-09-30,2015-09-30,"Payment from Parsons, Diaz and Jackson",REF13765620,0.0,702.3,8563.29
2015-09-30,2015-09-30,"Project payment - Leon, Jones and Jackson",REF60840802,0.0,415.73,8979.02
2015-09-30,2015-09-30,"Service payment - Brown, Ray and Torres",REF81591000,0.0,2244.02,11223.04
2015-10-02,2015-10-02,Business materials,REF56242758,822.2,0.0,10400.84
2015-10-02,2015-10-02,Fuel purchase,REF96882607,385.34,0.0,10015.5
2015-10-03,2015-10-03,Vehicle Maintenance expense,REF74372882,79.38,0.0,9936.12
2015-10-06,2015-10-06,Fuel purchase,REF30061358,333.63,0.0,9602.49
2015-10-10,2015-10-10,Subcontractors expense,REF95528345,1179.57,0.0,8422.92
2015-10-10,2015-10-10,Business materials,REF70336549,487.75,0.0,7935.17
2015-10-12,2015-10-12,Tools expense,REF38955700,73.87,0.0,7861.3
2015-10-14,2015-10-14,Permits Licenses expense,REF86012955,72.06,0.0,7789.24
2015-10-14,2015-10-14,Vehicle Maintenance expense,REF58220409,211.69,0.0,7577.55
2015-10-15,2015-10-15,"Payment from Brown, Ray and Torres",REF42034992,0.0,1308.8,8886.35
2015-10-15,2015-10-15,Business insurance premium,REF56432773,215.87,0.0,8670.48
2015-10-15,2015-10-15,Fuel purchase,REF26099429,172.98,0.0,8497.5
2015-10-15,2015-10-15,"Invoice payment - Parsons, Diaz and Jackson",REF39750499,0.0,668.47,9165.97
2015-10-15,2015-10-15,"Payment from Leon, Jones and Jackson",REF90719571,0.0,465.87,9631.84
2015-10-15,2015-10-15,Service payment - Burns PLC,REF91277397,0.0,1090.85,10722.69
2015-10-15,2015-10-15,Project payment - Cooper-Dean,REF99685268,0.0,743.73,11466.42
2015-10-17,2015-10-17,Business materials,REF96741916,613.48,0.0,10852.94
2015-10-27,2015-10-27,Vehicle Maintenance expense,REF20842194,222.98,0.0,10629.96
2015-10-28,2015-10-28,Safety Equipment expense,REF15725874,67.8,0.0,10562.16
2015-10-28,2015-10-28,Subcontractors expense,REF43517862,697.79,0.0,9864.37
2015-10-29,2015-10-29,Fuel purchase,REF88909135,412.85,0.0,9451.52
2015-10-30,2015-10-30,Business materials,REF77200443,799.27,0.0,8652.25
2015-10-30,2015-10-30,"Service payment - Brown, Ray and Torres",REF46679294,0.0,1583.82,10236.07
2015-10-30,2015-10-30,Project payment - Burns PLC,REF63323919,0.0,916.37,11152.44
2015-10-30,2015-10-30,"Service payment - Parsons, Diaz and Jackson",REF73741754,0.0,657.39,11809.83
2015-10-30,2015-10-30,"Invoice payment - Leon, Jones and Jackson",REF15115056,0.0,428.73,12238.56
2015-11-02,2015-11-02,Vehicle Maintenance expense,REF29235111,154.51,0.0,12084.05
2015-11-04,2015-11-04,Equipment Rental expense,REF46353585,595.54,0.0,11488.51
2015-11-04,2015-11-04,Fuel purchase,REF57778800,219.77,0.0,11268.74
2015-11-11,2015-11-11,Safety Equipment expense,REF62096562,76.67,0.0,11192.07
2015-11-13,2015-11-13,Safety Equipment expense,REF59525238,65.64,0.0,11126.43
2015-11-14,2015-11-14,Fuel purchase,REF45438385,83.8,0.0,11042.63
2015-11-14,2015-11-14,Permits Licenses expense,REF48464981,43.86,0.0,10998.77
2015-11-15,2015-11-15,Payment from Cooper-Dean,REF56208973,0.0,538.25,11537.02
2015-11-15,2015-11-15,Business insurance premium,REF24775481,155.01,0.0,11382.01
2015-11-15,2015-11-15,Invoice payment - Burns PLC,REF47455838,0.0,815.83,12197.84
2015-11-15,2015-11-15,"Payment from Leon, Jones and Jackson",REF76903029,0.0,327.84,12525.68
2015-11-15,2015-11-15,"Project payment - Brown, Ray and Torres",REF38664479,0.0,1364.99,13890.67
2015-11-15,2015-11-15,"Invoice payment - Parsons, Diaz and Jackson",REF30862082,0.0,500.35,14391.02
2015-11-17,2015-11-17,Business materials,REF66676655,679.37,0.0,13711.65
2015-11-20,2015-11-20,Business materials,REF59227187,623.35,0.0,13088.3
2015-11-22,2015-11-22,Business materials,REF87249635,706.04,0.0,12382.26
2015-11-23,2015-11-23,Subcontractors expense,REF40451205,433.14,0.0,11949.12
2015-11-26,2015-11-26,Business materials,REF85723436,590.16,0.0,11358.96
2015-11-28,2015-11-28,Safety Equipment expense,REF50549503,45.6,0.0,11313.36
2015-11-30,2015-11-30,"Project payment - Leon, Jones and Jackson",REF52353088,0.0,307.11,11620.47
2015-11-30,2015-11-30,"Project payment - Brown, Ray and Torres",REF30121079,0.0,1004.46,12624.93
2015-11-30,2015-11-30,"Payment from Parsons, Diaz and Jackson",REF23049774,0.0,637.44,13262.37
2015-11-30,2015-11-30,Invoice payment - Cooper-Dean,REF47207983,0.0,608.89,13871.26
2015-12-04,2015-12-04,Safety Equipment expense,REF47981482,54.23,0.0,13817.03
2015-12-05,2015-12-05,Business materials,REF39302500,301.19,0.0,13515.84
2015-12-05,2015-12-05,Equipment Rental expense,REF59941761,306.31,0.0,13209.53
2015-12-07,2015-12-07,Fuel purchase,REF47583827,109.5,0.0,13100.03
2015-12-10,2015-12-10,Vehicle Maintenance expense,REF41791221,46.63,0.0,13053.4
2015-12-11,2015-12-11,Safety Equipment expense,REF14405135,63.91,0.0,12989.49
2015-12-11,2015-12-11,Business materials,REF90509992,543.09,0.0,12446.4
2015-12-11,2015-12-11,Permits Licenses expense,REF58080973,49.36,0.0,12397.04
2015-12-12,2015-12-12,Fuel purchase,REF74506572,301.87,0.0,12095.17
2015-12-15,2015-12-15,"Invoice payment - Brown, Ray and Torres",REF12457607,0.0,849.63,12944.8
2015-12-15,2015-12-15,Business insurance premium,REF35368511,121.35,0.0,12823.45
2015-12-15,2015-12-15,Payment from Cooper-Dean,REF99086933,0.0,358.55,13182.0
2015-12-15,2015-12-15,"Project payment - Parsons, Diaz and Jackson",REF70877131,0.0,320.58,13502.58
2015-12-15,2015-12-15,Service payment - Burns PLC,REF39576965,0.0,671.02,14173.6
2015-12-18,2015-12-18,Subcontractors expense,REF14743819,514.33,0.0,13659.27
2015-12-30,2015-12-30,Invoice payment - Cooper-Dean,REF71106218,0.0,556.09,14215.36
2015-12-30,2015-12-30,"Project payment - Brown, Ray and Torres",REF12238184,0.0,1078.09,15293.45
2015-12-30,2015-12-30,"Project payment - Leon, Jones and Jackson",REF88477818,0.0,271.74,15565.19
2015-12-30,2015-12-30,Project payment - Burns PLC,REF82832332,0.0,396.53,15961.72
2015-12-30,2015-12-30,"Payment from Parsons, Diaz and Jackson",REF71242318,0.0,376.69,16338.41
2016-01-01,2016-01-01,Tools expense,REF61492810,99.59,0.0,16238.82
2016-01-02,2016-01-02,Fuel purchase,REF63048071,165.59,0.0,16073.23
2016-01-02,2016-01-02,Subcontractors expense,REF79245169,701.12,0.0,15372.11
2016-01-02,2016-01-02,Permits Licenses expense,REF96937313,80.83,0.0,15291.28
2016-01-02,2016-01-02,Business materials,REF45945561,559.92,0.0,14731.36
2016-01-03,2016-01-03,Fuel purchase,REF18123974,133.13,0.0,14598.23
2016-01-08,2016-01-08,Business materials,REF46886778,501.36,0.0,14096.87
2016-01-09,2016-01-09,Fuel purchase,REF63311870,274.6,0.0,13822.27
2016-01-13,2016-01-13,Tools expense,REF65462833,90.13,0.0,13732.14
2016-01-14,2016-01-14,Fuel purchase,REF59859700,341.28,0.0,13390.86
2016-01-15,2016-01-15,"Project payment - Brown, Ray and Torres",REF69474875,0.0,1332.57,14723.43
2016-01-15,2016-01-15,"Service payment - Parsons, Diaz and Jackson",REF11887091,0.0,438.59,15162.02
2016-01-15,2016-01-15,Business materials,REF58728860,673.18,0.0,14488.84
2016-01-15,2016-01-15,Project payment - Burns PLC,REF83911720,0.0,722.15,15210.99
2016-01-15,2016-01-15,"Service payment - Leon, Jones and Jackson",REF49621452,0.0,296.76,15507.75
2016-01-15,2016-01-15,Payment from Cooper-Dean,REF98358656,0.0,476.47,15984.22
2016-01-15,2016-01-15,Business insurance premium,REF30841233,146.57,0.0,15837.65
2016-01-17,2016-01-17,Business materials,REF18583401,520.16,0.0,15317.49
2016-01-20,2016-01-20,Permits Licenses expense,REF85031069,76.75,0.0,15240.74
2016-01-27,2016-01-27,Equipment Rental expense,REF61500183,212.52,0.0,15028.22
2016-01-29,2016-01-29,Business materials,REF17770558,647.02,0.0,14381.2
2016-01-30,2016-01-30,"Service payment - Parsons, Diaz and Jackson",REF88097676,0.0,428.73,14809.93
2016-01-30,2016-01-30,"Invoice payment - Leon, Jones and Jackson",REF50806277,0.0,310.43,15120.36
2016-01-30,2016-01-30,"Project payment - Brown, Ray and Torres",REF23809967,0.0,1144.97,16265.33
2016-01-30,2016-01-30,Service payment - Cooper-Dean,REF79115524,0.0,581.2,16846.53
2016-01-31,2016-01-31,Business materials,REF29090994,241.26,0.0,16605.27
2016-02-03,2016-02-03,Business materials,REF17054501,794.57,0.0,15810.7
2016-02-07,2016-02-07,Business materials,REF53440801,777.54,0.0,15033.16
2016-02-09,2016-02-09,Tools expense,REF46566059,107.65,0.0,14925.51
2016-02-12,2016-02-12,Tools expense,REF78628865,81.56,0.0,14843.95
2016-02-15,2016-02-15,Service payment - Cooper-Dean,REF33004075,0.0,722.04,15565.99
2016-02-15,2016-02-15,Business insurance premium,REF78625131,171.3,0.0,15394.69
2016-02-15,2016-02-15,"Payment from Brown, Ray and Torres",REF82962416,0.0,1098.56,16493.25
2016-02-15,2016-02-15,"Invoice payment - Parsons, Diaz and Jackson",REF22569557,0.0,548.69,17041.94
2016-02-15,2016-02-15,"Invoice payment - Leon, Jones and Jackson",REF32101127,0.0,344.01,17385.95
2016-02-20,2016-02-20,Business materials,REF81955131,780.53,0.0,16605.42
2016-02-23,2016-02-23,Safety Equipment expense,REF69061270,38.83,0.0,16566.59
2016-02-27,2016-02-27,Safety Equipment expense,REF26033471,88.04,0.0,16478.55
2016-02-28,2016-02-28,"Project payment - Brown, Ray and Torres",REF39292162,0.0,1173.11,17651.66
2016-02-28,2016-02-28,"Invoice payment - Parsons, Diaz and Jackson",REF53426884,0.0,446.81,18098.47
2016-02-28,2016-02-28,"Payment from Leon, Jones and Jackson",REF40946779,0.0,277.1,18375.57
2016-02-28,2016-02-28,Invoice payment - Burns PLC,REF36729373,0.0,566.39,18941.96
2016-03-03,2016-03-03,Subcontractors expense,REF49555665,843.1,0.0,18098.86
2016-03-05,2016-03-05,Subcontractors expense,REF84644983,737.35,0.0,17361.51
2016-03-05,2016-03-05,Safety Equipment expense,REF72261744,78.12,0.0,17283.39
2016-03-13,2016-03-13,Business materials,REF22117812,861.62,0.0,16421.77
2016-03-15,2016-03-15,Business insurance premium,REF88249849,203.22,0.0,16218.55
2016-03-15,2016-03-15,Invoice payment - Cooper-Dean,REF19098026,0.0,598.27,16816.82
2016-03-15,2016-03-15,Invoice payment - Burns PLC,REF47646810,0.0,956.51,17773.33
2016-03-15,2016-03-15,"Project payment - Leon, Jones and Jackson",REF81004191,0.0,457.38,18230.71
2016-03-15,2016-03-15,"Invoice payment - Brown, Ray and Torres",REF86850752,0.0,1379.28,19609.99
2016-03-15,2016-03-15,Business materials,REF36082615,582.15,0.0,19027.84
2016-03-19,2016-03-19,Equipment Rental expense,REF79430374,351.16,0.0,18676.68
2016-03-24,2016-03-24,Business materials,REF86343089,1145.53,0.0,17531.15
2016-03-24,2016-03-24,Equipment Rental expense,REF95144625,442.12,0.0,17089.03
2016-03-27,2016-03-27,Permits Licenses expense,REF24923246,79.54,0.0,17009.49
2016-03-27,2016-03-27,Safety Equipment expense,REF75363099,61.04,0.0,16948.45
2016-03-28,2016-03-28,Business materials,REF96054481,628.16,0.0,16320.29
2016-03-29,2016-03-29,Vehicle Maintenance expense,REF79469653,184.9,0.0,16135.39
2016-03-30,2016-03-30,"Project payment - Parsons, Diaz and Jackson",REF26310648,0.0,552.42,16687.81
2016-03-30,2016-03-30,"Project payment - Brown, Ray and Torres",REF59398108,0.0,1790.32,18478.13
2016-03-30,2016-03-30,"Project payment - Leon, Jones and Jackson",REF63657159,0.0,444.4,18922.53
2016-03-30,2016-03-30,Invoice payment - Cooper-Dean,REF42696364,0.0,861.1,19783.63
2016-03-30,2016-03-30,Project payment - Burns PLC,REF74678617,0.0,966.73,20750.36
2016-03-30,2016-03-30,Fuel purchase,REF77197208,371.1,0.0,20379.26
2016-04-02,2016-04-02,Business materials,REF20544766,538.27,0.0,19840.99
2016-04-04,2016-04-04,Business materials,REF11182370,965.01,0.0,18875.98
2016-04-06,2016-04-06,Fuel purchase,REF29244056,389.66,0.0,18486.32
2016-04-09,2016-04-09,Safety Equipment expense,REF90655606,84.53,0.0,18401.79
2016-04-09,2016-04-09,Fuel purchase,REF94563464,148.89,0.0,18252.9
2016-04-12,2016-04-12,Tools expense,REF90154880,111.66,0.0,18141.24
2016-04-15,2016-04-15,"Payment from Leon, Jones and Jackson",REF93259158,0.0,449.95,18591.19
2016-04-15,2016-04-15,Service payment - Burns PLC,REF74975436,0.0,1263.28,19854.47
2016-04-15,2016-04-15,Payment from Cooper-Dean,REF26800907,0.0,1014.94,20869.41
2016-04-15,2016-04-15,"Payment from Parsons, Diaz and Jackson",REF48146735,0.0,754.95,21624.36
2016-04-15,2016-04-15,"Service payment - Brown, Ray and Torres",REF76196863,0.0,2420.93,24045.29
2016-04-15,2016-04-15,Business insurance premium,REF26280819,226.3,0.0,23818.99
2016-04-17,2016-04-17,Subcontractors expense,REF85375092,1034.63,0.0,22784.36
2016-04-17,2016-04-17,Fuel purchase,REF86656903,365.66,0.0,22418.7
2016-04-18,2016-04-18,Permits Licenses expense,REF81716087,122.15,0.0,22296.55
2016-04-19,2016-04-19,Business materials,REF64634086,807.66,0.0,21488.89
2016-04-23,2016-04-23,Fuel purchase,REF44627205,394.38,0.0,21094.51
2016-04-27,2016-04-27,Business materials,REF65938865,761.02,0.0,20333.49
2016-04-30,2016-04-30,Project payment - Cooper-Dean,REF75464035,0.0,879.26,21212.75
2016-04-30,2016-04-30,Payment from Burns PLC,REF46799066,0.0,771.17,21983.92
2016-04-30,2016-04-30,"Invoice payment - Brown, Ray and Torres",REF72606537,0.0,1091.89,23075.81
2016-04-30,2016-04-30,"Service payment - Leon, Jones and Jackson",REF23140068,0.0,548.89,23624.7
2016-05-07,2016-05-07,Business materials,REF31291771,867.91,0.0,22756.79
2016-05-08,2016-05-08,Business materials,REF31126695,977.57,0.0,21779.22
2016-05-09,2016-05-09,Fuel purchase,REF23904509,342.39,0.0,21436.83
2016-05-11,2016-05-11,Business materials,REF83069995,1358.63,0.0,20078.2
2016-05-12,2016-05-12,Tools expense,REF33540283,138.14,0.0,19940.06
2016-05-15,2016-05-15,"Payment from Parsons, Diaz and Jackson",REF87419954,0.0,781.78,20721.84
2016-05-15,2016-05-15,Payment from Burns PLC,REF78144795,0.0,1355.68,22077.52
2016-05-15,2016-05-15,Business insurance premium,REF86038725,267.62,0.0,21809.9
2016-05-15,2016-05-15,"Project payment - Leon, Jones and Jackson",REF64339591,0.0,437.78,22247.68
2016-05-15,2016-05-15,"Payment from Brown, Ray and Torres",REF29852312,0.0,1864.44,24112.12
2016-05-15,2016-05-15,Service payment - Cooper-Dean,REF71719018,0.0,1154.63,25266.75
2016-05-15,2016-05-15,Vehicle Maintenance expense,REF87579666,5.0,0.0,25261.75
2016-05-17,2016-05-17,Business materials,REF97433634,1297.77,0.0,23963.98
2016-05-18,2016-05-18,Tools expense,REF35374929,194.63,0.0,23769.35
2016-05-19,2016-05-19,Permits Licenses expense,REF72609572,99.51,0.0,23669.84
2016-05-22,2016-05-22,Fuel purchase,REF66278170,602.71,0.0,23067.13
2016-05-24,2016-05-24,Business materials,REF97291058,1410.85,0.0,21656.28
2016-05-29,2016-05-29,Business materials,REF44420860,920.59,0.0,20735.69
2016-05-30,2016-05-30,"Service payment - Parsons, Diaz and Jackson",REF46967980,0.0,613.85,21349.54
2016-05-30,2016-05-30,Project payment - Cooper-Dean,REF63329051,0.0,881.24,22230.78
2016-05-30,2016-05-30,Invoice payment - Burns PLC,REF88772402,0.0,1327.8,23558.58
2016-05-30,2016-05-30,"Invoice payment - Brown, Ray and Torres",REF32755989,0.0,2282.35,25840.93
2016-05-31,2016-05-31,Fuel purchase,REF59844256,385.17,0.0,25455.76
2016-06-02,2016-06-02,Business materials,REF26065401,1260.09,0.0,24195.67
2016-06-04,2016-06-04,Business materials,REF34455874,972.58,0.0,23223.09
2016-06-08,2016-06-08,Tools expense,REF72810113,143.22,0.0,23079.87
2016-06-11,2016-06-11,Safety Equipment expense,REF60772053,90.92,0.0,22988.95
2016-06-15,2016-06-15,Business insurance premium,REF71388153,241.6,0.0,22747.35
2016-06-15,2016-06-15,Invoice payment - Cooper-Dean,REF90224366,0.0,815.2,23562.55
2016-06-15,2016-06-15,Payment from Burns PLC,REF67638405,0.0,806.17,24368.72
2016-06-15,2016-06-15,"Service payment - Parsons, Diaz and Jackson",REF50379501,0.0,791.55,25160.27
2016-06-15,2016-06-15,"Service payment - Leon, Jones and Jackson",REF92667741,0.0,287.46,25447.73
2016-06-15,2016-06-15,"Invoice payment - Brown, Ray and Torres",REF50612450,0.0,2051.75,27499.48
2016-06-16,2016-06-16,Fuel purchase,REF28104990,465.35,0.0,27034.13
2016-06-18,2016-06-18,Tools expense,REF37791554,210.38,0.0,26823.75
2016-06-21,2016-06-21,Vehicle Maintenance expense,REF56852425,104.02,0.0,26719.73
2016-06-30,2016-06-30,"Payment from Parsons, Diaz and Jackson",REF93681672,0.0,473.72,27193.45
2016-06-30,2016-06-30,Fuel purchase,REF58249761,303.4,0.0,26890.05
2016-06-30,2016-06-30,"Service payment - Brown, Ray and Torres",REF76785838,0.0,2249.77,29139.82
2016-06-30,2016-06-30,"Project payment - Leon, Jones and Jackson",REF33670228,0.0,532.73,29672.55
2016-06-30,2016-06-30,Project payment - Burns PLC,REF24773874,0.0,1198.18,30870.73
2016-06-30,2016-06-30,Project payment - Cooper-Dean,REF40788310,0.0,1049.76,31920.49
2016-07-06,2016-07-06,Tools expense,REF37424333,80.46,0.0,31840.03
2016-07-06,2016-07-06,Business materials,REF39785999,727.74,0.0,31112.29
2016-07-12,2016-07-12,Fuel purchase,REF98150416,395.33,0.0,30716.96
2016-07-15,2016-07-15,Business insurance premium,REF61300687,238.59,0.0,30478.37
2016-07-15,2016-07-15,Payment from Cooper-Dean,REF89758699,0.0,756.33,31234.7
2016-07-15,2016-07-15,"Payment from Leon, Jones and Jackson",REF15009166,0.0,489.8,31724.5
2016-07-15,2016-07-15,"Service payment - Parsons, Diaz and Jackson",REF29957926,0.0,654.43,32378.93
2016-07-15,2016-07-15,Invoice payment - Burns PLC,REF85447174,0.0,1107.33,33486.26
2016-07-15,2016-07-15,"Project payment - Brown, Ray and Torres",REF12342011,0.0,2330.18,35816.44
2016-07-19,2016-07-19,Business materials,REF27700267,958.76,0.0,34857.68
2016-07-22,2016-07-22,Subcontractors expense,REF46453219,920.49,0.0,33937.19
2016-07-25,2016-07-25,Business materials,REF33482693,509.18,0.0,33428.01
2016-07-30,2016-07-30,Payment from Cooper-Dean,REF55417197,0.0,672.26,34100.27
2016-07-30,2016-07-30,"Payment from Brown, Ray and Torres",REF16476537,0.0,1547.72,35647.99
2016-07-30,2016-07-30,Service payment - Burns PLC,REF92243886,0.0,1176.83,36824.82
2016-07-30,2016-07-30,"Service payment - Leon, Jones and Jackson",REF16072443,0.0,478.09,37302.91
2016-07-30,2016-07-30,"Payment from Parsons, Diaz and Jackson",REF79011331,0.0,727.35,38030.26
2016-08-01,2016-08-01,Vehicle Maintenance expense,REF16032196,203.6,0.0,37826.66
2016-08-03,2016-08-03,Business materials,REF90554740,1018.98,0.0,36807.68
2016-08-06,2016-08-06,Equipment Rental expense,REF57682882,379.53,0.0,36428.15
2016-08-08,2016-08-08,Business materials,REF85771783,770.91,0.0,35657.24
2016-08-11,2016-08-11,Fuel purchase,REF65526840,309.77,0.0,35347.47
2016-08-13,2016-08-13,Vehicle Maintenance expense,REF95106428,183.47,0.0,35164.0
2016-08-14,2016-08-14,Business materials,REF94644329,841.27,0.0,34322.73
2016-08-15,2016-08-15,Business insurance premium,REF89650407,254.07,0.0,34068.66
2016-08-15,2016-08-15,"Payment from Brown, Ray and Torres",REF56091569,0.0,1906.03,35974.69
2016-08-15,2016-08-15,Invoice payment - Cooper-Dean,REF77707021,0.0,1009.36,36984.05
2016-08-15,2016-08-15,"Payment from Parsons, Diaz and Jackson",REF58524672,0.0,779.91,37763.96
2016-08-15,2016-08-15,"Invoice payment - Leon, Jones and Jackson",REF53412993,0.0,490.51,38254.47
2016-08-15,2016-08-15,Payment from Burns PLC,REF54921296,0.0,946.41,39200.88
2016-08-15,2016-08-15,Business materials,REF95527706,1323.62,0.0,37877.26
2016-08-21,2016-08-21,Business materials,REF71554228,1193.27,0.0,36683.99
2016-08-23,2016-08-23,Equipment Rental expense,REF10491059,389.11,0.0,36294.88
2016-08-27,2016-08-27,Safety Equipment expense,REF63155657,117.9,0.0,36176.98
2016-08-30,2016-08-30,"Project payment - Brown, Ray and Torres",REF28880876,0.0,2094.4,38271.38
2016-08-30,2016-08-30,"Invoice payment - Leon, Jones and Jackson",REF21217829,0.0,508.62,38780.0
2016-08-30,2016-08-30,"Payment from Parsons, Diaz and Jackson",REF92089206,0.0,406.62,39186.62
2016-08-30,2016-08-30,Invoice payment - Burns PLC,REF92573820,0.0,1126.12,40312.74
2016-08-30,2016-08-30,Payment from Cooper-Dean,REF24877069,0.0,757.95,41070.69
2016-09-01,2016-09-01,Business materials,REF13226228,813.85,0.0,40256.84
2016-09-05,2016-09-05,Safety Equipment expense,REF38898789,98.2,0.0,40158.64
2016-09-09,2016-09-09,Business materials,REF82246879,732.71,0.0,39425.93
2016-09-12,2016-09-12,Fuel purchase,REF17537935,410.32,0.0,39015.61
2016-09-15,2016-09-15,"Payment from Leon, Jones and Jackson",REF71400055,0.0,376.44,39392.05
2016-09-15,2016-09-15,Business insurance premium,REF76792192,225.87,0.0,39166.18
2016-09-15,2016-09-15,Service payment - Cooper-Dean,REF65306385,0.0,658.46,39824.64
2016-09-15,2016-09-15,"Project payment - Brown, Ray and Torres",REF52131463,0.0,1918.56,41743.2
2016-09-15,2016-09-15,"Payment from Parsons, Diaz and Jackson",REF60566718,0.0,574.49,42317.69
2016-09-15,2016-09-15,Payment from Burns PLC,REF84678468,0.0,1021.43,43339.12
2016-09-16,2016-09-16,Safety Equipment expense,REF63482658,60.61,0.0,43278.51
2016-09-19,2016-09-19,Business materials,REF77832110,1115.57,0.0,42162.94
2016-09-19,2016-09-19,Fuel purchase,REF14237460,485.96,0.0,41676.98
2016-09-22,2016-09-22,Equipment Rental expense,REF50196152,601.4,0.0,41075.58
2016-09-23,2016-09-23,Business materials,REF91717893,661.23,0.0,40414.35
2016-09-25,2016-09-25,Business materials,REF59268750,512.7,0.0,39901.65
2016-09-26,2016-09-26,Fuel purchase,REF72743051,289.43,0.0,39612.22
2016-09-30,2016-09-30,"Project payment - Brown, Ray and Torres",REF12121727,0.0,1605.79,41218.01
2016-09-30,2016-09-30,Invoice payment - Cooper-Dean,REF49218508,0.0,549.83,41767.84
2016-09-30,2016-09-30,Payment from Burns PLC,REF21362001,0.0,866.54,42634.38
2016-09-30,2016-09-30,"Project payment - Parsons, Diaz and Jackson",REF61472079,0.0,766.91,43401.29
2016-09-30,2016-09-30,"Project payment - Leon, Jones and Jackson",REF46695072,0.0,520.88,43922.17
2016-10-03,2016-10-03,Business materials,REF48691706,930.26,0.0,42991.91
2016-10-05,2016-10-05,Business materials,REF62285871,586.17,0.0,42405.74
2016-10-15,2016-10-15,"Service payment - Brown, Ray and Torres",REF38156097,0.0,1159.28,43565.02
2016-10-15,2016-10-15,Business insurance premium,REF99025751,187.24,0.0,43377.78
2016-10-15,2016-10-15,Payment from Burns PLC,REF59325659,0.0,785.99,44163.77
2016-10-15,2016-10-15,"Project payment - Leon, Jones and Jackson",REF25745551,0.0,309.46,44473.23
2016-10-15,2016-10-15,Payment from Cooper-Dean,REF55106654,0.0,808.86,45282.09
2016-10-15,2016-10-15,"Service payment - Parsons, Diaz and Jackson",REF53431623,0.0,450.94,45733.03
2016-10-16,2016-10-16,Business materials,REF59162375,771.75,0.0,44961.28
2016-10-20,2016-10-20,Fuel purchase,REF61655834,358.95,0.0,44602.33
2016-10-22,2016-10-22,Subcontractors expense,REF56731680,392.54,0.0,44209.79
2016-10-29,2016-10-29,Fuel purchase,REF31358596,328.81,0.0,43880.98
2016-10-30,2016-10-30,Invoice payment - Cooper-Dean,REF85584029,0.0,759.06,44640.04
2016-10-30,2016-10-30,"Service payment - Parsons, Diaz and Jackson",REF34533153,0.0,679.92,45319.96
2016-10-30,2016-10-30,"Service payment - Brown, Ray and Torres",REF54330498,0.0,1614.67,46934.63
2016-11-01,2016-11-01,Fuel purchase,REF81546628,256.93,0.0,46677.7
2016-11-02,2016-11-02,Business materials,REF32640643,701.38,0.0,45976.32
2016-11-08,2016-11-08,Safety Equipment expense,REF49416235,77.57,0.0,45898.75
2016-11-08,2016-11-08,Fuel purchase,REF49957817,216.32,0.0,45682.43
2016-11-09,2016-11-09,Fuel purchase,REF62636723,243.17,0.0,45439.26
2016-11-11,2016-11-11,Business materials,REF88788999,467.27,0.0,44971.99
2016-11-12,2016-11-12,Equipment Rental expense,REF23772910,311.1,0.0,44660.89
2016-11-13,2016-11-13,Permits Licenses expense,REF43978488,89.62,0.0,44571.27
2016-11-15,2016-11-15,Business insurance premium,REF69543627,162.73,0.0,44408.54
2016-11-15,2016-11-15,"Payment from Leon, Jones and Jackson",REF28573217,0.0,373.87,44782.41
2016-11-15,2016-11-15,Payment from Cooper-Dean,REF10387008,0.0,559.13,45341.54
2016-11-15,2016-11-15,"Service payment - Parsons, Diaz and Jackson",REF19296167,0.0,496.15,45837.69
2016-11-15,2016-11-15,"Service payment - Brown, Ray and Torres",REF28463399,0.0,1334.75,47172.44
2016-11-18,2016-11-18,Safety Equipment expense,REF40186852,85.48,0.0,47086.96
2016-11-19,2016-11-19,Fuel purchase,REF59782065,254.23,0.0,46832.73
2016-11-30,2016-11-30,"Project payment - Leon, Jones and Jackson",REF45905030,0.0,304.32,47137.05
2016-11-30,2016-11-30,Invoice payment - Burns PLC,REF13220071,0.0,966.04,48103.09
2016-11-30,2016-11-30,"Service payment - Parsons, Diaz and Jackson",REF12589872,0.0,548.82,48651.91
2016-11-30,2016-11-30,Fuel purchase,REF17528235,185.87,0.0,48466.04
2016-11-30,2016-11-30,Project payment - Cooper-Dean,REF95613683,0.0,692.42,49158.46
2016-12-06,2016-12-06,Equipment Rental expense,REF24618886,226.03,0.0,48932.43
2016-12-09,2016-12-09,Equipment Rental expense,REF80150077,190.03,0.0,48742.4
2016-12-11,2016-12-11,Equipment Rental expense,REF44792763,221.87,0.0,48520.53
2016-12-12,2016-12-12,Tools expense,REF64661521,58.18,0.0,48462.35
2016-12-15,2016-12-15,"Invoice payment - Parsons, Diaz and Jackson",REF49105481,0.0,402.51,48864.86
2016-12-15,2016-12-15,Project payment - Cooper-Dean,REF88036491,0.0,403.69,49268.55
2016-12-15,2016-12-15,"Payment from Leon, Jones and Jackson",REF47689797,0.0,278.02,49546.57
2016-12-15,2016-12-15,Safety Equipment expense,REF81481767,44.37,0.0,49502.2
2016-12-15,2016-12-15,Business insurance premium,REF89303321,118.88,0.0,49383.32
2016-12-15,2016-12-15,"Invoice payment - Brown, Ray and Torres",REF43202292,0.0,980.16,50363.48
2016-12-15,2016-12-15,Business materials,REF53415589,613.84,0.0,49749.64
2016-12-21,2016-12-21,Subcontractors expense,REF53558605,738.02,0.0,49011.62
2016-12-24,2016-12-24,Subcontractors expense,REF25159274,562.64,0.0,48448.98
2016-12-26,2016-12-26,Equipment Rental expense,REF23340716,104.07,0.0,48344.91
2016-12-29,2016-12-29,Safety Equipment expense,REF29834737,41.45,0.0,48303.46
2016-12-30,2016-12-30,Fuel purchase,REF49374375,125.26,0.0,48178.2
2016-12-30,2016-12-30,Service payment - Cooper-Dean,REF71191540,0.0,379.13,48557.33
2016-12-30,2016-12-30,"Service payment - Parsons, Diaz and Jackson",REF70138776,0.0,321.9,48879.23
2016-12-30,2016-12-30,Payment from Burns PLC,REF87001098,0.0,582.09,49461.32
2016-12-30,2016-12-30,"Project payment - Leon, Jones and Jackson",REF54037441,0.0,126.16,49587.48
2016-12-30,2016-12-30,"Invoice payment - Brown, Ray and Torres",REF81221227,0.0,898.09,50485.57
2017-01-06,2017-01-06,Safety Equipment expense,REF48304734,82.68,0.0,50402.89
2017-01-07,2017-01-07,Business materials,REF92988774,644.5,0.0,49758.39
2017-01-15,2017-01-15,Business insurance premium,REF34222206,151.3,0.0,49607.09
2017-01-15,2017-01-15,"Payment from Leon, Jones and Jackson",REF79796105,0.0,337.92,49945.01
2017-01-15,2017-01-15,Service payment - Cooper-Dean,REF47069965,0.0,351.06,50296.07
2017-01-15,2017-01-15,"Project payment - Parsons, Diaz and Jackson",REF34844370,0.0,334.3,50630.37
2017-01-15,2017-01-15,Invoice payment - Burns PLC,REF98289714,0.0,652.49,51282.86
2017-01-16,2017-01-16,Vehicle Maintenance expense,REF87882540,72.12,0.0,51210.74
2017-01-17,2017-01-17,Equipment Rental expense,REF99062567,367.48,0.0,50843.26
2017-01-24,2017-01-24,Subcontractors expense,REF68604851,758.89,0.0,50084.37
2017-01-27,2017-01-27,Business materials,REF23720952,440.85,0.0,49643.52
2017-01-30,2017-01-30,Project payment - Burns PLC,REF42476684,0.0,816.37,50459.89
2017-01-30,2017-01-30,"Service payment - Leon, Jones and Jackson",REF24322751,0.0,176.26,50636.15
2017-01-30,2017-01-30,Payment from Cooper-Dean,REF85138579,0.0,429.57,51065.72
2017-01-30,2017-01-30,"Payment from Parsons, Diaz and Jackson",REF60822474,0.0,441.05,51506.77
2017-02-01,2017-02-01,Equipment Rental expense,REF82868605,239.69,0.0,51267.08
2017-02-05,2017-02-05,Subcontractors expense,REF79787210,911.07,0.0,50356.01
2017-02-05,2017-02-05,Vehicle Maintenance expense,REF17215511,47.59,0.0,50308.42
2017-02-05,2017-02-05,Equipment Rental expense,REF94332522,431.7,0.0,49876.72
2017-02-07,2017-02-07,Business materials,REF72308927,617.76,0.0,49258.96
2017-02-08,2017-02-08,Business materials,REF17343194,786.03,0.0,48472.93
2017-02-11,2017-02-11,Fuel purchase,REF97850902,335.62,0.0,48137.31
2017-02-13,2017-02-13,Equipment Rental expense,REF34544035,330.99,0.0,47806.32
2017-02-13,2017-02-13,Fuel purchase,REF38467534,268.4,0.0,47537.92
2017-02-15,2017-02-15,"Service payment - Parsons, Diaz and Jackson",REF71240714,0.0,386.96,47924.88
2017-02-15,2017-02-15,Business insurance premium,REF39080530,165.68,0.0,47759.2
2017-02-15,2017-02-15,Invoice payment - Cooper-Dean,REF36241157,0.0,579.06,48338.26
2017-02-15,2017-02-15,"Invoice payment - Leon, Jones and Jackson",REF59945395,0.0,269.12,48607.38
2017-02-15,2017-02-15,"Invoice payment - Brown, Ray and Torres",REF27346387,0.0,1203.88,49811.26
2017-02-15,2017-02-15,Payment from Burns PLC,REF40859752,0.0,686.14,50497.4
2017-02-16,2017-02-16,Equipment Rental expense,REF86553573,396.87,0.0,50100.53
2017-02-19,2017-02-19,Subcontractors expense,REF14206888,1019.42,0.0,49081.11
2017-02-20,2017-02-20,Equipment Rental expense,REF25187451,361.84,0.0,48719.27
2017-02-21,2017-02-21,Equipment Rental expense,REF16107273,174.84,0.0,48544.43
2017-02-22,2017-02-22,Fuel purchase,REF16548265,245.21,0.0,48299.22
2017-02-24,2017-02-24,Fuel purchase,REF40845459,244.89,0.0,48054.33
2017-02-25,2017-02-25,Business materials,REF99278721,878.0,0.0,47176.33
2017-02-25,2017-02-25,Subcontractors expense,REF44720523,905.62,0.0,46270.71
2017-02-28,2017-02-28,"Invoice payment - Parsons, Diaz and Jackson",REF92807637,0.0,569.3,46840.01
2017-02-28,2017-02-28,"Project payment - Leon, Jones and Jackson",REF56652597,0.0,342.58,47182.59
2017-02-28,2017-02-28,Payment from Burns PLC,REF89603558,0.0,701.48,47884.07
2017-02-28,2017-02-28,Service payment - Cooper-Dean,REF72422895,0.0,484.96,48369.03
2017-02-28,2017-02-28,Fuel purchase,REF33266287,254.84,0.0,48114.19
2017-03-06,2017-03-06,Tools expense,REF17330379,100.41,0.0,48013.78
2017-03-08,2017-03-08,Fuel purchase,REF15301271,123.3,0.0,47890.48
2017-03-11,2017-03-11,Business materials,REF19973960,1076.29,0.0,46814.19
2017-03-15,2017-03-15,"Invoice payment - Leon, Jones and Jackson",REF38278276,0.0,528.57,47342.76
2017-03-15,2017-03-15,"Project payment - Brown, Ray and Torres",REF88298788,0.0,1819.22,49161.98
2017-03-15,2017-03-15,Business insurance premium,REF47279069,215.08,0.0,48946.9
2017-03-15,2017-03-15,Invoice payment - Burns PLC,REF49331830,0.0,1035.39,49982.29
2017-03-15,2017-03-15,Service payment - Cooper-Dean,REF39770246,0.0,954.06,50936.35
2017-03-15,2017-03-15,"Payment from Parsons, Diaz and Jackson",REF94872440,0.0,499.17,51435.52
2017-03-22,2017-03-22,Fuel purchase,REF13327826,393.35,0.0,51042.17
2017-03-22,2017-03-22,Business materials,REF50750210,828.78,0.0,50213.39
2017-03-23,2017-03-23,Business materials,REF66087358,898.95,0.0,49314.44
2017-03-23,2017-03-23,Fuel purchase,REF35893149,391.56,0.0,48922.88
2017-03-24,2017-03-24,Permits Licenses expense,REF81331581,77.44,0.0,48845.44
2017-03-30,2017-03-30,"Project payment - Brown, Ray and Torres",REF18050370,0.0,1499.36,50344.8
2017-03-30,2017-03-30,"Invoice payment - Parsons, Diaz and Jackson",REF32724439,0.0,493.63,50838.43
2017-03-30,2017-03-30,Invoice payment - Burns PLC,REF69503676,0.0,904.96,51743.39
2017-03-30,2017-03-30,Invoice payment - Cooper-Dean,REF87500754,0.0,738.95,52482.34
2017-03-30,2017-03-30,"Project payment - Leon, Jones and Jackson",REF67240109,0.0,390.84,52873.18
2017-04-01,2017-04-01,Equipment Rental expense,REF82171725,520.17,0.0,52353.01
2017-04-04,2017-04-04,Business materials,REF51992652,1088.95,0.0,51264.06
2017-04-05,2017-04-05,Business materials,REF99653177,611.48,0.0,50652.58
2017-04-07,2017-04-07,Fuel purchase,REF84890024,522.38,0.0,50130.2
2017-04-07,2017-04-07,Safety Equipment expense,REF60987343,90.59,0.0,50039.61
2017-04-07,2017-04-07,Business materials,REF24816668,778.5,0.0,49261.11
2017-04-08,2017-04-08,Fuel purchase,REF74193012,329.35,0.0,48931.76
2017-04-09,2017-04-09,Business materials,REF54450107,1126.06,0.0,47805.7
2017-04-09,2017-04-09,Fuel purchase,REF48388939,466.43,0.0,47339.27
2017-04-10,2017-04-10,Business materials,REF87880221,1201.24,0.0,46138.03
2017-04-15,2017-04-15,Business insurance premium,REF12323094,245.22,0.0,45892.81
2017-04-15,2017-04-15,"Service payment - Brown, Ray and Torres",REF72738392,0.0,1540.9,47433.71
2017-04-15,2017-04-15,Payment from Burns PLC,REF91375728,0.0,1016.69,48450.4
2017-04-15,2017-04-15,"Project payment - Parsons, Diaz and Jackson",REF98484623,0.0,702.41,49152.81
2017-04-15,2017-04-15,Project payment - Cooper-Dean,REF28275324,0.0,852.46,50005.27
2017-04-15,2017-04-15,Business materials,REF35774068,1302.23,0.0,48703.04
2017-04-15,2017-04-15,"Payment from Leon, Jones and Jackson",REF50088188,0.0,483.08,49186.12
2017-04-17,2017-04-17,Equipment Rental expense,REF63002939,549.83,0.0,48636.29
2017-04-20,2017-04-20,Permits Licenses expense,REF24309833,106.48,0.0,48529.81
2017-04-24,2017-04-24,Fuel purchase,REF83186987,364.73,0.0,48165.08
2017-04-24,2017-04-24,Tools expense,REF94975210,134.08,0.0,48031.0
2017-04-24,2017-04-24,Safety Equipment expense,REF12019891,80.14,0.0,47950.86
2017-04-25,2017-04-25,Vehicle Maintenance expense,REF45212727,153.64,0.0,47797.22
2017-04-27,2017-04-27,Subcontractors expense,REF20017998,1705.34,0.0,46091.88
2017-04-28,2017-04-28,Business materials,REF75478378,680.45,0.0,45411.43
2017-04-30,2017-04-30,"Service payment - Brown, Ray and Torres",REF41434481,0.0,1876.94,47288.37
2017-04-30,2017-04-30,Service payment - Burns PLC,REF86075153,0.0,1007.9,48296.27
2017-04-30,2017-04-30,"Payment from Parsons, Diaz and Jackson",REF13280149,0.0,767.44,49063.71
2017-04-30,2017-04-30,Project payment - Cooper-Dean,REF40703786,0.0,941.17,50004.88
2017-04-30,2017-04-30,"Invoice payment - Leon, Jones and Jackson",REF54985944,0.0,450.97,50455.85
2017-05-01,2017-05-01,Business materials,REF60310601,880.67,0.0,49575.18
2017-05-02,2017-05-02,Subcontractors expense,REF21422819,1516.99,0.0,48058.19
2017-05-02,2017-05-02,Vehicle Maintenance expense,REF12229715,108.58,0.0,47949.61
2017-05-06,2017-05-06,Tools expense,REF12262863,217.84,0.0,47731.77
2017-05-06,2017-05-06,Business materials,REF14555190,454.0,0.0,47277.77
2017-05-08,2017-05-08,Fuel purchase,REF42539879,323.56,0.0,46954.21
2017-05-09,2017-05-09,Fuel purchase,REF95066792,456.13,0.0,46498.08
2017-05-11,2017-05-11,Fuel purchase,REF60948459,147.87,0.0,46350.21
2017-05-13,2017-05-13,Permits Licenses expense,REF82745673,108.0,0.0,46242.21
2017-05-14,2017-05-14,Business materials,REF49345272,1451.64,0.0,44790.57
2017-05-15,2017-05-15,"Service payment - Leon, Jones and Jackson",REF90018763,0.0,563.24,45353.81
2017-05-15,2017-05-15,"Invoice payment - Brown, Ray and Torres",REF16551127,0.0,1867.16,47220.97
2017-05-15,2017-05-15,"Invoice payment - Parsons, Diaz and Jackson",REF76959762,0.0,681.56,47902.53
2017-05-15,2017-05-15,Service payment - Cooper-Dean,REF88628106,0.0,1178.41,49080.94
2017-05-15,2017-05-15,Business insurance premium,REF98308202,288.61,0.0,48792.33
2017-05-15,2017-05-15,Payment from Burns PLC,REF98557058,0.0,1347.28,50139.61
2017-05-16,2017-05-16,Business materials,REF69119739,686.18,0.0,49453.43
2017-05-16,2017-05-16,Equipment Rental expense,REF81541041,504.76,0.0,48948.67
2017-05-22,2017-05-22,Tools expense,REF74298892,96.29,0.0,48852.38
2017-05-30,2017-05-30,Payment from Cooper-Dean,REF29754095,0.0,868.09,49720.47
2017-05-30,2017-05-30,Service payment - Burns PLC,REF90200755,0.0,1090.87,50811.34
2017-05-30,2017-05-30,"Payment from Parsons, Diaz and Jackson",REF40574129,0.0,876.51,51687.85
2017-05-30,2017-05-30,"Payment from Leon, Jones and Jackson",REF82317329,0.0,417.47,52105.32
2017-06-02,2017-06-02,Equipment Rental expense,REF63363093,477.27,0.0,51628.05
2017-06-04,2017-06-04,Tools expense,REF89619392,132.57,0.0,51495.48
2017-06-05,2017-06-05,Business materials,REF30012604,1608.13,0.0,49887.35
2017-06-09,2017-06-09,Vehicle Maintenance expense,REF35512480,302.06,0.0,49585.29
2017-06-14,2017-06-14,Safety Equipment expense,REF65142608,96.67,0.0,49488.62
2017-06-14,2017-06-14,Business materials,REF64453736,986.42,0.0,48502.2
2017-06-15,2017-06-15,Business insurance premium,REF99875030,281.66,0.0,48220.54
2017-06-15,2017-06-15,Project payment - Cooper-Dean,REF80954581,0.0,811.91,49032.45
2017-06-15,2017-06-15,"Project payment - Leon, Jones and Jackson",REF45147796,0.0,355.15,49387.6
2017-06-15,2017-06-15,"Invoice payment - Parsons, Diaz and Jackson",REF20869164,0.0,838.0,50225.6
2017-06-15,2017-06-15,Project payment - Burns PLC,REF98400420,0.0,1037.85,51263.45
2017-06-15,2017-06-15,"Service payment - Brown, Ray and Torres",REF40920847,0.0,1813.16,53076.61
2017-06-20,2017-06-20,Fuel purchase,REF24768992,264.98,0.0,52811.63
2017-06-26,2017-06-26,Fuel purchase,REF11447575,363.32,0.0,52448.31
2017-06-27,2017-06-27,Tools expense,REF86367126,72.37,0.0,52375.94
2017-06-27,2017-06-27,Safety Equipment expense,REF42540072,70.24,0.0,52305.7
2017-06-29,2017-06-29,Business materials,REF66883133,1115.97,0.0,51189.73
2017-06-30,2017-06-30,"Service payment - Parsons, Diaz and Jackson",REF96141116,0.0,633.69,51823.42
2017-06-30,2017-06-30,"Payment from Leon, Jones and Jackson",REF91650643,0.0,504.41,52327.83
2017-06-30,2017-06-30,Invoice payment - Burns PLC,REF80064303,0.0,1123.15,53450.98
2017-06-30,2017-06-30,"Invoice payment - Brown, Ray and Torres",REF62106190,0.0,2376.5,55827.48
2017-06-30,2017-06-30,Payment from Cooper-Dean,REF78595486,0.0,785.27,56612.75
2017-06-30,2017-06-30,Fuel purchase,REF92145494,225.37,0.0,56387.38
2017-07-01,2017-07-01,Fuel purchase,REF75602266,377.7,0.0,56009.68
2017-07-05,2017-07-05,Permits Licenses expense,REF79000990,156.18,0.0,55853.5
2017-07-06,2017-07-06,Tools expense,REF30571360,186.26,0.0,55667.24
2017-07-10,2017-07-10,Business materials,REF44851258,980.63,0.0,54686.61
2017-07-11,2017-07-11,Equipment Rental expense,REF98689078,1057.52,0.0,53629.09
2017-07-15,2017-07-15,Business insurance premium,REF65875957,213.54,0.0,53415.55
2017-07-15,2017-07-15,Payment from Cooper-Dean,REF26866514,0.0,947.02,54362.57
2017-07-15,2017-07-15,Service payment - Burns PLC,REF52337212,0.0,1147.37,55509.94
2017-07-15,2017-07-15,"Payment from Brown, Ray and Torres",REF53729020,0.0,1577.22,57087.16
2017-07-15,2017-07-15,"Payment from Leon, Jones and Jackson",REF23643662,0.0,408.25,57495.41
2017-07-15,2017-07-15,"Service payment - Parsons, Diaz and Jackson",REF57265672,0.0,741.88,58237.29
2017-07-16,2017-07-16,Business materials,REF32627657,656.98,0.0,57580.31
2017-07-19,2017-07-19,Business materials,REF94073239,561.19,0.0,57019.12
2017-07-21,2017-07-21,Vehicle Maintenance expense,REF70151050,243.21,0.0,56775.91
2017-07-26,2017-07-26,Business materials,REF75726861,1107.76,0.0,55668.15
2017-07-27,2017-07-27,Tools expense,REF27824563,147.62,0.0,55520.53
2017-07-30,2017-07-30,"Invoice payment - Leon, Jones and Jackson",REF67559422,0.0,516.42,56036.95
2017-07-30,2017-07-30,"Invoice payment - Brown, Ray and Torres",REF74810800,0.0,1713.81,57750.76
2017-07-30,2017-07-30,Project payment - Burns PLC,REF24999467,0.0,1345.57,59096.33
2017-07-30,2017-07-30,Invoice payment - Cooper-Dean,REF93211320,0.0,825.74,59922.07
2017-07-30,2017-07-30,"Project payment - Parsons, Diaz and Jackson",REF25849869,0.0,683.46,60605.53
2017-08-03,2017-08-03,Equipment Rental expense,REF20406591,605.0,0.0,60000.53
2017-08-09,2017-08-09,Business materials,REF12104589,1265.25,0.0,58735.28
2017-08-15,2017-08-15,"Invoice payment - Leon, Jones and Jackson",REF65356348,0.0,437.37,59172.65
2017-08-15,2017-08-15,"Payment from Parsons, Diaz and Jackson",REF91704697,0.0,809.47,59982.12
2017-08-15,2017-08-15,"Project payment - Brown, Ray and Torres",REF90032306,0.0,1634.71,61616.83
2017-08-15,2017-08-15,Service payment - Cooper-Dean,REF53358091,0.0,600.96,62217.79
2017-08-15,2017-08-15,Invoice payment - Burns PLC,REF41416862,0.0,724.32,62942.11
2017-08-15,2017-08-15,Business insurance premium,REF34649061,262.39,0.0,62679.72
2017-08-17,2017-08-17,Equipment Rental expense,REF63020504,553.51,0.0,62126.21
2017-08-17,2017-08-17,Business materials,REF89158009,1228.03,0.0,60898.18
2017-08-18,2017-08-18,Business materials,REF61192300,1067.07,0.0,59831.11
2017-08-21,2017-08-21,Fuel purchase,REF32312270,317.47,0.0,59513.64
2017-08-21,2017-08-21,Vehicle Maintenance expense,REF62858115,225.67,0.0,59287.97
2017-08-24,2017-08-24,Permits Licenses expense,REF52065166,78.12,0.0,59209.85
2017-08-26,2017-08-26,Business materials,REF80720515,1325.09,0.0,57884.76
2017-08-30,2017-08-30,"Payment from Brown, Ray and Torres",REF84406266,0.0,1771.47,59656.23
2017-08-30,2017-08-30,"Project payment - Parsons, Diaz and Jackson",REF12341006,0.0,710.15,60366.38
2017-08-30,2017-08-30,Service payment - Cooper-Dean,REF52880644,0.0,885.53,61251.91
2017-08-30,2017-08-30,Invoice payment - Burns PLC,REF24274236,0.0,1098.35,62350.26
2017-09-03,2017-09-03,Business materials,REF21295943,563.02,0.0,61787.24
2017-09-04,2017-09-04,Business materials,REF72309903,973.78,0.0,60813.46
2017-09-09,2017-09-09,Tools expense,REF37781207,110.13,0.0,60703.33
2017-09-10,2017-09-10,Tools expense,REF52481861,114.79,0.0,60588.54
2017-09-13,2017-09-13,Subcontractors expense,REF51809803,1351.6,0.0,59236.94
2017-09-15,2017-09-15,Business insurance premium,REF38941069,245.98,0.0,58990.96
2017-09-15,2017-09-15,Subcontractors expense,REF59262413,1154.01,0.0,57836.95
2017-09-15,2017-09-15,Invoice payment - Cooper-Dean,REF37164894,0.0,557.97,58394.92
2017-09-15,2017-09-15,"Project payment - Leon, Jones and Jackson",REF65408823,0.0,517.65,58912.57
2017-09-15,2017-09-15,Service payment - Burns PLC,REF34117080,0.0,888.15,59800.72
2017-09-15,2017-09-15,"Service payment - Brown, Ray and Torres",REF41593826,0.0,1558.15,61358.87
2017-09-19,2017-09-19,Permits Licenses expense,REF41439503,135.35,0.0,61223.52
2017-09-24,2017-09-24,Equipment Rental expense,REF10381486,272.79,0.0,60950.73
2017-09-25,2017-09-25,Safety Equipment expense,REF80567843,48.3,0.0,60902.43
2017-09-29,2017-09-29,Fuel purchase,REF86726160,215.31,0.0,60687.12
2017-09-29,2017-09-29,Vehicle Maintenance expense,REF52504880,117.21,0.0,60569.91
2017-09-30,2017-09-30,Invoice payment - Burns PLC,REF34064534,0.0,1221.97,61791.88
2017-09-30,2017-09-30,Project payment - Cooper-Dean,REF73218732,0.0,801.68,62593.56
2017-09-30,2017-09-30,"Invoice payment - Parsons, Diaz and Jackson",REF83324332,0.0,699.88,63293.44
2017-09-30,2017-09-30,"Service payment - Brown, Ray and Torres",REF65682355,0.0,1519.51,64812.95
2017-10-01,2017-10-01,Vehicle Maintenance expense,REF86851322,140.29,0.0,64672.66
2017-10-03,2017-10-03,Business materials,REF62343120,476.65,0.0,64196.01
2017-10-11,2017-10-11,Fuel purchase,REF55184379,235.07,0.0,63960.94
2017-10-15,2017-10-15,Safety Equipment expense,REF33916782,61.47,0.0,63899.47
2017-10-15,2017-10-15,Business insurance premium,REF91795695,203.28,0.0,63696.19
2017-10-15,2017-10-15,"Payment from Brown, Ray and Torres",REF71070285,0.0,1524.68,65220.87
2017-10-15,2017-10-15,Project payment - Cooper-Dean,REF90772141,0.0,724.96,65945.83
2017-10-15,2017-10-15,Project payment - Burns PLC,REF38924649,0.0,878.08,66823.91
2017-10-15,2017-10-15,"Service payment - Parsons, Diaz and Jackson",REF97483052,0.0,621.26,67445.17
2017-10-21,2017-10-21,Fuel purchase,REF25375365,365.11,0.0,67080.06
2017-10-24,2017-10-24,Tools expense,REF93526162,139.89,0.0,66940.17
2017-10-27,2017-10-27,Subcontractors expense,REF22926172,1805.31,0.0,65134.86
2017-10-29,2017-10-29,Equipment Rental expense,REF23545926,323.16,0.0,64811.7
2017-10-30,2017-10-30,Permits Licenses expense,REF42374782,52.45,0.0,64759.25
2017-10-30,2017-10-30,"Service payment - Leon, Jones and Jackson",REF62023213,0.0,483.75,65243.0
2017-10-30,2017-10-30,"Service payment - Parsons, Diaz and Jackson",REF35613470,0.0,651.47,65894.47
2017-10-30,2017-10-30,"Invoice payment - Brown, Ray and Torres",REF23367378,0.0,1685.13,67579.6
2017-10-30,2017-10-30,Service payment - Cooper-Dean,REF52624794,0.0,838.75,68418.35
2017-10-30,2017-10-30,Payment from Burns PLC,REF75101217,0.0,879.89,69298.24
2017-11-05,2017-11-05,Fuel purchase,REF15914200,347.72,0.0,68950.52
2017-11-14,2017-11-14,Fuel purchase,REF19824684,217.88,0.0,68732.64
2017-11-14,2017-11-14,Permits Licenses expense,REF32937929,60.71,0.0,68671.93
2017-11-15,2017-11-15,Business insurance premium,REF35240728,151.94,0.0,68519.99
2017-11-15,2017-11-15,Invoice payment - Cooper-Dean,REF37507633,0.0,584.59,69104.58
2017-11-15,2017-11-15,"Service payment - Leon, Jones and Jackson",REF35702900,0.0,271.97,69376.55
2017-11-15,2017-11-15,"Invoice payment - Brown, Ray and Torres",REF85128725,0.0,1474.91,70851.46
2017-11-15,2017-11-15,Invoice payment - Burns PLC,REF46423229,0.0,588.81,71440.27
2017-11-15,2017-11-15,"Service payment - Parsons, Diaz and Jackson",REF36455359,0.0,493.25,71933.52
2017-11-19,2017-11-19,Safety Equipment expense,REF90447718,49.88,0.0,71883.64
2017-11-22,2017-11-22,Business materials,REF22483650,821.89,0.0,71061.75
2017-11-25,2017-11-25,Safety Equipment expense,REF88678238,93.67,0.0,70968.08
2017-11-27,2017-11-27,Safety Equipment expense,REF39121043,53.41,0.0,70914.67
2017-11-30,2017-11-30,"Payment from Leon, Jones and Jackson",REF87816096,0.0,363.02,71277.69
2017-11-30,2017-11-30,"Service payment - Brown, Ray and Torres",REF94836198,0.0,1243.25,72520.94
2017-11-30,2017-11-30,"Project payment - Parsons, Diaz and Jackson",REF64886415,0.0,458.55,72979.49
2017-11-30,2017-11-30,Payment from Burns PLC,REF39773541,0.0,784.23,73763.72
2017-11-30,2017-11-30,Payment from Cooper-Dean,REF67542967,0.0,651.09,74414.81
2017-12-03,2017-12-03,Fuel purchase,REF31490491,133.77,0.0,74281.04
2017-12-07,2017-12-07,Subcontractors expense,REF27863120,423.09,0.0,73857.95
2017-12-08,2017-12-08,Equipment Rental expense,REF55377870,336.49,0.0,73521.46
2017-12-08,2017-12-08,Safety Equipment expense,REF37273325,40.71,0.0,73480.75
2017-12-10,2017-12-10,Permits Licenses expense,REF12019410,72.3,0.0,73408.45
2017-12-11,2017-12-11,Equipment Rental expense,REF67213176,272.29,0.0,73136.16
2017-12-12,2017-12-12,Fuel purchase,REF46099655,140.39,0.0,72995.77
2017-12-13,2017-12-13,Equipment Rental expense,REF21502660,334.24,0.0,72661.53
2017-12-15,2017-12-15,"Invoice payment - Brown, Ray and Torres",REF24631925,0.0,835.4,73496.93
2017-12-15,2017-12-15,"Invoice payment - Parsons, Diaz and Jackson",REF62576631,0.0,313.26,73810.19
2017-12-15,2017-12-15,Business insurance premium,REF92014736,110.34,0.0,73699.85
2017-12-15,2017-12-15,"Payment from Leon, Jones and Jackson",REF52750240,0.0,268.94,73968.79
2017-12-15,2017-12-15,Payment from Cooper-Dean,REF94485859,0.0,354.22,74323.01
2017-12-15,2017-12-15,Invoice payment - Burns PLC,REF25776780,0.0,450.46,74773.47
2017-12-16,2017-12-16,Permits Licenses expense,REF34141964,48.91,0.0,74724.56
2017-12-18,2017-12-18,Permits Licenses expense,REF73907820,33.78,0.0,74690.78
2017-12-21,2017-12-21,Fuel purchase,REF87174220,195.56,0.0,74495.22
2017-12-21,2017-12-21,Vehicle Maintenance expense,REF12526391,80.1,0.0,74415.12
2017-12-21,2017-12-21,Equipment Rental expense,REF91266237,130.5,0.0,74284.62
2017-12-25,2017-12-25,Vehicle Maintenance expense,REF76322617,96.53,0.0,74188.09
2017-12-28,2017-12-28,Equipment Rental expense,REF82003151,284.09,0.0,73904.0
2017-12-30,2017-12-30,"Service payment - Parsons, Diaz and Jackson",REF67638118,0.0,429.98,74333.98
2017-12-30,2017-12-30,"Payment from Leon, Jones and Jackson",REF54276324,0.0,201.63,74535.61
2017-12-30,2017-12-30,"Payment from Brown, Ray and Torres",REF74566621,0.0,878.28,75413.89
2017-12-30,2017-12-30,Fuel purchase,REF58053807,201.44,0.0,75212.45
2017-12-30,2017-12-30,Project payment - Cooper-Dean,REF79979670,0.0,404.56,75617.01
2017-12-30,2017-12-30,Invoice payment - Burns PLC,REF13598969,0.0,622.44,76239.45
2018-01-03,2018-01-03,Equipment Rental expense,REF91922288,324.52,0.0,75914.93
2018-01-05,2018-01-05,Fuel purchase,REF34512377,262.97,0.0,75651.96
2018-01-08,2018-01-08,Fuel purchase,REF97874625,215.69,0.0,75436.27
2018-01-09,2018-01-09,Vehicle Maintenance expense,REF76136168,115.53,0.0,75320.74
2018-01-09,2018-01-09,Business materials,REF82495728,609.13,0.0,74711.61
2018-01-14,2018-01-14,Tools expense,REF68689963,56.46,0.0,74655.15
2018-01-15,2018-01-15,"Invoice payment - Brown, Ray and Torres",REF92760720,0.0,1119.26,75774.41
2018-01-15,2018-01-15,Business insurance premium,REF87451356,134.7,0.0,75639.71
2018-01-15,2018-01-15,Service payment - Cooper-Dean,REF72159055,0.0,528.17,76167.88
2018-01-15,2018-01-15,"Service payment - Parsons, Diaz and Jackson",REF16498785,0.0,440.76,76608.64
2018-01-15,2018-01-15,Invoice payment - Burns PLC,REF34638407,0.0,557.0,77165.64
2018-01-17,2018-01-17,Fuel purchase,REF85062593,289.2,0.0,76876.44
2018-01-18,2018-01-18,Fuel purchase,REF29950066,141.66,0.0,76734.78
2018-01-30,2018-01-30,Vehicle Maintenance expense,REF15965018,163.25,0.0,76571.53
2018-01-30,2018-01-30,"Invoice payment - Leon, Jones and Jackson",REF39977860,0.0,356.35,76927.88
2018-01-30,2018-01-30,"Payment from Parsons, Diaz and Jackson",REF26529783,0.0,328.11,77255.99
2018-01-30,2018-01-30,"Invoice payment - Brown, Ray and Torres",REF79816208,0.0,1225.26,78481.25
2018-02-01,2018-02-01,Business materials,REF71537616,622.97,0.0,77858.28
2018-02-05,2018-02-05,Permits Licenses expense,REF81552625,99.68,0.0,77758.6
2018-02-07,2018-02-07,Business materials,REF79449668,758.56,0.0,77000.04
2018-02-08,2018-02-08,Vehicle Maintenance expense,REF19881783,82.46,0.0,76917.58
2018-02-09,2018-02-09,Permits Licenses expense,REF12349986,42.3,0.0,76875.28
2018-02-10,2018-02-10,Permits Licenses expense,REF30732330,78.88,0.0,76796.4
2018-02-12,2018-02-12,Vehicle Maintenance expense,REF83162270,137.35,0.0,76659.05
2018-02-13,2018-02-13,Safety Equipment expense,REF52479127,66.12,0.0,76592.93
2018-02-15,2018-02-15,Business insurance premium,REF85362779,150.77,0.0,76442.16
2018-02-15,2018-02-15,Invoice payment - Burns PLC,REF10298262,0.0,645.36,77087.52
2018-02-15,2018-02-15,Business materials,REF18158923,835.28,0.0,76252.24
2018-02-15,2018-02-15,"Invoice payment - Parsons, Diaz and Jackson",REF62006458,0.0,371.04,76623.28
2018-02-15,2018-02-15,"Service payment - Brown, Ray and Torres",REF39446212,0.0,1226.23,77849.51
2018-02-15,2018-02-15,"Service payment - Leon, Jones and Jackson",REF80635065,0.0,241.91,78091.42
2018-02-15,2018-02-15,Service payment - Cooper-Dean,REF35326264,0.0,569.85,78661.27
2018-02-22,2018-02-22,Fuel purchase,REF41920485,391.49,0.0,78269.78
2018-02-24,2018-02-24,Fuel purchase,REF44884742,278.89,0.0,77990.89
2018-02-28,2018-02-28,Payment from Cooper-Dean,REF52681918,0.0,726.24,78717.13
2018-02-28,2018-02-28,"Service payment - Leon, Jones and Jackson",REF18736030,0.0,388.01,79105.14
2018-02-28,2018-02-28,Payment from Burns PLC,REF58198905,0.0,816.98,79922.12
2018-02-28,2018-02-28,Business materials,REF50443151,334.71,0.0,79587.41
2018-03-02,2018-03-02,Vehicle Maintenance expense,REF51616235,115.14,0.0,79472.27
2018-03-06,2018-03-06,Business materials,REF89497349,1160.63,0.0,78311.64
2018-03-06,2018-03-06,Permits Licenses expense,REF21062331,37.75,0.0,78273.89
2018-03-07,2018-03-07,Tools expense,REF51199840,147.94,0.0,78125.95
2018-03-09,2018-03-09,Tools expense,REF82336919,118.83,0.0,78007.12
2018-03-09,2018-03-09,Fuel purchase,REF30705284,403.91,0.0,77603.21
2018-03-11,2018-03-11,Fuel purchase,REF20200986,340.0,0.0,77263.21
2018-03-15,2018-03-15,Business insurance premium,REF32341928,197.12,0.0,77066.09
2018-03-15,2018-03-15,Invoice payment - Cooper-Dean,REF61457559,0.0,850.58,77916.67
2018-03-15,2018-03-15,"Invoice payment - Parsons, Diaz and Jackson",REF74409232,0.0,715.99,78632.66
2018-03-15,2018-03-15,"Payment from Leon, Jones and Jackson",REF59187038,0.0,407.74,79040.4
2018-03-15,2018-03-15,Invoice payment - Burns PLC,REF97533471,0.0,739.12,79779.52
2018-03-24,2018-03-24,Safety Equipment expense,REF10583185,72.44,0.0,79707.08
2018-03-26,2018-03-26,Tools expense,REF15774929,108.52,0.0,79598.56
2018-03-27,2018-03-27,Equipment Rental expense,REF49778906,235.1,0.0,79363.46
2018-03-28,2018-03-28,Fuel purchase,REF93330903,332.92,0.0,79030.54
2018-03-29,2018-03-29,Safety Equipment expense,REF75121026,103.04,0.0,78927.5
2018-03-30,2018-03-30,"Payment from Leon, Jones and Jackson",REF19567358,0.0,343.26,79270.76
2018-03-30,2018-03-30,Project payment - Cooper-Dean,REF87710911,0.0,884.58,80155.34
2018-03-30,2018-03-30,"Invoice payment - Parsons, Diaz and Jackson",REF69291716,0.0,564.66,80720.0
2018-03-30,2018-03-30,Project payment - Burns PLC,REF14046898,0.0,805.47,81525.47
2018-03-30,2018-03-30,"Service payment - Brown, Ray and Torres",REF55807024,0.0,1745.51,83270.98
2018-03-31,2018-03-31,Vehicle Maintenance expense,REF85454410,125.44,0.0,83145.54
2018-03-31,2018-03-31,Safety Equipment expense,REF85686074,68.85,0.0,83076.69
2018-04-15,2018-04-15,Invoice payment - Burns PLC,REF94394076,0.0,1210.35,84287.04
2018-04-15,2018-04-15,Service payment - Cooper-Dean,REF60106749,0.0,834.45,85121.49
2018-04-15,2018-04-15,"Service payment - Leon, Jones and Jackson",REF78102133,0.0,420.13,85541.62
2018-04-15,2018-04-15,Business insurance premium,REF78310316,245.74,0.0,85295.88
2018-04-15,2018-04-15,"Payment from Parsons, Diaz and Jackson",REF75296247,0.0,780.24,86076.12
2018-04-15,2018-04-15,"Project payment - Brown, Ray and Torres",REF43190480,0.0,1723.65,87799.77
2018-04-15,2018-04-15,Business materials,REF41918408,902.05,0.0,86897.72
2018-04-23,2018-04-23,Business materials,REF79807969,927.8,0.0,85969.92
2018-04-24,2018-04-24,Business materials,REF49709740,735.34,0.0,85234.58
2018-04-27,2018-04-27,Fuel purchase,REF81563664,366.48,0.0,84868.1
2018-04-27,2018-04-27,Equipment Rental expense,REF59214008,427.71,0.0,84440.39
2018-04-30,2018-04-30,Tools expense,REF42606012,141.56,0.0,84298.83
2018-04-30,2018-04-30,Project payment - Burns PLC,REF67436930,0.0,1251.22,85550.05
2018-04-30,2018-04-30,"Payment from Parsons, Diaz and Jackson",REF33524481,0.0,534.77,86084.82
2018-04-30,2018-04-30,"Invoice payment - Brown, Ray and Torres",REF61968252,0.0,1718.13,87802.95
2018-04-30,2018-04-30,Business materials,REF74704155,1410.39,0.0,86392.56
2018-04-30,2018-04-30,"Payment from Leon, Jones and Jackson",REF98937073,0.0,558.94,86951.5
2018-04-30,2018-04-30,Invoice payment - Cooper-Dean,REF37597060,0.0,950.11,87901.61
2018-05-01,2018-05-01,Tools expense,REF13224548,186.07,0.0,87715.54
2018-05-02,2018-05-02,Permits Licenses expense,REF64833101,84.7,0.0,87630.84
2018-05-03,2018-05-03,Permits Licenses expense,REF75302332,93.58,0.0,87537.26
2018-05-11,2018-05-11,Fuel purchase,REF35851443,172.7,0.0,87364.56
2018-05-12,2018-05-12,Fuel purchase,REF22949755,508.22,0.0,86856.34
2018-05-13,2018-05-13,Tools expense,REF68314586,99.34,0.0,86757.0
2018-05-14,2018-05-14,Permits Licenses expense,REF46241799,128.47,0.0,86628.53
2018-05-15,2018-05-15,"Project payment - Leon, Jones and Jackson",REF48380260,0.0,573.04,87201.57
2018-05-15,2018-05-15,"Invoice payment - Parsons, Diaz and Jackson",REF69646451,0.0,973.92,88175.49
2018-05-15,2018-05-15,Service payment - Burns PLC,REF32061687,0.0,1356.6,89532.09
2018-05-15,2018-05-15,"Invoice payment - Brown, Ray and Torres",REF22657981,0.0,2438.71,91970.8
2018-05-15,2018-05-15,Business insurance premium,REF18075246,259.19,0.0,91711.61
2018-05-15,2018-05-15,Project payment - Cooper-Dean,REF29833248,0.0,1008.92,92720.53
2018-05-20,2018-05-20,Fuel purchase,REF18872112,575.51,0.0,92145.02
2018-05-21,2018-05-21,Equipment Rental expense,REF50680316,329.76,0.0,91815.26
2018-05-22,2018-05-22,Business materials,REF46648265,1481.13,0.0,90334.13
2018-05-26,2018-05-26,Business materials,REF79702878,1091.19,0.0,89242.94
2018-05-30,2018-05-30,"Project payment - Parsons, Diaz and Jackson",REF42113478,0.0,883.73,90126.67
2018-05-30,2018-05-30,"Project payment - Brown, Ray and Torres",REF35031309,0.0,1619.82,91746.49
2018-05-30,2018-05-30,Invoice payment - Burns PLC,REF21694416,0.0,1283.88,93030.37
2018-05-30,2018-05-30,"Project payment - Leon, Jones and Jackson",REF10959441,0.0,485.08,93515.45
2018-06-01,2018-06-01,Business materials,REF36511923,1229.95,0.0,92285.5
2018-06-04,2018-06-04,Fuel purchase,REF41350670,638.99,0.0,91646.51
2018-06-07,2018-06-07,Subcontractors expense,REF83850167,1940.06,0.0,89706.45
2018-06-08,2018-06-08,Business materials,REF40011707,1158.08,0.0,88548.37
2018-06-11,2018-06-11,Equipment Rental expense,REF26789664,462.54,0.0,88085.83
2018-06-13,2018-06-13,Tools expense,REF79452020,168.41,0.0,87917.42
2018-06-15,2018-06-15,Invoice payment - Cooper-Dean,REF96680014,0.0,1005.47,88922.89
2018-06-15,2018-06-15,"Invoice payment - Parsons, Diaz and Jackson",REF29185307,0.0,715.26,89638.15
2018-06-15,2018-06-15,"Project payment - Leon, Jones and Jackson",REF89841939,0.0,491.76,90129.91
2018-06-15,2018-06-15,"Service payment - Brown, Ray and Torres",REF10296575,0.0,2001.71,92131.62
2018-06-15,2018-06-15,Business insurance premium,REF80872553,237.34,0.0,91894.28
2018-06-18,2018-06-18,Business materials,REF87505603,730.21,0.0,91164.07
2018-06-19,2018-06-19,Safety Equipment expense,REF97656883,69.87,0.0,91094.2
2018-06-20,2018-06-20,Equipment Rental expense,REF73552062,402.73,0.0,90691.47
2018-06-21,2018-06-21,Safety Equipment expense,REF60273259,54.52,0.0,90636.95
2018-06-24,2018-06-24,Business materials,REF41225183,395.04,0.0,90241.91
2018-06-24,2018-06-24,Fuel purchase,REF90679335,392.11,0.0,89849.8
2018-06-25,2018-06-25,Tools expense,REF80451122,104.24,0.0,89745.56
2018-06-26,2018-06-26,Vehicle Maintenance expense,REF12094450,253.07,0.0,89492.49
2018-06-27,2018-06-27,Equipment Rental expense,REF72550265,595.65,0.0,88896.84
2018-06-27,2018-06-27,Fuel purchase,REF16320548,203.94,0.0,88692.9
2018-06-29,2018-06-29,Fuel purchase,REF68875209,298.35,0.0,88394.55
2018-06-30,2018-06-30,"Project payment - Leon, Jones and Jackson",REF30733947,0.0,459.66,88854.21
2018-06-30,2018-06-30,Business materials,REF22713310,1402.42,0.0,87451.79
2018-06-30,2018-06-30,"Service payment - Parsons, Diaz and Jackson",REF89759949,0.0,795.17,88246.96
2018-06-30,2018-06-30,Service payment - Burns PLC,REF83596732,0.0,1049.51,89296.47
2018-06-30,2018-06-30,Payment from Cooper-Dean,REF25317350,0.0,688.35,89984.82
2018-06-30,2018-06-30,Equipment Rental expense,REF94784405,491.51,0.0,89493.31
2018-07-01,2018-07-01,Business materials,REF59780498,892.14,0.0,88601.17
2018-07-02,2018-07-02,Fuel purchase,REF84035335,387.91,0.0,88213.26
2018-07-04,2018-07-04,Permits Licenses expense,REF84766725,141.24,0.0,88072.02
2018-07-05,2018-07-05,Business materials,REF23493789,958.42,0.0,87113.6
2018-07-14,2018-07-14,Fuel purchase,REF50816078,123.42,0.0,86990.18
2018-07-15,2018-07-15,"Project payment - Leon, Jones and Jackson",REF70905863,0.0,537.46,87527.64
2018-07-15,2018-07-15,Payment from Burns PLC,REF72253364,0.0,978.31,88505.95
2018-07-15,2018-07-15,Business insurance premium,REF61803663,213.49,0.0,88292.46
2018-07-15,2018-07-15,Business materials,REF73799241,1486.52,0.0,86805.94
2018-07-15,2018-07-15,Project payment - Cooper-Dean,REF55507120,0.0,864.87,87670.81
2018-07-15,2018-07-15,"Payment from Parsons, Diaz and Jackson",REF27491794,0.0,737.22,88408.03
2018-07-15,2018-07-15,"Service payment - Brown, Ray and Torres",REF29234951,0.0,1977.64,90385.67
2018-07-16,2018-07-16,Permits Licenses expense,REF76957930,81.99,0.0,90303.68
2018-07-19,2018-07-19,Business materials,REF71423739,953.8,0.0,89349.88
2018-07-21,2018-07-21,Equipment Rental expense,REF19197590,511.27,0.0,88838.61
2018-07-21,2018-07-21,Tools expense,REF95929830,100.91,0.0,88737.7
2018-07-27,2018-07-27,Business materials,REF36355143,547.75,0.0,88189.95
2018-07-29,2018-07-29,Fuel purchase,REF22912023,461.7,0.0,87728.25
2018-07-30,2018-07-30,Invoice payment - Cooper-Dean,REF60299573,0.0,1159.45,88887.7
2018-07-30,2018-07-30,"Service payment - Parsons, Diaz and Jackson",REF83681662,0.0,685.11,89572.81
2018-07-30,2018-07-30,"Service payment - Leon, Jones and Jackson",REF12276870,0.0,341.64,89914.45
2018-07-30,2018-07-30,Project payment - Burns PLC,REF39695401,0.0,980.12,90894.57
2018-08-03,2018-08-03,Fuel purchase,REF62503477,503.06,0.0,90391.51
2018-08-04,2018-08-04,Safety Equipment expense,REF87295071,103.7,0.0,90287.81
2018-08-06,2018-08-06,Fuel purchase,REF42136718,540.02,0.0,89747.79
2018-08-15,2018-08-15,Project payment - Cooper-Dean,REF68640515,0.0,919.84,90667.63
2018-08-15,2018-08-15,"Invoice payment - Brown, Ray and Torres",REF10174546,0.0,1370.19,92037.82
2018-08-15,2018-08-15,"Payment from Leon, Jones and Jackson",REF12685559,0.0,609.96,92647.78
2018-08-15,2018-08-15,Service payment - Burns PLC,REF73396343,0.0,1291.72,93939.5
2018-08-15,2018-08-15,"Invoice payment - Parsons, Diaz and Jackson",REF60250090,0.0,578.45,94517.95
2018-08-15,2018-08-15,Business insurance premium,REF53520408,243.22,0.0,94274.73
2018-08-18,2018-08-18,Vehicle Maintenance expense,REF28581953,255.29,0.0,94019.44
2018-08-18,2018-08-18,Business materials,REF12593619,1137.4,0.0,92882.04
2018-08-19,2018-08-19,Fuel purchase,REF24660481,327.7,0.0,92554.34
2018-08-21,2018-08-21,Business materials,REF10857600,1342.48,0.0,91211.86
2018-08-22,2018-08-22,Subcontractors expense,REF83681626,1488.2,0.0,89723.66
2018-08-23,2018-08-23,Business materials,REF73862142,1157.69,0.0,88565.97
2018-08-25,2018-08-25,Business materials,REF15055095,577.63,0.0,87988.34
2018-08-28,2018-08-28,Fuel purchase,REF14032676,539.9,0.0,87448.44
2018-08-30,2018-08-30,"Invoice payment - Leon, Jones and Jackson",REF45626362,0.0,489.96,87938.4
2018-08-30,2018-08-30,"Invoice payment - Brown, Ray and Torres",REF53831352,0.0,2257.69,90196.09
2018-08-30,2018-08-30,Project payment - Cooper-Dean,REF98527938,0.0,1030.22,91226.31
2018-08-30,2018-08-30,"Invoice payment - Parsons, Diaz and Jackson",REF18471459,0.0,565.39,91791.7
2018-08-30,2018-08-30,Permits Licenses expense,REF20000546,122.88,0.0,91668.82
2018-08-31,2018-08-31,Business materials,REF66160382,1349.28,0.0,90319.54
2018-09-09,2018-09-09,Tools expense,REF98691294,129.19,0.0,90190.35
2018-09-09,2018-09-09,Business materials,REF62324962,967.74,0.0,89222.61
2018-09-10,2018-09-10,Fuel purchase,REF29377209,493.0,0.0,88729.61
2018-09-15,2018-09-15,"Payment from Leon, Jones and Jackson",REF88082753,0.0,429.32,89158.93
2018-09-15,2018-09-15,Business insurance premium,REF87264816,226.97,0.0,88931.96
2018-09-15,2018-09-15,Payment from Cooper-Dean,REF93174477,0.0,814.37,89746.33
2018-09-15,2018-09-15,Service payment - Burns PLC,REF31148550,0.0,717.8,90464.13
2018-09-15,2018-09-15,"Service payment - Parsons, Diaz and Jackson",REF84438910,0.0,626.44,91090.57
2018-09-16,2018-09-16,Fuel purchase,REF47962841,101.83,0.0,90988.74
2018-09-17,2018-09-17,Business materials,REF70262362,1249.76,0.0,89738.98
2018-09-19,2018-09-19,Fuel purchase,REF77169580,390.99,0.0,89347.99
2018-09-21,2018-09-21,Equipment Rental expense,REF51221834,443.24,0.0,88904.75
2018-09-23,2018-09-23,Vehicle Maintenance expense,REF89105762,182.44,0.0,88722.31
2018-09-27,2018-09-27,Safety Equipment expense,REF99135742,106.31,0.0,88616.0
2018-09-30,2018-09-30,"Service payment - Leon, Jones and Jackson",REF75220390,0.0,370.65,88986.65
2018-09-30,2018-09-30,Payment from Burns PLC,REF40937190,0.0,1134.06,90120.71
2018-09-30,2018-09-30,"Payment from Brown, Ray and Torres",REF29740605,0.0,1764.61,91885.32
2018-09-30,2018-09-30,Service payment - Cooper-Dean,REF15742357,0.0,854.42,92739.74
2018-09-30,2018-09-30,"Payment from Parsons, Diaz and Jackson",REF45837550,0.0,629.6,93369.34
2018-10-01,2018-10-01,Business materials,REF86559941,771.82,0.0,92597.52
2018-10-02,2018-10-02,Fuel purchase,REF66291723,282.6,0.0,92314.92
2018-10-02,2018-10-02,Business materials,REF29723187,1077.77,0.0,91237.15
2018-10-03,2018-10-03,Tools expense,REF63969919,129.69,0.0,91107.46
2018-10-04,2018-10-04,Fuel purchase,REF30308126,342.45,0.0,90765.01
2018-10-06,2018-10-06,Tools expense,REF23913103,106.83,0.0,90658.18
2018-10-08,2018-10-08,Subcontractors expense,REF23944023,1716.72,0.0,88941.46
2018-10-12,2018-10-12,Business materials,REF13062038,656.54,0.0,88284.92
2018-10-13,2018-10-13,Vehicle Maintenance expense,REF44391023,100.49,0.0,88184.43
2018-10-15,2018-10-15,"Invoice payment - Parsons, Diaz and Jackson",REF34288168,0.0,482.77,88667.2
2018-10-15,2018-10-15,"Invoice payment - Brown, Ray and Torres",REF35069126,0.0,1378.01,90045.21
2018-10-15,2018-10-15,Business insurance premium,REF56953578,210.64,0.0,89834.57
2018-10-15,2018-10-15,Payment from Cooper-Dean,REF63748870,0.0,656.28,90490.85
2018-10-15,2018-10-15,"Invoice payment - Leon, Jones and Jackson",REF66390516,0.0,414.6,90905.45
2018-10-15,2018-10-15,Project payment - Burns PLC,REF12644470,0.0,1061.76,91967.21
2018-10-16,2018-10-16,Business materials,REF16520852,586.44,0.0,91380.77
2018-10-17,2018-10-17,Equipment Rental expense,REF31168851,533.54,0.0,90847.23
2018-10-18,2018-10-18,Tools expense,REF26640666,70.58,0.0,90776.65
2018-10-20,2018-10-20,Fuel purchase,REF11051594,261.11,0.0,90515.54
2018-10-22,2018-10-22,Business materials,REF25646745,1049.33,0.0,89466.21
2018-10-23,2018-10-23,Business materials,REF46184633,486.18,0.0,88980.03
2018-10-23,2018-10-23,Fuel purchase,REF97244260,300.8,0.0,88679.23
2018-10-24,2018-10-24,Fuel purchase,REF88771946,265.7,0.0,88413.53
2018-10-27,2018-10-27,Vehicle Maintenance expense,REF54508809,168.44,0.0,88245.09
2018-10-30,2018-10-30,Payment from Burns PLC,REF20862590,0.0,891.79,89136.88
2018-10-30,2018-10-30,"Invoice payment - Leon, Jones and Jackson",REF61535936,0.0,503.43,89640.31
2018-10-30,2018-10-30,"Project payment - Brown, Ray and Torres",REF63224789,0.0,1636.56,91276.87
2018-10-30,2018-10-30,"Payment from Parsons, Diaz and Jackson",REF60895142,0.0,579.31,91856.18
2018-10-30,2018-10-30,Service payment - Cooper-Dean,REF79373463,0.0,716.64,92572.82
2018-11-01,2018-11-01,Permits Licenses expense,REF44764190,63.32,0.0,92509.5
2018-11-09,2018-11-09,Business materials,REF75742529,422.05,0.0,92087.45
2018-11-13,2018-11-13,Business materials,REF48420019,501.71,0.0,91585.74
2018-11-14,2018-11-14,Permits Licenses expense,REF66371524,83.89,0.0,91501.85
2018-11-14,2018-11-14,Subcontractors expense,REF44896910,647.21,0.0,90854.64
2018-11-15,2018-11-15,Subcontractors expense,REF30353365,724.86,0.0,90129.78
2018-11-15,2018-11-15,Service payment - Cooper-Dean,REF20938952,0.0,689.96,90819.74
2018-11-15,2018-11-15,Service payment - Burns PLC,REF72791817,0.0,515.13,91334.87
2018-11-15,2018-11-15,Business insurance premium,REF51708443,156.11,0.0,91178.76
2018-11-15,2018-11-15,"Invoice payment - Parsons, Diaz and Jackson",REF48991428,0.0,499.22,91677.98
2018-11-15,2018-11-15,"Service payment - Brown, Ray and Torres",REF13748491,0.0,1504.02,93182.0
2018-11-16,2018-11-16,Vehicle Maintenance expense,REF61538545,85.39,0.0,93096.61
2018-11-19,2018-11-19,Equipment Rental expense,REF41783104,297.05,0.0,92799.56
2018-11-25,2018-11-25,Safety Equipment expense,REF79438653,95.9,0.0,92703.66
2018-11-27,2018-11-27,Fuel purchase,REF84472199,245.11,0.0,92458.55
2018-11-30,2018-11-30,"Project payment - Brown, Ray and Torres",REF24540297,0.0,1165.28,93623.83
2018-11-30,2018-11-30,Invoice payment - Burns PLC,REF84830439,0.0,882.94,94506.77
2018-11-30,2018-11-30,Payment from Cooper-Dean,REF31136538,0.0,609.44,95116.21
2018-11-30,2018-11-30,"Invoice payment - Parsons, Diaz and Jackson",REF88631014,0.0,446.23,95562.44
2018-11-30,2018-11-30,"Service payment - Leon, Jones and Jackson",REF50216218,0.0,258.87,95821.31
2018-12-02,2018-12-02,Business materials,REF60060962,408.84,0.0,95412.47
2018-12-09,2018-12-09,Fuel purchase,REF62675612,166.86,0.0,95245.61
2018-12-12,2018-12-12,Business materials,REF55480938,597.84,0.0,94647.77
2018-12-15,2018-12-15,Business insurance premium,REF21343271,116.2,0.0,94531.57
2018-12-15,2018-12-15,"Project payment - Parsons, Diaz and Jackson",REF52017460,0.0,393.27,94924.84
2018-12-15,2018-12-15,Equipment Rental expense,REF84667108,211.81,0.0,94713.03
2018-12-15,2018-12-15,"Invoice payment - Brown, Ray and Torres",REF26309296,0.0,1175.51,95888.54
2018-12-15,2018-12-15,Business materials,REF89024570,400.76,0.0,95487.78
2018-12-15,2018-12-15,"Payment from Leon, Jones and Jackson",REF13403263,0.0,307.26,95795.04
2018-12-15,2018-12-15,Project payment - Burns PLC,REF18317047,0.0,585.64,96380.68
2018-12-18,2018-12-18,Fuel purchase,REF20624518,196.74,0.0,96183.94
2018-12-18,2018-12-18,Vehicle Maintenance expense,REF51478284,61.04,0.0,96122.9
2018-12-22,2018-12-22,Permits Licenses expense,REF91899077,31.64,0.0,96091.26
2018-12-23,2018-12-23,Business materials,REF25024283,389.76,0.0,95701.5
2018-12-23,2018-12-23,Fuel purchase,REF33620088,144.45,0.0,95557.05
2018-12-24,2018-12-24,Fuel purchase,REF55389253,288.64,0.0,95268.41
2018-12-25,2018-12-25,Permits Licenses expense,REF20195128,59.16,0.0,95209.25
2018-12-25,2018-12-25,Fuel purchase,REF36147063,217.12,0.0,94992.13
2018-12-26,2018-12-26,Fuel purchase,REF48167203,186.24,0.0,94805.89
2018-12-26,2018-12-26,Subcontractors expense,REF10839236,534.45,0.0,94271.44
2018-12-29,2018-12-29,Tools expense,REF80425117,77.18,0.0,94194.26
2018-12-30,2018-12-30,"Payment from Leon, Jones and Jackson",REF50136274,0.0,217.61,94411.87
2018-12-30,2018-12-30,"Payment from Parsons, Diaz and Jackson",REF51114898,0.0,431.12,94842.99
2018-12-30,2018-12-30,Payment from Cooper-Dean,REF99846732,0.0,457.72,95300.71
2018-12-30,2018-12-30,Project payment - Burns PLC,REF70125684,0.0,609.88,95910.59
2019-01-05,2019-01-05,Business materials,REF94827701,601.4,0.0,95309.19
2019-01-06,2019-01-06,Subcontractors expense,REF82860402,740.68,0.0,94568.51
2019-01-09,2019-01-09,Business materials,REF46686496,365.21,0.0,94203.3
2019-01-11,2019-01-11,Equipment Rental expense,REF52882782,355.08,0.0,93848.22
2019-01-11,2019-01-11,Tools expense,REF47259736,53.92,0.0,93794.3
2019-01-12,2019-01-12,Business materials,REF21784887,747.33,0.0,93046.97
2019-01-13,2019-01-13,Tools expense,REF63826683,108.08,0.0,92938.89
2019-01-14,2019-01-14,Safety Equipment expense,REF81479936,51.09,0.0,92887.8
2019-01-15,2019-01-15,Invoice payment - Cooper-Dean,REF33613791,0.0,506.96,93394.76
2019-01-15,2019-01-15,Invoice payment - Burns PLC,REF46549945,0.0,669.27,94064.03
2019-01-15,2019-01-15,Business insurance premium,REF53305363,139.31,0.0,93924.72
2019-01-15,2019-01-15,"Project payment - Parsons, Diaz and Jackson",REF18424622,0.0,427.9,94352.62
2019-01-15,2019-01-15,"Service payment - Leon, Jones and Jackson",REF73558536,0.0,274.37,94626.99
2019-01-24,2019-01-24,Business materials,REF88504604,375.04,0.0,94251.95
2019-01-25,2019-01-25,Safety Equipment expense,REF12479580,40.93,0.0,94211.02
2019-01-30,2019-01-30,"Invoice payment - Leon, Jones and Jackson",REF13239655,0.0,253.06,94464.08
2019-01-30,2019-01-30,Invoice payment - Cooper-Dean,REF24337150,0.0,591.94,95056.02
2019-01-30,2019-01-30,"Invoice payment - Brown, Ray and Torres",REF18992155,0.0,1004.69,96060.71
2019-01-30,2019-01-30,"Payment from Parsons, Diaz and Jackson",REF11323180,0.0,320.69,96381.4
2019-01-31,2019-01-31,Permits Licenses expense,REF86610662,48.34,0.0,96333.06
2019-02-04,2019-02-04,Equipment Rental expense,REF13103028,316.49,0.0,96016.57
2019-02-04,2019-02-04,Tools expense,REF52876133,42.93,0.0,95973.64
2019-02-05,2019-02-05,Permits Licenses expense,REF18140167,64.08,0.0,95909.56
2019-02-11,2019-02-11,Business materials,REF25377703,784.01,0.0,95125.55
2019-02-11,2019-02-11,Equipment Rental expense,REF83796725,330.22,0.0,94795.33
2019-02-12,2019-02-12,Business materials,REF25476871,252.56,0.0,94542.77
2019-02-12,2019-02-12,Permits Licenses expense,REF45065269,56.82,0.0,94485.95
2019-02-14,2019-02-14,Safety Equipment expense,REF96616437,73.16,0.0,94412.79
2019-02-15,2019-02-15,Business insurance premium,REF60538879,160.39,0.0,94252.4
2019-02-15,2019-02-15,Service payment - Cooper-Dean,REF21129594,0.0,647.59,94899.99
2019-02-15,2019-02-15,"Payment from Parsons, Diaz and Jackson",REF22872073,0.0,457.4,95357.39
2019-02-15,2019-02-15,"Invoice payment - Leon, Jones and Jackson",REF47398657,0.0,251.72,95609.11
2019-02-21,2019-02-21,Fuel purchase,REF98078874,321.06,0.0,95288.05
2019-02-23,2019-02-23,Business materials,REF58772955,620.45,0.0,94667.6
2019-02-24,2019-02-24,Safety Equipment expense,REF40651503,66.03,0.0,94601.57
2019-02-28,2019-02-28,"Service payment - Leon, Jones and Jackson",REF99922213,0.0,319.58,94921.15
2019-02-28,2019-02-28,Project payment - Burns PLC,REF33545802,0.0,789.23,95710.38
2019-02-28,2019-02-28,"Payment from Parsons, Diaz and Jackson",REF39640083,0.0,420.33,96130.71
2019-02-28,2019-02-28,Service payment - Cooper-Dean,REF67742342,0.0,475.14,96605.85
2019-02-28,2019-02-28,"Payment from Brown, Ray and Torres",REF38748120,0.0,1224.93,97830.78
2019-03-01,2019-03-01,Tools expense,REF11143227,118.88,0.0,97711.9
2019-03-02,2019-03-02,Fuel purchase,REF45360206,464.08,0.0,97247.82
2019-03-05,2019-03-05,Tools expense,REF15392206,56.29,0.0,97191.53
2019-03-06,2019-03-06,Business materials,REF93962283,1118.86,0.0,96072.67
2019-03-15,2019-03-15,Business insurance premium,REF70012129,186.29,0.0,95886.38
2019-03-15,2019-03-15,"Service payment - Brown, Ray and Torres",REF94545822,0.0,1618.31,97504.69
2019-03-15,2019-03-15,"Payment from Parsons, Diaz and Jackson",REF38209235,0.0,515.76,98020.45
2019-03-15,2019-03-15,"Service payment - Leon, Jones and Jackson",REF75078827,0.0,512.74,98533.19
2019-03-15,2019-03-15,Invoice payment - Burns PLC,REF73508285,0.0,1118.03,99651.22
2019-03-15,2019-03-15,Project payment - Cooper-Dean,REF95851271,0.0,599.68,100250.9
2019-03-24,2019-03-24,Permits Licenses expense,REF32655932,98.02,0.0,100152.88
2019-03-24,2019-03-24,Subcontractors expense,REF59255528,1000.35,0.0,99152.53
2019-03-25,2019-03-25,Business materials,REF99412104,1031.4,0.0,98121.13
2019-03-26,2019-03-26,Business materials,REF29913208,915.58,0.0,97205.55
2019-03-28,2019-03-28,Business materials,REF11632122,712.3,0.0,96493.25
2019-03-30,2019-03-30,Service payment - Cooper-Dean,REF53941914,0.0,869.56,97362.81
2019-03-30,2019-03-30,"Project payment - Brown, Ray and Torres",REF29551529,0.0,1990.65,99353.46
2019-03-30,2019-03-30,Service payment - Burns PLC,REF68343431,0.0,742.15,100095.61
2019-03-30,2019-03-30,"Service payment - Leon, Jones and Jackson",REF98229008,0.0,384.65,100480.26
2019-03-31,2019-03-31,Safety Equipment expense,REF74125498,89.3,0.0,100390.96
2019-04-01,2019-04-01,Fuel purchase,REF51525207,354.85,0.0,100036.11
2019-04-07,2019-04-07,Permits Licenses expense,REF46396727,108.05,0.0,99928.06
2019-04-08,2019-04-08,Fuel purchase,REF33539471,455.74,0.0,99472.32
2019-04-10,2019-04-10,Vehicle Maintenance expense,REF69529562,198.61,0.0,99273.71
2019-04-15,2019-04-15,Project payment - Burns PLC,REF30065940,0.0,990.26,100263.97
2019-04-15,2019-04-15,Permits Licenses expense,REF28503995,39.21,0.0,100224.76
2019-04-15,2019-04-15,"Project payment - Leon, Jones and Jackson",REF53329563,0.0,407.68,100632.44
2019-04-15,2019-04-15,Service payment - Cooper-Dean,REF22261783,0.0,504.48,101136.92
2019-04-15,2019-04-15,"Service payment - Parsons, Diaz and Jackson",REF41264288,0.0,679.78,101816.7
2019-04-15,2019-04-15,Business insurance premium,REF37252911,238.9,0.0,101577.8
2019-04-15,2019-04-15,"Payment from Brown, Ray and Torres",REF63957007,0.0,1499.54,103077.34
2019-04-17,2019-04-17,Permits Licenses expense,REF80475065,112.71,0.0,102964.63
2019-04-18,2019-04-18,Business materials,REF13660684,1116.76,0.0,101847.87
2019-04-20,2019-04-20,Vehicle Maintenance expense,REF96931123,214.76,0.0,101633.11
2019-04-21,2019-04-21,Permits Licenses expense,REF70361670,49.35,0.0,101583.76
2019-04-22,2019-04-22,Subcontractors expense,REF52826551,1260.91,0.0,100322.85
2019-04-23,2019-04-23,Business materials,REF65115753,1264.54,0.0,99058.31
2019-04-23,2019-04-23,Permits Licenses expense,REF96760443,124.73,0.0,98933.58
2019-04-26,2019-04-26,Business materials,REF22402651,1423.24,0.0,97510.34
2019-04-27,2019-04-27,Tools expense,REF14592891,136.24,0.0,97374.1
2019-04-28,2019-04-28,Permits Licenses expense,REF27562872,113.81,0.0,97260.29
2019-04-30,2019-04-30,Tools expense,REF80898066,62.95,0.0,97197.34
2019-04-30,2019-04-30,"Project payment - Brown, Ray and Torres",REF18183795,0.0,2785.59,99982.93
2019-04-30,2019-04-30,"Payment from Leon, Jones and Jackson",REF81332987,0.0,500.64,100483.57
2019-04-30,2019-04-30,"Service payment - Parsons, Diaz and Jackson",REF82045861,0.0,690.41,101173.98
2019-04-30,2019-04-30,Service payment - Cooper-Dean,REF75377905,0.0,948.96,102122.94
2019-04-30,2019-04-30,Invoice payment - Burns PLC,REF13254404,0.0,1084.34,103207.28
2019-05-01,2019-05-01,Business materials,REF50713434,1078.57,0.0,102128.71
2019-05-02,2019-05-02,Fuel purchase,REF87482375,336.05,0.0,101792.66
2019-05-02,2019-05-02,Business materials,REF62472047,1053.02,0.0,100739.64
2019-05-04,2019-05-04,Subcontractors expense,REF63063823,1533.63,0.0,99206.01
2019-05-04,2019-05-04,Equipment Rental expense,REF53908064,426.85,0.0,98779.16
2019-05-10,2019-05-10,Vehicle Maintenance expense,REF67600744,258.33,0.0,98520.83
2019-05-15,2019-05-15,Business insurance premium,REF32472871,265.62,0.0,98255.21
2019-05-15,2019-05-15,"Service payment - Brown, Ray and Torres",REF40495257,0.0,1981.41,100236.62
2019-05-15,2019-05-15,"Service payment - Parsons, Diaz and Jackson",REF29633808,0.0,836.55,101073.17
2019-05-15,2019-05-15,Invoice payment - Cooper-Dean,REF40745786,0.0,1289.94,102363.11
2019-05-15,2019-05-15,"Project payment - Leon, Jones and Jackson",REF25748400,0.0,493.89,102857.0
2019-05-15,2019-05-15,Project payment - Burns PLC,REF70209636,0.0,1084.36,103941.36
2019-05-22,2019-05-22,Permits Licenses expense,REF93413954,111.4,0.0,103829.96
2019-05-22,2019-05-22,Equipment Rental expense,REF81501641,472.09,0.0,103357.87
2019-05-24,2019-05-24,Permits Licenses expense,REF14678659,64.32,0.0,103293.55
2019-05-25,2019-05-25,Vehicle Maintenance expense,REF32971680,129.07,0.0,103164.48
2019-05-26,2019-05-26,Subcontractors expense,REF15201119,1489.79,0.0,101674.69
2019-05-27,2019-05-27,Fuel purchase,REF40773922,388.69,0.0,101286.0
2019-05-30,2019-05-30,Service payment - Burns PLC,REF49499759,0.0,1239.49,102525.49
2019-05-30,2019-05-30,Payment from Cooper-Dean,REF73674439,0.0,821.36,103346.85
2019-05-30,2019-05-30,"Project payment - Parsons, Diaz and Jackson",REF31481330,0.0,766.91,104113.76
2019-05-30,2019-05-30,"Payment from Leon, Jones and Jackson",REF75625046,0.0,607.57,104721.33
2019-05-30,2019-05-30,"Project payment - Brown, Ray and Torres",REF20407258,0.0,1767.67,106489.0
2019-06-05,2019-06-05,Business materials,REF63129784,1139.61,0.0,105349.39
2019-06-05,2019-06-05,Fuel purchase,REF34552131,465.24,0.0,104884.15
2019-06-07,2019-06-07,Equipment Rental expense,REF17745192,658.93,0.0,104225.22
2019-06-07,2019-06-07,Subcontractors expense,REF21487147,842.48,0.0,103382.74
2019-06-11,2019-06-11,Fuel purchase,REF20416929,446.69,0.0,102936.05
2019-06-11,2019-06-11,Equipment Rental expense,REF35229200,424.18,0.0,102511.87
2019-06-12,2019-06-12,Fuel purchase,REF94505918,320.1,0.0,102191.77
2019-06-15,2019-06-15,Business insurance premium,REF81397984,281.77,0.0,101910.0
2019-06-15,2019-06-15,Invoice payment - Burns PLC,REF93742941,0.0,1069.45,102979.45
2019-06-15,2019-06-15,"Payment from Parsons, Diaz and Jackson",REF43578768,0.0,719.47,103698.92
2019-06-15,2019-06-15,"Service payment - Brown, Ray and Torres",REF17811395,0.0,1869.02,105567.94
2019-06-19,2019-06-19,Tools expense,REF97143261,56.75,0.0,105511.19
2019-06-20,2019-06-20,Business materials,REF23060847,1354.47,0.0,104156.72
2019-06-22,2019-06-22,Fuel purchase,REF70819536,233.37,0.0,103923.35
2019-06-23,2019-06-23,Fuel purchase,REF14845329,393.92,0.0,103529.43
2019-06-23,2019-06-23,Business materials,REF73395875,913.04,0.0,102616.39
2019-06-25,2019-06-25,Equipment Rental expense,REF36934917,429.76,0.0,102186.63
2019-06-25,2019-06-25,Fuel purchase,REF31893063,393.27,0.0,101793.36
2019-06-27,2019-06-27,Business materials,REF44283110,1051.71,0.0,100741.65
2019-06-30,2019-06-30,Project payment - Burns PLC,REF68924311,0.0,1042.54,101784.19
2019-06-30,2019-06-30,"Service payment - Parsons, Diaz and Jackson",REF18770624,0.0,921.5,102705.69
2019-06-30,2019-06-30,"Invoice payment - Brown, Ray and Torres",REF22353120,0.0,2226.31,104932.0
2019-06-30,2019-06-30,"Payment from Leon, Jones and Jackson",REF35051943,0.0,579.42,105511.42
2019-06-30,2019-06-30,Project payment - Cooper-Dean,REF44152193,0.0,977.12,106488.54
2019-07-01,2019-07-01,Permits Licenses expense,REF70841544,107.23,0.0,106381.31
2019-07-01,2019-07-01,Business materials,REF40838939,693.09,0.0,105688.22
2019-07-03,2019-07-03,Permits Licenses expense,REF42697016,104.78,0.0,105583.44
2019-07-06,2019-07-06,Vehicle Maintenance expense,REF13663215,250.96,0.0,105332.48
2019-07-10,2019-07-10,Tools expense,REF35582626,120.12,0.0,105212.36
2019-07-12,2019-07-12,Business materials,REF76266398,1078.6,0.0,104133.76
2019-07-13,2019-07-13,Business materials,REF41437975,766.76,0.0,103367.0
2019-07-15,2019-07-15,"Project payment - Brown, Ray and Torres",REF47933944,0.0,1847.53,105214.53
2019-07-15,2019-07-15,"Invoice payment - Leon, Jones and Jackson",REF44719828,0.0,442.98,105657.51
2019-07-15,2019-07-15,Project payment - Cooper-Dean,REF91804122,0.0,731.27,106388.78
2019-07-15,2019-07-15,Service payment - Burns PLC,REF33969666,0.0,1022.47,107411.25
2019-07-15,2019-07-15,Business insurance premium,REF70446653,258.17,0.0,107153.08
2019-07-17,2019-07-17,Tools expense,REF20487460,96.73,0.0,107056.35
2019-07-19,2019-07-19,Permits Licenses expense,REF99915888,82.58,0.0,106973.77
2019-07-20,2019-07-20,Fuel purchase,REF24549481,498.66,0.0,106475.11
2019-07-22,2019-07-22,Permits Licenses expense,REF72270439,84.93,0.0,106390.18
2019-07-24,2019-07-24,Fuel purchase,REF37539759,187.08,0.0,106203.1
2019-07-29,2019-07-29,Business materials,REF17165456,560.67,0.0,105642.43
2019-07-29,2019-07-29,Fuel purchase,REF88387345,358.49,0.0,105283.94
2019-07-30,2019-07-30,"Service payment - Parsons, Diaz and Jackson",REF19524556,0.0,711.47,105995.41
2019-07-30,2019-07-30,Service payment - Cooper-Dean,REF93215031,0.0,670.04,106665.45
2019-07-30,2019-07-30,Business materials,REF59554013,1363.0,0.0,105302.45
2019-07-30,2019-07-30,"Invoice payment - Brown, Ray and Torres",REF36692256,0.0,1996.66,107299.11
2019-07-30,2019-07-30,"Payment from Leon, Jones and Jackson",REF14067862,0.0,475.53,107774.64
2019-08-10,2019-08-10,Business materials,REF83621625,1119.8,0.0,106654.84
2019-08-12,2019-08-12,Business materials,REF53319707,1176.34,0.0,105478.5
2019-08-13,2019-08-13,Tools expense,REF38184783,100.9,0.0,105377.6
2019-08-15,2019-08-15,Business materials,REF94651105,805.38,0.0,104572.22
2019-08-15,2019-08-15,Business insurance premium,REF67156171,235.52,0.0,104336.7
2019-08-15,2019-08-15,"Payment from Brown, Ray and Torres",REF30408148,0.0,1545.32,105882.02
2019-08-15,2019-08-15,"Invoice payment - Leon, Jones and Jackson",REF11711247,0.0,532.85,106414.87
2019-08-15,2019-08-15,Invoice payment - Cooper-Dean,REF41677635,0.0,796.1,107210.97
2019-08-15,2019-08-15,Project payment - Burns PLC,REF62869651,0.0,1018.72,108229.69
2019-08-15,2019-08-15,"Invoice payment - Parsons, Diaz and Jackson",REF40532884,0.0,677.54,108907.23
2019-08-23,2019-08-23,Vehicle Maintenance expense,REF13455977,273.48,0.0,108633.75
2019-08-24,2019-08-24,Subcontractors expense,REF77594852,1476.84,0.0,107156.91
2019-08-25,2019-08-25,Fuel purchase,REF44536400,508.67,0.0,106648.24
2019-08-25,2019-08-25,Business materials,REF24512601,1577.25,0.0,105070.99
2019-08-30,2019-08-30,"Project payment - Parsons, Diaz and Jackson",REF70417507,0.0,337.7,105408.69
2019-08-30,2019-08-30,"Service payment - Brown, Ray and Torres",REF55336486,0.0,2192.48,107601.17
2019-08-30,2019-08-30,Invoice payment - Burns PLC,REF87273090,0.0,1091.71,108692.88
2019-08-30,2019-08-30,"Payment from Leon, Jones and Jackson",REF91732427,0.0,401.98,109094.86
2019-08-30,2019-08-30,Service payment - Cooper-Dean,REF78238537,0.0,732.26,109827.12
2019-09-07,2019-09-07,Fuel purchase,REF21152230,254.62,0.0,109572.5
2019-09-07,2019-09-07,Business materials,REF61327543,1418.77,0.0,108153.73
2019-09-15,2019-09-15,"Payment from Leon, Jones and Jackson",REF64780306,0.0,402.37,108556.1
2019-09-15,2019-09-15,Business insurance premium,REF23435674,226.23,0.0,108329.87
2019-09-15,2019-09-15,Project payment - Burns PLC,REF12691033,0.0,841.54,109171.41
2019-09-15,2019-09-15,Invoice payment - Cooper-Dean,REF73445849,0.0,838.54,110009.95
2019-09-15,2019-09-15,"Payment from Brown, Ray and Torres",REF10975008,0.0,1695.23,111705.18
2019-09-15,2019-09-15,"Payment from Parsons, Diaz and Jackson",REF24172162,0.0,688.15,112393.33
2019-09-21,2019-09-21,Business materials,REF71486259,989.92,0.0,111403.41
2019-09-22,2019-09-22,Business materials,REF28689984,772.04,0.0,110631.37
2019-09-23,2019-09-23,Business materials,REF78743385,961.15,0.0,109670.22
2019-09-24,2019-09-24,Fuel purchase,REF57329979,495.98,0.0,109174.24
2019-09-28,2019-09-28,Safety Equipment expense,REF64094099,63.13,0.0,109111.11
2019-09-30,2019-09-30,"Project payment - Parsons, Diaz and Jackson",REF43118880,0.0,630.51,109741.62
2019-09-30,2019-09-30,Payment from Burns PLC,REF28297925,0.0,1260.01,111001.63
2019-09-30,2019-09-30,"Service payment - Brown, Ray and Torres",REF96551743,0.0,1509.68,112511.31
2019-09-30,2019-09-30,"Project payment - Leon, Jones and Jackson",REF81122765,0.0,355.14,112866.45
2019-09-30,2019-09-30,Project payment - Cooper-Dean,REF97230997,0.0,954.72,113821.17
2019-10-01,2019-10-01,Fuel purchase,REF81736870,253.69,0.0,113567.48
2019-10-04,2019-10-04,Fuel purchase,REF81632148,423.19,0.0,113144.29
2019-10-06,2019-10-06,Fuel purchase,REF34087090,367.08,0.0,112777.21
2019-10-08,2019-10-08,Fuel purchase,REF94877550,239.63,0.0,112537.58
2019-10-09,2019-10-09,Vehicle Maintenance expense,REF62565364,129.58,0.0,112408.0
2019-10-11,2019-10-11,Vehicle Maintenance expense,REF73389225,163.16,0.0,112244.84
2019-10-12,2019-10-12,Business materials,REF26899528,629.24,0.0,111615.6
2019-10-15,2019-10-15,Project payment - Cooper-Dean,REF88363712,0.0,737.74,112353.34
2019-10-15,2019-10-15,"Service payment - Leon, Jones and Jackson",REF39840775,0.0,402.05,112755.39
2019-10-15,2019-10-15,"Invoice payment - Brown, Ray and Torres",REF75035103,0.0,1372.5,114127.89
2019-10-15,2019-10-15,Business insurance premium,REF70186352,184.35,0.0,113943.54
2019-10-15,2019-10-15,Service payment - Burns PLC,REF79279216,0.0,755.87,114699.41
2019-10-19,2019-10-19,Business materials,REF58304175,827.77,0.0,113871.64
2019-10-19,2019-10-19,Vehicle Maintenance expense,REF50946454,194.5,0.0,113677.14
2019-10-19,2019-10-19,Fuel purchase,REF89704369,359.73,0.0,113317.41
2019-10-22,2019-10-22,Fuel purchase,REF91303597,283.85,0.0,113033.56
2019-10-24,2019-10-24,Vehicle Maintenance expense,REF43283038,157.26,0.0,112876.3
2019-10-30,2019-10-30,Payment from Burns PLC,REF46917745,0.0,924.71,113801.01
2019-10-30,2019-10-30,Payment from Cooper-Dean,REF32722455,0.0,522.08,114323.09
2019-10-30,2019-10-30,"Payment from Brown, Ray and Torres",REF41047514,0.0,1827.86,116150.95
2019-10-30,2019-10-30,"Project payment - Leon, Jones and Jackson",REF90521305,0.0,408.03,116558.98
2019-10-31,2019-10-31,Fuel purchase,REF75610383,241.08,0.0,116317.9
2019-11-01,2019-11-01,Business materials,REF70898180,487.22,0.0,115830.68
2019-11-02,2019-11-02,Vehicle Maintenance expense,REF55838158,131.24,0.0,115699.44
2019-11-04,2019-11-04,Permits Licenses expense,REF16599623,56.03,0.0,115643.41
2019-11-08,2019-11-08,Fuel purchase,REF49261904,285.71,0.0,115357.7
2019-11-10,2019-11-10,Business materials,REF78144372,528.89,0.0,114828.81
2019-11-15,2019-11-15,Service payment - Cooper-Dean,REF12152592,0.0,390.61,115219.42
2019-11-15,2019-11-15,Service payment - Burns PLC,REF51565380,0.0,659.37,115878.79
2019-11-15,2019-11-15,"Invoice payment - Leon, Jones and Jackson",REF26453347,0.0,371.59,116250.38
2019-11-15,2019-11-15,Fuel purchase,REF36944213,163.29,0.0,116087.09
2019-11-15,2019-11-15,"Invoice payment - Parsons, Diaz and Jackson",REF16101531,0.0,471.31,116558.4
2019-11-15,2019-11-15,Business insurance premium,REF42934845,163.69,0.0,116394.71
2019-11-20,2019-11-20,Business materials,REF72212377,949.57,0.0,115445.14
2019-11-21,2019-11-21,Vehicle Maintenance expense,REF91813318,179.72,0.0,115265.42
2019-11-22,2019-11-22,Permits Licenses expense,REF97258202,53.95,0.0,115211.47
2019-11-30,2019-11-30,"Invoice payment - Leon, Jones and Jackson",REF76528383,0.0,280.09,115491.56
2019-11-30,2019-11-30,"Payment from Parsons, Diaz and Jackson",REF28790854,0.0,419.35,115910.91
2019-11-30,2019-11-30,Payment from Burns PLC,REF36407794,0.0,564.9,116475.81
2019-12-03,2019-12-03,Tools expense,REF76775459,43.72,0.0,116432.09
2019-12-04,2019-12-04,Permits Licenses expense,REF53825533,38.2,0.0,116393.89
2019-12-05,2019-12-05,Business materials,REF11496837,459.45,0.0,115934.44
2019-12-07,2019-12-07,Tools expense,REF23812335,51.98,0.0,115882.46
2019-12-08,2019-12-08,Tools expense,REF55722891,71.58,0.0,115810.88
2019-12-10,2019-12-10,Equipment Rental expense,REF26798131,348.49,0.0,115462.39
2019-12-14,2019-12-14,Business materials,REF23098251,476.85,0.0,114985.54
2019-12-15,2019-12-15,"Invoice payment - Parsons, Diaz and Jackson",REF12708794,0.0,319.43,115304.97
2019-12-15,2019-12-15,Project payment - Cooper-Dean,REF26072754,0.0,445.76,115750.73
2019-12-15,2019-12-15,"Invoice payment - Brown, Ray and Torres",REF78741900,0.0,713.58,116464.31
2019-12-15,2019-12-15,Business materials,REF10491707,450.31,0.0,116014.0
2019-12-15,2019-12-15,Equipment Rental expense,REF73974662,179.08,0.0,115834.92
2019-12-15,2019-12-15,"Payment from Leon, Jones and Jackson",REF63231983,0.0,182.19,116017.11
2019-12-15,2019-12-15,Business insurance premium,REF82018412,113.55,0.0,115903.56
2019-12-15,2019-12-15,Service payment - Burns PLC,REF81121288,0.0,648.54,116552.1
2019-12-17,2019-12-17,Safety Equipment expense,REF98772828,46.97,0.0,116505.13
2019-12-18,2019-12-18,Vehicle Maintenance expense,REF19756283,105.6,0.0,116399.53
2019-12-19,2019-12-19,Fuel purchase,REF26595089,170.13,0.0,116229.4
2019-12-23,2019-12-23,Business materials,REF29710454,549.02,0.0,115680.38
2019-12-25,2019-12-25,Tools expense,REF63492668,44.58,0.0,115635.8
2019-12-25,2019-12-25,Equipment Rental expense,REF89719738,342.57,0.0,115293.23
2019-12-30,2019-12-30,"Project payment - Leon, Jones and Jackson",REF68104544,0.0,233.64,115526.87
2019-12-30,2019-12-30,Business materials,REF35134943,487.55,0.0,115039.32
2019-12-30,2019-12-30,Project payment - Burns PLC,REF61879871,0.0,573.05,115612.37
2019-12-30,2019-12-30,"Payment from Parsons, Diaz and Jackson",REF83161940,0.0,299.67,115912.04
2019-12-30,2019-12-30,Project payment - Cooper-Dean,REF11345395,0.0,420.2,116332.24
2020-01-01,2020-01-01,Fuel purchase,REF10952203,197.97,0.0,116134.27
2020-01-02,2020-01-02,Business materials,REF88388898,498.32,0.0,115635.95
2020-01-11,2020-01-11,Business materials,REF85979384,389.08,0.0,115246.87
2020-01-15,2020-01-15,Business insurance premium,REF88428088,141.53,0.0,115105.34
2020-01-15,2020-01-15,"Payment from Brown, Ray and Torres",REF48899558,0.0,1186.53,116291.87
2020-01-15,2020-01-15,"Payment from Parsons, Diaz and Jackson",REF91258808,0.0,445.74,116737.61
2020-01-15,2020-01-15,Invoice payment - Cooper-Dean,REF80261886,0.0,557.31,117294.92
2020-01-15,2020-01-15,Payment from Burns PLC,REF14494947,0.0,575.2,117870.12
2020-01-16,2020-01-16,Business materials,REF78381013,699.14,0.0,117170.98
2020-01-17,2020-01-17,Business materials,REF23881433,396.08,0.0,116774.9
2020-01-26,2020-01-26,Subcontractors expense,REF66316438,619.26,0.0,116155.64
2020-01-27,2020-01-27,Safety Equipment expense,REF77754826,67.0,0.0,116088.64
2020-01-30,2020-01-30,Invoice payment - Burns PLC,REF11860430,0.0,571.47,116660.11
2020-01-30,2020-01-30,"Payment from Brown, Ray and Torres",REF17168827,0.0,1126.97,117787.08
2020-01-30,2020-01-30,Service payment - Cooper-Dean,REF25147725,0.0,513.23,118300.31
2020-01-30,2020-01-30,"Payment from Parsons, Diaz and Jackson",REF69633900,0.0,335.61,118635.92
2020-01-30,2020-01-30,"Payment from Leon, Jones and Jackson",REF29223813,0.0,246.38,118882.3
2020-02-01,2020-02-01,Vehicle Maintenance expense,REF20612543,151.79,0.0,118730.51
2020-02-02,2020-02-02,Business materials,REF92964951,829.78,0.0,117900.73
2020-02-02,2020-02-02,Safety Equipment expense,REF70643074,32.81,0.0,117867.92
2020-02-05,2020-02-05,Fuel purchase,REF78649577,246.1,0.0,117621.82
2020-02-14,2020-02-14,Tools expense,REF87376110,95.96,0.0,117525.86
2020-02-15,2020-02-15,Business insurance premium,REF88845785,148.35,0.0,117377.51
2020-02-15,2020-02-15,"Project payment - Leon, Jones and Jackson",REF46635519,0.0,282.81,117660.32
2020-02-15,2020-02-15,"Payment from Parsons, Diaz and Jackson",REF17000495,0.0,476.6,118136.92
2020-02-15,2020-02-15,Service payment - Cooper-Dean,REF49830519,0.0,503.82,118640.74
2020-02-15,2020-02-15,"Service payment - Brown, Ray and Torres",REF16206692,0.0,876.31,119517.05
2020-02-15,2020-02-15,Payment from Burns PLC,REF45822543,0.0,767.81,120284.86
2020-02-15,2020-02-15,Permits Licenses expense,REF54972614,76.45,0.0,120208.41
2020-02-18,2020-02-18,Equipment Rental expense,REF40427917,214.95,0.0,119993.46
2020-02-20,2020-02-20,Fuel purchase,REF84282042,161.65,0.0,119831.81
2020-02-21,2020-02-21,Business materials,REF32140065,821.9,0.0,119009.91
2020-02-23,2020-02-23,Subcontractors expense,REF33177675,467.56,0.0,118542.35
2020-02-25,2020-02-25,Business materials,REF71867252,909.81,0.0,117632.54
2020-02-25,2020-02-25,Fuel purchase,REF57481265,127.82,0.0,117504.72
2020-02-25,2020-02-25,Tools expense,REF94738447,73.78,0.0,117430.94
2020-02-26,2020-02-26,Fuel purchase,REF89045831,160.99,0.0,117269.95
2020-02-27,2020-02-27,Business materials,REF25161613,712.42,0.0,116557.53
2020-02-28,2020-02-28,"Project payment - Brown, Ray and Torres",REF10932259,0.0,1437.42,117994.95
2020-02-28,2020-02-28,Payment from Burns PLC,REF98097602,0.0,512.91,118507.86
2020-02-28,2020-02-28,"Invoice payment - Leon, Jones and Jackson",REF56507871,0.0,179.76,118687.62
2020-02-28,2020-02-28,Service payment - Cooper-Dean,REF90357259,0.0,584.68,119272.3
2020-02-28,2020-02-28,"Payment from Parsons, Diaz and Jackson",REF46100764,0.0,574.81,119847.11
2020-03-02,2020-03-02,Business materials,REF49957661,897.75,0.0,118949.36
2020-03-03,2020-03-03,Business materials,REF73148260,933.48,0.0,118015.88
2020-03-08,2020-03-08,Business materials,REF86717635,1146.31,0.0,116869.57
2020-03-09,2020-03-09,Subcontractors expense,REF45217244,996.75,0.0,115872.82
2020-03-11,2020-03-11,Fuel purchase,REF20212175,492.69,0.0,115380.13
2020-03-12,2020-03-12,Fuel purchase,REF15162027,274.09,0.0,115106.04
2020-03-13,2020-03-13,Fuel purchase,REF99873537,200.48,0.0,114905.56
2020-03-15,2020-03-15,Business insurance premium,REF50805810,197.96,0.0,114707.6
2020-03-15,2020-03-15,"Project payment - Parsons, Diaz and Jackson",REF57601009,0.0,602.17,115309.77
2020-03-15,2020-03-15,Invoice payment - Burns PLC,REF55929423,0.0,1163.74,116473.51
2020-03-15,2020-03-15,"Invoice payment - Leon, Jones and Jackson",REF37735801,0.0,373.04,116846.55
2020-03-15,2020-03-15,Service payment - Cooper-Dean,REF48310393,0.0,731.86,117578.41
2020-03-15,2020-03-15,"Payment from Brown, Ray and Torres",REF12001154,0.0,1449.54,119027.95
2020-03-17,2020-03-17,Business materials,REF66630163,843.36,0.0,118184.59
2020-03-18,2020-03-18,Permits Licenses expense,REF39203792,59.1,0.0,118125.49
2020-03-22,2020-03-22,Fuel purchase,REF41131144,374.71,0.0,117750.78
2020-03-25,2020-03-25,Fuel purchase,REF28008282,232.74,0.0,117518.04
2020-03-26,2020-03-26,Permits Licenses expense,REF12751398,100.77,0.0,117417.27
2020-03-30,2020-03-30,Fuel purchase,REF89794519,327.35,0.0,117089.92
2020-03-30,2020-03-30,Invoice payment - Burns PLC,REF78431273,0.0,827.47,117917.39
2020-03-30,2020-03-30,"Project payment - Parsons, Diaz and Jackson",REF95930636,0.0,670.22,118587.61
2020-03-30,2020-03-30,Project payment - Cooper-Dean,REF38394812,0.0,820.29,119407.9
2020-03-30,2020-03-30,"Service payment - Leon, Jones and Jackson",REF61414369,0.0,350.85,119758.75
2020-03-30,2020-03-30,"Payment from Brown, Ray and Torres",REF29624974,0.0,1359.49,121118.24
2020-04-01,2020-04-01,Equipment Rental expense,REF42930512,344.16,0.0,120774.08
2020-04-03,2020-04-03,Subcontractors expense,REF37133767,1493.83,0.0,119280.25
2020-04-03,2020-04-03,Fuel purchase,REF24527999,393.35,0.0,118886.9
2020-04-12,2020-04-12,Fuel purchase,REF67452689,531.68,0.0,118355.22
2020-04-15,2020-04-15,"Payment from Parsons, Diaz and Jackson",REF12191754,0.0,626.05,118981.27
2020-04-15,2020-04-15,Project payment - Burns PLC,REF14135003,0.0,1208.91,120190.18
2020-04-15,2020-04-15,Business insurance premium,REF28107986,242.85,0.0,119947.33
2020-04-15,2020-04-15,Payment from Cooper-Dean,REF50734035,0.0,983.33,120930.66
2020-04-15,2020-04-15,"Service payment - Leon, Jones and Jackson",REF44798456,0.0,468.09,121398.75
2020-04-15,2020-04-15,"Service payment - Brown, Ray and Torres",REF90570209,0.0,1406.85,122805.6
2020-04-22,2020-04-22,Business materials,REF83737070,584.2,0.0,122221.4
2020-04-23,2020-04-23,Fuel purchase,REF18596657,352.49,0.0,121868.91
2020-04-29,2020-04-29,Equipment Rental expense,REF77312268,786.66,0.0,121082.25
2020-04-30,2020-04-30,Service payment - Cooper-Dean,REF45282307,0.0,930.02,122012.27
2020-04-30,2020-04-30,"Payment from Brown, Ray and Torres",REF99566568,0.0,2170.58,124182.85
2020-04-30,2020-04-30,"Project payment - Parsons, Diaz and Jackson",REF49746502,0.0,762.18,124945.03
2020-04-30,2020-04-30,"Project payment - Leon, Jones and Jackson",REF97132107,0.0,512.66,125457.69
2020-04-30,2020-04-30,Service payment - Burns PLC,REF70007197,0.0,1087.84,126545.53
2020-05-03,2020-05-03,Business materials,REF74040573,678.09,0.0,125867.44
2020-05-03,2020-05-03,Permits Licenses expense,REF41972652,132.7,0.0,125734.74
2020-05-04,2020-05-04,Business materials,REF54857936,640.41,0.0,125094.33
2020-05-06,2020-05-06,Vehicle Maintenance expense,REF46358219,260.04,0.0,124834.29
2020-05-06,2020-05-06,Business materials,REF30461255,1043.29,0.0,123791.0
2020-05-06,2020-05-06,Safety Equipment expense,REF31167877,89.2,0.0,123701.8
2020-05-11,2020-05-11,Vehicle Maintenance expense,REF87050177,260.36,0.0,123441.44
2020-05-12,2020-05-12,Equipment Rental expense,REF71900005,420.98,0.0,123020.46
2020-05-14,2020-05-14,Subcontractors expense,REF91371416,1560.67,0.0,121459.79
2020-05-15,2020-05-15,"Project payment - Brown, Ray and Torres",REF51317727,0.0,2214.77,123674.56
2020-05-15,2020-05-15,Project payment - Cooper-Dean,REF43570011,0.0,648.48,124323.04
2020-05-15,2020-05-15,"Service payment - Leon, Jones and Jackson",REF93316470,0.0,634.81,124957.85
2020-05-15,2020-05-15,Service payment - Burns PLC,REF90219408,0.0,977.6,125935.45
2020-05-15,2020-05-15,Business insurance premium,REF93473897,288.53,0.0,125646.92
2020-05-19,2020-05-19,Safety Equipment expense,REF27281535,32.85,0.0,125614.07
2020-05-23,2020-05-23,Fuel purchase,REF14993547,386.01,0.0,125228.06
2020-05-24,2020-05-24,Business materials,REF33327160,1129.06,0.0,124099.0
2020-05-30,2020-05-30,"Service payment - Brown, Ray and Torres",REF67587741,0.0,1852.62,125951.62
2020-05-30,2020-05-30,"Payment from Leon, Jones and Jackson",REF66867381,0.0,482.64,126434.26
2020-05-30,2020-05-30,Payment from Cooper-Dean,REF59591208,0.0,1007.1,127441.36
2020-05-30,2020-05-30,"Payment from Parsons, Diaz and Jackson",REF54110005,0.0,912.0,128353.36
2020-05-30,2020-05-30,Invoice payment - Burns PLC,REF65657880,0.0,1161.35,129514.71
2020-05-31,2020-05-31,Tools expense,REF44863032,110.44,0.0,129404.27
2020-06-05,2020-06-05,Fuel purchase,REF71207202,316.7,0.0,129087.57
2020-06-06,2020-06-06,Subcontractors expense,REF51768921,403.77,0.0,128683.8
2020-06-07,2020-06-07,Fuel purchase,REF33294265,301.89,0.0,128381.91
2020-06-08,2020-06-08,Safety Equipment expense,REF98225107,148.61,0.0,128233.3
2020-06-08,2020-06-08,Fuel purchase,REF85196794,370.7,0.0,127862.6
2020-06-11,2020-06-11,Safety Equipment expense,REF82345613,156.35,0.0,127706.25
2020-06-12,2020-06-12,Business materials,REF96109892,989.59,0.0,126716.66
2020-06-13,2020-06-13,Vehicle Maintenance expense,REF88627232,251.02,0.0,126465.64
2020-06-14,2020-06-14,Business materials,REF69007594,762.43,0.0,125703.21
2020-06-15,2020-06-15,Business insurance premium,REF67635824,280.38,0.0,125422.83
2020-06-15,2020-06-15,"Invoice payment - Parsons, Diaz and Jackson",REF59057839,0.0,766.93,126189.76
2020-06-15,2020-06-15,Payment from Cooper-Dean,REF51860148,0.0,1025.65,127215.41
2020-06-15,2020-06-15,"Service payment - Brown, Ray and Torres",REF87561833,0.0,2008.8,129224.21
2020-06-16,2020-06-16,Equipment Rental expense,REF64202519,530.78,0.0,128693.43
2020-06-16,2020-06-16,Subcontractors expense,REF23168585,820.93,0.0,127872.5
2020-06-24,2020-06-24,Business materials,REF35562813,996.87,0.0,126875.63
2020-06-25,2020-06-25,Subcontractors expense,REF95007254,96.47,0.0,126779.16
2020-06-29,2020-06-29,Business materials,REF43431769,1133.75,0.0,125645.41
2020-06-30,2020-06-30,Business materials,REF22502038,1300.16,0.0,124345.25
2020-06-30,2020-06-30,Service payment - Burns PLC,REF58302546,0.0,1258.59,125603.84
2020-06-30,2020-06-30,"Service payment - Parsons, Diaz and Jackson",REF94196245,0.0,603.9,126207.74
2020-06-30,2020-06-30,Service payment - Cooper-Dean,REF92625268,0.0,1033.75,127241.49
2020-07-11,2020-07-11,Fuel purchase,REF64716199,265.4,0.0,126976.09
2020-07-13,2020-07-13,Equipment Rental expense,REF92677926,444.98,0.0,126531.11
2020-07-15,2020-07-15,Business materials,REF61687778,1155.96,0.0,125375.15
2020-07-15,2020-07-15,"Invoice payment - Leon, Jones and Jackson",REF65067291,0.0,490.81,125865.96
2020-07-15,2020-07-15,Invoice payment - Burns PLC,REF20960328,0.0,1096.35,126962.31
2020-07-15,2020-07-15,Business insurance premium,REF69614534,236.19,0.0,126726.12
2020-07-15,2020-07-15,"Payment from Parsons, Diaz and Jackson",REF89804658,0.0,854.76,127580.88
2020-07-15,2020-07-15,"Invoice payment - Brown, Ray and Torres",REF47353526,0.0,1722.06,129302.94
2020-07-15,2020-07-15,Service payment - Cooper-Dean,REF84785725,0.0,1081.23,130384.17
2020-07-16,2020-07-16,Vehicle Maintenance expense,REF67199062,131.76,0.0,130252.41
2020-07-21,2020-07-21,Tools expense,REF17948993,88.51,0.0,130163.9
2020-07-22,2020-07-22,Safety Equipment expense,REF83117749,121.06,0.0,130042.84
2020-07-25,2020-07-25,Equipment Rental expense,REF22433298,448.26,0.0,129594.58
2020-07-27,2020-07-27,Business materials,REF85463600,793.66,0.0,128800.92
2020-07-29,2020-07-29,Tools expense,REF90045584,121.69,0.0,128679.23
2020-07-30,2020-07-30,Business materials,REF70463865,743.25,0.0,127935.98
2020-07-30,2020-07-30,Invoice payment - Cooper-Dean,REF12009129,0.0,915.57,128851.55
2020-07-30,2020-07-30,Payment from Burns PLC,REF44410560,0.0,1097.12,129948.67
2020-07-30,2020-07-30,"Payment from Leon, Jones and Jackson",REF26618010,0.0,389.03,130337.7
2020-07-30,2020-07-30,"Service payment - Brown, Ray and Torres",REF92355360,0.0,1934.74,132272.44
2020-07-31,2020-07-31,Fuel purchase,REF92704633,552.34,0.0,131720.1
2020-08-03,2020-08-03,Vehicle Maintenance expense,REF95954209,198.93,0.0,131521.17
2020-08-04,2020-08-04,Fuel purchase,REF58413033,347.95,0.0,131173.22
2020-08-06,2020-08-06,Business materials,REF96583334,742.27,0.0,130430.95
2020-08-14,2020-08-14,Fuel purchase,REF60005646,390.17,0.0,130040.78
2020-08-15,2020-08-15,"Project payment - Brown, Ray and Torres",REF44652339,0.0,2154.78,132195.56
2020-08-15,2020-08-15,Service payment - Cooper-Dean,REF61357783,0.0,879.42,133074.98
2020-08-15,2020-08-15,Payment from Burns PLC,REF22486694,0.0,1151.3,134226.28
2020-08-15,2020-08-15,Business insurance premium,REF80069704,238.14,0.0,133988.14
2020-08-16,2020-08-16,Business materials,REF13113865,1212.28,0.0,132775.86
2020-08-23,2020-08-23,Equipment Rental expense,REF57586914,678.57,0.0,132097.29
2020-08-24,2020-08-24,Fuel purchase,REF27921541,409.25,0.0,131688.04
2020-08-28,2020-08-28,Fuel purchase,REF69793391,348.34,0.0,131339.7
2020-08-30,2020-08-30,"Invoice payment - Parsons, Diaz and Jackson",REF10344638,0.0,788.19,132127.89
2020-08-30,2020-08-30,Service payment - Burns PLC,REF46258774,0.0,1210.02,133337.91
2020-08-30,2020-08-30,Invoice payment - Cooper-Dean,REF17280125,0.0,935.22,134273.13
2020-08-30,2020-08-30,"Project payment - Leon, Jones and Jackson",REF65919144,0.0,461.88,134735.01
2020-08-31,2020-08-31,Fuel purchase,REF38203770,403.27,0.0,134331.74
2020-09-02,2020-09-02,Equipment Rental expense,REF18246161,587.58,0.0,133744.16
2020-09-05,2020-09-05,Permits Licenses expense,REF18829521,50.69,0.0,133693.47
2020-09-05,2020-09-05,Business materials,REF90914383,642.79,0.0,133050.68
2020-09-07,2020-09-07,Equipment Rental expense,REF44027654,595.86,0.0,132454.82
2020-09-11,2020-09-11,Business materials,REF47971704,559.3,0.0,131895.52
2020-09-15,2020-09-15,"Payment from Parsons, Diaz and Jackson",REF34522477,0.0,728.04,132623.56
2020-09-15,2020-09-15,"Project payment - Leon, Jones and Jackson",REF31849534,0.0,485.45,133109.01
2020-09-15,2020-09-15,Payment from Burns PLC,REF77407893,0.0,1068.14,134177.15
2020-09-15,2020-09-15,Business insurance premium,REF45843501,239.11,0.0,133938.04
2020-09-15,2020-09-15,"Invoice payment - Brown, Ray and Torres",REF31068952,0.0,1664.82,135602.86
2020-09-15,2020-09-15,Payment from Cooper-Dean,REF70054469,0.0,846.73,136449.59
2020-09-16,2020-09-16,Business materials,REF84295444,416.64,0.0,136032.95
2020-09-20,2020-09-20,Business materials,REF79403090,946.18,0.0,135086.77
2020-09-21,2020-09-21,Fuel purchase,REF61483801,250.12,0.0,134836.65
2020-09-22,2020-09-22,Permits Licenses expense,REF52838709,118.89,0.0,134717.76
2020-09-24,2020-09-24,Business materials,REF81658094,723.42,0.0,133994.34
2020-09-25,2020-09-25,Business materials,REF18177070,925.41,0.0,133068.93
2020-09-30,2020-09-30,"Service payment - Leon, Jones and Jackson",REF29386159,0.0,439.55,133508.48
2020-09-30,2020-09-30,Service payment - Burns PLC,REF35484453,0.0,1016.01,134524.49
2020-09-30,2020-09-30,Service payment - Cooper-Dean,REF23677898,0.0,771.78,135296.27
2020-09-30,2020-09-30,"Project payment - Parsons, Diaz and Jackson",REF46273571,0.0,818.6,136114.87
2020-09-30,2020-09-30,"Invoice payment - Brown, Ray and Torres",REF70964647,0.0,1835.87,137950.74
2020-09-30,2020-09-30,Tools expense,REF21985561,152.66,0.0,137798.08
2020-09-30,2020-09-30,Fuel purchase,REF16771237,123.65,0.0,137674.43
2020-10-07,2020-10-07,Business materials,REF84192594,465.41,0.0,137209.02
2020-10-10,2020-10-10,Business materials,REF79223801,867.77,0.0,136341.25
2020-10-15,2020-10-15,Invoice payment - Burns PLC,REF53372837,0.0,724.02,137065.27
2020-10-15,2020-10-15,"Invoice payment - Parsons, Diaz and Jackson",REF44189618,0.0,663.9,137729.17
2020-10-15,2020-10-15,Invoice payment - Cooper-Dean,REF66632300,0.0,760.11,138489.28
2020-10-15,2020-10-15,"Service payment - Leon, Jones and Jackson",REF46654280,0.0,239.73,138729.01
2020-10-15,2020-10-15,Business insurance premium,REF46316101,188.65,0.0,138540.36
2020-10-17,2020-10-17,Fuel purchase,REF61315586,94.41,0.0,138445.95
2020-10-17,2020-10-17,Business materials,REF45864508,986.89,0.0,137459.06
2020-10-19,2020-10-19,Business materials,REF59050750,768.78,0.0,136690.28
2020-10-20,2020-10-20,Vehicle Maintenance expense,REF36104452,137.06,0.0,136553.22
2020-10-21,2020-10-21,Safety Equipment expense,REF40697511,99.13,0.0,136454.09
2020-10-24,2020-10-24,Business materials,REF76557040,755.01,0.0,135699.08
2020-10-26,2020-10-26,Business materials,REF43569958,1028.63,0.0,134670.45
2020-10-28,2020-10-28,Fuel purchase,REF44561854,290.29,0.0,134380.16
2020-10-30,2020-10-30,Invoice payment - Burns PLC,REF29317489,0.0,807.96,135188.12
2020-10-30,2020-10-30,"Payment from Leon, Jones and Jackson",REF72230653,0.0,306.86,135494.98
2020-10-30,2020-10-30,Project payment - Cooper-Dean,REF38103717,0.0,821.28,136316.26
2020-10-30,2020-10-30,"Project payment - Brown, Ray and Torres",REF50745051,0.0,1374.1,137690.36
2020-10-30,2020-10-30,"Invoice payment - Parsons, Diaz and Jackson",REF76241340,0.0,490.18,138180.54
2020-10-31,2020-10-31,Subcontractors expense,REF25615747,1366.59,0.0,136813.95
2020-11-09,2020-11-09,Fuel purchase,REF95242162,233.2,0.0,136580.75
2020-11-11,2020-11-11,Business materials,REF57125774,360.06,0.0,136220.69
2020-11-14,2020-11-14,Subcontractors expense,REF54270897,1544.43,0.0,134676.26
2020-11-14,2020-11-14,Business materials,REF93165904,502.07,0.0,134174.19
2020-11-15,2020-11-15,Payment from Burns PLC,REF75932021,0.0,607.68,134781.87
2020-11-15,2020-11-15,"Project payment - Brown, Ray and Torres",REF77455429,0.0,1183.85,135965.72
2020-11-15,2020-11-15,Business insurance premium,REF58370289,155.72,0.0,135810.0
2020-11-15,2020-11-15,"Service payment - Parsons, Diaz and Jackson",REF50427148,0.0,556.02,136366.02
2020-11-15,2020-11-15,Payment from Cooper-Dean,REF72551388,0.0,560.01,136926.03
2020-11-15,2020-11-15,"Invoice payment - Leon, Jones and Jackson",REF10011373,0.0,386.66,137312.69
2020-11-28,2020-11-28,Business materials,REF16102564,813.78,0.0,136498.91
2020-11-30,2020-11-30,Payment from Cooper-Dean,REF70036948,0.0,680.3,137179.21
2020-11-30,2020-11-30,"Project payment - Brown, Ray and Torres",REF26096750,0.0,1259.86,138439.07
2020-11-30,2020-11-30,Project payment - Burns PLC,REF89953714,0.0,737.17,139176.24
2020-11-30,2020-11-30,Permits Licenses expense,REF97192637,85.22,0.0,139091.02
2020-12-02,2020-12-02,Equipment Rental expense,REF26336910,162.94,0.0,138928.08
2020-12-06,2020-12-06,Business materials,REF86966345,263.43,0.0,138664.65
2020-12-15,2020-12-15,Business insurance premium,REF19951893,124.48,0.0,138540.17
2020-12-15,2020-12-15,"Project payment - Parsons, Diaz and Jackson",REF61604885,0.0,283.34,138823.51
2020-12-15,2020-12-15,Invoice payment - Cooper-Dean,REF72272523,0.0,496.11,139319.62
2020-12-15,2020-12-15,"Project payment - Brown, Ray and Torres",REF88063078,0.0,1122.48,140442.1
2020-12-15,2020-12-15,"Service payment - Leon, Jones and Jackson",REF22544210,0.0,225.1,140667.2
2020-12-17,2020-12-17,Vehicle Maintenance expense,REF66478174,58.79,0.0,140608.41
2020-12-17,2020-12-17,Business materials,REF80260192,484.32,0.0,140124.09
2020-12-18,2020-12-18,Business materials,REF34830936,396.67,0.0,139727.42
2020-12-18,2020-12-18,Fuel purchase,REF10896368,227.3,0.0,139500.12
2020-12-22,2020-12-22,Safety Equipment expense,REF17694339,40.32,0.0,139459.8
2020-12-22,2020-12-22,Subcontractors expense,REF49995810,435.46,0.0,139024.34
2020-12-27,2020-12-27,Business materials,REF61033638,211.91,0.0,138812.43
2020-12-30,2020-12-30,"Invoice payment - Leon, Jones and Jackson",REF39969671,0.0,215.56,139027.99
2020-12-30,2020-12-30,"Invoice payment - Brown, Ray and Torres",REF79353384,0.0,922.27,139950.26
2020-12-30,2020-12-30,Project payment - Cooper-Dean,REF65166139,0.0,456.41,140406.67
2020-12-30,2020-12-30,Payment from Burns PLC,REF22426677,0.0,460.38,140867.05
2020-12-31,2020-12-31,Business materials,REF53222161,510.0,0.0,140357.05
2021-01-02,2021-01-02,Business materials,REF58866241,651.08,0.0,139705.97
2021-01-06,2021-01-06,Equipment Rental expense,REF39650930,215.67,0.0,139490.3
2021-01-06,2021-01-06,Vehicle Maintenance expense,REF75027299,92.69,0.0,139397.61
2021-01-11,2021-01-11,Fuel purchase,REF24756136,250.11,0.0,139147.5
2021-01-11,2021-01-11,Business materials,REF31392049,704.6,0.0,138442.9
2021-01-12,2021-01-12,Vehicle Maintenance expense,REF14302310,85.99,0.0,138356.91
2021-01-15,2021-01-15,"Project payment - Brown, Ray and Torres",REF81807327,0.0,1271.43,139628.34
2021-01-15,2021-01-15,"Payment from Leon, Jones and Jackson",REF79228126,0.0,211.45,139839.79
2021-01-15,2021-01-15,"Project payment - Parsons, Diaz and Jackson",REF40649966,0.0,453.25,140293.04
2021-01-15,2021-01-15,Service payment - Cooper-Dean,REF25452170,0.0,573.42,140866.46
2021-01-15,2021-01-15,Payment from Burns PLC,REF37029178,0.0,484.05,141350.51
2021-01-15,2021-01-15,Business insurance premium,REF80474834,133.82,0.0,141216.69
2021-01-15,2021-01-15,Business materials,REF11550986,430.45,0.0,140786.24
2021-01-16,2021-01-16,Tools expense,REF29029717,59.2,0.0,140727.04
2021-01-18,2021-01-18,Safety Equipment expense,REF46911108,29.18,0.0,140697.86
2021-01-19,2021-01-19,Tools expense,REF54440846,69.76,0.0,140628.1
2021-01-30,2021-01-30,Permits Licenses expense,REF13102796,61.21,0.0,140566.89
2021-01-30,2021-01-30,"Project payment - Parsons, Diaz and Jackson",REF59059287,0.0,398.98,140965.87
2021-01-30,2021-01-30,"Invoice payment - Leon, Jones and Jackson",REF82723142,0.0,266.1,141231.97
2021-01-30,2021-01-30,Project payment - Burns PLC,REF21075171,0.0,824.24,142056.21
2021-01-30,2021-01-30,Project payment - Cooper-Dean,REF16934371,0.0,471.0,142527.21
2021-01-30,2021-01-30,"Project payment - Brown, Ray and Torres",REF87489647,0.0,1361.88,143889.09
2021-01-31,2021-01-31,Tools expense,REF69606532,67.82,0.0,143821.27
2021-02-01,2021-02-01,Safety Equipment expense,REF13413521,48.29,0.0,143772.98
2021-02-02,2021-02-02,Business materials,REF15858731,529.18,0.0,143243.8
2021-02-07,2021-02-07,Fuel purchase,REF98345388,277.59,0.0,142966.21
2021-02-12,2021-02-12,Fuel purchase,REF90735468,229.02,0.0,142737.19
2021-02-13,2021-02-13,Fuel purchase,REF56371292,258.4,0.0,142478.79
2021-02-14,2021-02-14,Tools expense,REF92015571,74.11,0.0,142404.68
2021-02-15,2021-02-15,"Payment from Parsons, Diaz and Jackson",REF89201733,0.0,437.59,142842.27
2021-02-15,2021-02-15,Service payment - Burns PLC,REF66430840,0.0,737.52,143579.79
2021-02-15,2021-02-15,Service payment - Cooper-Dean,REF71535745,0.0,650.38,144230.17
2021-02-15,2021-02-15,"Payment from Leon, Jones and Jackson",REF32615256,0.0,302.71,144532.88
2021-02-15,2021-02-15,"Project payment - Brown, Ray and Torres",REF75443007,0.0,1286.6,145819.48
2021-02-15,2021-02-15,Business insurance premium,REF49431411,163.89,0.0,145655.59
2021-02-16,2021-02-16,Safety Equipment expense,REF48895827,81.88,0.0,145573.71
2021-02-21,2021-02-21,Safety Equipment expense,REF15475388,56.36,0.0,145517.35
2021-02-22,2021-02-22,Safety Equipment expense,REF84223915,89.41,0.0,145427.94
2021-02-22,2021-02-22,Fuel purchase,REF24280386,246.89,0.0,145181.05
2021-02-23,2021-02-23,Vehicle Maintenance expense,REF17089945,106.61,0.0,145074.44
2021-02-24,2021-02-24,Fuel purchase,REF89924866,316.84,0.0,144757.6
2021-02-28,2021-02-28,"Payment from Brown, Ray and Torres",REF17205276,0.0,1182.16,145939.76
2021-02-28,2021-02-28,Service payment - Cooper-Dean,REF95409091,0.0,766.21,146705.97
2021-02-28,2021-02-28,"Project payment - Leon, Jones and Jackson",REF66204934,0.0,334.46,147040.43
2021-03-04,2021-03-04,Safety Equipment expense,REF78138368,67.32,0.0,146973.11
2021-03-04,2021-03-04,Tools expense,REF38570312,118.68,0.0,146854.43
2021-03-05,2021-03-05,Tools expense,REF28324876,116.04,0.0,146738.39
2021-03-07,2021-03-07,Fuel purchase,REF10264316,344.68,0.0,146393.71
2021-03-13,2021-03-13,Subcontractors expense,REF60151875,1388.33,0.0,145005.38
2021-03-13,2021-03-13,Business materials,REF72402052,712.79,0.0,144292.59
2021-03-14,2021-03-14,Safety Equipment expense,REF55089848,72.95,0.0,144219.64
2021-03-15,2021-03-15,"Service payment - Parsons, Diaz and Jackson",REF33117485,0.0,489.42,144709.06
2021-03-15,2021-03-15,Project payment - Burns PLC,REF12459721,0.0,874.47,145583.53
2021-03-15,2021-03-15,"Invoice payment - Brown, Ray and Torres",REF95924422,0.0,1278.84,146862.37
2021-03-15,2021-03-15,Business insurance premium,REF96495395,200.18,0.0,146662.19
2021-03-15,2021-03-15,Invoice payment - Cooper-Dean,REF20414751,0.0,729.49,147391.68
2021-03-15,2021-03-15,"Invoice payment - Leon, Jones and Jackson",REF47906856,0.0,405.64,147797.32
2021-03-18,2021-03-18,Business materials,REF90633641,925.65,0.0,146871.67
2021-03-23,2021-03-23,Fuel purchase,REF94195084,220.76,0.0,146650.91
2021-03-30,2021-03-30,Invoice payment - Burns PLC,REF82218733,0.0,689.83,147340.74
2021-03-30,2021-03-30,Subcontractors expense,REF27042199,1013.1,0.0,146327.64
2021-03-30,2021-03-30,"Service payment - Parsons, Diaz and Jackson",REF70527132,0.0,743.72,147071.36
2021-03-30,2021-03-30,"Project payment - Brown, Ray and Torres",REF79049203,0.0,1750.0,148821.36
2021-03-30,2021-03-30,"Invoice payment - Leon, Jones and Jackson",REF11363342,0.0,310.48,149131.84
2021-04-01,2021-04-01,Tools expense,REF88645903,140.64,0.0,148991.2
2021-04-04,2021-04-04,Subcontractors expense,REF88430108,1348.24,0.0,147642.96
2021-04-08,2021-04-08,Permits Licenses expense,REF88860826,137.92,0.0,147505.04
2021-04-09,2021-04-09,Fuel purchase,REF60929945,550.98,0.0,146954.06
2021-04-11,2021-04-11,Tools expense,REF44880000,61.16,0.0,146892.9
2021-04-14,2021-04-14,Safety Equipment expense,REF43278037,169.27,0.0,146723.63
2021-04-15,2021-04-15,Vehicle Maintenance expense,REF99161059,204.76,0.0,146518.87
2021-04-15,2021-04-15,Payment from Cooper-Dean,REF53978844,0.0,877.87,147396.74
2021-04-15,2021-04-15,"Invoice payment - Leon, Jones and Jackson",REF87098681,0.0,561.89,147958.63
2021-04-15,2021-04-15,"Invoice payment - Parsons, Diaz and Jackson",REF60942630,0.0,661.15,148619.78
2021-04-15,2021-04-15,"Invoice payment - Brown, Ray and Torres",REF54760301,0.0,1886.17,150505.95
2021-04-15,2021-04-15,Business insurance premium,REF45323211,246.83,0.0,150259.12
2021-04-18,2021-04-18,Fuel purchase,REF42034252,440.05,0.0,149819.07
2021-04-19,2021-04-19,Fuel purchase,REF67603086,424.94,0.0,149394.13
2021-04-19,2021-04-19,Business materials,REF26699915,333.33,0.0,149060.8
2021-04-21,2021-04-21,Fuel purchase,REF25533986,412.97,0.0,148647.83
2021-04-22,2021-04-22,Subcontractors expense,REF16451141,1105.21,0.0,147542.62
2021-04-29,2021-04-29,Subcontractors expense,REF27424761,1058.73,0.0,146483.89
2021-04-29,2021-04-29,Vehicle Maintenance expense,REF30919278,201.33,0.0,146282.56
2021-04-30,2021-04-30,"Project payment - Brown, Ray and Torres",REF86056099,0.0,1587.0,147869.56
2021-04-30,2021-04-30,"Project payment - Leon, Jones and Jackson",REF26638771,0.0,562.89,148432.45
2021-04-30,2021-04-30,Project payment - Cooper-Dean,REF50672710,0.0,873.07,149305.52
2021-04-30,2021-04-30,Payment from Burns PLC,REF84517673,0.0,867.23,150172.75
2021-05-02,2021-05-02,Permits Licenses expense,REF68223612,110.72,0.0,150062.03
2021-05-06,2021-05-06,Permits Licenses expense,REF78109487,167.27,0.0,149894.76
2021-05-07,2021-05-07,Fuel purchase,REF32660297,100.04,0.0,149794.72
2021-05-10,2021-05-10,Business materials,REF58673424,1743.81,0.0,148050.91
2021-05-13,2021-05-13,Subcontractors expense,REF98400684,1318.72,0.0,146732.19
2021-05-14,2021-05-14,Safety Equipment expense,REF27226271,110.74,0.0,146621.45
2021-05-15,2021-05-15,Business insurance premium,REF67378214,263.19,0.0,146358.26
2021-05-15,2021-05-15,Invoice payment - Cooper-Dean,REF31407211,0.0,1049.37,147407.63
2021-05-15,2021-05-15,"Invoice payment - Brown, Ray and Torres",REF88028024,0.0,2034.54,149442.17
2021-05-15,2021-05-15,"Project payment - Leon, Jones and Jackson",REF55375172,0.0,440.15,149882.32
2021-05-15,2021-05-15,Project payment - Burns PLC,REF57630332,0.0,1237.46,151119.78
2021-05-15,2021-05-15,"Project payment - Parsons, Diaz and Jackson",REF20571539,0.0,635.42,151755.2
2021-05-15,2021-05-15,Fuel purchase,REF79443309,302.19,0.0,151453.01
2021-05-16,2021-05-16,Equipment Rental expense,REF67398337,562.66,0.0,150890.35
2021-05-19,2021-05-19,Business materials,REF63058346,509.68,0.0,150380.67
2021-05-21,2021-05-21,Safety Equipment expense,REF60689329,102.37,0.0,150278.3
2021-05-22,2021-05-22,Safety Equipment expense,REF60737931,94.54,0.0,150183.76
2021-05-22,2021-05-22,Fuel purchase,REF48898679,419.3,0.0,149764.46
2021-05-25,2021-05-25,Business materials,REF68967846,1893.82,0.0,147870.64
2021-05-28,2021-05-28,Business materials,REF44874123,1006.06,0.0,146864.58
2021-05-29,2021-05-29,Fuel purchase,REF37244829,356.66,0.0,146507.92
2021-05-30,2021-05-30,"Payment from Parsons, Diaz and Jackson",REF52978068,0.0,701.64,147209.56
2021-05-30,2021-05-30,Project payment - Burns PLC,REF87439008,0.0,1043.4,148252.96
2021-05-30,2021-05-30,"Invoice payment - Leon, Jones and Jackson",REF19858632,0.0,547.61,148800.57
2021-05-30,2021-05-30,Project payment - Cooper-Dean,REF81924621,0.0,881.9,149682.47
2021-05-30,2021-05-30,"Payment from Brown, Ray and Torres",REF82686951,0.0,1818.2,151500.67
2021-06-03,2021-06-03,Fuel purchase,REF92402017,475.95,0.0,151024.72
2021-06-06,2021-06-06,Equipment Rental expense,REF19079304,448.89,0.0,150575.83
2021-06-08,2021-06-08,Fuel purchase,REF36869556,350.88,0.0,150224.95
2021-06-10,2021-06-10,Business materials,REF83718839,1387.14,0.0,148837.81
2021-06-11,2021-06-11,Fuel purchase,REF95347762,420.63,0.0,148417.18
2021-06-11,2021-06-11,Business materials,REF48481251,1111.21,0.0,147305.97
2021-06-15,2021-06-15,Service payment - Cooper-Dean,REF89310139,0.0,800.06,148106.03
2021-06-15,2021-06-15,Invoice payment - Burns PLC,REF85072903,0.0,1142.59,149248.62
2021-06-15,2021-06-15,"Invoice payment - Brown, Ray and Torres",REF27800791,0.0,1888.72,151137.34
2021-06-15,2021-06-15,"Service payment - Leon, Jones and Jackson",REF87419349,0.0,396.7,151534.04
2021-06-15,2021-06-15,"Invoice payment - Parsons, Diaz and Jackson",REF79499343,0.0,1021.63,152555.67
2021-06-15,2021-06-15,Business insurance premium,REF65728006,275.41,0.0,152280.26
2021-06-23,2021-06-23,Subcontractors expense,REF63100160,1737.65,0.0,150542.61
2021-06-24,2021-06-24,Fuel purchase,REF30417455,394.11,0.0,150148.5
2021-06-28,2021-06-28,Business materials,REF85212846,719.88,0.0,149428.62
2021-06-29,2021-06-29,Business materials,REF93945746,1034.76,0.0,148393.86
2021-06-30,2021-06-30,"Project payment - Brown, Ray and Torres",REF71829977,0.0,1596.16,149990.02
2021-06-30,2021-06-30,"Project payment - Parsons, Diaz and Jackson",REF55336189,0.0,637.55,150627.57
2021-06-30,2021-06-30,Project payment - Cooper-Dean,REF92818317,0.0,940.75,151568.32
2021-06-30,2021-06-30,Business materials,REF28072191,1381.15,0.0,150187.17
2021-06-30,2021-06-30,"Service payment - Leon, Jones and Jackson",REF79468942,0.0,476.88,150664.05
2021-06-30,2021-06-30,Project payment - Burns PLC,REF33968062,0.0,914.37,151578.42
2021-07-03,2021-07-03,Business materials,REF88153738,633.13,0.0,150945.29
2021-07-07,2021-07-07,Safety Equipment expense,REF64650036,104.15,0.0,150841.14
2021-07-09,2021-07-09,Tools expense,REF79318060,116.25,0.0,150724.89
2021-07-09,2021-07-09,Equipment Rental expense,REF49557185,503.27,0.0,150221.62
2021-07-10,2021-07-10,Fuel purchase,REF10512369,477.61,0.0,149744.01
2021-07-10,2021-07-10,Safety Equipment expense,REF96271649,61.22,0.0,149682.79
2021-07-15,2021-07-15,Business insurance premium,REF34940521,242.94,0.0,149439.85
2021-07-15,2021-07-15,"Invoice payment - Leon, Jones and Jackson",REF98525448,0.0,594.47,150034.32
2021-07-15,2021-07-15,"Payment from Brown, Ray and Torres",REF11499551,0.0,1895.02,151929.34
2021-07-15,2021-07-15,Invoice payment - Burns PLC,REF67078548,0.0,1130.3,153059.64
2021-07-15,2021-07-15,Project payment - Cooper-Dean,REF45858077,0.0,734.85,153794.49
2021-07-17,2021-07-17,Subcontractors expense,REF37994535,779.36,0.0,153015.13
2021-07-17,2021-07-17,Fuel purchase,REF77378333,316.19,0.0,152698.94
2021-07-24,2021-07-24,Fuel purchase,REF27598699,164.18,0.0,152534.76
2021-07-25,2021-07-25,Business materials,REF82675581,1147.01,0.0,151387.75
2021-07-28,2021-07-28,Tools expense,REF65029167,144.89,0.0,151242.86
2021-07-30,2021-07-30,Payment from Cooper-Dean,REF35101659,0.0,1118.47,152361.33
2021-07-30,2021-07-30,"Project payment - Parsons, Diaz and Jackson",REF42370514,0.0,873.88,153235.21
2021-07-30,2021-07-30,"Invoice payment - Leon, Jones and Jackson",REF63598721,0.0,533.35,153768.56
2021-07-30,2021-07-30,Service payment - Burns PLC,REF17795659,0.0,737.31,154505.87
2021-07-30,2021-07-30,"Project payment - Brown, Ray and Torres",REF61421923,0.0,2079.59,156585.46
2021-07-31,2021-07-31,Safety Equipment expense,REF99937978,66.73,0.0,156518.73
2021-08-01,2021-08-01,Tools expense,REF22161532,113.26,0.0,156405.47
2021-08-01,2021-08-01,Business materials,REF17141106,1048.63,0.0,155356.84
2021-08-10,2021-08-10,Safety Equipment expense,REF48684926,71.15,0.0,155285.69
2021-08-12,2021-08-12,Business materials,REF10010747,1242.32,0.0,154043.37
2021-08-13,2021-08-13,Permits Licenses expense,REF32302754,56.94,0.0,153986.43
2021-08-14,2021-08-14,Subcontractors expense,REF66898049,1099.01,0.0,152887.42
2021-08-15,2021-08-15,Business insurance premium,REF36431992,228.92,0.0,152658.5
2021-08-15,2021-08-15,"Payment from Leon, Jones and Jackson",REF56467818,0.0,539.46,153197.96
2021-08-15,2021-08-15,Payment from Cooper-Dean,REF18580299,0.0,926.87,154124.83
2021-08-15,2021-08-15,"Payment from Brown, Ray and Torres",REF19225633,0.0,2477.23,156602.06
2021-08-15,2021-08-15,"Payment from Parsons, Diaz and Jackson",REF94819587,0.0,740.49,157342.55
2021-08-15,2021-08-15,Invoice payment - Burns PLC,REF86182052,0.0,1088.75,158431.3
2021-08-16,2021-08-16,Safety Equipment expense,REF68303523,94.25,0.0,158337.05
2021-08-23,2021-08-23,Safety Equipment expense,REF87714356,91.41,0.0,158245.64
2021-08-23,2021-08-23,Fuel purchase,REF33611761,598.41,0.0,157647.23
2021-08-25,2021-08-25,Business materials,REF10318645,564.89,0.0,157082.34
2021-08-30,2021-08-30,Payment from Burns PLC,REF12047055,0.0,1224.44,158306.78
2021-08-30,2021-08-30,"Payment from Parsons, Diaz and Jackson",REF50296891,0.0,628.67,158935.45
2021-08-30,2021-08-30,Service payment - Cooper-Dean,REF40793682,0.0,1091.08,160026.53
2021-08-30,2021-08-30,"Payment from Brown, Ray and Torres",REF41181880,0.0,1423.7,161450.23
2021-08-30,2021-08-30,"Payment from Leon, Jones and Jackson",REF90037335,0.0,419.27,161869.5
2021-09-01,2021-09-01,Fuel purchase,REF68210514,278.24,0.0,161591.26
2021-09-03,2021-09-03,Vehicle Maintenance expense,REF65670024,94.08,0.0,161497.18
2021-09-09,2021-09-09,Subcontractors expense,REF78993433,453.95,0.0,161043.23
2021-09-10,2021-09-10,Fuel purchase,REF42673956,350.02,0.0,160693.21
2021-09-10,2021-09-10,Tools expense,REF98522157,178.94,0.0,160514.27
2021-09-11,2021-09-11,Vehicle Maintenance expense,REF13907625,60.02,0.0,160454.25
2021-09-12,2021-09-12,Tools expense,REF57853284,137.88,0.0,160316.37
2021-09-12,2021-09-12,Subcontractors expense,REF21373154,1463.94,0.0,158852.43
2021-09-15,2021-09-15,Business insurance premium,REF66181334,216.24,0.0,158636.19
2021-09-15,2021-09-15,"Invoice payment - Brown, Ray and Torres",REF22619103,0.0,1578.49,160214.68
2021-09-15,2021-09-15,Service payment - Cooper-Dean,REF90531471,0.0,900.97,161115.65
2021-09-15,2021-09-15,"Payment from Parsons, Diaz and Jackson",REF83571241,0.0,759.59,161875.24
2021-09-15,2021-09-15,Service payment - Burns PLC,REF77161895,0.0,924.2,162799.44
2021-09-17,2021-09-17,Fuel purchase,REF26632137,128.49,0.0,162670.95
2021-09-18,2021-09-18,Business materials,REF54694295,884.06,0.0,161786.89
2021-09-19,2021-09-19,Business materials,REF55561569,765.41,0.0,161021.48
2021-09-20,2021-09-20,Tools expense,REF85995678,144.37,0.0,160877.11
2021-09-20,2021-09-20,Business materials,REF36489568,660.2,0.0,160216.91
2021-09-24,2021-09-24,Fuel purchase,REF23282480,330.54,0.0,159886.37
2021-09-25,2021-09-25,Tools expense,REF70060953,146.15,0.0,159740.22
2021-09-30,2021-09-30,Subcontractors expense,REF82696887,1272.03,0.0,158468.19
2021-09-30,2021-09-30,"Service payment - Brown, Ray and Torres",REF91597435,0.0,1698.82,160167.01
2021-09-30,2021-09-30,"Project payment - Parsons, Diaz and Jackson",REF92830613,0.0,616.69,160783.7
2021-09-30,2021-09-30,Service payment - Burns PLC,REF35976561,0.0,973.89,161757.59
2021-09-30,2021-09-30,Service payment - Cooper-Dean,REF83033123,0.0,865.94,162623.53
2021-09-30,2021-09-30,Business materials,REF76193202,992.69,0.0,161630.84
2021-10-05,2021-10-05,Business materials,REF15378391,927.32,0.0,160703.52
2021-10-12,2021-10-12,Fuel purchase,REF61350301,341.37,0.0,160362.15
2021-10-15,2021-10-15,Business insurance premium,REF93426235,191.91,0.0,160170.24
2021-10-15,2021-10-15,Service payment - Burns PLC,REF42398087,0.0,913.19,161083.43
2021-10-15,2021-10-15,"Invoice payment - Leon, Jones and Jackson",REF97072782,0.0,343.4,161426.83
2021-10-15,2021-10-15,Service payment - Cooper-Dean,REF37130797,0.0,675.26,162102.09
2021-10-15,2021-10-15,"Service payment - Parsons, Diaz and Jackson",REF77826803,0.0,671.45,162773.54
2021-10-15,2021-10-15,"Project payment - Brown, Ray and Torres",REF27914046,0.0,1456.5,164230.04
2021-10-15,2021-10-15,Safety Equipment expense,REF83994864,85.44,0.0,164144.6
2021-10-21,2021-10-21,Tools expense,REF48236663,72.76,0.0,164071.84
2021-10-25,2021-10-25,Business materials,REF69654329,1025.6,0.0,163046.24
2021-10-28,2021-10-28,Permits Licenses expense,REF70240298,94.57,0.0,162951.67
2021-10-30,2021-10-30,Permits Licenses expense,REF53174305,34.74,0.0,162916.93
2021-10-30,2021-10-30,Project payment - Cooper-Dean,REF88936411,0.0,716.46,163633.39
2021-10-30,2021-10-30,"Service payment - Parsons, Diaz and Jackson",REF88808958,0.0,769.49,164402.88
2021-10-30,2021-10-30,Project payment - Burns PLC,REF61006127,0.0,850.17,165253.05
2021-10-30,2021-10-30,"Service payment - Leon, Jones and Jackson",REF36002687,0.0,402.01,165655.06
2021-10-30,2021-10-30,"Project payment - Brown, Ray and Torres",REF95346302,0.0,1443.01,167098.07
2021-11-02,2021-11-02,Permits Licenses expense,REF47073573,95.36,0.0,167002.71
2021-11-02,2021-11-02,Vehicle Maintenance expense,REF21907456,109.93,0.0,166892.78
2021-11-02,2021-11-02,Business materials,REF76284460,521.99,0.0,166370.79
2021-11-03,2021-11-03,Tools expense,REF71816061,92.71,0.0,166278.08
2021-11-07,2021-11-07,Business materials,REF84827310,829.12,0.0,165448.96
2021-11-08,2021-11-08,Fuel purchase,REF43235382,375.73,0.0,165073.23
2021-11-11,2021-11-11,Equipment Rental expense,REF68532161,259.39,0.0,164813.84
2021-11-15,2021-11-15,Payment from Burns PLC,REF30498189,0.0,714.77,165528.61
2021-11-15,2021-11-15,Tools expense,REF67055997,114.65,0.0,165413.96
2021-11-15,2021-11-15,"Payment from Parsons, Diaz and Jackson",REF54575201,0.0,546.58,165960.54
2021-11-15,2021-11-15,Service payment - Cooper-Dean,REF25310030,0.0,818.33,166778.87
2021-11-15,2021-11-15,Business insurance premium,REF80227851,155.86,0.0,166623.01
2021-11-16,2021-11-16,Equipment Rental expense,REF27243151,265.0,0.0,166358.01
2021-11-16,2021-11-16,Business materials,REF24154594,968.8,0.0,165389.21
2021-11-17,2021-11-17,Fuel purchase,REF38830217,281.21,0.0,165108.0
2021-11-17,2021-11-17,Business materials,REF96049656,530.98,0.0,164577.02
2021-11-23,2021-11-23,Vehicle Maintenance expense,REF78246011,176.51,0.0,164400.51
2021-11-30,2021-11-30,"Service payment - Brown, Ray and Torres",REF39795194,0.0,1173.26,165573.77
2021-11-30,2021-11-30,Service payment - Burns PLC,REF21523956,0.0,551.4,166125.17
2021-11-30,2021-11-30,"Service payment - Parsons, Diaz and Jackson",REF53754595,0.0,487.41,166612.58
2021-11-30,2021-11-30,"Service payment - Leon, Jones and Jackson",REF54754055,0.0,358.61,166971.19
2021-11-30,2021-11-30,Payment from Cooper-Dean,REF36430850,0.0,546.04,167517.23
2021-12-08,2021-12-08,Tools expense,REF35239354,61.81,0.0,167455.42
2021-12-10,2021-12-10,Equipment Rental expense,REF81411521,149.28,0.0,167306.14
2021-12-10,2021-12-10,Business materials,REF40899351,29.85,0.0,167276.29
2021-12-15,2021-12-15,Permits Licenses expense,REF24161667,70.24,0.0,167206.05
2021-12-15,2021-12-15,"Project payment - Leon, Jones and Jackson",REF71436889,0.0,203.12,167409.17
2021-12-15,2021-12-15,Invoice payment - Cooper-Dean,REF57649625,0.0,387.0,167796.17
2021-12-15,2021-12-15,"Invoice payment - Parsons, Diaz and Jackson",REF56530646,0.0,322.4,168118.57
2021-12-15,2021-12-15,Business insurance premium,REF62128776,123.06,0.0,167995.51
2021-12-15,2021-12-15,Invoice payment - Burns PLC,REF27389452,0.0,641.86,168637.37
2021-12-15,2021-12-15,"Service payment - Brown, Ray and Torres",REF52675738,0.0,1200.66,169838.03
2021-12-19,2021-12-19,Permits Licenses expense,REF50326832,34.4,0.0,169803.63
2021-12-21,2021-12-21,Safety Equipment expense,REF88911884,18.69,0.0,169784.94
2021-12-23,2021-12-23,Fuel purchase,REF91955597,233.87,0.0,169551.07
2021-12-23,2021-12-23,Business materials,REF31293670,507.85,0.0,169043.22
2021-12-25,2021-12-25,Subcontractors expense,REF45303373,361.42,0.0,168681.8
2021-12-26,2021-12-26,Permits Licenses expense,REF13709369,56.81,0.0,168624.99
2021-12-30,2021-12-30,Vehicle Maintenance expense,REF82451898,92.69,0.0,168532.3
2021-12-30,2021-12-30,"Project payment - Brown, Ray and Torres",REF12362864,0.0,991.65,169523.95
2021-12-30,2021-12-30,"Project payment - Parsons, Diaz and Jackson",REF57632750,0.0,367.14,169891.09
2021-12-30,2021-12-30,"Payment from Leon, Jones and Jackson",REF58331634,0.0,311.52,170202.61
2021-12-30,2021-12-30,Payment from Burns PLC,REF14234411,0.0,562.08,170764.69
2021-12-30,2021-12-30,Service payment - Cooper-Dean,REF80305432,0.0,464.75,171229.44
2022-01-04,2022-01-04,Equipment Rental expense,REF23135525,325.64,0.0,170903.8
2022-01-04,2022-01-04,Tools expense,REF45956178,74.32,0.0,170829.48
2022-01-05,2022-01-05,Fuel purchase,REF17778910,120.49,0.0,170708.99
2022-01-06,2022-01-06,Equipment Rental expense,REF89704557,430.77,0.0,170278.22
2022-01-08,2022-01-08,Business materials,REF69104958,770.18,0.0,169508.04
2022-01-10,2022-01-10,Vehicle Maintenance expense,REF37107561,109.83,0.0,169398.21
2022-01-14,2022-01-14,Fuel purchase,REF11662550,237.61,0.0,169160.6
2022-01-15,2022-01-15,Project payment - Burns PLC,REF51463720,0.0,497.78,169658.38
2022-01-15,2022-01-15,"Invoice payment - Leon, Jones and Jackson",REF87007809,0.0,301.67,169960.05
2022-01-15,2022-01-15,"Service payment - Brown, Ray and Torres",REF86349021,0.0,1226.83,171186.88
2022-01-15,2022-01-15,Business insurance premium,REF82330196,143.63,0.0,171043.25
2022-01-15,2022-01-15,Payment from Cooper-Dean,REF83722987,0.0,469.11,171512.36
2022-01-15,2022-01-15,"Invoice payment - Parsons, Diaz and Jackson",REF16951582,0.0,374.77,171887.13
2022-01-21,2022-01-21,Business materials,REF76227366,874.64,0.0,171012.49
2022-01-24,2022-01-24,Tools expense,REF86541946,50.42,0.0,170962.07
2022-01-30,2022-01-30,Invoice payment - Burns PLC,REF63323813,0.0,716.98,171679.05
2022-01-30,2022-01-30,"Invoice payment - Brown, Ray and Torres",REF56040263,0.0,1155.39,172834.44
2022-01-30,2022-01-30,"Project payment - Parsons, Diaz and Jackson",REF46445305,0.0,515.23,173349.67
2022-01-30,2022-01-30,"Project payment - Leon, Jones and Jackson",REF42791870,0.0,324.85,173674.52
2022-01-30,2022-01-30,Invoice payment - Cooper-Dean,REF38051821,0.0,478.13,174152.65
2022-02-09,2022-02-09,Business materials,REF75092921,752.19,0.0,173400.46
2022-02-10,2022-02-10,Business materials,REF62956824,678.8,0.0,172721.66
2022-02-11,2022-02-11,Fuel purchase,REF55969002,329.04,0.0,172392.62
2022-02-13,2022-02-13,Fuel purchase,REF18164562,305.31,0.0,172087.31
2022-02-15,2022-02-15,Business insurance premium,REF75209730,165.14,0.0,171922.17
2022-02-15,2022-02-15,"Payment from Brown, Ray and Torres",REF46966608,0.0,1683.21,173605.38
2022-02-15,2022-02-15,"Invoice payment - Parsons, Diaz and Jackson",REF47811591,0.0,464.06,174069.44
2022-02-15,2022-02-15,Payment from Burns PLC,REF24944681,0.0,580.21,174649.65
2022-02-15,2022-02-15,"Invoice payment - Leon, Jones and Jackson",REF54154224,0.0,266.05,174915.7
2022-02-15,2022-02-15,Project payment - Cooper-Dean,REF61371432,0.0,569.88,175485.58
2022-02-17,2022-02-17,Tools expense,REF82232716,37.31,0.0,175448.27
2022-02-19,2022-02-19,Fuel purchase,REF71870778,132.63,0.0,175315.64
2022-02-20,2022-02-20,Business materials,REF68289119,612.32,0.0,174703.32
2022-02-22,2022-02-22,Safety Equipment expense,REF53774698,30.64,0.0,174672.68
2022-02-23,2022-02-23,Fuel purchase,REF45114097,216.75,0.0,174455.93
2022-02-28,2022-02-28,"Invoice payment - Parsons, Diaz and Jackson",REF20723489,0.0,461.57,174917.5
2022-02-28,2022-02-28,Invoice payment - Cooper-Dean,REF11943475,0.0,566.03,175483.53
2022-02-28,2022-02-28,"Invoice payment - Leon, Jones and Jackson",REF51637318,0.0,290.34,175773.87
2022-02-28,2022-02-28,Equipment Rental expense,REF23296343,378.01,0.0,175395.86
2022-02-28,2022-02-28,Project payment - Burns PLC,REF66770670,0.0,616.09,176011.95
2022-02-28,2022-02-28,"Service payment - Brown, Ray and Torres",REF75068101,0.0,1111.17,177123.12
2022-03-14,2022-03-14,Equipment Rental expense,REF30763932,429.12,0.0,176694.0
2022-03-15,2022-03-15,"Invoice payment - Parsons, Diaz and Jackson",REF62674369,0.0,741.5,177435.5
2022-03-15,2022-03-15,Business insurance premium,REF98219507,203.99,0.0,177231.51
2022-03-15,2022-03-15,"Invoice payment - Brown, Ray and Torres",REF13640716,0.0,1451.27,178682.78
2022-03-15,2022-03-15,Payment from Cooper-Dean,REF15072999,0.0,755.4,179438.18
2022-03-15,2022-03-15,Service payment - Burns PLC,REF47116538,0.0,896.12,180334.3
2022-03-17,2022-03-17,Fuel purchase,REF15987303,212.32,0.0,180121.98
2022-03-20,2022-03-20,Vehicle Maintenance expense,REF27188685,207.25,0.0,179914.73
2022-03-21,2022-03-21,Permits Licenses expense,REF60605287,99.84,0.0,179814.89
2022-03-22,2022-03-22,Business materials,REF90278011,927.82,0.0,178887.07
2022-03-26,2022-03-26,Business materials,REF89234577,748.48,0.0,178138.59
2022-03-30,2022-03-30,"Project payment - Parsons, Diaz and Jackson",REF14498860,0.0,466.65,178605.24
2022-03-30,2022-03-30,"Service payment - Brown, Ray and Torres",REF47060440,0.0,1454.76,180060.0
2022-03-30,2022-03-30,Invoice payment - Burns PLC,REF75083860,0.0,1211.93,181271.93
2022-03-30,2022-03-30,Payment from Cooper-Dean,REF43401808,0.0,662.15,181934.08
2022-03-30,2022-03-30,"Project payment - Leon, Jones and Jackson",REF39475488,0.0,426.55,182360.63
2022-03-31,2022-03-31,Permits Licenses expense,REF42410871,87.84,0.0,182272.79
2022-03-31,2022-03-31,Business materials,REF74870374,737.99,0.0,181534.8
2022-04-01,2022-04-01,Fuel purchase,REF25709289,355.47,0.0,181179.33
2022-04-04,2022-04-04,Business materials,REF49953689,321.16,0.0,180858.17
2022-04-04,2022-04-04,Vehicle Maintenance expense,REF96838610,159.71,0.0,180698.46
2022-04-06,2022-04-06,Equipment Rental expense,REF66202074,639.16,0.0,180059.3
2022-04-07,2022-04-07,Subcontractors expense,REF80737183,1821.98,0.0,178237.32
2022-04-09,2022-04-09,Safety Equipment expense,REF45016838,84.26,0.0,178153.06
2022-04-12,2022-04-12,Fuel purchase,REF78939320,531.55,0.0,177621.51
2022-04-14,2022-04-14,Safety Equipment expense,REF97429091,53.49,0.0,177568.02
2022-04-15,2022-04-15,Business insurance premium,REF15867193,248.12,0.0,177319.9
2022-04-15,2022-04-15,Business materials,REF94869344,836.19,0.0,176483.71
2022-04-15,2022-04-15,"Payment from Leon, Jones and Jackson",REF47779854,0.0,501.22,176984.93
2022-04-15,2022-04-15,Payment from Burns PLC,REF82859959,0.0,781.51,177766.44
2022-04-15,2022-04-15,Project payment - Cooper-Dean,REF45952455,0.0,1007.16,178773.6
2022-04-15,2022-04-15,"Payment from Brown, Ray and Torres",REF44109460,0.0,1465.2,180238.8
2022-04-15,2022-04-15,"Project payment - Parsons, Diaz and Jackson",REF81291091,0.0,679.94,180918.74
2022-04-18,2022-04-18,Permits Licenses expense,REF65972740,66.71,0.0,180852.03
2022-04-19,2022-04-19,Equipment Rental expense,REF43787064,598.3,0.0,180253.73
2022-04-19,2022-04-19,Permits Licenses expense,REF17423760,110.03,0.0,180143.7
2022-04-22,2022-04-22,Fuel purchase,REF12108367,377.73,0.0,179765.97
2022-04-23,2022-04-23,Tools expense,REF56559893,111.14,0.0,179654.83
2022-04-24,2022-04-24,Fuel purchase,REF36107008,118.72,0.0,179536.11
2022-04-25,2022-04-25,Vehicle Maintenance expense,REF86677389,134.21,0.0,179401.9
2022-04-26,2022-04-26,Fuel purchase,REF53936889,300.1,0.0,179101.8
2022-04-30,2022-04-30,Fuel purchase,REF81866487,347.0,0.0,178754.8
2022-04-30,2022-04-30,Project payment - Burns PLC,REF41690558,0.0,1209.24,179964.04
2022-04-30,2022-04-30,"Invoice payment - Parsons, Diaz and Jackson",REF84228941,0.0,641.12,180605.16
2022-04-30,2022-04-30,Payment from Cooper-Dean,REF39268491,0.0,730.19,181335.35
2022-04-30,2022-04-30,Business materials,REF67216407,983.24,0.0,180352.11
2022-04-30,2022-04-30,"Payment from Leon, Jones and Jackson",REF94185149,0.0,512.62,180864.73
2022-04-30,2022-04-30,"Project payment - Brown, Ray and Torres",REF79197771,0.0,2201.91,183066.64
2022-05-02,2022-05-02,Subcontractors expense,REF25877858,1534.83,0.0,181531.81
2022-05-07,2022-05-07,Business materials,REF97268914,484.96,0.0,181046.85
2022-05-11,2022-05-11,Safety Equipment expense,REF19035067,110.8,0.0,180936.05
2022-05-12,2022-05-12,Fuel purchase,REF48543374,388.91,0.0,180547.14
2022-05-14,2022-05-14,Fuel purchase,REF19593112,412.75,0.0,180134.39
2022-05-15,2022-05-15,"Invoice payment - Parsons, Diaz and Jackson",REF70927462,0.0,790.1,180924.49
2022-05-15,2022-05-15,Business insurance premium,REF76900258,235.35,0.0,180689.14
2022-05-15,2022-05-15,Payment from Cooper-Dean,REF65049783,0.0,949.94,181639.08
2022-05-15,2022-05-15,"Payment from Brown, Ray and Torres",REF50949450,0.0,2231.56,183870.64
2022-05-15,2022-05-15,"Payment from Leon, Jones and Jackson",REF13155419,0.0,706.1,184576.74
2022-05-15,2022-05-15,Invoice payment - Burns PLC,REF14488516,0.0,1128.4,185705.14
2022-05-15,2022-05-15,Fuel purchase,REF60465388,219.97,0.0,185485.17
2022-05-17,2022-05-17,Vehicle Maintenance expense,REF57754957,218.68,0.0,185266.49
2022-05-17,2022-05-17,Permits Licenses expense,REF98445602,138.49,0.0,185128.0
2022-05-19,2022-05-19,Permits Licenses expense,REF32079942,129.04,0.0,184998.96
2022-05-22,2022-05-22,Vehicle Maintenance expense,REF96091894,144.2,0.0,184854.76
2022-05-24,2022-05-24,Business materials,REF53153503,1526.6,0.0,183328.16
2022-05-26,2022-05-26,Subcontractors expense,REF48842930,1529.65,0.0,181798.51
2022-05-30,2022-05-30,"Payment from Leon, Jones and Jackson",REF22290730,0.0,520.47,182318.98
2022-05-30,2022-05-30,"Payment from Parsons, Diaz and Jackson",REF44424831,0.0,800.55,183119.53
2022-05-30,2022-05-30,"Service payment - Brown, Ray and Torres",REF12973472,0.0,2441.23,185560.76
2022-05-30,2022-05-30,Payment from Cooper-Dean,REF13207654,0.0,1472.66,187033.42
2022-05-30,2022-05-30,Project payment - Burns PLC,REF84667984,0.0,970.44,188003.86
2022-06-03,2022-06-03,Subcontractors expense,REF83805029,1746.99,0.0,186256.87
2022-06-06,2022-06-06,Safety Equipment expense,REF70445250,95.93,0.0,186160.94
2022-06-07,2022-06-07,Fuel purchase,REF48194717,580.39,0.0,185580.55
2022-06-10,2022-06-10,Business materials,REF14558743,885.53,0.0,184695.02
2022-06-12,2022-06-12,Equipment Rental expense,REF99014726,686.35,0.0,184008.67
2022-06-14,2022-06-14,Fuel purchase,REF63733556,316.62,0.0,183692.05
2022-06-15,2022-06-15,"Project payment - Brown, Ray and Torres",REF28211099,0.0,1825.16,185517.21
2022-06-15,2022-06-15,Payment from Burns PLC,REF36181813,0.0,1047.63,186564.84
2022-06-15,2022-06-15,"Project payment - Parsons, Diaz and Jackson",REF21545372,0.0,732.6,187297.44
2022-06-15,2022-06-15,Business insurance premium,REF50773185,258.4,0.0,187039.04
2022-06-15,2022-06-15,Project payment - Cooper-Dean,REF22289874,0.0,945.88,187984.92
2022-06-15,2022-06-15,"Project payment - Leon, Jones and Jackson",REF34058809,0.0,484.71,188469.63
2022-06-16,2022-06-16,Tools expense,REF10303916,168.12,0.0,188301.51
2022-06-19,2022-06-19,Vehicle Maintenance expense,REF19662051,203.06,0.0,188098.45
2022-06-26,2022-06-26,Permits Licenses expense,REF21652232,119.88,0.0,187978.57
2022-06-28,2022-06-28,Fuel purchase,REF30411127,392.18,0.0,187586.39
2022-06-30,2022-06-30,Business materials,REF67381030,709.45,0.0,186876.94
2022-06-30,2022-06-30,"Invoice payment - Parsons, Diaz and Jackson",REF30507172,0.0,763.62,187640.56
2022-06-30,2022-06-30,"Service payment - Brown, Ray and Torres",REF96084059,0.0,2160.8,189801.36
2022-06-30,2022-06-30,"Project payment - Leon, Jones and Jackson",REF16149335,0.0,569.03,190370.39
2022-06-30,2022-06-30,Payment from Cooper-Dean,REF57588819,0.0,1027.01,191397.4
2022-06-30,2022-06-30,Payment from Burns PLC,REF55567616,0.0,1340.74,192738.14
2022-07-02,2022-07-02,Business materials,REF80531621,1397.8,0.0,191340.34
2022-07-10,2022-07-10,Vehicle Maintenance expense,REF38995938,353.53,0.0,190986.81
2022-07-15,2022-07-15,"Service payment - Brown, Ray and Torres",REF98581047,0.0,2076.63,193063.44
2022-07-15,2022-07-15,Service payment - Cooper-Dean,REF11488949,0.0,1116.12,194179.56
2022-07-15,2022-07-15,Business insurance premium,REF67146852,244.19,0.0,193935.37
2022-07-15,2022-07-15,Invoice payment - Burns PLC,REF26247512,0.0,1280.42,195215.79
2022-07-15,2022-07-15,"Invoice payment - Parsons, Diaz and Jackson",REF71724085,0.0,557.38,195773.17
2022-07-15,2022-07-15,"Project payment - Leon, Jones and Jackson",REF29858376,0.0,429.8,196202.97
2022-07-16,2022-07-16,Fuel purchase,REF60703225,248.4,0.0,195954.57
2022-07-20,2022-07-20,Tools expense,REF86867540,99.64,0.0,195854.93
2022-07-22,2022-07-22,Fuel purchase,REF98526051,450.26,0.0,195404.67
2022-07-23,2022-07-23,Tools expense,REF79582137,167.09,0.0,195237.58
2022-07-23,2022-07-23,Vehicle Maintenance expense,REF60379064,173.87,0.0,195063.71
2022-07-29,2022-07-29,Business materials,REF51276032,554.81,0.0,194508.9
2022-07-30,2022-07-30,"Invoice payment - Leon, Jones and Jackson",REF99947962,0.0,453.97,194962.87
2022-07-30,2022-07-30,"Payment from Parsons, Diaz and Jackson",REF66625018,0.0,698.08,195660.95
2022-07-30,2022-07-30,Service payment - Cooper-Dean,REF15789911,0.0,1154.02,196814.97
2022-07-30,2022-07-30,"Service payment - Brown, Ray and Torres",REF96744826,0.0,1891.3,198706.27
2022-08-02,2022-08-02,Vehicle Maintenance expense,REF71724337,115.43,0.0,198590.84
2022-08-03,2022-08-03,Subcontractors expense,REF75421375,1645.81,0.0,196945.03
2022-08-08,2022-08-08,Fuel purchase,REF25420314,447.5,0.0,196497.53
2022-08-09,2022-08-09,Business materials,REF41041791,523.29,0.0,195974.24
2022-08-10,2022-08-10,Tools expense,REF66467783,108.78,0.0,195865.46
2022-08-12,2022-08-12,Vehicle Maintenance expense,REF69016585,205.36,0.0,195660.1
2022-08-13,2022-08-13,Subcontractors expense,REF71251446,872.09,0.0,194788.01
2022-08-15,2022-08-15,Business insurance premium,REF32021850,236.05,0.0,194551.96
2022-08-15,2022-08-15,Payment from Cooper-Dean,REF70882600,0.0,1004.62,195556.58
2022-08-15,2022-08-15,"Service payment - Brown, Ray and Torres",REF26380213,0.0,1661.34,197217.92
2022-08-15,2022-08-15,"Payment from Leon, Jones and Jackson",REF96843591,0.0,479.28,197697.2
2022-08-15,2022-08-15,"Project payment - Parsons, Diaz and Jackson",REF94187831,0.0,834.74,198531.94
2022-08-15,2022-08-15,Invoice payment - Burns PLC,REF42853082,0.0,999.55,199531.49
2022-08-19,2022-08-19,Permits Licenses expense,REF19389251,74.84,0.0,199456.65
2022-08-26,2022-08-26,Vehicle Maintenance expense,REF17079223,177.18,0.0,199279.47
2022-08-28,2022-08-28,Equipment Rental expense,REF65846569,413.12,0.0,198866.35
2022-08-29,2022-08-29,Safety Equipment expense,REF98800874,95.41,0.0,198770.94
2022-08-30,2022-08-30,Project payment - Burns PLC,REF95895465,0.0,1070.48,199841.42
2022-08-30,2022-08-30,"Service payment - Parsons, Diaz and Jackson",REF53102103,0.0,740.33,200581.75
2022-08-30,2022-08-30,"Service payment - Leon, Jones and Jackson",REF31220294,0.0,486.77,201068.52
2022-08-30,2022-08-30,"Invoice payment - Brown, Ray and Torres",REF93389919,0.0,1950.13,203018.65
2022-08-30,2022-08-30,Service payment - Cooper-Dean,REF96348332,0.0,797.85,203816.5
2022-09-02,2022-09-02,Business materials,REF44712777,1360.1,0.0,202456.4
2022-09-03,2022-09-03,Fuel purchase,REF21112734,391.93,0.0,202064.47
2022-09-08,2022-09-08,Equipment Rental expense,REF43495036,345.12,0.0,201719.35
2022-09-12,2022-09-12,Fuel purchase,REF80428680,192.3,0.0,201527.05
2022-09-12,2022-09-12,Permits Licenses expense,REF20865390,110.13,0.0,201416.92
2022-09-15,2022-09-15,Business insurance premium,REF17857486,235.34,0.0,201181.58
2022-09-15,2022-09-15,Service payment - Cooper-Dean,REF82027309,0.0,1135.53,202317.11
2022-09-15,2022-09-15,"Invoice payment - Leon, Jones and Jackson",REF65700099,0.0,438.96,202756.07
2022-09-15,2022-09-15,Project payment - Burns PLC,REF65571120,0.0,828.28,203584.35
2022-09-16,2022-09-16,Business materials,REF23359609,334.16,0.0,203250.19
2022-09-19,2022-09-19,Subcontractors expense,REF21661405,1451.28,0.0,201798.91
2022-09-20,2022-09-20,Business materials,REF38610977,826.69,0.0,200972.22
2022-09-25,2022-09-25,Fuel purchase,REF20764984,371.4,0.0,200600.82
2022-09-26,2022-09-26,Business materials,REF65686963,721.32,0.0,199879.5
2022-09-27,2022-09-27,Equipment Rental expense,REF50744424,524.24,0.0,199355.26
2022-09-30,2022-09-30,Project payment - Burns PLC,REF54054711,0.0,1160.87,200516.13
2022-09-30,2022-09-30,"Payment from Leon, Jones and Jackson",REF48798516,0.0,454.35,200970.48
2022-09-30,2022-09-30,"Service payment - Brown, Ray and Torres",REF40820386,0.0,2219.15,203189.63
2022-09-30,2022-09-30,"Payment from Parsons, Diaz and Jackson",REF44479295,0.0,635.88,203825.51
2022-10-08,2022-10-08,Equipment Rental expense,REF31184349,207.49,0.0,203618.02
2022-10-11,2022-10-11,Fuel purchase,REF41752077,326.39,0.0,203291.63
2022-10-13,2022-10-13,Fuel purchase,REF85630014,327.22,0.0,202964.41
2022-10-13,2022-10-13,Subcontractors expense,REF42021976,469.26,0.0,202495.15
2022-10-15,2022-10-15,"Service payment - Leon, Jones and Jackson",REF95235745,0.0,457.89,202953.04
2022-10-15,2022-10-15,"Service payment - Brown, Ray and Torres",REF47471469,0.0,1652.0,204605.04
2022-10-15,2022-10-15,Payment from Burns PLC,REF30263941,0.0,787.76,205392.8
2022-10-15,2022-10-15,Service payment - Cooper-Dean,REF20984641,0.0,826.99,206219.79
2022-10-15,2022-10-15,"Project payment - Parsons, Diaz and Jackson",REF17737674,0.0,693.38,206913.17
2022-10-15,2022-10-15,Business insurance premium,REF67833035,189.44,0.0,206723.73
2022-10-17,2022-10-17,Permits Licenses expense,REF63461697,47.94,0.0,206675.79
2022-10-18,2022-10-18,Tools expense,REF75071650,89.25,0.0,206586.54
2022-10-21,2022-10-21,Subcontractors expense,REF46396189,845.04,0.0,205741.5
2022-10-22,2022-10-22,Equipment Rental expense,REF49318640,686.78,0.0,205054.72
2022-10-25,2022-10-25,Tools expense,REF86784195,93.86,0.0,204960.86
2022-10-28,2022-10-28,Permits Licenses expense,REF30432488,56.43,0.0,204904.43
2022-10-30,2022-10-30,"Payment from Brown, Ray and Torres",REF30925227,0.0,1284.76,206189.19
2022-10-30,2022-10-30,Payment from Burns PLC,REF26420837,0.0,1040.28,207229.47
2022-10-30,2022-10-30,Service payment - Cooper-Dean,REF79912503,0.0,688.83,207918.3
2022-10-30,2022-10-30,"Payment from Leon, Jones and Jackson",REF50884560,0.0,285.58,208203.88
2022-11-04,2022-11-04,Business materials,REF64867773,403.29,0.0,207800.59
2022-11-05,2022-11-05,Vehicle Maintenance expense,REF45575234,79.14,0.0,207721.45
2022-11-05,2022-11-05,Fuel purchase,REF89466019,189.19,0.0,207532.26
2022-11-06,2022-11-06,Equipment Rental expense,REF15316074,483.88,0.0,207048.38
2022-11-06,2022-11-06,Business materials,REF49992557,547.15,0.0,206501.23
2022-11-12,2022-11-12,Equipment Rental expense,REF10973104,68.84,0.0,206432.39
2022-11-15,2022-11-15,Service payment - Burns PLC,REF51697202,0.0,978.56,207410.95
2022-11-15,2022-11-15,Permits Licenses expense,REF36701044,68.65,0.0,207342.3
2022-11-15,2022-11-15,"Service payment - Brown, Ray and Torres",REF73961678,0.0,1396.41,208738.71
2022-11-15,2022-11-15,"Payment from Parsons, Diaz and Jackson",REF66024765,0.0,373.84,209112.55
2022-11-15,2022-11-15,"Payment from Leon, Jones and Jackson",REF86846171,0.0,295.75,209408.3
2022-11-15,2022-11-15,Business insurance premium,REF93698313,160.07,0.0,209248.23
2022-11-17,2022-11-17,Fuel purchase,REF68260468,201.8,0.0,209046.43
2022-11-23,2022-11-23,Tools expense,REF53164424,87.62,0.0,208958.81
2022-11-25,2022-11-25,Subcontractors expense,REF89435212,1142.08,0.0,207816.73
2022-11-28,2022-11-28,Business materials,REF42578641,367.6,0.0,207449.13
2022-11-29,2022-11-29,Equipment Rental expense,REF94295337,381.12,0.0,207068.01
2022-11-30,2022-11-30,Payment from Burns PLC,REF48356358,0.0,759.86,207827.87
2022-11-30,2022-11-30,Project payment - Cooper-Dean,REF23145584,0.0,654.82,208482.69
2022-11-30,2022-11-30,"Project payment - Parsons, Diaz and Jackson",REF48565031,0.0,444.22,208926.91
2022-11-30,2022-11-30,"Invoice payment - Leon, Jones and Jackson",REF33479386,0.0,308.33,209235.24
2022-11-30,2022-11-30,"Service payment - Brown, Ray and Torres",REF70068521,0.0,1456.83,210692.07
2022-12-01,2022-12-01,Vehicle Maintenance expense,REF68827612,70.36,0.0,210621.71
2022-12-02,2022-12-02,Vehicle Maintenance expense,REF68185664,73.81,0.0,210547.9
2022-12-03,2022-12-03,Equipment Rental expense,REF82392696,268.82,0.0,210279.08
2022-12-04,2022-12-04,Fuel purchase,REF42671437,5.0,0.0,210274.08
2022-12-05,2022-12-05,Business materials,REF62905984,164.27,0.0,210109.81
2022-12-11,2022-12-11,Fuel purchase,REF23101903,256.54,0.0,209853.27
2022-12-12,2022-12-12,Fuel purchase,REF43446152,242.31,0.0,209610.96
2022-12-15,2022-12-15,Invoice payment - Cooper-Dean,REF85691085,0.0,413.99,210024.95
2022-12-15,2022-12-15,Business insurance premium,REF18254696,127.06,0.0,209897.89
2022-12-15,2022-12-15,"Payment from Brown, Ray and Torres",REF85196756,0.0,787.46,210685.35
2022-12-15,2022-12-15,"Payment from Leon, Jones and Jackson",REF87299289,0.0,298.74,210984.09
2022-12-15,2022-12-15,"Project payment - Parsons, Diaz and Jackson",REF80165631,0.0,397.21,211381.3
2022-12-16,2022-12-16,Subcontractors expense,REF32217208,706.72,0.0,210674.58
2022-12-17,2022-12-17,Fuel purchase,REF44140289,174.22,0.0,210500.36
2022-12-17,2022-12-17,Business materials,REF60343760,377.29,0.0,210123.07
2022-12-19,2022-12-19,Business materials,REF31932299,427.55,0.0,209695.52
2022-12-19,2022-12-19,Fuel purchase,REF92348701,221.64,0.0,209473.88
2022-12-22,2022-12-22,Business materials,REF65195884,414.68,0.0,209059.2
2022-12-25,2022-12-25,Vehicle Maintenance expense,REF97640341,102.42,0.0,208956.78
2022-12-27,2022-12-27,Fuel purchase,REF79311353,152.83,0.0,208803.95
2022-12-28,2022-12-28,Fuel purchase,REF64686537,133.84,0.0,208670.11
2022-12-30,2022-12-30,Business materials,REF61312330,604.03,0.0,208066.08
2022-12-30,2022-12-30,Project payment - Burns PLC,REF32764255,0.0,502.67,208568.75
2022-12-30,2022-12-30,"Project payment - Brown, Ray and Torres",REF22573950,0.0,1072.04,209640.79
2022-12-30,2022-12-30,Invoice payment - Cooper-Dean,REF75344624,0.0,498.01,210138.8
2022-12-30,2022-12-30,"Invoice payment - Parsons, Diaz and Jackson",REF24178917,0.0,339.58,210478.38
2022-12-30,2022-12-30,Vehicle Maintenance expense,REF88919384,72.96,0.0,210405.42
2022-12-31,2022-12-31,Fuel purchase,REF83866838,181.95,0.0,210223.47
2023-01-01,2023-01-01,Business materials,REF98128109,494.94,0.0,209728.53
2023-01-04,2023-01-04,Fuel purchase,REF82727510,51.56,0.0,209676.97
2023-01-05,2023-01-05,Fuel purchase,REF31256986,191.0,0.0,209485.97
2023-01-05,2023-01-05,Business materials,REF26555846,471.87,0.0,209014.1
2023-01-10,2023-01-10,Tools expense,REF11909564,72.66,0.0,208941.44
2023-01-12,2023-01-12,Fuel purchase,REF73060660,255.33,0.0,208686.11
2023-01-14,2023-01-14,Fuel purchase,REF16161916,281.33,0.0,208404.78
2023-01-15,2023-01-15,"Project payment - Leon, Jones and Jackson",REF21350598,0.0,292.89,208697.67
2023-01-15,2023-01-15,"Payment from Parsons, Diaz and Jackson",REF52326016,0.0,374.43,209072.1
2023-01-15,2023-01-15,Business insurance premium,REF72191009,139.5,0.0,208932.6
2023-01-15,2023-01-15,"Payment from Brown, Ray and Torres",REF43931467,0.0,1219.19,210151.79
2023-01-17,2023-01-17,Fuel purchase,REF10229024,276.22,0.0,209875.57
2023-01-17,2023-01-17,Equipment Rental expense,REF41906926,271.12,0.0,209604.45
2023-01-19,2023-01-19,Fuel purchase,REF59207559,296.37,0.0,209308.08
2023-01-21,2023-01-21,Equipment Rental expense,REF49065346,78.42,0.0,209229.66
2023-01-21,2023-01-21,Subcontractors expense,REF93774621,814.28,0.0,208415.38
2023-01-25,2023-01-25,Vehicle Maintenance expense,REF26829347,117.56,0.0,208297.82
2023-01-30,2023-01-30,"Project payment - Brown, Ray and Torres",REF44024757,0.0,1357.84,209655.66
2023-01-30,2023-01-30,Project payment - Cooper-Dean,REF97182453,0.0,571.36,210227.02
2023-01-30,2023-01-30,"Invoice payment - Parsons, Diaz and Jackson",REF31199761,0.0,437.03,210664.05
2023-01-30,2023-01-30,"Payment from Leon, Jones and Jackson",REF94298378,0.0,354.46,211018.51
2023-01-30,2023-01-30,Invoice payment - Burns PLC,REF64795629,0.0,483.33,211501.84
2023-02-03,2023-02-03,Tools expense,REF55891746,104.65,0.0,211397.19
2023-02-04,2023-02-04,Subcontractors expense,REF32621654,639.51,0.0,210757.68
2023-02-05,2023-02-05,Fuel purchase,REF96283292,238.0,0.0,210519.68
2023-02-08,2023-02-08,Business materials,REF35969331,838.6,0.0,209681.08
2023-02-12,2023-02-12,Business materials,REF32501472,1036.83,0.0,208644.25
2023-02-15,2023-02-15,Subcontractors expense,REF27040258,513.53,0.0,208130.72
2023-02-15,2023-02-15,"Project payment - Parsons, Diaz and Jackson",REF12374861,0.0,518.0,208648.72
2023-02-15,2023-02-15,"Payment from Leon, Jones and Jackson",REF21136316,0.0,259.4,208908.12
2023-02-15,2023-02-15,Payment from Burns PLC,REF78668909,0.0,910.98,209819.1
2023-02-15,2023-02-15,"Payment from Brown, Ray and Torres",REF96495188,0.0,1375.78,211194.88
2023-02-15,2023-02-15,Business insurance premium,REF65827331,150.93,0.0,211043.95
2023-02-17,2023-02-17,Tools expense,REF82984656,85.63,0.0,210958.32
2023-02-18,2023-02-18,Vehicle Maintenance expense,REF65932048,74.04,0.0,210884.28
2023-02-20,2023-02-20,Vehicle Maintenance expense,REF79008746,81.06,0.0,210803.22
2023-02-25,2023-02-25,Business materials,REF37202006,1064.47,0.0,209738.75
2023-02-25,2023-02-25,Tools expense,REF87312775,90.44,0.0,209648.31
2023-02-26,2023-02-26,Business materials,REF22097830,403.35,0.0,209244.96
2023-02-26,2023-02-26,Permits Licenses expense,REF66131779,57.79,0.0,209187.17
2023-02-28,2023-02-28,"Payment from Brown, Ray and Torres",REF90976032,0.0,1376.8,210563.97
2023-02-28,2023-02-28,Service payment - Cooper-Dean,REF10160226,0.0,522.92,211086.89
2023-02-28,2023-02-28,Payment from Burns PLC,REF44176743,0.0,656.0,211742.89
2023-02-28,2023-02-28,"Invoice payment - Parsons, Diaz and Jackson",REF46494491,0.0,544.08,212286.97
2023-03-01,2023-03-01,Permits Licenses expense,REF23896253,89.02,0.0,212197.95
2023-03-02,2023-03-02,Safety Equipment expense,REF98659760,87.88,0.0,212110.07
2023-03-04,2023-03-04,Permits Licenses expense,REF20413179,85.47,0.0,212024.6
2023-03-04,2023-03-04,Business materials,REF41956835,263.6,0.0,211761.0
2023-03-05,2023-03-05,Vehicle Maintenance expense,REF46835902,63.82,0.0,211697.18
2023-03-09,2023-03-09,Equipment Rental expense,REF10580058,491.49,0.0,211205.69
2023-03-09,2023-03-09,Safety Equipment expense,REF28054179,83.34,0.0,211122.35
2023-03-10,2023-03-10,Business materials,REF66331120,604.2,0.0,210518.15
2023-03-12,2023-03-12,Tools expense,REF84822689,82.91,0.0,210435.24
2023-03-12,2023-03-12,Fuel purchase,REF20250585,232.68,0.0,210202.56
2023-03-12,2023-03-12,Vehicle Maintenance expense,REF73693541,64.83,0.0,210137.73
2023-03-15,2023-03-15,"Service payment - Leon, Jones and Jackson",REF30981644,0.0,399.34,210537.07
2023-03-15,2023-03-15,"Invoice payment - Parsons, Diaz and Jackson",REF95234226,0.0,622.52,211159.59
2023-03-15,2023-03-15,Vehicle Maintenance expense,REF51481954,127.59,0.0,211032.0
2023-03-15,2023-03-15,Business insurance premium,REF34875668,196.35,0.0,210835.65
2023-03-15,2023-03-15,"Project payment - Brown, Ray and Torres",REF59840839,0.0,1749.68,212585.33
2023-03-15,2023-03-15,Invoice payment - Cooper-Dean,REF72040031,0.0,767.09,213352.42
2023-03-15,2023-03-15,Project payment - Burns PLC,REF42467378,0.0,871.17,214223.59
2023-03-16,2023-03-16,Equipment Rental expense,REF14985381,527.25,0.0,213696.34
2023-03-16,2023-03-16,Permits Licenses expense,REF94590706,20.23,0.0,213676.11
2023-03-17,2023-03-17,Subcontractors expense,REF98110259,978.81,0.0,212697.3
2023-03-18,2023-03-18,Business materials,REF57215217,648.34,0.0,212048.96
2023-03-25,2023-03-25,Business materials,REF51770471,776.2,0.0,211272.76
2023-03-27,2023-03-27,Safety Equipment expense,REF98866901,78.0,0.0,211194.76
2023-03-30,2023-03-30,"Service payment - Leon, Jones and Jackson",REF24876205,0.0,428.72,211623.48
2023-03-30,2023-03-30,"Invoice payment - Brown, Ray and Torres",REF26915035,0.0,1173.95,212797.43
2023-03-30,2023-03-30,Payment from Burns PLC,REF48052413,0.0,796.7,213594.13
2023-03-30,2023-03-30,"Invoice payment - Parsons, Diaz and Jackson",REF68087050,0.0,597.74,214191.87
2023-04-02,2023-04-02,Subcontractors expense,REF48563593,1295.52,0.0,212896.35
2023-04-04,2023-04-04,Subcontractors expense,REF34179364,1038.84,0.0,211857.51
2023-04-07,2023-04-07,Subcontractors expense,REF78625616,1023.05,0.0,210834.46
2023-04-09,2023-04-09,Fuel purchase,REF84690814,112.14,0.0,210722.32
2023-04-10,2023-04-10,Safety Equipment expense,REF81556352,137.28,0.0,210585.04
2023-04-13,2023-04-13,Tools expense,REF98405143,89.69,0.0,210495.35
2023-04-15,2023-04-15,Subcontractors expense,REF51071336,1085.37,0.0,209409.98
2023-04-15,2023-04-15,Invoice payment - Cooper-Dean,REF66531281,0.0,1018.77,210428.75
2023-04-15,2023-04-15,"Payment from Parsons, Diaz and Jackson",REF54491477,0.0,776.56,211205.31
2023-04-15,2023-04-15,"Project payment - Brown, Ray and Torres",REF10381064,0.0,1533.33,212738.64
2023-04-15,2023-04-15,"Invoice payment - Leon, Jones and Jackson",REF40685441,0.0,423.62,213162.26
2023-04-15,2023-04-15,Business insurance premium,REF85824444,241.66,0.0,212920.6
2023-04-16,2023-04-16,Tools expense,REF39197933,113.55,0.0,212807.05
2023-04-20,2023-04-20,Fuel purchase,REF32438037,335.24,0.0,212471.81
2023-04-20,2023-04-20,Equipment Rental expense,REF43584741,684.64,0.0,211787.17
2023-04-29,2023-04-29,Tools expense,REF86415014,83.8,0.0,211703.37
2023-04-30,2023-04-30,Payment from Cooper-Dean,REF94015667,0.0,1237.46,212940.83
2023-04-30,2023-04-30,"Service payment - Brown, Ray and Torres",REF44253592,0.0,1551.42,214492.25
2023-04-30,2023-04-30,"Service payment - Parsons, Diaz and Jackson",REF37786612,0.0,683.29,215175.54
2023-04-30,2023-04-30,Service payment - Burns PLC,REF84948220,0.0,1275.16,216450.7
2023-04-30,2023-04-30,"Project payment - Leon, Jones and Jackson",REF31867473,0.0,505.41,216956.11
2023-05-02,2023-05-02,Business materials,REF53243407,1544.54,0.0,215411.57
2023-05-03,2023-05-03,Fuel purchase,REF80725857,401.55,0.0,215010.02
2023-05-05,2023-05-05,Tools expense,REF32257009,128.49,0.0,214881.53
2023-05-06,2023-05-06,Safety Equipment expense,REF41179871,100.03,0.0,214781.5
2023-05-09,2023-05-09,Fuel purchase,REF15927300,443.99,0.0,214337.51
2023-05-15,2023-05-15,Business insurance premium,REF33239616,262.51,0.0,214075.0
2023-05-15,2023-05-15,"Payment from Leon, Jones and Jackson",REF56292263,0.0,490.49,214565.49
2023-05-15,2023-05-15,"Project payment - Brown, Ray and Torres",REF81136228,0.0,2180.72,216746.21
2023-05-15,2023-05-15,Payment from Cooper-Dean,REF31390162,0.0,1260.62,218006.83
2023-05-15,2023-05-15,"Invoice payment - Parsons, Diaz and Jackson",REF65638604,0.0,759.26,218766.09
2023-05-30,2023-05-30,Invoice payment - Burns PLC,REF90517238,0.0,1248.29,220014.38
2023-05-30,2023-05-30,"Service payment - Parsons, Diaz and Jackson",REF40672401,0.0,771.89,220786.27
2023-05-30,2023-05-30,Payment from Cooper-Dean,REF63273181,0.0,881.48,221667.75
2023-05-30,2023-05-30,"Invoice payment - Brown, Ray and Torres",REF65765253,0.0,2170.66,223838.41
2023-06-02,2023-06-02,Fuel purchase,REF44628169,682.66,0.0,223155.75
2023-06-02,2023-06-02,Business materials,REF87639752,826.64,0.0,222329.11
2023-06-08,2023-06-08,Fuel purchase,REF14214338,394.05,0.0,221935.06
2023-06-09,2023-06-09,Tools expense,REF22269643,118.8,0.0,221816.26
2023-06-13,2023-06-13,Business materials,REF31866726,1141.18,0.0,220675.08
2023-06-15,2023-06-15,Project payment - Cooper-Dean,REF58486874,0.0,939.2,221614.28
2023-06-15,2023-06-15,"Payment from Brown, Ray and Torres",REF53942450,0.0,2517.09,224131.37
2023-06-15,2023-06-15,Business insurance premium,REF56942728,265.24,0.0,223866.13
2023-06-15,2023-06-15,"Service payment - Leon, Jones and Jackson",REF65570644,0.0,541.29,224407.42
2023-06-15,2023-06-15,Service payment - Burns PLC,REF13157677,0.0,1228.4,225635.82
2023-06-15,2023-06-15,"Service payment - Parsons, Diaz and Jackson",REF67613286,0.0,663.44,226299.26
2023-06-20,2023-06-20,Fuel purchase,REF12920489,294.85,0.0,226004.41
2023-06-24,2023-06-24,Business materials,REF12093650,1573.21,0.0,224431.2
2023-06-30,2023-06-30,Payment from Cooper-Dean,REF56029738,0.0,930.54,225361.74
2023-06-30,2023-06-30,"Project payment - Brown, Ray and Torres",REF78146108,0.0,2431.47,227793.21
2023-06-30,2023-06-30,Service payment - Burns PLC,REF87119327,0.0,1021.66,228814.87
2023-06-30,2023-06-30,"Project payment - Leon, Jones and Jackson",REF47533415,0.0,472.77,229287.64
2023-07-03,2023-07-03,Subcontractors expense,REF28242873,1109.64,0.0,228178.0
2023-07-04,2023-07-04,Subcontractors expense,REF56016662,835.3,0.0,227342.7
2023-07-06,2023-07-06,Safety Equipment expense,REF24941873,116.37,0.0,227226.33
2023-07-11,2023-07-11,Fuel purchase,REF83406577,290.79,0.0,226935.54
2023-07-15,2023-07-15,Payment from Burns PLC,REF33713952,0.0,1186.32,228121.86
2023-07-15,2023-07-15,Business insurance premium,REF43053051,265.05,0.0,227856.81
2023-07-15,2023-07-15,"Service payment - Brown, Ray and Torres",REF36156467,0.0,1800.7,229657.51
2023-07-15,2023-07-15,Business materials,REF70411715,1480.36,0.0,228177.15
2023-07-15,2023-07-15,Project payment - Cooper-Dean,REF10582653,0.0,736.31,228913.46
2023-07-15,2023-07-15,"Invoice payment - Leon, Jones and Jackson",REF89845105,0.0,519.92,229433.38
2023-07-15,2023-07-15,"Invoice payment - Parsons, Diaz and Jackson",REF49015090,0.0,554.8,229988.18
2023-07-17,2023-07-17,Business materials,REF69551144,714.05,0.0,229274.13
2023-07-18,2023-07-18,Fuel purchase,REF20829600,117.12,0.0,229157.01
2023-07-21,2023-07-21,Business materials,REF26554280,820.78,0.0,228336.23
2023-07-21,2023-07-21,Safety Equipment expense,REF45530149,89.31,0.0,228246.92
2023-07-22,2023-07-22,Business materials,REF34098114,1194.67,0.0,227052.25
2023-07-25,2023-07-25,Business materials,REF38553942,718.02,0.0,226334.23
2023-07-30,2023-07-30,Service payment - Cooper-Dean,REF46891864,0.0,619.69,226953.92
2023-07-30,2023-07-30,Service payment - Burns PLC,REF95896806,0.0,947.03,227900.95
2023-07-30,2023-07-30,"Invoice payment - Parsons, Diaz and Jackson",REF69692338,0.0,590.77,228491.72
2023-07-30,2023-07-30,"Project payment - Leon, Jones and Jackson",REF71995856,0.0,527.67,229019.39
2023-07-31,2023-07-31,Fuel purchase,REF78861761,498.8,0.0,228520.59
2023-08-01,2023-08-01,Safety Equipment expense,REF40833816,54.26,0.0,228466.33
2023-08-02,2023-08-02,Tools expense,REF14809503,147.56,0.0,228318.77
2023-08-05,2023-08-05,Business materials,REF79898080,948.05,0.0,227370.72
2023-08-12,2023-08-12,Fuel purchase,REF13996431,318.66,0.0,227052.06
2023-08-12,2023-08-12,Business materials,REF42844150,811.16,0.0,226240.9
2023-08-13,2023-08-13,Business materials,REF83869484,907.74,0.0,225333.16
2023-08-14,2023-08-14,Fuel purchase,REF20538597,385.83,0.0,224947.33
2023-08-15,2023-08-15,Payment from Cooper-Dean,REF10911823,0.0,956.61,225903.94
2023-08-15,2023-08-15,"Payment from Parsons, Diaz and Jackson",REF17912376,0.0,611.27,226515.21
2023-08-15,2023-08-15,Project payment - Burns PLC,REF61919965,0.0,1069.71,227584.92
2023-08-15,2023-08-15,"Service payment - Leon, Jones and Jackson",REF14604037,0.0,371.24,227956.16
2023-08-15,2023-08-15,Business insurance premium,REF76590423,250.5,0.0,227705.66
2023-08-17,2023-08-17,Equipment Rental expense,REF80647177,326.9,0.0,227378.76
2023-08-19,2023-08-19,Fuel purchase,REF50645292,361.34,0.0,227017.42
2023-08-20,2023-08-20,Business materials,REF82439558,863.65,0.0,226153.77
2023-08-20,2023-08-20,Fuel purchase,REF40639771,252.25,0.0,225901.52
2023-08-21,2023-08-21,Subcontractors expense,REF61526964,1177.69,0.0,224723.83
2023-08-21,2023-08-21,Fuel purchase,REF15433445,300.95,0.0,224422.88
2023-08-22,2023-08-22,Business materials,REF29344367,479.83,0.0,223943.05
2023-08-24,2023-08-24,Vehicle Maintenance expense,REF27653582,222.42,0.0,223720.63
2023-08-27,2023-08-27,Fuel purchase,REF73755094,358.29,0.0,223362.34
2023-08-28,2023-08-28,Safety Equipment expense,REF61906375,89.16,0.0,223273.18
2023-08-30,2023-08-30,Safety Equipment expense,REF39942293,79.31,0.0,223193.87
2023-08-30,2023-08-30,"Invoice payment - Leon, Jones and Jackson",REF12792150,0.0,600.28,223794.15
2023-08-30,2023-08-30,"Service payment - Parsons, Diaz and Jackson",REF89339348,0.0,770.34,224564.49
2023-08-30,2023-08-30,"Payment from Brown, Ray and Torres",REF23935133,0.0,2011.54,226576.03
2023-08-30,2023-08-30,Project payment - Burns PLC,REF94292941,0.0,1394.54,227970.57
2023-08-31,2023-08-31,Equipment Rental expense,REF97843405,262.47,0.0,227708.1
2023-09-02,2023-09-02,Permits Licenses expense,REF74590195,76.58,0.0,227631.52
2023-09-02,2023-09-02,Business materials,REF30309537,937.1,0.0,226694.42
2023-09-05,2023-09-05,Fuel purchase,REF82416130,295.16,0.0,226399.26
2023-09-07,2023-09-07,Equipment Rental expense,REF35661112,425.13,0.0,225974.13
2023-09-08,2023-09-08,Equipment Rental expense,REF10782897,464.56,0.0,225509.57
2023-09-09,2023-09-09,Safety Equipment expense,REF68419184,120.05,0.0,225389.52
2023-09-15,2023-09-15,Business insurance premium,REF86575962,220.08,0.0,225169.44
2023-09-15,2023-09-15,Payment from Burns PLC,REF27860449,0.0,822.3,225991.74
2023-09-15,2023-09-15,"Service payment - Brown, Ray and Torres",REF67662107,0.0,1912.97,227904.71
2023-09-15,2023-09-15,Project payment - Cooper-Dean,REF62113036,0.0,893.58,228798.29
2023-09-16,2023-09-16,Business materials,REF98916110,1065.89,0.0,227732.4
2023-09-19,2023-09-19,Safety Equipment expense,REF45589330,90.41,0.0,227641.99
2023-09-22,2023-09-22,Business materials,REF95557904,585.67,0.0,227056.32
2023-09-22,2023-09-22,Subcontractors expense,REF55149871,1410.84,0.0,225645.48
2023-09-24,2023-09-24,Permits Licenses expense,REF72707925,103.95,0.0,225541.53
2023-09-24,2023-09-24,Fuel purchase,REF72191886,214.41,0.0,225327.12
2023-09-27,2023-09-27,Business materials,REF11695075,651.79,0.0,224675.33
2023-09-29,2023-09-29,Fuel purchase,REF39924453,234.26,0.0,224441.07
2023-09-30,2023-09-30,Invoice payment - Burns PLC,REF66815550,0.0,1175.75,225616.82
2023-09-30,2023-09-30,"Invoice payment - Brown, Ray and Torres",REF61065672,0.0,1618.33,227235.15
2023-09-30,2023-09-30,"Service payment - Parsons, Diaz and Jackson",REF18313261,0.0,581.44,227816.59
2023-09-30,2023-09-30,"Invoice payment - Leon, Jones and Jackson",REF68643512,0.0,469.96,228286.55
2023-09-30,2023-09-30,Service payment - Cooper-Dean,REF20393458,0.0,745.0,229031.55
2023-10-03,2023-10-03,Business materials,REF69502401,941.76,0.0,228089.79
2023-10-06,2023-10-06,Business materials,REF41587163,762.32,0.0,227327.47
2023-10-06,2023-10-06,Vehicle Maintenance expense,REF36377871,210.78,0.0,227116.69
2023-10-11,2023-10-11,Vehicle Maintenance expense,REF97010463,173.5,0.0,226943.19
2023-10-12,2023-10-12,Business materials,REF16592645,994.64,0.0,225948.55
2023-10-14,2023-10-14,Fuel purchase,REF95569439,284.62,0.0,225663.93
2023-10-15,2023-10-15,Invoice payment - Burns PLC,REF54097610,0.0,1151.23,226815.16
2023-10-15,2023-10-15,"Project payment - Brown, Ray and Torres",REF55573829,0.0,1558.61,228373.77
2023-10-15,2023-10-15,"Invoice payment - Parsons, Diaz and Jackson",REF13657130,0.0,565.17,228938.94
2023-10-15,2023-10-15,Equipment Rental expense,REF18340176,512.54,0.0,228426.4
2023-10-15,2023-10-15,Business insurance premium,REF70023389,203.38,0.0,228223.02
2023-10-15,2023-10-15,Payment from Cooper-Dean,REF27937636,0.0,910.92,229133.94
2023-10-15,2023-10-15,"Payment from Leon, Jones and Jackson",REF87082560,0.0,337.59,229471.53
2023-10-16,2023-10-16,Fuel purchase,REF80478129,297.21,0.0,229174.32
2023-10-19,2023-10-19,Business materials,REF15928055,1106.29,0.0,228068.03
2023-10-20,2023-10-20,Fuel purchase,REF64636411,358.51,0.0,227709.52
2023-10-21,2023-10-21,Safety Equipment expense,REF82658105,65.13,0.0,227644.39
2023-10-25,2023-10-25,Business materials,REF82107392,676.02,0.0,226968.37
2023-10-26,2023-10-26,Fuel purchase,REF95177577,200.92,0.0,226767.45
2023-10-30,2023-10-30,"Service payment - Brown, Ray and Torres",REF12881734,0.0,1694.82,228462.27
2023-10-30,2023-10-30,"Service payment - Parsons, Diaz and Jackson",REF79524505,0.0,448.84,228911.11
2023-10-30,2023-10-30,"Project payment - Leon, Jones and Jackson",REF60322987,0.0,384.41,229295.52
2023-10-30,2023-10-30,Service payment - Burns PLC,REF33877834,0.0,731.0,230026.52
2023-10-30,2023-10-30,Invoice payment - Cooper-Dean,REF57636684,0.0,800.1,230826.62
2023-11-04,2023-11-04,Safety Equipment expense,REF19448262,56.44,0.0,230770.18
2023-11-05,2023-11-05,Fuel purchase,REF73377206,380.65,0.0,230389.53
2023-11-09,2023-11-09,Vehicle Maintenance expense,REF40952794,79.42,0.0,230310.11
2023-11-10,2023-11-10,Vehicle Maintenance expense,REF17776075,185.49,0.0,230124.62
2023-11-11,2023-11-11,Safety Equipment expense,REF44720172,57.01,0.0,230067.61
2023-11-14,2023-11-14,Vehicle Maintenance expense,REF11483445,115.08,0.0,229952.53
2023-11-15,2023-11-15,Equipment Rental expense,REF88090017,408.86,0.0,229543.67
2023-11-15,2023-11-15,"Payment from Leon, Jones and Jackson",REF54466899,0.0,358.63,229902.3
2023-11-15,2023-11-15,"Project payment - Brown, Ray and Torres",REF18943802,0.0,1458.76,231361.06
2023-11-15,2023-11-15,Service payment - Burns PLC,REF39217459,0.0,823.07,232184.13
2023-11-15,2023-11-15,"Project payment - Parsons, Diaz and Jackson",REF51369499,0.0,346.98,232531.11
2023-11-15,2023-11-15,Business insurance premium,REF74172421,173.47,0.0,232357.64
2023-11-15,2023-11-15,Service payment - Cooper-Dean,REF88611415,0.0,667.63,233025.27
2023-11-18,2023-11-18,Fuel purchase,REF97072582,314.82,0.0,232710.45
2023-11-24,2023-11-24,Fuel purchase,REF81488558,122.03,0.0,232588.42
2023-11-24,2023-11-24,Business materials,REF61519491,701.25,0.0,231887.17
2023-11-26,2023-11-26,Equipment Rental expense,REF13212980,408.18,0.0,231478.99
2023-11-30,2023-11-30,Payment from Cooper-Dean,REF21413925,0.0,545.79,232024.78
2023-11-30,2023-11-30,"Payment from Brown, Ray and Torres",REF70069274,0.0,1244.29,233269.07
2023-11-30,2023-11-30,Project payment - Burns PLC,REF89918564,0.0,590.01,233859.08
2023-11-30,2023-11-30,"Project payment - Parsons, Diaz and Jackson",REF98844614,0.0,512.84,234371.92
2023-12-03,2023-12-03,Tools expense,REF55946217,78.81,0.0,234293.11
2023-12-04,2023-12-04,Business materials,REF24598896,593.68,0.0,233699.43
2023-12-05,2023-12-05,Safety Equipment expense,REF85677408,43.85,0.0,233655.58
2023-12-08,2023-12-08,Equipment Rental expense,REF47113942,299.75,0.0,233355.83
2023-12-09,2023-12-09,Permits Licenses expense,REF54649380,37.14,0.0,233318.69
2023-12-09,2023-12-09,Business materials,REF77453238,345.59,0.0,232973.1
2023-12-10,2023-12-10,Vehicle Maintenance expense,REF34333617,114.15,0.0,232858.95
2023-12-13,2023-12-13,Fuel purchase,REF42180429,131.2,0.0,232727.75
2023-12-14,2023-12-14,Business materials,REF56633269,418.65,0.0,232309.1
2023-12-15,2023-12-15,"Service payment - Brown, Ray and Torres",REF79989505,0.0,1062.44,233371.54
2023-12-15,2023-12-15,Business insurance premium,REF27818270,120.13,0.0,233251.41
2023-12-15,2023-12-15,"Invoice payment - Parsons, Diaz and Jackson",REF34746216,0.0,399.48,233650.89
2023-12-15,2023-12-15,Project payment - Cooper-Dean,REF17505329,0.0,490.21,234141.1
2023-12-15,2023-12-15,Project payment - Burns PLC,REF65750205,0.0,654.9,234796.0
2023-12-15,2023-12-15,"Project payment - Leon, Jones and Jackson",REF98165242,0.0,299.76,235095.76
2023-12-16,2023-12-16,Business materials,REF35069311,372.1,0.0,234723.66
2023-12-16,2023-12-16,Tools expense,REF98867109,59.6,0.0,234664.06
2023-12-20,2023-12-20,Fuel purchase,REF38323983,154.68,0.0,234509.38
2023-12-24,2023-12-24,Fuel purchase,REF72117787,176.15,0.0,234333.23
2023-12-27,2023-12-27,Fuel purchase,REF43943029,94.54,0.0,234238.69
2023-12-30,2023-12-30,Invoice payment - Cooper-Dean,REF54677434,0.0,534.22,234772.91
2023-12-30,2023-12-30,"Invoice payment - Parsons, Diaz and Jackson",REF12488112,0.0,378.02,235150.93
2023-12-30,2023-12-30,Payment from Burns PLC,REF11852095,0.0,584.76,235735.69
2023-12-30,2023-12-30,"Project payment - Brown, Ray and Torres",REF96500421,0.0,1131.03,236866.72
2024-01-01,2024-01-01,Business materials,REF32049943,662.39,0.0,236204.33
2024-01-04,2024-01-04,Subcontractors expense,REF18342573,396.72,0.0,235807.61
2024-01-07,2024-01-07,Fuel purchase,REF25995378,180.42,0.0,235627.19
2024-01-12,2024-01-12,Permits Licenses expense,REF54306153,32.75,0.0,235594.44
2024-01-15,2024-01-15,Service payment - Cooper-Dean,REF55014715,0.0,469.82,236064.26
2024-01-15,2024-01-15,Invoice payment - Burns PLC,REF21425123,0.0,705.85,236770.11
2024-01-15,2024-01-15,"Invoice payment - Brown, Ray and Torres",REF50119420,0.0,1168.43,237938.54
2024-01-15,2024-01-15,Business insurance premium,REF23184916,131.69,0.0,237806.85
2024-01-16,2024-01-16,Permits Licenses expense,REF73340253,78.86,0.0,237727.99
2024-01-17,2024-01-17,Business materials,REF11778866,479.14,0.0,237248.85
2024-01-19,2024-01-19,Tools expense,REF62519832,84.35,0.0,237164.5
2024-01-19,2024-01-19,Subcontractors expense,REF83379713,1049.57,0.0,236114.93
2024-01-21,2024-01-21,Safety Equipment expense,REF87749342,56.82,0.0,236058.11
2024-01-21,2024-01-21,Subcontractors expense,REF35168686,1067.71,0.0,234990.4
2024-01-22,2024-01-22,Fuel purchase,REF73685197,114.03,0.0,234876.37
2024-01-23,2024-01-23,Subcontractors expense,REF49820963,706.12,0.0,234170.25
2024-01-25,2024-01-25,Fuel purchase,REF59715551,176.6,0.0,233993.65
2024-01-26,2024-01-26,Tools expense,REF86330728,70.25,0.0,233923.4
2024-01-28,2024-01-28,Business materials,REF28761325,520.75,0.0,233402.65
2024-01-30,2024-01-30,"Payment from Brown, Ray and Torres",REF93418979,0.0,1293.86,234696.51
2024-01-30,2024-01-30,Project payment - Burns PLC,REF23289714,0.0,613.74,235310.25
2024-01-30,2024-01-30,"Service payment - Parsons, Diaz and Jackson",REF37565613,0.0,392.03,235702.28
2024-02-02,2024-02-02,Business materials,REF86280315,841.2,0.0,234861.08
2024-02-03,2024-02-03,Vehicle Maintenance expense,REF19510900,137.99,0.0,234723.09
2024-02-03,2024-02-03,Fuel purchase,REF84269634,327.24,0.0,234395.85
2024-02-13,2024-02-13,Permits Licenses expense,REF48733255,65.21,0.0,234330.64
2024-02-15,2024-02-15,Business insurance premium,REF58406416,153.92,0.0,234176.72
2024-02-15,2024-02-15,"Service payment - Leon, Jones and Jackson",REF39474966,0.0,322.21,234498.93
2024-02-15,2024-02-15,Project payment - Burns PLC,REF89507737,0.0,797.71,235296.64
2024-02-15,2024-02-15,Invoice payment - Cooper-Dean,REF21067091,0.0,681.98,235978.62
2024-02-15,2024-02-15,"Service payment - Brown, Ray and Torres",REF11914370,0.0,1919.77,237898.39
2024-02-24,2024-02-24,Permits Licenses expense,REF37919725,60.83,0.0,237837.56
2024-02-25,2024-02-25,Business materials,REF99387178,507.91,0.0,237329.65
2024-02-28,2024-02-28,"Service payment - Brown, Ray and Torres",REF30780424,0.0,1390.25,238719.9
2024-02-28,2024-02-28,Project payment - Burns PLC,REF55853597,0.0,611.97,239331.87
2024-02-28,2024-02-28,Service payment - Cooper-Dean,REF25026578,0.0,518.13,239850.0
2024-02-28,2024-02-28,"Invoice payment - Parsons, Diaz and Jackson",REF35500460,0.0,513.31,240363.31
2024-02-28,2024-02-28,"Service payment - Leon, Jones and Jackson",REF64344379,0.0,399.1,240762.41
2024-02-28,2024-02-28,Fuel purchase,REF20002629,240.03,0.0,240522.38
2024-03-01,2024-03-01,Tools expense,REF29076063,130.26,0.0,240392.12
2024-03-04,2024-03-04,Equipment Rental expense,REF96975960,235.86,0.0,240156.26
2024-03-06,2024-03-06,Subcontractors expense,REF36380743,678.88,0.0,239477.38
2024-03-08,2024-03-08,Business materials,REF73816726,597.72,0.0,238879.66
2024-03-08,2024-03-08,Permits Licenses expense,REF22067935,85.02,0.0,238794.64
2024-03-08,2024-03-08,Fuel purchase,REF71500180,187.81,0.0,238606.83
2024-03-10,2024-03-10,Fuel purchase,REF44332801,266.77,0.0,238340.06
2024-03-13,2024-03-13,Equipment Rental expense,REF91412382,520.15,0.0,237819.91
2024-03-15,2024-03-15,Business insurance premium,REF46588329,213.66,0.0,237606.25
2024-03-15,2024-03-15,"Payment from Parsons, Diaz and Jackson",REF66227725,0.0,591.19,238197.44
2024-03-15,2024-03-15,Tools expense,REF79767295,53.66,0.0,238143.78
2024-03-15,2024-03-15,Invoice payment - Cooper-Dean,REF85305108,0.0,827.73,238971.51
2024-03-15,2024-03-15,"Service payment - Leon, Jones and Jackson",REF81997074,0.0,366.68,239338.19
2024-03-15,2024-03-15,"Invoice payment - Brown, Ray and Torres",REF20181860,0.0,983.5,240321.69
2024-03-15,2024-03-15,Invoice payment - Burns PLC,REF86614368,0.0,1038.34,241360.03
2024-03-16,2024-03-16,Business materials,REF35799347,1013.55,0.0,240346.48
2024-03-19,2024-03-19,Equipment Rental expense,REF63883650,372.07,0.0,239974.41
2024-03-21,2024-03-21,Fuel purchase,REF80087508,239.65,0.0,239734.76
2024-03-25,2024-03-25,Fuel purchase,REF99309940,376.11,0.0,239358.65
2024-03-30,2024-03-30,Project payment - Cooper-Dean,REF87457988,0.0,739.31,240097.96
2024-03-30,2024-03-30,"Invoice payment - Parsons, Diaz and Jackson",REF41374122,0.0,600.09,240698.05
2024-03-30,2024-03-30,Service payment - Burns PLC,REF90531586,0.0,943.02,241641.07
2024-03-30,2024-03-30,"Service payment - Brown, Ray and Torres",REF87081545,0.0,1973.71,243614.78
2024-03-30,2024-03-30,"Invoice payment - Leon, Jones and Jackson",REF79102302,0.0,381.14,243995.92
2024-04-05,2024-04-05,Subcontractors expense,REF65527387,1141.44,0.0,242854.48
2024-04-08,2024-04-08,Business materials,REF72992160,628.57,0.0,242225.91
2024-04-10,2024-04-10,Equipment Rental expense,REF33296841,634.91,0.0,241591.0
2024-04-14,2024-04-14,Vehicle Maintenance expense,REF70725574,267.55,0.0,241323.45
2024-04-15,2024-04-15,"Invoice payment - Leon, Jones and Jackson",REF65389463,0.0,420.14,241743.59
2024-04-15,2024-04-15,"Service payment - Brown, Ray and Torres",REF38979668,0.0,1803.54,243547.13
2024-04-15,2024-04-15,Service payment - Burns PLC,REF30061074,0.0,1073.23,244620.36
2024-04-15,2024-04-15,Business insurance premium,REF79460623,242.48,0.0,244377.88
2024-04-15,2024-04-15,Business materials,REF90298627,965.6,0.0,243412.28
2024-04-15,2024-04-15,Payment from Cooper-Dean,REF63204740,0.0,698.5,244110.78
2024-04-15,2024-04-15,"Service payment - Parsons, Diaz and Jackson",REF72782937,0.0,766.79,244877.57
2024-04-19,2024-04-19,Vehicle Maintenance expense,REF72967098,259.65,0.0,244617.92
2024-04-22,2024-04-22,Fuel purchase,REF88337549,360.1,0.0,244257.82
2024-04-22,2024-04-22,Permits Licenses expense,REF65328635,121.35,0.0,244136.47
2024-04-30,2024-04-30,"Service payment - Brown, Ray and Torres",REF25231310,0.0,1901.46,246037.93
2024-04-30,2024-04-30,Service payment - Cooper-Dean,REF89100086,0.0,742.36,246780.29
2024-04-30,2024-04-30,"Service payment - Parsons, Diaz and Jackson",REF19014384,0.0,720.34,247500.63
2024-04-30,2024-04-30,Project payment - Burns PLC,REF24884435,0.0,981.22,248481.85
2024-04-30,2024-04-30,"Service payment - Leon, Jones and Jackson",REF73162392,0.0,587.75,249069.6
2024-04-30,2024-04-30,Business materials,REF64527953,996.41,0.0,248073.19
2024-05-01,2024-05-01,Business materials,REF86471352,889.82,0.0,247183.37
2024-05-01,2024-05-01,Vehicle Maintenance expense,REF74998297,234.09,0.0,246949.28
2024-05-02,2024-05-02,Business materials,REF89849655,1290.22,0.0,245659.06
2024-05-03,2024-05-03,Fuel purchase,REF66330530,326.09,0.0,245332.97
2024-05-04,2024-05-04,Fuel purchase,REF14051967,292.95,0.0,245040.02
2024-05-05,2024-05-05,Fuel purchase,REF36726551,444.04,0.0,244595.98
2024-05-07,2024-05-07,Tools expense,REF97976877,151.1,0.0,244444.88
2024-05-13,2024-05-13,Permits Licenses expense,REF48693663,87.74,0.0,244357.14
2024-05-13,2024-05-13,Fuel purchase,REF22634162,436.6,0.0,243920.54
2024-05-15,2024-05-15,Business insurance premium,REF17965345,255.39,0.0,243665.15
2024-05-15,2024-05-15,Vehicle Maintenance expense,REF25434287,292.27,0.0,243372.88
2024-05-15,2024-05-15,Invoice payment - Cooper-Dean,REF47890552,0.0,924.38,244297.26
2024-05-15,2024-05-15,"Project payment - Parsons, Diaz and Jackson",REF63243739,0.0,822.83,245120.09
2024-05-15,2024-05-15,Project payment - Burns PLC,REF37778355,0.0,1044.86,246164.95
2024-05-15,2024-05-15,"Invoice payment - Brown, Ray and Torres",REF44425922,0.0,2538.98,248703.93
2024-05-15,2024-05-15,"Service payment - Leon, Jones and Jackson",REF89402411,0.0,665.6,249369.53
2024-05-16,2024-05-16,Fuel purchase,REF93346415,357.49,0.0,249012.04
2024-05-19,2024-05-19,Safety Equipment expense,REF26223020,135.04,0.0,248877.0
2024-05-22,2024-05-22,Tools expense,REF60116430,133.34,0.0,248743.66
2024-05-25,2024-05-25,Business materials,REF35829588,951.57,0.0,247792.09
2024-05-28,2024-05-28,Business materials,REF52900806,1157.5,0.0,246634.59
2024-05-29,2024-05-29,Fuel purchase,REF13374085,420.09,0.0,246214.5
2024-05-30,2024-05-30,Payment from Cooper-Dean,REF52708374,0.0,1005.16,247219.66
2024-05-30,2024-05-30,"Service payment - Leon, Jones and Jackson",REF87374111,0.0,464.45,247684.11
2024-05-30,2024-05-30,Payment from Burns PLC,REF17793824,0.0,1363.6,249047.71
2024-05-30,2024-05-30,"Service payment - Parsons, Diaz and Jackson",REF77538821,0.0,608.56,249656.27
2024-06-02,2024-06-02,Business materials,REF39928096,834.13,0.0,248822.14
2024-06-07,2024-06-07,Permits Licenses expense,REF90811400,138.52,0.0,248683.62
2024-06-08,2024-06-08,Business materials,REF33500243,722.41,0.0,247961.21
2024-06-11,2024-06-11,Vehicle Maintenance expense,REF69167247,217.31,0.0,247743.9
2024-06-12,2024-06-12,Subcontractors expense,REF19972037,1112.48,0.0,246631.42
2024-06-13,2024-06-13,Equipment Rental expense,REF85545896,811.23,0.0,245820.19
2024-06-15,2024-06-15,"Service payment - Parsons, Diaz and Jackson",REF60845362,0.0,671.63,246491.82
2024-06-15,2024-06-15,"Service payment - Leon, Jones and Jackson",REF98020396,0.0,631.71,247123.53
2024-06-15,2024-06-15,Service payment - Cooper-Dean,REF92644957,0.0,1164.15,248287.68
2024-06-15,2024-06-15,Service payment - Burns PLC,REF57347142,0.0,802.66,249090.34
2024-06-15,2024-06-15,Business insurance premium,REF76877082,276.63,0.0,248813.71
2024-06-17,2024-06-17,Fuel purchase,REF43126911,299.47,0.0,248514.24
2024-06-22,2024-06-22,Equipment Rental expense,REF34405552,632.21,0.0,247882.03
2024-06-23,2024-06-23,Business materials,REF93508581,551.4,0.0,247330.63
2024-06-24,2024-06-24,Subcontractors expense,REF84160516,1183.5,0.0,246147.13
2024-06-25,2024-06-25,Business materials,REF60203559,1117.1,0.0,245030.03
2024-06-26,2024-06-26,Business materials,REF13197492,865.27,0.0,244164.76
2024-06-30,2024-06-30,Payment from Burns PLC,REF74230692,0.0,1351.88,245516.64
2024-06-30,2024-06-30,"Payment from Brown, Ray and Torres",REF71250372,0.0,2061.03,247577.67
2024-06-30,2024-06-30,Fuel purchase,REF32860087,157.66,0.0,247420.01
2024-06-30,2024-06-30,"Invoice payment - Leon, Jones and Jackson",REF57788902,0.0,640.76,248060.77
2024-06-30,2024-06-30,Service payment - Cooper-Dean,REF32360061,0.0,969.32,249030.09
2024-06-30,2024-06-30,"Payment from Parsons, Diaz and Jackson",REF55875805,0.0,698.65,249728.74
2024-07-06,2024-07-06,Business materials,REF13038538,911.02,0.0,248817.72
2024-07-09,2024-07-09,Fuel purchase,REF72398387,294.52,0.0,248523.2
2024-07-14,2024-07-14,Fuel purchase,REF66191356,169.21,0.0,248353.99
2024-07-14,2024-07-14,Tools expense,REF72550995,227.17,0.0,248126.82
2024-07-15,2024-07-15,Service payment - Cooper-Dean,REF41423754,0.0,902.81,249029.63
2024-07-15,2024-07-15,"Invoice payment - Parsons, Diaz and Jackson",REF46191605,0.0,744.05,249773.68
2024-07-15,2024-07-15,Payment from Burns PLC,REF59034052,0.0,1003.43,250777.11
2024-07-15,2024-07-15,"Payment from Leon, Jones and Jackson",REF22609328,0.0,471.97,251249.08
2024-07-15,2024-07-15,Business insurance premium,REF80345505,235.5,0.0,251013.58
2024-07-15,2024-07-15,"Project payment - Brown, Ray and Torres",REF67589529,0.0,1534.04,252547.62
2024-07-17,2024-07-17,Business materials,REF21804262,537.84,0.0,252009.78
2024-07-17,2024-07-17,Fuel purchase,REF95788348,418.79,0.0,251590.99
2024-07-18,2024-07-18,Safety Equipment expense,REF25012456,89.34,0.0,251501.65
2024-07-20,2024-07-20,Business materials,REF93825073,749.16,0.0,250752.49
2024-07-21,2024-07-21,Fuel purchase,REF24051763,403.06,0.0,250349.43
2024-07-21,2024-07-21,Business materials,REF51444725,661.46,0.0,249687.97
2024-07-22,2024-07-22,Subcontractors expense,REF72623502,1165.39,0.0,248522.58
2024-07-27,2024-07-27,Subcontractors expense,REF76953577,1103.32,0.0,247419.26
2024-07-30,2024-07-30,Project payment - Cooper-Dean,REF12467402,0.0,943.84,248363.1
2024-07-30,2024-07-30,"Invoice payment - Brown, Ray and Torres",REF99260324,0.0,2139.75,250502.85
2024-07-30,2024-07-30,"Invoice payment - Leon, Jones and Jackson",REF99096370,0.0,362.27,250865.12
2024-07-30,2024-07-30,"Invoice payment - Parsons, Diaz and Jackson",REF11504077,0.0,619.7,251484.82
2024-08-04,2024-08-04,Fuel purchase,REF42341741,434.82,0.0,251050.0
2024-08-04,2024-08-04,Equipment Rental expense,REF55782904,486.65,0.0,250563.35
2024-08-06,2024-08-06,Safety Equipment expense,REF69304739,81.31,0.0,250482.04
2024-08-06,2024-08-06,Business materials,REF50519664,1078.66,0.0,249403.38
2024-08-08,2024-08-08,Equipment Rental expense,REF85994502,499.25,0.0,248904.13
2024-08-09,2024-08-09,Fuel purchase,REF98936720,389.1,0.0,248515.03
2024-08-10,2024-08-10,Business materials,REF32622526,1054.34,0.0,247460.69
2024-08-13,2024-08-13,Vehicle Maintenance expense,REF94197462,148.45,0.0,247312.24
2024-08-13,2024-08-13,Tools expense,REF83374462,90.89,0.0,247221.35
2024-08-15,2024-08-15,Business insurance premium,REF95945736,238.28,0.0,246983.07
2024-08-15,2024-08-15,"Project payment - Parsons, Diaz and Jackson",REF74523788,0.0,745.77,247728.84
2024-08-15,2024-08-15,Project payment - Cooper-Dean,REF83419007,0.0,889.57,248618.41
2024-08-15,2024-08-15,Service payment - Burns PLC,REF56959450,0.0,1034.32,249652.73
2024-08-15,2024-08-15,"Project payment - Leon, Jones and Jackson",REF85593456,0.0,312.54,249965.27
2024-08-15,2024-08-15,"Service payment - Brown, Ray and Torres",REF93608430,0.0,1858.77,251824.04
2024-08-16,2024-08-16,Fuel purchase,REF66743464,232.57,0.0,251591.47
2024-08-17,2024-08-17,Fuel purchase,REF43506077,326.51,0.0,251264.96
2016-08-19,2016-08-19,Fuel purchase,REF58895424,352.22,0.0,4592.74
2016-08-20,2016-08-20,Fuel purchase,REF20401139,434.75,0.0,4157.99
2016-08-21,2016-08-21,Tools expense,REF24543575,79.0,0.0,4078.99
2016-08-23,2016-08-23,Fuel purchase,REF91058674,201.4,0.0,3877.59
2016-08-24,2016-08-24,Safety Equipment expense,REF95087261,101.05,0.0,3776.54
2016-08-30,2016-08-30,Invoice payment - Lowe-James,REF21036610,0.0,851.58,4628.12
2016-08-30,2016-08-30,"Service payment - Harris, Haney and Lewis",REF17149237,0.0,1505.76,6133.88
2016-08-30,2016-08-30,Project payment - Jimenez-Singh,REF71670837,0.0,946.51,7080.39
2016-08-30,2016-08-30,Invoice payment - Hughes LLC,REF50074257,0.0,1932.8,9013.19
2016-08-30,2016-08-30,"Service payment - Jackson, Madden and Fernandez",REF51321655,0.0,1322.37,10335.56
2016-09-01,2016-09-01,Fuel purchase,REF60936958,305.1,0.0,10030.46
2016-09-02,2016-09-02,Fuel purchase,REF73163107,205.1,0.0,9825.36
2016-09-04,2016-09-04,Fuel purchase,REF53084960,274.87,0.0,9550.49
2016-09-05,2016-09-05,Safety Equipment expense,REF82939521,92.9,0.0,9457.59
2016-09-10,2016-09-10,Tools expense,REF51609995,39.43,0.0,9418.16
2016-09-15,2016-09-15,Business insurance premium,REF38271338,237.72,0.0,9180.44
2016-09-15,2016-09-15,Invoice payment - Jimenez-Singh,REF20988961,0.0,746.8,9927.24
2016-09-15,2016-09-15,"Project payment - Harris, Haney and Lewis",REF67876905,0.0,896.98,10824.22
2016-09-15,2016-09-15,Service payment - Hughes LLC,REF12293015,0.0,2093.57,12917.79
2016-09-15,2016-09-15,Project payment - Lowe-James,REF71542380,0.0,1014.2,13931.99
2016-09-15,2016-09-15,"Service payment - Jackson, Madden and Fernandez",REF89022469,0.0,1337.77,15269.76
2016-09-17,2016-09-17,Vehicle Maintenance expense,REF51209256,179.82,0.0,15089.94
2016-09-17,2016-09-17,Business materials,REF94760082,733.08,0.0,14356.86
2016-09-19,2016-09-19,Business materials,REF39552593,632.86,0.0,13724.0
2016-09-19,2016-09-19,Subcontractors expense,REF47616813,1155.62,0.0,12568.38
2016-09-21,2016-09-21,Business materials,REF31408828,585.82,0.0,11982.56
2016-09-22,2016-09-22,Subcontractors expense,REF88935483,1534.75,0.0,10447.81
2016-09-23,2016-09-23,Business materials,REF10731869,851.78,0.0,9596.03
2016-09-23,2016-09-23,Equipment Rental expense,REF85886240,390.03,0.0,9206.0
2016-09-25,2016-09-25,Fuel purchase,REF38201071,524.41,0.0,8681.59
2016-09-26,2016-09-26,Equipment Rental expense,REF85365530,512.38,0.0,8169.21
2016-09-30,2016-09-30,Invoice payment - Jimenez-Singh,REF21399148,0.0,585.28,8754.49
2016-09-30,2016-09-30,Business materials,REF33506004,702.28,0.0,8052.21
2016-09-30,2016-09-30,Invoice payment - Hughes LLC,REF27336957,0.0,1989.41,10041.62
2016-10-01,2016-10-01,Tools expense,REF35879729,116.7,0.0,9924.92
2016-10-02,2016-10-02,Permits Licenses expense,REF36605901,76.04,0.0,9848.88
2016-10-02,2016-10-02,Fuel purchase,REF44478768,192.68,0.0,9656.2
2016-10-03,2016-10-03,Business materials,REF84341927,1109.75,0.0,8546.45
2016-10-03,2016-10-03,Fuel purchase,REF20066360,222.57,0.0,8323.88
2016-10-10,2016-10-10,Safety Equipment expense,REF56178488,63.01,0.0,8260.87
2016-10-11,2016-10-11,Fuel purchase,REF63213406,424.24,0.0,7836.63
2016-10-14,2016-10-14,Business materials,REF33599644,1308.6,0.0,6528.03
2016-10-15,2016-10-15,Equipment Rental expense,REF24424831,426.43,0.0,6101.6
2016-10-15,2016-10-15,"Project payment - Jackson, Madden and Fernandez",REF72654424,0.0,1139.7,7241.3
2016-10-15,2016-10-15,Payment from Hughes LLC,REF22926857,0.0,2385.76,9627.06
2016-10-15,2016-10-15,Payment from Lowe-James,REF19294416,0.0,692.95,10320.01
2016-10-15,2016-10-15,Service payment - Jimenez-Singh,REF14091451,0.0,713.76,11033.77
2016-10-15,2016-10-15,"Project payment - Harris, Haney and Lewis",REF65541704,0.0,995.19,12028.96
2016-10-15,2016-10-15,Business insurance premium,REF10818122,217.87,0.0,11811.09
2016-10-15,2016-10-15,Business materials,REF83406992,1009.76,0.0,10801.33
2016-10-16,2016-10-16,Vehicle Maintenance expense,REF51485224,122.06,0.0,10679.27
2016-10-20,2016-10-20,Subcontractors expense,REF67576302,1121.74,0.0,9557.53
2016-10-24,2016-10-24,Permits Licenses expense,REF12031081,127.55,0.0,9429.98
2016-10-25,2016-10-25,Subcontractors expense,REF72781931,712.98,0.0,8717.0
2016-10-27,2016-10-27,Vehicle Maintenance expense,REF85898514,183.39,0.0,8533.61
2016-10-27,2016-10-27,Business materials,REF74984496,1269.88,0.0,7263.73
2016-10-29,2016-10-29,Fuel purchase,REF63971554,218.65,0.0,7045.08
2016-10-30,2016-10-30,"Project payment - Jackson, Madden and Fernandez",REF23314472,0.0,1116.73,8161.81
2016-10-30,2016-10-30,Invoice payment - Jimenez-Singh,REF33400367,0.0,656.25,8818.06
2016-10-30,2016-10-30,"Payment from Harris, Haney and Lewis",REF95976154,0.0,891.29,9709.35
2016-10-30,2016-10-30,Payment from Lowe-James,REF11329244,0.0,727.57,10436.92
2016-10-30,2016-10-30,Payment from Hughes LLC,REF60537860,0.0,2272.84,12709.76
2016-11-06,2016-11-06,Business materials,REF63138826,717.02,0.0,11992.74
2016-11-08,2016-11-08,Fuel purchase,REF56382408,85.53,0.0,11907.21
2016-11-10,2016-11-10,Permits Licenses expense,REF33203048,82.89,0.0,11824.32
2016-11-11,2016-11-11,Fuel purchase,REF61312391,98.13,0.0,11726.19
2016-11-11,2016-11-11,Vehicle Maintenance expense,REF64938429,83.46,0.0,11642.73
2016-11-13,2016-11-13,Safety Equipment expense,REF51944655,54.44,0.0,11588.29
2016-11-13,2016-11-13,Business materials,REF89268305,557.38,0.0,11030.91
2016-11-15,2016-11-15,Payment from Lowe-James,REF87793239,0.0,585.47,11616.38
2016-11-15,2016-11-15,"Project payment - Jackson, Madden and Fernandez",REF84103889,0.0,899.94,12516.32
2016-11-15,2016-11-15,"Service payment - Harris, Haney and Lewis",REF51618837,0.0,814.27,13330.59
2016-11-15,2016-11-15,Business insurance premium,REF19336218,157.19,0.0,13173.4
2016-11-15,2016-11-15,Service payment - Hughes LLC,REF62883715,0.0,1084.71,14258.11
2016-11-16,2016-11-16,Permits Licenses expense,REF76948200,53.34,0.0,14204.77
2016-11-17,2016-11-17,Tools expense,REF88322175,85.37,0.0,14119.4
2016-11-18,2016-11-18,Permits Licenses expense,REF88901238,55.69,0.0,14063.71
2016-11-21,2016-11-21,Fuel purchase,REF90367301,260.66,0.0,13803.05
2016-11-22,2016-11-22,Vehicle Maintenance expense,REF76204781,83.37,0.0,13719.68
2016-11-24,2016-11-24,Fuel purchase,REF82302609,191.49,0.0,13528.19
2016-11-25,2016-11-25,Tools expense,REF30106838,82.38,0.0,13445.81
2016-11-28,2016-11-28,Business materials,REF41155576,607.48,0.0,12838.33
2016-11-30,2016-11-30,Payment from Jimenez-Singh,REF88500625,0.0,442.93,13281.26
2016-11-30,2016-11-30,"Service payment - Harris, Haney and Lewis",REF45749400,0.0,970.19,14251.45
2016-11-30,2016-11-30,Service payment - Hughes LLC,REF93962803,0.0,1307.5,15558.95
2016-11-30,2016-11-30,Service payment - Lowe-James,REF22548014,0.0,569.4,16128.35
2016-12-02,2016-12-02,Fuel purchase,REF66293635,243.62,0.0,15884.73
2016-12-05,2016-12-05,Business materials,REF37147250,462.93,0.0,15421.8
2016-12-06,2016-12-06,Fuel purchase,REF74108624,72.89,0.0,15348.91
2016-12-09,2016-12-09,Fuel purchase,REF46022457,194.92,0.0,15153.99
2016-12-11,2016-12-11,Business materials,REF12700653,254.11,0.0,14899.88
2016-12-12,2016-12-12,Business materials,REF95846773,516.22,0.0,14383.66
2016-12-13,2016-12-13,Business materials,REF18660076,569.85,0.0,13813.81
2016-12-14,2016-12-14,Subcontractors expense,REF89137574,625.12,0.0,13188.69
2016-12-15,2016-12-15,"Service payment - Jackson, Madden and Fernandez",REF86329749,0.0,720.13,13908.82
2016-12-15,2016-12-15,Fuel purchase,REF42247664,243.75,0.0,13665.07
2016-12-15,2016-12-15,"Invoice payment - Harris, Haney and Lewis",REF31831130,0.0,580.38,14245.45
2016-12-15,2016-12-15,Service payment - Hughes LLC,REF46179306,0.0,1291.69,15537.14
2016-12-15,2016-12-15,Business insurance premium,REF98516695,118.52,0.0,15418.62
2016-12-15,2016-12-15,Invoice payment - Lowe-James,REF70336839,0.0,415.97,15834.59
2016-12-15,2016-12-15,Project payment - Jimenez-Singh,REF58568043,0.0,422.16,16256.75
2016-12-16,2016-12-16,Safety Equipment expense,REF39265076,47.07,0.0,16209.68
2016-12-18,2016-12-18,Fuel purchase,REF70235872,228.63,0.0,15981.05
2016-12-19,2016-12-19,Permits Licenses expense,REF49065883,48.19,0.0,15932.86
2016-12-23,2016-12-23,Fuel purchase,REF25645465,241.11,0.0,15691.75
2016-12-25,2016-12-25,Business materials,REF30899944,520.37,0.0,15171.38
2016-12-30,2016-12-30,Business materials,REF85359177,558.18,0.0,14613.2
2016-12-30,2016-12-30,Payment from Hughes LLC,REF38717170,0.0,1463.1,16076.3
2016-12-30,2016-12-30,"Invoice payment - Harris, Haney and Lewis",REF14353376,0.0,656.51,16732.81
2016-12-30,2016-12-30,Project payment - Lowe-James,REF32953704,0.0,589.91,17322.72
2016-12-30,2016-12-30,"Payment from Jackson, Madden and Fernandez",REF33741585,0.0,611.71,17934.43
2016-12-30,2016-12-30,Project payment - Jimenez-Singh,REF69725690,0.0,309.66,18244.09
2016-12-31,2016-12-31,Fuel purchase,REF30788786,118.07,0.0,18126.02
2017-01-01,2017-01-01,Business materials,REF67281353,869.81,0.0,17256.21
2017-01-02,2017-01-02,Fuel purchase,REF11370106,219.52,0.0,17036.69
2017-01-02,2017-01-02,Equipment Rental expense,REF19873457,239.96,0.0,16796.73
2017-01-03,2017-01-03,Business materials,REF65875210,589.9,0.0,16206.83
2017-01-09,2017-01-09,Equipment Rental expense,REF43491333,361.82,0.0,15845.01
2017-01-09,2017-01-09,Fuel purchase,REF24532804,193.25,0.0,15651.76
2017-01-11,2017-01-11,Vehicle Maintenance expense,REF23668036,37.27,0.0,15614.49
2017-01-15,2017-01-15,Subcontractors expense,REF25417846,1045.39,0.0,14569.1
2017-01-15,2017-01-15,Invoice payment - Lowe-James,REF15260033,0.0,328.3,14897.4
2017-01-15,2017-01-15,Business insurance premium,REF69666697,141.83,0.0,14755.57
2017-01-15,2017-01-15,Project payment - Hughes LLC,REF48410435,0.0,1294.32,16049.89
2017-01-15,2017-01-15,"Project payment - Harris, Haney and Lewis",REF59825741,0.0,674.2,16724.09
2017-01-15,2017-01-15,"Service payment - Jackson, Madden and Fernandez",REF42198465,0.0,894.76,17618.85
2017-01-16,2017-01-16,Vehicle Maintenance expense,REF10912460,122.45,0.0,17496.4
2017-01-18,2017-01-18,Fuel purchase,REF80907037,203.85,0.0,17292.55
2017-01-18,2017-01-18,Permits Licenses expense,REF77757780,93.47,0.0,17199.08
2017-01-22,2017-01-22,Business materials,REF20169591,509.38,0.0,16689.7
2017-01-27,2017-01-27,Tools expense,REF35061422,66.05,0.0,16623.65
2017-01-28,2017-01-28,Safety Equipment expense,REF75530787,56.19,0.0,16567.46
2017-01-30,2017-01-30,"Invoice payment - Harris, Haney and Lewis",REF85328069,0.0,761.42,17328.88
2017-01-30,2017-01-30,Service payment - Lowe-James,REF46129630,0.0,521.25,17850.13
2017-01-30,2017-01-30,"Invoice payment - Jackson, Madden and Fernandez",REF38867127,0.0,855.34,18705.47
2017-01-30,2017-01-30,Service payment - Hughes LLC,REF94651173,0.0,1471.66,20177.13
2017-01-30,2017-01-30,Project payment - Jimenez-Singh,REF65490278,0.0,505.94,20683.07
2017-01-31,2017-01-31,Vehicle Maintenance expense,REF95182537,87.52,0.0,20595.55
2017-02-04,2017-02-04,Business materials,REF30946201,628.58,0.0,19966.97
2017-02-06,2017-02-06,Business materials,REF52424259,219.01,0.0,19747.96
2017-02-06,2017-02-06,Vehicle Maintenance expense,REF92737909,23.07,0.0,19724.89
2017-02-06,2017-02-06,Fuel purchase,REF90490504,157.68,0.0,19567.21
2017-02-11,2017-02-11,Safety Equipment expense,REF17039671,62.14,0.0,19505.07
2017-02-13,2017-02-13,Subcontractors expense,REF49865114,1262.06,0.0,18243.01
2017-02-15,2017-02-15,Payment from Jimenez-Singh,REF75934877,0.0,527.67,18770.68
2017-02-15,2017-02-15,Service payment - Lowe-James,REF81927502,0.0,595.3,19365.98
2017-02-15,2017-02-15,Business insurance premium,REF16993830,157.62,0.0,19208.36
2017-02-15,2017-02-15,Invoice payment - Hughes LLC,REF35129912,0.0,1617.55,20825.91
2017-02-15,2017-02-15,"Invoice payment - Harris, Haney and Lewis",REF29868297,0.0,806.85,21632.76
2017-02-15,2017-02-15,"Project payment - Jackson, Madden and Fernandez",REF73519259,0.0,798.2,22430.96
2017-02-16,2017-02-16,Equipment Rental expense,REF57777895,185.5,0.0,22245.46
2017-02-16,2017-02-16,Business materials,REF21824653,677.8,0.0,21567.66
2017-02-19,2017-02-19,Vehicle Maintenance expense,REF58802397,45.77,0.0,21521.89
2017-02-26,2017-02-26,Tools expense,REF72105865,125.15,0.0,21396.74
2017-02-27,2017-02-27,Tools expense,REF41042249,57.28,0.0,21339.46
2017-02-28,2017-02-28,Invoice payment - Jimenez-Singh,REF95693923,0.0,580.27,21919.73
2017-02-28,2017-02-28,"Invoice payment - Jackson, Madden and Fernandez",REF28781319,0.0,719.98,22639.71
2017-02-28,2017-02-28,Service payment - Hughes LLC,REF62668751,0.0,2090.53,24730.24
2017-02-28,2017-02-28,Project payment - Lowe-James,REF35585538,0.0,632.47,25362.71
2017-02-28,2017-02-28,"Service payment - Harris, Haney and Lewis",REF77807096,0.0,903.38,26266.09
2017-02-28,2017-02-28,Tools expense,REF80609794,99.57,0.0,26166.52
2017-03-09,2017-03-09,Vehicle Maintenance expense,REF98828069,107.56,0.0,26058.96
2017-03-11,2017-03-11,Subcontractors expense,REF69205456,588.84,0.0,25470.12
2017-03-14,2017-03-14,Vehicle Maintenance expense,REF26192700,208.25,0.0,25261.87
2017-03-15,2017-03-15,Business insurance premium,REF60556476,203.9,0.0,25057.97
2017-03-15,2017-03-15,Project payment - Hughes LLC,REF22950285,0.0,2041.7,27099.67
2017-03-15,2017-03-15,"Service payment - Harris, Haney and Lewis",REF56411641,0.0,841.14,27940.81
2017-03-15,2017-03-15,"Invoice payment - Jackson, Madden and Fernandez",REF84619299,0.0,1018.51,28959.32
2017-03-15,2017-03-15,Invoice payment - Jimenez-Singh,REF52582164,0.0,576.47,29535.79
2017-03-15,2017-03-15,Payment from Lowe-James,REF50534121,0.0,853.27,30389.06
2017-03-17,2017-03-17,Vehicle Maintenance expense,REF24504071,208.81,0.0,30180.25
2017-03-18,2017-03-18,Fuel purchase,REF30809258,329.31,0.0,29850.94
2017-03-23,2017-03-23,Business materials,REF57083208,653.64,0.0,29197.3
2017-03-25,2017-03-25,Fuel purchase,REF93662157,369.2,0.0,28828.1
2017-03-25,2017-03-25,Tools expense,REF82397036,78.19,0.0,28749.91
2017-03-26,2017-03-26,Equipment Rental expense,REF72466447,412.07,0.0,28337.84
2017-03-29,2017-03-29,Safety Equipment expense,REF72408599,88.06,0.0,28249.78
2017-03-30,2017-03-30,Service payment - Jimenez-Singh,REF88717939,0.0,546.42,28796.2
2017-03-30,2017-03-30,"Project payment - Harris, Haney and Lewis",REF71432643,0.0,1252.92,30049.12
2017-03-30,2017-03-30,"Payment from Jackson, Madden and Fernandez",REF26343371,0.0,1387.83,31436.95
2017-03-30,2017-03-30,Project payment - Lowe-James,REF95716616,0.0,880.15,32317.1
2017-03-30,2017-03-30,Project payment - Hughes LLC,REF91443420,0.0,1789.75,34106.85
2017-04-01,2017-04-01,Fuel purchase,REF84105798,386.07,0.0,33720.78
2017-04-01,2017-04-01,Tools expense,REF75760270,146.27,0.0,33574.51
2017-04-02,2017-04-02,Subcontractors expense,REF30047998,741.13,0.0,32833.38
2017-04-13,2017-04-13,Safety Equipment expense,REF72393469,102.39,0.0,32730.99
2017-04-13,2017-04-13,Business materials,REF13196888,1078.3,0.0,31652.69
2017-04-14,2017-04-14,Safety Equipment expense,REF81903000,51.85,0.0,31600.84
2017-04-15,2017-04-15,Invoice payment - Hughes LLC,REF79806292,0.0,2751.43,34352.27
2017-04-15,2017-04-15,Payment from Lowe-James,REF64477987,0.0,808.86,35161.13
2017-04-15,2017-04-15,"Invoice payment - Jackson, Madden and Fernandez",REF46848425,0.0,1049.66,36210.79
2017-04-15,2017-04-15,"Payment from Harris, Haney and Lewis",REF35938885,0.0,1395.83,37606.62
2017-04-15,2017-04-15,Business insurance premium,REF55068429,234.55,0.0,37372.07
2017-04-17,2017-04-17,Subcontractors expense,REF62767576,1327.2,0.0,36044.87
2017-04-17,2017-04-17,Fuel purchase,REF68213232,556.88,0.0,35487.99
2017-04-17,2017-04-17,Business materials,REF12033415,539.39,0.0,34948.6
2017-04-18,2017-04-18,Safety Equipment expense,REF85756630,111.97,0.0,34836.63
2017-04-22,2017-04-22,Fuel purchase,REF69706848,195.61,0.0,34641.02
2017-04-24,2017-04-24,Permits Licenses expense,REF44853614,70.94,0.0,34570.08
2017-04-25,2017-04-25,Business materials,REF14646451,541.46,0.0,34028.62
2017-04-26,2017-04-26,Subcontractors expense,REF10706006,687.21,0.0,33341.41
2017-04-27,2017-04-27,Fuel purchase,REF39279733,133.3,0.0,33208.11
2017-04-30,2017-04-30,Payment from Hughes LLC,REF67587373,0.0,2427.68,35635.79
2017-04-30,2017-04-30,Payment from Lowe-James,REF45993314,0.0,922.87,36558.66
2017-04-30,2017-04-30,"Payment from Jackson, Madden and Fernandez",REF58649467,0.0,1234.8,37793.46
2017-04-30,2017-04-30,Vehicle Maintenance expense,REF18246461,248.59,0.0,37544.87
2017-04-30,2017-04-30,Project payment - Jimenez-Singh,REF53708310,0.0,772.09,38316.96
2017-04-30,2017-04-30,Business materials,REF38354574,710.46,0.0,37606.5
2017-04-30,2017-04-30,"Payment from Harris, Haney and Lewis",REF26932799,0.0,1153.55,38760.05
2017-05-01,2017-05-01,Subcontractors expense,REF89157553,1756.37,0.0,37003.68
2017-05-02,2017-05-02,Fuel purchase,REF25414136,307.03,0.0,36696.65
2017-05-05,2017-05-05,Fuel purchase,REF49059874,496.24,0.0,36200.41
2017-05-07,2017-05-07,Fuel purchase,REF95967830,368.8,0.0,35831.61
2017-05-08,2017-05-08,Vehicle Maintenance expense,REF12195114,53.24,0.0,35778.37
2017-05-09,2017-05-09,Fuel purchase,REF93663129,303.05,0.0,35475.32
2017-05-12,2017-05-12,Tools expense,REF95317048,170.91,0.0,35304.41
2017-05-12,2017-05-12,Permits Licenses expense,REF15982851,157.7,0.0,35146.71
2017-05-13,2017-05-13,Equipment Rental expense,REF34444398,792.91,0.0,34353.8
2017-05-15,2017-05-15,"Service payment - Harris, Haney and Lewis",REF14737707,0.0,1031.69,35385.49
2017-05-15,2017-05-15,Service payment - Hughes LLC,REF10978256,0.0,2371.69,37757.18
2017-05-15,2017-05-15,Service payment - Lowe-James,REF95940175,0.0,819.19,38576.37
2017-05-15,2017-05-15,Business insurance premium,REF99477407,263.37,0.0,38313.0
2017-05-15,2017-05-15,Payment from Jimenez-Singh,REF82690836,0.0,894.67,39207.67
2017-05-15,2017-05-15,Tools expense,REF81360980,132.0,0.0,39075.67
2017-05-15,2017-05-15,"Invoice payment - Jackson, Madden and Fernandez",REF66327129,0.0,1219.17,40294.84
2017-05-20,2017-05-20,Vehicle Maintenance expense,REF76991601,247.21,0.0,40047.63
2017-05-23,2017-05-23,Equipment Rental expense,REF20182702,595.72,0.0,39451.91
2017-05-28,2017-05-28,Fuel purchase,REF88514866,143.11,0.0,39308.8
2017-05-30,2017-05-30,"Project payment - Harris, Haney and Lewis",REF89796947,0.0,1281.79,40590.59
2017-05-30,2017-05-30,Invoice payment - Jimenez-Singh,REF65998909,0.0,860.37,41450.96
2017-05-30,2017-05-30,Subcontractors expense,REF69066038,1445.8,0.0,40005.16
2017-05-30,2017-05-30,Payment from Hughes LLC,REF80813396,0.0,2905.04,42910.2
2017-05-30,2017-05-30,"Invoice payment - Jackson, Madden and Fernandez",REF48889435,0.0,1193.37,44103.57
2017-05-30,2017-05-30,Payment from Lowe-James,REF95341703,0.0,1008.91,45112.48
2017-05-31,2017-05-31,Business materials,REF99746316,1337.84,0.0,43774.64
2017-05-31,2017-05-31,Safety Equipment expense,REF45516983,156.12,0.0,43618.52
2017-06-01,2017-06-01,Safety Equipment expense,REF27065615,59.08,0.0,43559.44
2017-06-06,2017-06-06,Equipment Rental expense,REF25831007,638.65,0.0,42920.79
2017-06-07,2017-06-07,Vehicle Maintenance expense,REF52829848,201.18,0.0,42719.61
2017-06-10,2017-06-10,Tools expense,REF50349329,113.65,0.0,42605.96
2017-06-11,2017-06-11,Fuel purchase,REF46068407,473.96,0.0,42132.0
2017-06-11,2017-06-11,Vehicle Maintenance expense,REF39452180,206.76,0.0,41925.24
2017-06-12,2017-06-12,Fuel purchase,REF74724413,404.0,0.0,41521.24
2017-06-12,2017-06-12,Permits Licenses expense,REF20204836,32.91,0.0,41488.33
2017-06-13,2017-06-13,Fuel purchase,REF40881433,417.32,0.0,41071.01
2017-06-14,2017-06-14,Safety Equipment expense,REF36744308,98.46,0.0,40972.55
2017-06-15,2017-06-15,Service payment - Jimenez-Singh,REF80313301,0.0,948.43,41920.98
2017-06-15,2017-06-15,Invoice payment - Lowe-James,REF37518679,0.0,975.69,42896.67
2017-06-15,2017-06-15,Business insurance premium,REF10267629,279.89,0.0,42616.78
2017-06-15,2017-06-15,"Project payment - Harris, Haney and Lewis",REF47997048,0.0,1310.85,43927.63
2017-06-15,2017-06-15,"Service payment - Jackson, Madden and Fernandez",REF92025645,0.0,1460.99,45388.62
2017-06-15,2017-06-15,Invoice payment - Hughes LLC,REF65499579,0.0,2585.39,47974.01
2017-06-17,2017-06-17,Equipment Rental expense,REF50677491,371.14,0.0,47602.87
2017-06-20,2017-06-20,Equipment Rental expense,REF66291084,486.11,0.0,47116.76
2017-06-22,2017-06-22,Tools expense,REF32814988,166.01,0.0,46950.75
2017-06-26,2017-06-26,Vehicle Maintenance expense,REF92810592,330.04,0.0,46620.71
2017-06-28,2017-06-28,Permits Licenses expense,REF56084692,104.68,0.0,46516.03
2017-06-30,2017-06-30,"Project payment - Jackson, Madden and Fernandez",REF64078977,0.0,1467.63,47983.66
2017-06-30,2017-06-30,"Invoice payment - Harris, Haney and Lewis",REF91938577,0.0,1210.41,49194.07
2017-06-30,2017-06-30,Project payment - Lowe-James,REF27838453,0.0,927.35,50121.42
2017-06-30,2017-06-30,Payment from Hughes LLC,REF34271898,0.0,2480.83,52602.25
2017-07-01,2017-07-01,Business materials,REF68735700,1359.93,0.0,51242.32
2017-07-05,2017-07-05,Vehicle Maintenance expense,REF19622385,229.8,0.0,51012.52
2017-07-05,2017-07-05,Business materials,REF90559444,936.3,0.0,50076.22
2017-07-10,2017-07-10,Safety Equipment expense,REF87737197,57.29,0.0,50018.93
2017-07-11,2017-07-11,Business materials,REF68502925,490.87,0.0,49528.06
2017-07-11,2017-07-11,Tools expense,REF96755946,153.51,0.0,49374.55
2017-07-11,2017-07-11,Permits Licenses expense,REF29426352,103.98,0.0,49270.57
2017-07-15,2017-07-15,Business insurance premium,REF89625064,247.7,0.0,49022.87
2017-07-15,2017-07-15,Project payment - Hughes LLC,REF60424890,0.0,2590.09,51612.96
2017-07-15,2017-07-15,"Invoice payment - Harris, Haney and Lewis",REF15340899,0.0,1247.35,52860.31
2017-07-15,2017-07-15,Service payment - Jimenez-Singh,REF78550058,0.0,932.4,53792.71
2017-07-15,2017-07-15,"Payment from Jackson, Madden and Fernandez",REF57594818,0.0,1034.24,54826.95
2017-07-15,2017-07-15,Invoice payment - Lowe-James,REF26741274,0.0,1057.62,55884.57
2017-07-16,2017-07-16,Equipment Rental expense,REF74345927,321.54,0.0,55563.03
2017-07-18,2017-07-18,Business materials,REF23797752,1526.26,0.0,54036.77
2017-07-18,2017-07-18,Fuel purchase,REF11666172,202.7,0.0,53834.07
2017-07-19,2017-07-19,Fuel purchase,REF98806231,327.88,0.0,53506.19
2017-07-24,2017-07-24,Business materials,REF70638619,975.43,0.0,52530.76
2017-07-25,2017-07-25,Fuel purchase,REF87283001,300.83,0.0,52229.93
2017-07-27,2017-07-27,Permits Licenses expense,REF69634772,104.73,0.0,52125.2
2017-07-27,2017-07-27,Fuel purchase,REF54546242,611.9,0.0,51513.3
2017-07-29,2017-07-29,Equipment Rental expense,REF46391305,603.38,0.0,50909.92
2017-07-30,2017-07-30,Subcontractors expense,REF40896049,1406.07,0.0,49503.85
2017-07-30,2017-07-30,"Invoice payment - Harris, Haney and Lewis",REF44562567,0.0,1246.34,50750.19
2017-07-30,2017-07-30,Equipment Rental expense,REF88289956,324.43,0.0,50425.76
2017-07-30,2017-07-30,Service payment - Lowe-James,REF48219912,0.0,860.06,51285.82
2017-07-30,2017-07-30,Service payment - Hughes LLC,REF23436031,0.0,1407.77,52693.59
2017-07-30,2017-07-30,Project payment - Jimenez-Singh,REF27811852,0.0,865.41,53559.0
2017-07-30,2017-07-30,"Invoice payment - Jackson, Madden and Fernandez",REF92610376,0.0,1056.55,54615.55
2017-08-01,2017-08-01,Fuel purchase,REF48143210,418.77,0.0,54196.78
2017-08-02,2017-08-02,Business materials,REF20453618,778.4,0.0,53418.38
2017-08-04,2017-08-04,Subcontractors expense,REF55371475,345.95,0.0,53072.43
2017-08-06,2017-08-06,Subcontractors expense,REF50458206,1235.37,0.0,51837.06
2017-08-09,2017-08-09,Equipment Rental expense,REF43710209,520.09,0.0,51316.97
2017-08-10,2017-08-10,Tools expense,REF95467008,111.48,0.0,51205.49
2017-08-13,2017-08-13,Business materials,REF83054942,1648.95,0.0,49556.54
2017-08-15,2017-08-15,Business insurance premium,REF56600482,226.29,0.0,49330.25
2017-08-15,2017-08-15,Invoice payment - Lowe-James,REF14970639,0.0,751.35,50081.6
2017-08-15,2017-08-15,"Payment from Harris, Haney and Lewis",REF78801860,0.0,1282.64,51364.24
2017-08-15,2017-08-15,"Payment from Jackson, Madden and Fernandez",REF18079093,0.0,1432.28,52796.52
2017-08-15,2017-08-15,Project payment - Hughes LLC,REF75654873,0.0,2429.44,55225.96
2017-08-15,2017-08-15,Service payment - Jimenez-Singh,REF12755501,0.0,906.51,56132.47
2017-08-16,2017-08-16,Business materials,REF35656286,962.63,0.0,55169.84
2017-08-23,2017-08-23,Business materials,REF62147707,815.91,0.0,54353.93
2017-08-25,2017-08-25,Permits Licenses expense,REF99953395,97.41,0.0,54256.52
2017-08-25,2017-08-25,Business materials,REF14405267,1278.66,0.0,52977.86
2017-08-26,2017-08-26,Safety Equipment expense,REF82230683,92.11,0.0,52885.75
2017-08-30,2017-08-30,Invoice payment - Hughes LLC,REF43566341,0.0,2578.79,55464.54
2017-08-30,2017-08-30,"Service payment - Jackson, Madden and Fernandez",REF47045202,0.0,1613.92,57078.46
2017-08-30,2017-08-30,"Service payment - Harris, Haney and Lewis",REF77500836,0.0,1151.87,58230.33
2017-08-30,2017-08-30,Service payment - Jimenez-Singh,REF29593815,0.0,758.11,58988.44
2017-08-30,2017-08-30,Invoice payment - Lowe-James,REF78998123,0.0,930.1,59918.54
2017-08-31,2017-08-31,Fuel purchase,REF29120391,322.92,0.0,59595.62
2017-09-02,2017-09-02,Fuel purchase,REF96403306,420.25,0.0,59175.37
2017-09-12,2017-09-12,Subcontractors expense,REF49060816,1348.55,0.0,57826.82
2017-09-13,2017-09-13,Tools expense,REF26836931,99.98,0.0,57726.84
2017-09-15,2017-09-15,Business materials,REF81623411,814.36,0.0,56912.48
2017-09-15,2017-09-15,Service payment - Hughes LLC,REF94815777,0.0,2374.93,59287.41
2017-09-15,2017-09-15,Business insurance premium,REF75895271,215.74,0.0,59071.67
2017-09-15,2017-09-15,"Project payment - Jackson, Madden and Fernandez",REF20775297,0.0,912.12,59983.79
2017-09-15,2017-09-15,Service payment - Jimenez-Singh,REF28079512,0.0,697.87,60681.66
2017-09-15,2017-09-15,Payment from Lowe-James,REF19868254,0.0,659.1,61340.76
2017-09-17,2017-09-17,Equipment Rental expense,REF45144152,229.62,0.0,61111.14
2017-09-17,2017-09-17,Business materials,REF80230951,938.86,0.0,60172.28
2017-09-19,2017-09-19,Equipment Rental expense,REF40207078,471.14,0.0,59701.14
2017-09-25,2017-09-25,Equipment Rental expense,REF28640081,571.84,0.0,59129.3
2017-09-29,2017-09-29,Subcontractors expense,REF42411172,1055.91,0.0,58073.39
2017-09-30,2017-09-30,Invoice payment - Jimenez-Singh,REF80032440,0.0,715.89,58789.28
2017-09-30,2017-09-30,"Service payment - Jackson, Madden and Fernandez",REF96116384,0.0,1314.95,60104.23
2017-09-30,2017-09-30,Payment from Lowe-James,REF90589585,0.0,1001.44,61105.67
2017-10-01,2017-10-01,Vehicle Maintenance expense,REF10932070,148.66,0.0,60957.01
2017-10-01,2017-10-01,Safety Equipment expense,REF90914742,38.98,0.0,60918.03
2017-10-09,2017-10-09,Fuel purchase,REF53025517,203.89,0.0,60714.14
2017-10-10,2017-10-10,Business materials,REF90524288,731.88,0.0,59982.26
2017-10-10,2017-10-10,Tools expense,REF46012574,38.97,0.0,59943.29
2017-10-12,2017-10-12,Business materials,REF47955302,850.87,0.0,59092.42
2017-10-15,2017-10-15,Business insurance premium,REF56393937,209.24,0.0,58883.18
2017-10-15,2017-10-15,"Project payment - Jackson, Madden and Fernandez",REF40188986,0.0,1282.03,60165.21
2017-10-15,2017-10-15,Payment from Lowe-James,REF46669006,0.0,737.42,60902.63
2017-10-15,2017-10-15,Project payment - Jimenez-Singh,REF54621583,0.0,733.82,61636.45
2017-10-15,2017-10-15,Service payment - Hughes LLC,REF62427556,0.0,2363.09,63999.54
2017-10-15,2017-10-15,"Service payment - Harris, Haney and Lewis",REF57239667,0.0,1249.97,65249.51
2017-10-16,2017-10-16,Business materials,REF91857053,659.02,0.0,64590.49
2017-10-20,2017-10-20,Fuel purchase,REF81269102,217.0,0.0,64373.49
2017-10-25,2017-10-25,Safety Equipment expense,REF51582916,55.37,0.0,64318.12
2017-10-27,2017-10-27,Fuel purchase,REF68591566,370.3,0.0,63947.82
2017-10-30,2017-10-30,Permits Licenses expense,REF97669448,63.1,0.0,63884.72
2017-10-30,2017-10-30,Invoice payment - Lowe-James,REF40354774,0.0,675.21,64559.93
2017-10-30,2017-10-30,"Payment from Jackson, Madden and Fernandez",REF57471794,0.0,1063.13,65623.06
2017-10-30,2017-10-30,Project payment - Hughes LLC,REF43624952,0.0,2387.58,68010.64
2017-10-30,2017-10-30,"Payment from Harris, Haney and Lewis",REF35878211,0.0,1098.35,69108.99
2017-10-30,2017-10-30,Service payment - Jimenez-Singh,REF53502032,0.0,537.88,69646.87
2017-10-30,2017-10-30,Vehicle Maintenance expense,REF51924347,189.95,0.0,69456.92
2017-11-01,2017-11-01,Fuel purchase,REF71336114,308.01,0.0,69148.91
2017-11-05,2017-11-05,Tools expense,REF18799649,58.97,0.0,69089.94
2017-11-05,2017-11-05,Business materials,REF82807141,436.82,0.0,68653.12
2017-11-07,2017-11-07,Vehicle Maintenance expense,REF76931499,91.94,0.0,68561.18
2017-11-09,2017-11-09,Business materials,REF57859514,706.36,0.0,67854.82
2017-11-14,2017-11-14,Equipment Rental expense,REF64278123,196.66,0.0,67658.16
2017-11-15,2017-11-15,Invoice payment - Hughes LLC,REF36007935,0.0,1741.62,69399.78
2017-11-15,2017-11-15,"Project payment - Harris, Haney and Lewis",REF21775361,0.0,846.67,70246.45
2017-11-15,2017-11-15,"Payment from Jackson, Madden and Fernandez",REF93302892,0.0,902.01,71148.46
2017-11-15,2017-11-15,Payment from Jimenez-Singh,REF96766545,0.0,624.33,71772.79
2017-11-15,2017-11-15,Invoice payment - Lowe-James,REF33281537,0.0,666.96,72439.75
2017-11-15,2017-11-15,Business materials,REF74816335,1016.91,0.0,71422.84
2017-11-15,2017-11-15,Business insurance premium,REF11804212,158.89,0.0,71263.95
2017-11-16,2017-11-16,Subcontractors expense,REF71845375,897.44,0.0,70366.51
2017-11-17,2017-11-17,Business materials,REF20920786,542.58,0.0,69823.93
2017-11-18,2017-11-18,Vehicle Maintenance expense,REF48687508,153.13,0.0,69670.8
2017-11-18,2017-11-18,Equipment Rental expense,REF11623976,300.84,0.0,69369.96
2017-11-24,2017-11-24,Subcontractors expense,REF49659722,875.48,0.0,68494.48
2017-11-24,2017-11-24,Business materials,REF28712706,656.45,0.0,67838.03
2017-11-30,2017-11-30,"Invoice payment - Harris, Haney and Lewis",REF30830248,0.0,993.09,68831.12
2017-11-30,2017-11-30,Payment from Hughes LLC,REF80115525,0.0,1490.47,70321.59
2017-11-30,2017-11-30,Invoice payment - Jimenez-Singh,REF13148074,0.0,498.37,70819.96
2017-11-30,2017-11-30,"Project payment - Jackson, Madden and Fernandez",REF41014364,0.0,834.82,71654.78
2017-11-30,2017-11-30,Payment from Lowe-James,REF79587113,0.0,750.89,72405.67
2017-12-04,2017-12-04,Business materials,REF64701509,597.92,0.0,71807.75
2017-12-08,2017-12-08,Fuel purchase,REF51716626,132.98,0.0,71674.77
2017-12-08,2017-12-08,Vehicle Maintenance expense,REF38515576,43.21,0.0,71631.56
2017-12-12,2017-12-12,Subcontractors expense,REF23716866,410.1,0.0,71221.46
2017-12-14,2017-12-14,Equipment Rental expense,REF37178455,252.4,0.0,70969.06
2017-12-15,2017-12-15,Service payment - Hughes LLC,REF16472790,0.0,1246.57,72215.63
2017-12-15,2017-12-15,Business insurance premium,REF21228417,119.78,0.0,72095.85
2017-12-15,2017-12-15,"Payment from Jackson, Madden and Fernandez",REF90925691,0.0,793.4,72889.25
2017-12-15,2017-12-15,"Project payment - Harris, Haney and Lewis",REF76152598,0.0,537.86,73427.11
2017-12-15,2017-12-15,Invoice payment - Lowe-James,REF89066293,0.0,485.75,73912.86
2017-12-15,2017-12-15,Service payment - Jimenez-Singh,REF30595418,0.0,354.32,74267.18
2017-12-20,2017-12-20,Fuel purchase,REF32031049,227.02,0.0,74040.16
2017-12-21,2017-12-21,Business materials,REF46185865,541.38,0.0,73498.78
2017-12-22,2017-12-22,Business materials,REF56098484,522.22,0.0,72976.56
2017-12-28,2017-12-28,Safety Equipment expense,REF53360941,39.52,0.0,72937.04
2017-12-30,2017-12-30,Tools expense,REF73124167,87.32,0.0,72849.72
2017-12-30,2017-12-30,"Project payment - Harris, Haney and Lewis",REF96384789,0.0,617.36,73467.08
2017-12-30,2017-12-30,"Service payment - Jackson, Madden and Fernandez",REF17694598,0.0,834.88,74301.96
2017-12-30,2017-12-30,Project payment - Jimenez-Singh,REF93849616,0.0,385.06,74687.02
2017-12-30,2017-12-30,Payment from Lowe-James,REF20833448,0.0,412.84,75099.86
2018-01-01,2018-01-01,Fuel purchase,REF80840888,279.31,0.0,74820.55
2018-01-02,2018-01-02,Fuel purchase,REF31490812,89.37,0.0,74731.18
2018-01-05,2018-01-05,Subcontractors expense,REF78486360,693.71,0.0,74037.47
2018-01-06,2018-01-06,Business materials,REF33973770,618.72,0.0,73418.75
2018-01-07,2018-01-07,Fuel purchase,REF76098329,176.1,0.0,73242.65
2018-01-10,2018-01-10,Fuel purchase,REF64623675,221.28,0.0,73021.37
2018-01-15,2018-01-15,Safety Equipment expense,REF68738190,70.69,0.0,72950.68
2018-01-15,2018-01-15,Invoice payment - Jimenez-Singh,REF90193654,0.0,377.46,73328.14
2018-01-15,2018-01-15,Business insurance premium,REF35687538,133.41,0.0,73194.73
2018-01-15,2018-01-15,"Payment from Jackson, Madden and Fernandez",REF42646629,0.0,618.61,73813.34
2018-01-15,2018-01-15,Invoice payment - Lowe-James,REF67523168,0.0,560.75,74374.09
2018-01-15,2018-01-15,"Service payment - Harris, Haney and Lewis",REF44647459,0.0,600.51,74974.6
2018-01-15,2018-01-15,Payment from Hughes LLC,REF32472541,0.0,1312.83,76287.43
2018-01-16,2018-01-16,Tools expense,REF93864267,84.57,0.0,76202.86
2018-01-20,2018-01-20,Fuel purchase,REF29296163,151.59,0.0,76051.27
2018-01-22,2018-01-22,Safety Equipment expense,REF79621046,55.52,0.0,75995.75
2018-01-22,2018-01-22,Business materials,REF19338061,710.82,0.0,75284.93
2018-01-24,2018-01-24,Business materials,REF13977183,488.64,0.0,74796.29
2018-01-24,2018-01-24,Subcontractors expense,REF37333340,897.11,0.0,73899.18
2018-01-25,2018-01-25,Equipment Rental expense,REF91203085,261.61,0.0,73637.57
2018-01-26,2018-01-26,Equipment Rental expense,REF65914145,290.89,0.0,73346.68
2018-01-26,2018-01-26,Vehicle Maintenance expense,REF62104274,146.68,0.0,73200.0
2018-01-28,2018-01-28,Subcontractors expense,REF15297060,462.43,0.0,72737.57
2018-01-30,2018-01-30,"Invoice payment - Harris, Haney and Lewis",REF79689041,0.0,644.97,73382.54
2018-01-30,2018-01-30,"Invoice payment - Jackson, Madden and Fernandez",REF46696758,0.0,881.44,74263.98
2018-01-30,2018-01-30,Service payment - Jimenez-Singh,REF69730933,0.0,479.0,74742.98
2018-01-31,2018-01-31,Subcontractors expense,REF78540932,398.26,0.0,74344.72
2018-02-03,2018-02-03,Business materials,REF66625079,792.28,0.0,73552.44
2018-02-05,2018-02-05,Subcontractors expense,REF15519745,555.38,0.0,72997.06
2018-02-09,2018-02-09,Business materials,REF88995773,873.83,0.0,72123.23
2018-02-09,2018-02-09,Permits Licenses expense,REF92833212,74.57,0.0,72048.66
2018-02-10,2018-02-10,Fuel purchase,REF21251666,154.8,0.0,71893.86
2018-02-10,2018-02-10,Permits Licenses expense,REF68666785,10.87,0.0,71882.99
2018-02-14,2018-02-14,Vehicle Maintenance expense,REF42651593,156.78,0.0,71726.21
2018-02-15,2018-02-15,Business insurance premium,REF96063615,151.98,0.0,71574.23
2018-02-15,2018-02-15,Business materials,REF57206132,495.05,0.0,71079.18
2018-02-15,2018-02-15,"Invoice payment - Harris, Haney and Lewis",REF21033316,0.0,802.99,71882.17
2018-02-15,2018-02-15,Project payment - Jimenez-Singh,REF29167838,0.0,411.24,72293.41
2018-02-15,2018-02-15,"Payment from Jackson, Madden and Fernandez",REF30660032,0.0,1050.78,73344.19
2018-02-15,2018-02-15,Payment from Hughes LLC,REF39474849,0.0,1655.49,74999.68
2018-02-16,2018-02-16,Fuel purchase,REF96637106,268.58,0.0,74731.1
2018-02-17,2018-02-17,Fuel purchase,REF42832621,243.65,0.0,74487.45
2018-02-19,2018-02-19,Business materials,REF87898395,702.48,0.0,73784.97
2018-02-20,2018-02-20,Fuel purchase,REF83588564,186.85,0.0,73598.12
2018-02-25,2018-02-25,Fuel purchase,REF60620983,171.93,0.0,73426.19
2018-02-27,2018-02-27,Tools expense,REF69729897,66.14,0.0,73360.05
2018-02-28,2018-02-28,Project payment - Hughes LLC,REF51613635,0.0,1241.83,74601.88
2018-02-28,2018-02-28,Invoice payment - Jimenez-Singh,REF86400562,0.0,547.36,75149.24
2018-02-28,2018-02-28,Payment from Lowe-James,REF81992561,0.0,513.13,75662.37
2018-02-28,2018-02-28,"Service payment - Harris, Haney and Lewis",REF77512088,0.0,733.92,76396.29
2018-02-28,2018-02-28,"Invoice payment - Jackson, Madden and Fernandez",REF56749356,0.0,935.35,77331.64
2018-03-03,2018-03-03,Vehicle Maintenance expense,REF61250429,122.54,0.0,77209.1
2018-03-06,2018-03-06,Vehicle Maintenance expense,REF39639144,129.56,0.0,77079.54
2018-03-08,2018-03-08,Fuel purchase,REF24535110,117.58,0.0,76961.96
2018-03-09,2018-03-09,Tools expense,REF58481613,65.1,0.0,76896.86
2018-03-10,2018-03-10,Business materials,REF58026432,1029.44,0.0,75867.42
2018-03-10,2018-03-10,Subcontractors expense,REF57750961,472.08,0.0,75395.34
2018-03-14,2018-03-14,Safety Equipment expense,REF72880498,81.12,0.0,75314.22
2018-03-15,2018-03-15,Service payment - Hughes LLC,REF92888748,0.0,1958.1,77272.32
2018-03-15,2018-03-15,Project payment - Lowe-James,REF87562172,0.0,677.99,77950.31
2018-03-15,2018-03-15,Business insurance premium,REF71024720,195.14,0.0,77755.17
2018-03-15,2018-03-15,"Invoice payment - Harris, Haney and Lewis",REF75330300,0.0,1323.26,79078.43
2018-03-15,2018-03-15,"Payment from Jackson, Madden and Fernandez",REF13698421,0.0,1072.57,80151.0
2018-03-15,2018-03-15,Payment from Jimenez-Singh,REF11117653,0.0,634.8,80785.8
2018-03-21,2018-03-21,Equipment Rental expense,REF64560697,435.79,0.0,80350.01
2018-03-27,2018-03-27,Subcontractors expense,REF61412406,957.57,0.0,79392.44
2018-03-29,2018-03-29,Equipment Rental expense,REF20356605,485.73,0.0,78906.71
2018-03-30,2018-03-30,"Invoice payment - Jackson, Madden and Fernandez",REF27640495,0.0,1407.85,80314.56
2018-03-30,2018-03-30,Invoice payment - Lowe-James,REF98718718,0.0,746.29,81060.85
2018-03-30,2018-03-30,Project payment - Jimenez-Singh,REF26551385,0.0,717.62,81778.47
2018-03-30,2018-03-30,"Payment from Harris, Haney and Lewis",REF48836209,0.0,1069.46,82847.93
2018-03-31,2018-03-31,Business materials,REF88951177,1205.74,0.0,81642.19
2018-04-01,2018-04-01,Permits Licenses expense,REF19029217,156.22,0.0,81485.97
2018-04-05,2018-04-05,Vehicle Maintenance expense,REF48833911,198.17,0.0,81287.8
2018-04-08,2018-04-08,Fuel purchase,REF75704559,321.6,0.0,80966.2
2018-04-14,2018-04-14,Subcontractors expense,REF70773869,1092.6,0.0,79873.6
2018-04-15,2018-04-15,Business insurance premium,REF96156213,234.77,0.0,79638.83
2018-04-15,2018-04-15,"Project payment - Jackson, Madden and Fernandez",REF60690051,0.0,1384.84,81023.67
2018-04-15,2018-04-15,"Payment from Harris, Haney and Lewis",REF52167629,0.0,1134.37,82158.04
2018-04-15,2018-04-15,Payment from Lowe-James,REF15332083,0.0,849.98,83008.02
2018-04-15,2018-04-15,Invoice payment - Hughes LLC,REF61173895,0.0,2106.09,85114.11
2018-04-15,2018-04-15,Invoice payment - Jimenez-Singh,REF27038394,0.0,637.51,85751.62
2018-04-16,2018-04-16,Fuel purchase,REF22621202,443.18,0.0,85308.44
2018-04-18,2018-04-18,Business materials,REF69975855,1311.24,0.0,83997.2
2018-04-20,2018-04-20,Business materials,REF78495368,862.88,0.0,83134.32
2018-04-20,2018-04-20,Fuel purchase,REF74295018,464.64,0.0,82669.68
2018-04-21,2018-04-21,Fuel purchase,REF18647954,303.55,0.0,82366.13
2018-04-21,2018-04-21,Business materials,REF55823837,1289.25,0.0,81076.88
2018-04-27,2018-04-27,Fuel purchase,REF98893329,468.23,0.0,80608.65
2018-04-28,2018-04-28,Safety Equipment expense,REF53924059,51.94,0.0,80556.71
2018-04-30,2018-04-30,"Invoice payment - Harris, Haney and Lewis",REF77521219,0.0,944.81,81501.52
2018-04-30,2018-04-30,Project payment - Hughes LLC,REF68393099,0.0,2515.69,84017.21
2018-04-30,2018-04-30,Project payment - Jimenez-Singh,REF30856652,0.0,719.65,84736.86
2018-04-30,2018-04-30,Service payment - Lowe-James,REF27723704,0.0,1050.54,85787.4
2018-04-30,2018-04-30,"Project payment - Jackson, Madden and Fernandez",REF64648071,0.0,1207.29,86994.69
2018-05-02,2018-05-02,Business materials,REF58375570,640.83,0.0,86353.86
2018-05-06,2018-05-06,Business materials,REF34174253,706.03,0.0,85647.83
2018-05-08,2018-05-08,Business materials,REF53816635,1025.99,0.0,84621.84
2018-05-11,2018-05-11,Equipment Rental expense,REF99556712,449.13,0.0,84172.71
2018-05-13,2018-05-13,Business materials,REF98399856,1190.12,0.0,82982.59
2018-05-14,2018-05-14,Equipment Rental expense,REF49282035,515.68,0.0,82466.91
2018-05-14,2018-05-14,Business materials,REF15908227,963.66,0.0,81503.25
2018-05-15,2018-05-15,Business insurance premium,REF59876229,248.69,0.0,81254.56
2018-05-15,2018-05-15,Payment from Lowe-James,REF14938141,0.0,949.97,82204.53
2018-05-15,2018-05-15,"Service payment - Harris, Haney and Lewis",REF45047209,0.0,1197.03,83401.56
2018-05-15,2018-05-15,Business materials,REF90721445,759.59,0.0,82641.97
2018-05-15,2018-05-15,Project payment - Hughes LLC,REF61635396,0.0,2976.23,85618.2
2018-05-16,2018-05-16,Business materials,REF62184600,1130.51,0.0,84487.69
2018-05-18,2018-05-18,Fuel purchase,REF84651186,439.22,0.0,84048.47
2018-05-20,2018-05-20,Safety Equipment expense,REF32885042,60.92,0.0,83987.55
2018-05-25,2018-05-25,Vehicle Maintenance expense,REF11123703,245.53,0.0,83742.02
2018-05-26,2018-05-26,Vehicle Maintenance expense,REF44635894,205.08,0.0,83536.94
2018-05-27,2018-05-27,Tools expense,REF31131056,69.11,0.0,83467.83
2018-05-30,2018-05-30,Service payment - Jimenez-Singh,REF76329523,0.0,592.63,84060.46
2018-05-30,2018-05-30,Payment from Hughes LLC,REF60476086,0.0,2701.11,86761.57
2018-05-30,2018-05-30,Service payment - Lowe-James,REF76669612,0.0,1096.9,87858.47
2018-05-30,2018-05-30,"Service payment - Harris, Haney and Lewis",REF64919512,0.0,1306.74,89165.21
2018-05-30,2018-05-30,"Project payment - Jackson, Madden and Fernandez",REF56788214,0.0,1837.49,91002.7
2018-06-01,2018-06-01,Vehicle Maintenance expense,REF84439625,221.91,0.0,90780.79
2018-06-02,2018-06-02,Business materials,REF96858792,618.28,0.0,90162.51
2018-06-03,2018-06-03,Permits Licenses expense,REF83271686,117.55,0.0,90044.96
2018-06-03,2018-06-03,Fuel purchase,REF36108958,367.94,0.0,89677.02
2018-06-04,2018-06-04,Business materials,REF60695879,785.89,0.0,88891.13
2018-06-07,2018-06-07,Fuel purchase,REF34937587,499.98,0.0,88391.15
2018-06-11,2018-06-11,Safety Equipment expense,REF94554563,72.95,0.0,88318.2
2018-06-15,2018-06-15,"Payment from Jackson, Madden and Fernandez",REF15866144,0.0,1539.29,89857.49
2018-06-15,2018-06-15,Service payment - Jimenez-Singh,REF91179440,0.0,728.83,90586.32
2018-06-15,2018-06-15,Business insurance premium,REF81160111,247.6,0.0,90338.72
2018-06-15,2018-06-15,Project payment - Hughes LLC,REF83981714,0.0,2385.94,92724.66
2018-06-15,2018-06-15,"Payment from Harris, Haney and Lewis",REF98644317,0.0,1681.53,94406.19
2018-06-15,2018-06-15,Invoice payment - Lowe-James,REF25635591,0.0,980.82,95387.01
2018-06-17,2018-06-17,Equipment Rental expense,REF25737134,300.74,0.0,95086.27
2018-06-19,2018-06-19,Equipment Rental expense,REF10116822,564.18,0.0,94522.09
2018-06-19,2018-06-19,Safety Equipment expense,REF64060009,110.13,0.0,94411.96
2018-06-21,2018-06-21,Tools expense,REF64956684,158.1,0.0,94253.86
2018-06-23,2018-06-23,Fuel purchase,REF25426717,270.1,0.0,93983.76
2018-06-23,2018-06-23,Equipment Rental expense,REF57225174,449.48,0.0,93534.28
2018-06-26,2018-06-26,Business materials,REF63256732,1434.71,0.0,92099.57
2018-06-30,2018-06-30,"Service payment - Jackson, Madden and Fernandez",REF80116473,0.0,1589.37,93688.94
2018-06-30,2018-06-30,Payment from Jimenez-Singh,REF63516091,0.0,1081.91,94770.85
2018-07-03,2018-07-03,Business materials,REF37951944,956.73,0.0,93814.12
2018-07-05,2018-07-05,Business materials,REF79349346,916.88,0.0,92897.24
2018-07-09,2018-07-09,Fuel purchase,REF22443937,323.75,0.0,92573.49
2018-07-11,2018-07-11,Fuel purchase,REF12813551,263.21,0.0,92310.28
2018-07-15,2018-07-15,Business insurance premium,REF51862178,249.36,0.0,92060.92
2018-07-15,2018-07-15,Project payment - Jimenez-Singh,REF66094761,0.0,503.91,92564.83
2018-07-15,2018-07-15,"Service payment - Jackson, Madden and Fernandez",REF63465429,0.0,1180.34,93745.17
2018-07-15,2018-07-15,"Project payment - Harris, Haney and Lewis",REF41887758,0.0,1373.49,95118.66
2018-07-15,2018-07-15,Payment from Hughes LLC,REF22059053,0.0,1842.13,96960.79
2018-07-16,2018-07-16,Permits Licenses expense,REF53333356,107.41,0.0,96853.38
2018-07-16,2018-07-16,Fuel purchase,REF34240223,230.35,0.0,96623.03
2018-07-24,2018-07-24,Fuel purchase,REF38725163,170.71,0.0,96452.32
2018-07-25,2018-07-25,Business materials,REF47080482,1010.23,0.0,95442.09
2018-07-26,2018-07-26,Vehicle Maintenance expense,REF71122145,65.87,0.0,95376.22
2018-07-27,2018-07-27,Business materials,REF61659176,1005.7,0.0,94370.52
2018-07-28,2018-07-28,Subcontractors expense,REF52765477,847.66,0.0,93522.86
2018-07-30,2018-07-30,Payment from Lowe-James,REF76702234,0.0,916.36,94439.22
2018-07-30,2018-07-30,Payment from Hughes LLC,REF85283879,0.0,2158.19,96597.41
2018-07-30,2018-07-30,Project payment - Jimenez-Singh,REF53168575,0.0,749.26,97346.67
2018-07-30,2018-07-30,"Service payment - Harris, Haney and Lewis",REF51018103,0.0,1237.78,98584.45
2018-07-30,2018-07-30,"Payment from Jackson, Madden and Fernandez",REF22330861,0.0,1705.89,100290.34
2018-08-05,2018-08-05,Vehicle Maintenance expense,REF36489053,237.1,0.0,100053.24
2018-08-05,2018-08-05,Tools expense,REF11067134,127.76,0.0,99925.48
2018-08-09,2018-08-09,Vehicle Maintenance expense,REF95580683,165.0,0.0,99760.48
2018-08-13,2018-08-13,Equipment Rental expense,REF47651748,534.85,0.0,99225.63
2018-08-13,2018-08-13,Business materials,REF28977784,936.24,0.0,98289.39
2018-08-13,2018-08-13,Tools expense,REF73672431,88.56,0.0,98200.83
2018-08-14,2018-08-14,Tools expense,REF83065168,64.89,0.0,98135.94
2018-08-15,2018-08-15,Invoice payment - Jimenez-Singh,REF91099719,0.0,715.2,98851.14
2018-08-15,2018-08-15,Business insurance premium,REF46472457,247.18,0.0,98603.96
2018-08-15,2018-08-15,Project payment - Hughes LLC,REF81869788,0.0,2604.44,101208.4
2018-08-15,2018-08-15,"Invoice payment - Harris, Haney and Lewis",REF12005411,0.0,1254.36,102462.76
2018-08-15,2018-08-15,"Payment from Jackson, Madden and Fernandez",REF89104314,0.0,1449.45,103912.21
2018-08-15,2018-08-15,Invoice payment - Lowe-James,REF28699599,0.0,791.41,104703.62
2018-08-16,2018-08-16,Business materials,REF54797106,966.19,0.0,103737.43
2018-08-17,2018-08-17,Permits Licenses expense,REF59689558,106.4,0.0,103631.03
2018-08-17,2018-08-17,Fuel purchase,REF85089507,353.68,0.0,103277.35
2018-08-20,2018-08-20,Business materials,REF96610650,1420.89,0.0,101856.46
2018-08-22,2018-08-22,Equipment Rental expense,REF85061366,517.72,0.0,101338.74
2018-08-26,2018-08-26,Permits Licenses expense,REF81084749,81.74,0.0,101257.0
2018-08-27,2018-08-27,Subcontractors expense,REF93476966,2007.89,0.0,99249.11
2018-08-30,2018-08-30,Service payment - Hughes LLC,REF82098350,0.0,2815.63,102064.74
2018-08-30,2018-08-30,"Service payment - Harris, Haney and Lewis",REF94674416,0.0,1364.61,103429.35
2018-08-30,2018-08-30,Service payment - Lowe-James,REF19960280,0.0,550.52,103979.87
2018-08-30,2018-08-30,"Service payment - Jackson, Madden and Fernandez",REF92504877,0.0,1504.14,105484.01
2018-09-03,2018-09-03,Subcontractors expense,REF20764312,1305.8,0.0,104178.21
2018-09-05,2018-09-05,Subcontractors expense,REF43845053,909.82,0.0,103268.39
2018-09-05,2018-09-05,Permits Licenses expense,REF71670348,105.88,0.0,103162.51
2018-09-06,2018-09-06,Business materials,REF38484133,808.94,0.0,102353.57
2018-09-09,2018-09-09,Fuel purchase,REF55768929,349.09,0.0,102004.48
2018-09-09,2018-09-09,Equipment Rental expense,REF14001030,255.46,0.0,101749.02
2018-09-15,2018-09-15,Payment from Jimenez-Singh,REF58137481,0.0,665.85,102414.87
2018-09-15,2018-09-15,Project payment - Hughes LLC,REF15872810,0.0,2166.41,104581.28
2018-09-15,2018-09-15,Project payment - Lowe-James,REF26718625,0.0,602.89,105184.17
2018-09-15,2018-09-15,"Project payment - Jackson, Madden and Fernandez",REF49210612,0.0,1277.26,106461.43
2018-09-15,2018-09-15,"Invoice payment - Harris, Haney and Lewis",REF69699095,0.0,1276.35,107737.78
2018-09-15,2018-09-15,Business insurance premium,REF93079000,224.36,0.0,107513.42
2018-09-16,2018-09-16,Subcontractors expense,REF27773549,1272.12,0.0,106241.3
2018-09-17,2018-09-17,Fuel purchase,REF41988670,421.71,0.0,105819.59
2018-09-18,2018-09-18,Permits Licenses expense,REF23789260,70.98,0.0,105748.61
2018-09-18,2018-09-18,Subcontractors expense,REF30085171,592.87,0.0,105155.74
2018-09-20,2018-09-20,Fuel purchase,REF96085689,381.28,0.0,104774.46
2018-09-26,2018-09-26,Safety Equipment expense,REF29546933,62.91,0.0,104711.55
2018-09-29,2018-09-29,Business materials,REF83680554,975.29,0.0,103736.26
2018-09-30,2018-09-30,Invoice payment - Hughes LLC,REF74120575,0.0,2393.3,106129.56
2018-09-30,2018-09-30,Payment from Lowe-James,REF81473856,0.0,728.2,106857.76
2018-09-30,2018-09-30,"Invoice payment - Harris, Haney and Lewis",REF91422831,0.0,1075.81,107933.57
2018-09-30,2018-09-30,Safety Equipment expense,REF70955629,59.94,0.0,107873.63
2018-10-02,2018-10-02,Equipment Rental expense,REF22579822,321.71,0.0,107551.92
2018-10-05,2018-10-05,Tools expense,REF30214385,127.32,0.0,107424.6
2018-10-12,2018-10-12,Safety Equipment expense,REF20934990,66.36,0.0,107358.24
2018-10-14,2018-10-14,Business materials,REF49578134,1014.22,0.0,106344.02
2018-10-15,2018-10-15,Business insurance premium,REF98322283,194.46,0.0,106149.56
2018-10-15,2018-10-15,Business materials,REF69871923,993.04,0.0,105156.52
2018-10-15,2018-10-15,Project payment - Lowe-James,REF13566944,0.0,737.69,105894.21
2018-10-15,2018-10-15,"Payment from Jackson, Madden and Fernandez",REF62595850,0.0,787.16,106681.37
2018-10-15,2018-10-15,Project payment - Hughes LLC,REF85005479,0.0,1815.14,108496.51
2018-10-15,2018-10-15,Invoice payment - Jimenez-Singh,REF44458544,0.0,716.39,109212.9
2018-10-15,2018-10-15,"Payment from Harris, Haney and Lewis",REF93660238,0.0,1184.64,110397.54
2018-10-16,2018-10-16,Subcontractors expense,REF92761048,1184.35,0.0,109213.19
2018-10-18,2018-10-18,Tools expense,REF10522220,108.59,0.0,109104.6
2018-10-22,2018-10-22,Business materials,REF49439262,242.29,0.0,108862.31
2018-10-28,2018-10-28,Safety Equipment expense,REF32195355,70.29,0.0,108792.02
2018-10-28,2018-10-28,Permits Licenses expense,REF72916730,91.5,0.0,108700.52
2018-10-29,2018-10-29,Subcontractors expense,REF30783368,1084.24,0.0,107616.28
2018-10-30,2018-10-30,Business materials,REF52669413,755.23,0.0,106861.05
2018-10-30,2018-10-30,Fuel purchase,REF99689343,145.25,0.0,106715.8
2018-10-30,2018-10-30,Service payment - Jimenez-Singh,REF86350668,0.0,571.27,107287.07
2018-10-30,2018-10-30,Invoice payment - Hughes LLC,REF63938822,0.0,2011.15,109298.22
2018-10-30,2018-10-30,Project payment - Lowe-James,REF48577543,0.0,811.81,110110.03
2018-10-30,2018-10-30,"Service payment - Harris, Haney and Lewis",REF88660050,0.0,1026.32,111136.35
2018-10-30,2018-10-30,"Project payment - Jackson, Madden and Fernandez",REF14945968,0.0,1623.23,112759.58
2018-11-02,2018-11-02,Business materials,REF48922601,586.68,0.0,112172.9
2018-11-08,2018-11-08,Fuel purchase,REF63201251,263.13,0.0,111909.77
2018-11-10,2018-11-10,Fuel purchase,REF25552855,222.29,0.0,111687.48
2018-11-12,2018-11-12,Vehicle Maintenance expense,REF29766781,87.36,0.0,111600.12
2018-11-15,2018-11-15,Payment from Lowe-James,REF93275959,0.0,568.27,112168.39
2018-11-15,2018-11-15,Payment from Hughes LLC,REF82612510,0.0,1514.85,113683.24
2018-11-15,2018-11-15,Business insurance premium,REF70677036,152.78,0.0,113530.46
2018-11-15,2018-11-15,"Payment from Harris, Haney and Lewis",REF25404856,0.0,899.41,114429.87
2018-11-15,2018-11-15,Service payment - Jimenez-Singh,REF99673984,0.0,471.04,114900.91
2018-11-15,2018-11-15,"Service payment - Jackson, Madden and Fernandez",REF97337135,0.0,977.61,115878.52
2018-11-17,2018-11-17,Business materials,REF52322751,895.2,0.0,114983.32
2018-11-19,2018-11-19,Fuel purchase,REF44448246,182.38,0.0,114800.94
2018-11-20,2018-11-20,Subcontractors expense,REF39700232,716.5,0.0,114084.44
2018-11-22,2018-11-22,Vehicle Maintenance expense,REF76692949,181.02,0.0,113903.42
2018-11-24,2018-11-24,Business materials,REF75727550,468.36,0.0,113435.06
2018-11-24,2018-11-24,Fuel purchase,REF92402723,315.64,0.0,113119.42
2018-11-28,2018-11-28,Permits Licenses expense,REF98750600,65.87,0.0,113053.55
2018-11-29,2018-11-29,Safety Equipment expense,REF62715161,31.46,0.0,113022.09
2018-11-30,2018-11-30,"Service payment - Jackson, Madden and Fernandez",REF99129590,0.0,823.38,113845.47
2018-11-30,2018-11-30,Service payment - Lowe-James,REF14313327,0.0,492.97,114338.44
2018-11-30,2018-11-30,Project payment - Jimenez-Singh,REF38833126,0.0,574.98,114913.42
2018-11-30,2018-11-30,Service payment - Hughes LLC,REF20291779,0.0,1566.47,116479.89
2018-11-30,2018-11-30,"Project payment - Harris, Haney and Lewis",REF26241696,0.0,678.5,117158.39
2018-12-04,2018-12-04,Fuel purchase,REF63416272,161.84,0.0,116996.55
2018-12-04,2018-12-04,Business materials,REF64580732,528.29,0.0,116468.26
2018-12-12,2018-12-12,Fuel purchase,REF43962586,214.54,0.0,116253.72
2018-12-13,2018-12-13,Fuel purchase,REF57518703,168.75,0.0,116084.97
2018-12-15,2018-12-15,"Project payment - Jackson, Madden and Fernandez",REF45217354,0.0,621.02,116705.99
2018-12-15,2018-12-15,Invoice payment - Jimenez-Singh,REF59346330,0.0,402.44,117108.43
2018-12-15,2018-12-15,Business insurance premium,REF92449085,116.08,0.0,116992.35
2018-12-15,2018-12-15,"Service payment - Harris, Haney and Lewis",REF65446478,0.0,729.17,117721.52
2018-12-15,2018-12-15,Project payment - Lowe-James,REF76648262,0.0,541.94,118263.46
2018-12-15,2018-12-15,Service payment - Hughes LLC,REF59517218,0.0,1317.18,119580.64
2018-12-17,2018-12-17,Subcontractors expense,REF98533081,516.99,0.0,119063.65
2018-12-18,2018-12-18,Tools expense,REF30398370,70.99,0.0,118992.66
2018-12-18,2018-12-18,Business materials,REF10687732,462.87,0.0,118529.79
2018-12-18,2018-12-18,Equipment Rental expense,REF98731381,264.57,0.0,118265.22
2018-12-18,2018-12-18,Fuel purchase,REF46282769,264.03,0.0,118001.19
2018-12-19,2018-12-19,Equipment Rental expense,REF57964994,404.4,0.0,117596.79
2018-12-21,2018-12-21,Fuel purchase,REF58136218,251.84,0.0,117344.95
2018-12-21,2018-12-21,Subcontractors expense,REF82204644,919.23,0.0,116425.72
2018-12-22,2018-12-22,Business materials,REF23045196,544.65,0.0,115881.07
2018-12-23,2018-12-23,Vehicle Maintenance expense,REF54305079,122.27,0.0,115758.8
2018-12-23,2018-12-23,Business materials,REF69087977,648.08,0.0,115110.72
2018-12-25,2018-12-25,Safety Equipment expense,REF68002509,36.76,0.0,115073.96
2018-12-25,2018-12-25,Permits Licenses expense,REF39860906,37.97,0.0,115035.99
2018-12-29,2018-12-29,Fuel purchase,REF96985414,219.9,0.0,114816.09
2018-12-30,2018-12-30,Invoice payment - Lowe-James,REF40214512,0.0,463.94,115280.03
2018-12-30,2018-12-30,"Project payment - Harris, Haney and Lewis",REF21257474,0.0,677.67,115957.7
2018-12-30,2018-12-30,Payment from Hughes LLC,REF30670896,0.0,956.3,116914.0
2018-12-30,2018-12-30,"Project payment - Jackson, Madden and Fernandez",REF15865225,0.0,527.97,117441.97
2018-12-30,2018-12-30,Payment from Jimenez-Singh,REF41750930,0.0,429.67,117871.64
2019-01-04,2019-01-04,Business materials,REF28858121,306.81,0.0,117564.83
2019-01-07,2019-01-07,Vehicle Maintenance expense,REF79284756,150.08,0.0,117414.75
2019-01-11,2019-01-11,Business materials,REF93262508,476.65,0.0,116938.1
2019-01-12,2019-01-12,Equipment Rental expense,REF92043889,263.71,0.0,116674.39
2019-01-15,2019-01-15,"Invoice payment - Jackson, Madden and Fernandez",REF53985613,0.0,862.44,117536.83
2019-01-15,2019-01-15,"Service payment - Harris, Haney and Lewis",REF65894852,0.0,815.52,118352.35
2019-01-15,2019-01-15,Invoice payment - Jimenez-Singh,REF79966331,0.0,327.78,118680.13
2019-01-15,2019-01-15,Business insurance premium,REF30679053,116.68,0.0,118563.45
2019-01-15,2019-01-15,Project payment - Hughes LLC,REF51048200,0.0,1007.36,119570.81
2019-01-15,2019-01-15,Project payment - Lowe-James,REF15916082,0.0,585.65,120156.46
2019-01-19,2019-01-19,Business materials,REF73593869,437.25,0.0,119719.21
2019-01-27,2019-01-27,Fuel purchase,REF81885747,314.87,0.0,119404.34
2019-01-27,2019-01-27,Safety Equipment expense,REF15273621,31.6,0.0,119372.74
2019-01-29,2019-01-29,Business materials,REF45519412,501.0,0.0,118871.74
2019-01-30,2019-01-30,Payment from Hughes LLC,REF14329725,0.0,1321.57,120193.31
2019-01-30,2019-01-30,"Payment from Harris, Haney and Lewis",REF23505395,0.0,724.69,120918.0
2019-01-30,2019-01-30,"Payment from Jackson, Madden and Fernandez",REF64063920,0.0,448.85,121366.85
2019-01-30,2019-01-30,Payment from Jimenez-Singh,REF25383746,0.0,491.65,121858.5
2019-02-02,2019-02-02,Subcontractors expense,REF88104827,819.68,0.0,121038.82
2019-02-09,2019-02-09,Permits Licenses expense,REF31868589,113.98,0.0,120924.84
2019-02-10,2019-02-10,Business materials,REF49464300,620.26,0.0,120304.58
2019-02-11,2019-02-11,Business materials,REF89109361,369.76,0.0,119934.82
2019-02-15,2019-02-15,Business insurance premium,REF67555437,162.6,0.0,119772.22
2019-02-15,2019-02-15,Project payment - Lowe-James,REF85960448,0.0,530.13,120302.35
2019-02-15,2019-02-15,"Invoice payment - Harris, Haney and Lewis",REF80303029,0.0,786.71,121089.06
2019-02-15,2019-02-15,"Invoice payment - Jackson, Madden and Fernandez",REF70992033,0.0,877.22,121966.28
2019-02-15,2019-02-15,Business materials,REF18571268,822.31,0.0,121143.97
2019-02-15,2019-02-15,Project payment - Hughes LLC,REF31273933,0.0,1561.13,122705.1
2019-02-15,2019-02-15,Invoice payment - Jimenez-Singh,REF59635378,0.0,348.15,123053.25
2019-02-20,2019-02-20,Equipment Rental expense,REF75133718,117.08,0.0,122936.17
2019-02-28,2019-02-28,Equipment Rental expense,REF65191079,402.19,0.0,122533.98
2019-02-28,2019-02-28,"Project payment - Harris, Haney and Lewis",REF96414851,0.0,817.06,123351.04
2019-02-28,2019-02-28,Fuel purchase,REF69367884,261.46,0.0,123089.58
2019-02-28,2019-02-28,Invoice payment - Hughes LLC,REF71048738,0.0,1728.11,124817.69
2019-02-28,2019-02-28,"Project payment - Jackson, Madden and Fernandez",REF85382504,0.0,776.31,125594.0
2019-02-28,2019-02-28,Service payment - Jimenez-Singh,REF89133854,0.0,541.6,126135.6
2019-03-02,2019-03-02,Business materials,REF64365768,1293.42,0.0,124842.18
2019-03-06,2019-03-06,Vehicle Maintenance expense,REF70756299,262.0,0.0,124580.18
2019-03-09,2019-03-09,Fuel purchase,REF65219503,279.87,0.0,124300.31
2019-03-10,2019-03-10,Subcontractors expense,REF91387346,1415.67,0.0,122884.64
2019-03-12,2019-03-12,Safety Equipment expense,REF80811453,64.71,0.0,122819.93
2019-03-14,2019-03-14,Subcontractors expense,REF98270000,985.75,0.0,121834.18
2019-03-15,2019-03-15,Business insurance premium,REF50936084,203.37,0.0,121630.81
2019-03-15,2019-03-15,Fuel purchase,REF56920927,426.18,0.0,121204.63
2019-03-15,2019-03-15,Invoice payment - Jimenez-Singh,REF97990972,0.0,610.55,121815.18
2019-03-15,2019-03-15,"Invoice payment - Harris, Haney and Lewis",REF44496106,0.0,1163.6,122978.78
2019-03-15,2019-03-15,Payment from Lowe-James,REF50778882,0.0,477.32,123456.1
2019-03-15,2019-03-15,Project payment - Hughes LLC,REF82216129,0.0,2216.93,125673.03
2019-03-20,2019-03-20,Vehicle Maintenance expense,REF32442970,124.4,0.0,125548.63
2019-03-22,2019-03-22,Business materials,REF28143251,1028.92,0.0,124519.71
2019-03-29,2019-03-29,Equipment Rental expense,REF80341683,517.04,0.0,124002.67
2019-03-29,2019-03-29,Permits Licenses expense,REF52628886,90.48,0.0,123912.19
2019-03-30,2019-03-30,"Payment from Jackson, Madden and Fernandez",REF73481453,0.0,1083.31,124995.5
2019-03-30,2019-03-30,"Payment from Harris, Haney and Lewis",REF53409160,0.0,962.37,125957.87
2019-03-30,2019-03-30,Service payment - Lowe-James,REF83740873,0.0,681.64,126639.51
2019-03-30,2019-03-30,Service payment - Hughes LLC,REF78127688,0.0,1499.41,128138.92
2019-03-30,2019-03-30,Service payment - Jimenez-Singh,REF50287021,0.0,475.0,128613.92
2019-04-06,2019-04-06,Business materials,REF14731088,1062.12,0.0,127551.8
2019-04-06,2019-04-06,Fuel purchase,REF75860969,186.15,0.0,127365.65
2019-04-09,2019-04-09,Permits Licenses expense,REF51942186,156.08,0.0,127209.57
2019-04-14,2019-04-14,Tools expense,REF37344988,116.46,0.0,127093.11
2019-04-15,2019-04-15,Project payment - Jimenez-Singh,REF39999124,0.0,906.66,127999.77
2019-04-15,2019-04-15,"Project payment - Harris, Haney and Lewis",REF21553086,0.0,1138.97,129138.74
2019-04-15,2019-04-15,Business insurance premium,REF36790088,239.0,0.0,128899.74
2019-04-15,2019-04-15,Project payment - Hughes LLC,REF28934601,0.0,2921.55,131821.29
2019-04-15,2019-04-15,Equipment Rental expense,REF19384963,592.77,0.0,131228.52
2019-04-15,2019-04-15,Invoice payment - Lowe-James,REF95588703,0.0,902.39,132130.91
2019-04-15,2019-04-15,"Invoice payment - Jackson, Madden and Fernandez",REF30143007,0.0,963.38,133094.29
2019-04-18,2019-04-18,Safety Equipment expense,REF12248019,120.06,0.0,132974.23
2019-04-21,2019-04-21,Tools expense,REF14263234,52.57,0.0,132921.66
2019-04-22,2019-04-22,Tools expense,REF51220048,64.34,0.0,132857.32
2019-04-24,2019-04-24,Fuel purchase,REF75916242,312.97,0.0,132544.35
2019-04-24,2019-04-24,Equipment Rental expense,REF97358380,367.88,0.0,132176.47
2019-04-29,2019-04-29,Subcontractors expense,REF78409576,435.4,0.0,131741.07
2019-04-30,2019-04-30,Business materials,REF24895862,1270.55,0.0,130470.52
2019-04-30,2019-04-30,"Project payment - Jackson, Madden and Fernandez",REF47911174,0.0,1574.91,132045.43
2019-04-30,2019-04-30,"Service payment - Harris, Haney and Lewis",REF28376843,0.0,1030.46,133075.89
2019-04-30,2019-04-30,Payment from Hughes LLC,REF55750798,0.0,2753.85,135829.74
2019-04-30,2019-04-30,Project payment - Jimenez-Singh,REF31460102,0.0,894.25,136723.99
2019-04-30,2019-04-30,Invoice payment - Lowe-James,REF81575917,0.0,505.96,137229.95
2019-04-30,2019-04-30,Permits Licenses expense,REF26904770,114.89,0.0,137115.06
2019-05-03,2019-05-03,Fuel purchase,REF63956445,351.02,0.0,136764.04
2019-05-03,2019-05-03,Subcontractors expense,REF94585613,1092.35,0.0,135671.69
2019-05-06,2019-05-06,Vehicle Maintenance expense,REF94316135,236.33,0.0,135435.36
2019-05-07,2019-05-07,Safety Equipment expense,REF81200777,58.63,0.0,135376.73
2019-05-12,2019-05-12,Fuel purchase,REF62712156,438.61,0.0,134938.12
2019-05-15,2019-05-15,"Project payment - Jackson, Madden and Fernandez",REF12382332,0.0,1749.23,136687.35
2019-05-15,2019-05-15,Project payment - Jimenez-Singh,REF20108446,0.0,883.52,137570.87
2019-05-15,2019-05-15,Service payment - Hughes LLC,REF30063341,0.0,2600.78,140171.65
2019-05-15,2019-05-15,Business insurance premium,REF88926504,279.39,0.0,139892.26
2019-05-15,2019-05-15,Service payment - Lowe-James,REF72158791,0.0,838.49,140730.75
2019-05-15,2019-05-15,Business materials,REF84110367,879.32,0.0,139851.43
2019-05-15,2019-05-15,"Project payment - Harris, Haney and Lewis",REF90700882,0.0,1351.5,141202.93
2019-05-18,2019-05-18,Tools expense,REF81023666,70.02,0.0,141132.91
2019-05-18,2019-05-18,Safety Equipment expense,REF95016337,61.74,0.0,141071.17
2019-05-20,2019-05-20,Fuel purchase,REF75208326,345.53,0.0,140725.64
2019-05-22,2019-05-22,Tools expense,REF40270387,179.92,0.0,140545.72
2019-05-22,2019-05-22,Business materials,REF41961370,865.65,0.0,139680.07
2019-05-24,2019-05-24,Fuel purchase,REF11228294,543.13,0.0,139136.94
2019-05-27,2019-05-27,Subcontractors expense,REF70758304,700.64,0.0,138436.3
2019-05-27,2019-05-27,Business materials,REF49575511,769.64,0.0,137666.66
2019-05-30,2019-05-30,Invoice payment - Hughes LLC,REF11088644,0.0,2820.92,140487.58
2019-05-30,2019-05-30,Project payment - Lowe-James,REF14704820,0.0,893.74,141381.32
2019-05-30,2019-05-30,"Invoice payment - Jackson, Madden and Fernandez",REF51554242,0.0,1727.71,143109.03
2019-05-30,2019-05-30,"Project payment - Harris, Haney and Lewis",REF59689309,0.0,1119.09,144228.12
2019-05-30,2019-05-30,Project payment - Jimenez-Singh,REF79227780,0.0,466.68,144694.8
2019-06-07,2019-06-07,Business materials,REF44838561,819.1,0.0,143875.7
2019-06-08,2019-06-08,Subcontractors expense,REF47078764,1037.61,0.0,142838.09
2019-06-11,2019-06-11,Vehicle Maintenance expense,REF93879990,83.14,0.0,142754.95
2019-06-13,2019-06-13,Vehicle Maintenance expense,REF55024959,189.66,0.0,142565.29
2019-06-15,2019-06-15,Business insurance premium,REF55164475,251.53,0.0,142313.76
2019-06-15,2019-06-15,Service payment - Lowe-James,REF37783544,0.0,805.82,143119.58
2019-06-15,2019-06-15,Equipment Rental expense,REF57190113,427.13,0.0,142692.45
2019-06-15,2019-06-15,"Project payment - Harris, Haney and Lewis",REF37297893,0.0,1444.58,144137.03
2019-06-15,2019-06-15,Invoice payment - Hughes LLC,REF23257430,0.0,2571.71,146708.74
2019-06-15,2019-06-15,Invoice payment - Jimenez-Singh,REF21423051,0.0,730.08,147438.82
2019-06-15,2019-06-15,"Payment from Jackson, Madden and Fernandez",REF45270977,0.0,1554.83,148993.65
2019-06-17,2019-06-17,Fuel purchase,REF88268798,441.42,0.0,148552.23
2019-06-18,2019-06-18,Equipment Rental expense,REF54382412,482.42,0.0,148069.81
2019-06-21,2019-06-21,Subcontractors expense,REF65373475,850.41,0.0,147219.4
2019-06-21,2019-06-21,Fuel purchase,REF24947712,416.73,0.0,146802.67
2019-06-22,2019-06-22,Fuel purchase,REF73088883,498.45,0.0,146304.22
2019-06-22,2019-06-22,Subcontractors expense,REF86731694,1136.09,0.0,145168.13
2019-06-23,2019-06-23,Fuel purchase,REF65273935,290.23,0.0,144877.9
2019-06-28,2019-06-28,Subcontractors expense,REF27035705,1169.29,0.0,143708.61
2019-06-30,2019-06-30,Fuel purchase,REF95657952,394.64,0.0,143313.97
2019-06-30,2019-06-30,Project payment - Jimenez-Singh,REF95829402,0.0,942.91,144256.88
2019-06-30,2019-06-30,"Service payment - Harris, Haney and Lewis",REF73445181,0.0,922.9,145179.78
2019-06-30,2019-06-30,"Project payment - Jackson, Madden and Fernandez",REF70986830,0.0,1294.22,146474.0
2019-06-30,2019-06-30,Permits Licenses expense,REF63222569,92.98,0.0,146381.02
2019-07-02,2019-07-02,Permits Licenses expense,REF13335881,106.02,0.0,146275.0
2019-07-14,2019-07-14,Vehicle Maintenance expense,REF14971104,174.51,0.0,146100.49
2019-07-14,2019-07-14,Safety Equipment expense,REF56746166,39.9,0.0,146060.59
2019-07-15,2019-07-15,Business insurance premium,REF38075662,250.06,0.0,145810.53
2019-07-15,2019-07-15,Invoice payment - Hughes LLC,REF41123091,0.0,2505.45,148315.98
2019-07-15,2019-07-15,Service payment - Jimenez-Singh,REF87287086,0.0,902.62,149218.6
2019-07-15,2019-07-15,"Payment from Jackson, Madden and Fernandez",REF41643198,0.0,1255.81,150474.41
2019-07-15,2019-07-15,Project payment - Lowe-James,REF29085589,0.0,1344.78,151819.19
2019-07-15,2019-07-15,"Payment from Harris, Haney and Lewis",REF48712407,0.0,1289.68,153108.87
2019-07-19,2019-07-19,Fuel purchase,REF89649123,198.55,0.0,152910.32
2019-07-23,2019-07-23,Permits Licenses expense,REF32361389,26.43,0.0,152883.89
2019-07-26,2019-07-26,Subcontractors expense,REF76908801,1229.55,0.0,151654.34
2019-07-27,2019-07-27,Vehicle Maintenance expense,REF49072680,132.33,0.0,151522.01
2019-07-29,2019-07-29,Tools expense,REF41713165,110.96,0.0,151411.05
2019-07-30,2019-07-30,Project payment - Hughes LLC,REF39476495,0.0,2478.35,153889.4
2019-07-30,2019-07-30,"Payment from Harris, Haney and Lewis",REF47053414,0.0,1364.07,155253.47
2019-07-30,2019-07-30,Project payment - Lowe-James,REF10278473,0.0,926.96,156180.43
2019-07-31,2019-07-31,Safety Equipment expense,REF67825309,104.11,0.0,156076.32
2019-08-05,2019-08-05,Fuel purchase,REF82804168,282.8,0.0,155793.52
2019-08-07,2019-08-07,Fuel purchase,REF67599445,540.68,0.0,155252.84
2019-08-08,2019-08-08,Tools expense,REF42054379,132.35,0.0,155120.49
2019-08-08,2019-08-08,Subcontractors expense,REF10743813,1698.84,0.0,153421.65
2019-08-15,2019-08-15,"Invoice payment - Harris, Haney and Lewis",REF68170988,0.0,1527.64,154949.29
2019-08-15,2019-08-15,Invoice payment - Hughes LLC,REF65713228,0.0,2101.94,157051.23
2019-08-15,2019-08-15,Payment from Jimenez-Singh,REF14708440,0.0,631.75,157682.98
2019-08-15,2019-08-15,Project payment - Lowe-James,REF57666402,0.0,1050.07,158733.05
2019-08-15,2019-08-15,"Service payment - Jackson, Madden and Fernandez",REF72618957,0.0,1390.47,160123.52
2019-08-15,2019-08-15,Business insurance premium,REF70987262,234.08,0.0,159889.44
2019-08-20,2019-08-20,Safety Equipment expense,REF80814731,115.51,0.0,159773.93
2019-08-21,2019-08-21,Safety Equipment expense,REF57188524,74.61,0.0,159699.32
2019-08-25,2019-08-25,Vehicle Maintenance expense,REF60943335,180.52,0.0,159518.8
2019-08-26,2019-08-26,Permits Licenses expense,REF83057712,66.95,0.0,159451.85
2019-08-27,2019-08-27,Subcontractors expense,REF25773484,1315.23,0.0,158136.62
2019-08-28,2019-08-28,Subcontractors expense,REF33861522,1706.68,0.0,156429.94
2019-08-30,2019-08-30,Service payment - Jimenez-Singh,REF53414542,0.0,881.26,157311.2
2019-08-30,2019-08-30,Service payment - Lowe-James,REF14585120,0.0,739.66,158050.86
2019-08-30,2019-08-30,"Payment from Harris, Haney and Lewis",REF82921624,0.0,1338.35,159389.21
2019-08-30,2019-08-30,"Project payment - Jackson, Madden and Fernandez",REF50880361,0.0,1372.19,160761.4
2019-09-03,2019-09-03,Safety Equipment expense,REF28876744,69.53,0.0,160691.87
2019-09-09,2019-09-09,Permits Licenses expense,REF78079769,117.73,0.0,160574.14
2019-09-12,2019-09-12,Fuel purchase,REF23060733,350.43,0.0,160223.71
2019-09-15,2019-09-15,"Payment from Harris, Haney and Lewis",REF74281552,0.0,1011.76,161235.47
2019-09-15,2019-09-15,Invoice payment - Lowe-James,REF68607756,0.0,681.6,161917.07
2019-09-15,2019-09-15,Service payment - Jimenez-Singh,REF81095360,0.0,409.58,162326.65
2019-09-15,2019-09-15,Invoice payment - Hughes LLC,REF19393189,0.0,2790.08,165116.73
2019-09-15,2019-09-15,Business insurance premium,REF90367672,214.7,0.0,164902.03
2019-09-16,2019-09-16,Business materials,REF21618740,1022.98,0.0,163879.05
2019-09-19,2019-09-19,Business materials,REF14062061,763.03,0.0,163116.02
2019-09-20,2019-09-20,Subcontractors expense,REF36980277,1312.61,0.0,161803.41
2019-09-21,2019-09-21,Business materials,REF98116796,961.45,0.0,160841.96
2019-09-22,2019-09-22,Safety Equipment expense,REF71994719,55.24,0.0,160786.72
2019-09-28,2019-09-28,Tools expense,REF56116416,101.5,0.0,160685.22
2019-09-30,2019-09-30,Permits Licenses expense,REF47395354,118.83,0.0,160566.39
2019-09-30,2019-09-30,"Invoice payment - Jackson, Madden and Fernandez",REF63946105,0.0,1048.93,161615.32
2019-09-30,2019-09-30,"Payment from Harris, Haney and Lewis",REF94860115,0.0,1381.86,162997.18
2019-09-30,2019-09-30,Service payment - Jimenez-Singh,REF33755815,0.0,764.51,163761.69
2019-09-30,2019-09-30,Payment from Lowe-James,REF87544446,0.0,824.99,164586.68
2019-09-30,2019-09-30,Payment from Hughes LLC,REF58164699,0.0,2633.82,167220.5
2019-10-03,2019-10-03,Fuel purchase,REF64651861,377.16,0.0,166843.34
2019-10-03,2019-10-03,Safety Equipment expense,REF65384827,79.33,0.0,166764.01
2019-10-07,2019-10-07,Subcontractors expense,REF90915103,860.08,0.0,165903.93
2019-10-07,2019-10-07,Business materials,REF50379351,611.81,0.0,165292.12
2019-10-08,2019-10-08,Equipment Rental expense,REF84353292,335.22,0.0,164956.9
2019-10-09,2019-10-09,Safety Equipment expense,REF50660640,81.12,0.0,164875.78
2019-10-10,2019-10-10,Business materials,REF69645091,769.81,0.0,164105.97
2019-10-15,2019-10-15,Project payment - Jimenez-Singh,REF20710477,0.0,701.93,164807.9
2019-10-15,2019-10-15,Payment from Hughes LLC,REF48125478,0.0,2314.48,167122.38
2019-10-15,2019-10-15,"Invoice payment - Jackson, Madden and Fernandez",REF71478680,0.0,751.56,167873.94
2019-10-15,2019-10-15,Business insurance premium,REF41266650,203.47,0.0,167670.47
2019-10-15,2019-10-15,"Service payment - Harris, Haney and Lewis",REF69583668,0.0,859.0,168529.47
2019-10-15,2019-10-15,Service payment - Lowe-James,REF87902016,0.0,671.43,169200.9
2019-10-19,2019-10-19,Business materials,REF84366493,992.36,0.0,168208.54
2019-10-19,2019-10-19,Tools expense,REF10316938,70.51,0.0,168138.03
2019-10-21,2019-10-21,Subcontractors expense,REF56710738,737.39,0.0,167400.64
2019-10-30,2019-10-30,Payment from Hughes LLC,REF39752525,0.0,2000.76,169401.4
2019-10-30,2019-10-30,"Payment from Jackson, Madden and Fernandez",REF43046707,0.0,1307.28,170708.68
2019-10-30,2019-10-30,Payment from Lowe-James,REF79372393,0.0,778.81,171487.49
2019-10-30,2019-10-30,Project payment - Jimenez-Singh,REF97684111,0.0,672.74,172160.23
2019-11-05,2019-11-05,Fuel purchase,REF71459701,242.08,0.0,171918.15
2019-11-10,2019-11-10,Vehicle Maintenance expense,REF67482649,188.35,0.0,171729.8
2019-11-12,2019-11-12,Fuel purchase,REF59058554,300.15,0.0,171429.65
2019-11-14,2019-11-14,Equipment Rental expense,REF94523250,283.94,0.0,171145.71
2019-11-15,2019-11-15,Vehicle Maintenance expense,REF11352748,130.06,0.0,171015.65
2019-11-15,2019-11-15,Invoice payment - Jimenez-Singh,REF71395444,0.0,479.85,171495.5
2019-11-15,2019-11-15,"Invoice payment - Jackson, Madden and Fernandez",REF68436658,0.0,890.28,172385.78
2019-11-15,2019-11-15,"Project payment - Harris, Haney and Lewis",REF95506648,0.0,822.76,173208.54
2019-11-15,2019-11-15,Business insurance premium,REF52016340,147.79,0.0,173060.75
2019-11-15,2019-11-15,Payment from Lowe-James,REF18481466,0.0,595.28,173656.03
2019-11-16,2019-11-16,Fuel purchase,REF97854421,181.73,0.0,173474.3
2019-11-17,2019-11-17,Fuel purchase,REF21558679,248.42,0.0,173225.88
2019-11-29,2019-11-29,Business materials,REF29650012,609.06,0.0,172616.82
2019-11-30,2019-11-30,"Project payment - Jackson, Madden and Fernandez",REF74397214,0.0,1112.95,173729.77
2019-11-30,2019-11-30,Payment from Lowe-James,REF17553413,0.0,499.17,174228.94
2019-11-30,2019-11-30,Project payment - Jimenez-Singh,REF40188996,0.0,545.5,174774.44
2019-11-30,2019-11-30,Payment from Hughes LLC,REF88777458,0.0,1658.77,176433.21
2019-11-30,2019-11-30,"Invoice payment - Harris, Haney and Lewis",REF96979375,0.0,1067.76,177500.97
2019-12-01,2019-12-01,Equipment Rental expense,REF35565445,296.16,0.0,177204.81
2019-12-05,2019-12-05,Safety Equipment expense,REF35549098,63.41,0.0,177141.4
2019-12-08,2019-12-08,Tools expense,REF41421278,70.13,0.0,177071.27
2019-12-14,2019-12-14,Tools expense,REF57769231,29.69,0.0,177041.58
2019-12-15,2019-12-15,Invoice payment - Hughes LLC,REF29044285,0.0,1264.74,178306.32
2019-12-15,2019-12-15,"Project payment - Jackson, Madden and Fernandez",REF20062705,0.0,660.49,178966.81
2019-12-15,2019-12-15,Business insurance premium,REF49691503,137.42,0.0,178829.39
2019-12-18,2019-12-18,Safety Equipment expense,REF27800389,42.07,0.0,178787.32
2019-12-20,2019-12-20,Fuel purchase,REF10323301,202.13,0.0,178585.19
2019-12-21,2019-12-21,Fuel purchase,REF12736895,157.25,0.0,178427.94
2019-12-22,2019-12-22,Equipment Rental expense,REF50989476,178.78,0.0,178249.16
2019-12-24,2019-12-24,Vehicle Maintenance expense,REF87902807,66.2,0.0,178182.96
2019-12-26,2019-12-26,Fuel purchase,REF81325796,216.46,0.0,177966.5
2019-12-27,2019-12-27,Equipment Rental expense,REF26338092,351.67,0.0,177614.83
2019-12-30,2019-12-30,"Project payment - Jackson, Madden and Fernandez",REF29068331,0.0,634.95,178249.78
2019-12-30,2019-12-30,Service payment - Lowe-James,REF46911908,0.0,537.49,178787.27
2019-12-30,2019-12-30,Invoice payment - Jimenez-Singh,REF29136387,0.0,412.59,179199.86
2019-12-30,2019-12-30,Service payment - Hughes LLC,REF61178049,0.0,1168.13,180367.99
2019-12-30,2019-12-30,"Invoice payment - Harris, Haney and Lewis",REF40164972,0.0,646.93,181014.92
2019-12-31,2019-12-31,Fuel purchase,REF22155096,151.81,0.0,180863.11
2020-01-07,2020-01-07,Fuel purchase,REF83866011,168.34,0.0,180694.77
2020-01-10,2020-01-10,Equipment Rental expense,REF71538373,264.11,0.0,180430.66
2020-01-12,2020-01-12,Permits Licenses expense,REF54019486,118.27,0.0,180312.39
2020-01-15,2020-01-15,Permits Licenses expense,REF65705932,69.14,0.0,180243.25
2020-01-15,2020-01-15,Payment from Jimenez-Singh,REF96172683,0.0,408.91,180652.16
2020-01-15,2020-01-15,Project payment - Hughes LLC,REF60188292,0.0,1311.87,181964.03
2020-01-15,2020-01-15,"Service payment - Jackson, Madden and Fernandez",REF21538600,0.0,752.44,182716.47
2020-01-15,2020-01-15,Equipment Rental expense,REF47002980,305.51,0.0,182410.96
2020-01-15,2020-01-15,Service payment - Lowe-James,REF25304057,0.0,489.6,182900.56
2020-01-15,2020-01-15,Business insurance premium,REF99270614,144.45,0.0,182756.11
2020-01-17,2020-01-17,Equipment Rental expense,REF64454440,380.94,0.0,182375.17
2020-01-19,2020-01-19,Business materials,REF83992127,413.36,0.0,181961.81
2020-01-23,2020-01-23,Tools expense,REF77732983,94.42,0.0,181867.39
2020-01-24,2020-01-24,Business materials,REF58103889,718.51,0.0,181148.88
2020-01-26,2020-01-26,Permits Licenses expense,REF71655086,38.79,0.0,181110.09
2020-01-30,2020-01-30,Project payment - Jimenez-Singh,REF87858306,0.0,492.88,181602.97
2020-01-30,2020-01-30,"Project payment - Jackson, Madden and Fernandez",REF12583815,0.0,567.64,182170.61
2020-01-30,2020-01-30,Invoice payment - Hughes LLC,REF99016199,0.0,1436.34,183606.95
2020-01-30,2020-01-30,"Payment from Harris, Haney and Lewis",REF23778438,0.0,634.76,184241.71
2020-01-30,2020-01-30,Safety Equipment expense,REF74454200,38.16,0.0,184203.55
2020-01-31,2020-01-31,Subcontractors expense,REF57531041,727.71,0.0,183475.84
2020-02-01,2020-02-01,Business materials,REF49720890,505.83,0.0,182970.01
2020-02-05,2020-02-05,Vehicle Maintenance expense,REF26205776,145.45,0.0,182824.56
2020-02-09,2020-02-09,Business materials,REF94730909,376.96,0.0,182447.6
2020-02-14,2020-02-14,Permits Licenses expense,REF85874073,67.74,0.0,182379.86
2020-02-15,2020-02-15,"Service payment - Harris, Haney and Lewis",REF69491451,0.0,872.31,183252.17
2020-02-15,2020-02-15,Payment from Hughes LLC,REF29675593,0.0,2043.91,185296.08
2020-02-15,2020-02-15,Business insurance premium,REF47644632,153.66,0.0,185142.42
2020-02-15,2020-02-15,"Service payment - Jackson, Madden and Fernandez",REF50912275,0.0,907.63,186050.05
2020-02-15,2020-02-15,Fuel purchase,REF43869115,206.49,0.0,185843.56
2020-02-15,2020-02-15,Payment from Lowe-James,REF67273003,0.0,537.83,186381.39
2020-02-15,2020-02-15,Equipment Rental expense,REF77653542,420.06,0.0,185961.33
2020-02-17,2020-02-17,Fuel purchase,REF13109331,256.49,0.0,185704.84
2020-02-17,2020-02-17,Vehicle Maintenance expense,REF50668882,182.13,0.0,185522.71
2020-02-19,2020-02-19,Business materials,REF36646434,923.26,0.0,184599.45
2020-02-19,2020-02-19,Fuel purchase,REF67647622,252.17,0.0,184347.28
2020-02-20,2020-02-20,Business materials,REF54238998,567.94,0.0,183779.34
2020-02-22,2020-02-22,Fuel purchase,REF83999903,227.64,0.0,183551.7
2020-02-28,2020-02-28,Service payment - Hughes LLC,REF91503341,0.0,1877.02,185428.72
2020-02-28,2020-02-28,"Invoice payment - Jackson, Madden and Fernandez",REF78531818,0.0,1195.32,186624.04
2020-02-28,2020-02-28,"Invoice payment - Harris, Haney and Lewis",REF87632238,0.0,608.65,187232.69
2020-02-28,2020-02-28,Fuel purchase,REF62394345,204.77,0.0,187027.92
2020-02-28,2020-02-28,Project payment - Lowe-James,REF14576537,0.0,687.4,187715.32
2020-02-28,2020-02-28,Service payment - Jimenez-Singh,REF95329005,0.0,563.43,188278.75
2020-03-01,2020-03-01,Fuel purchase,REF74794666,318.95,0.0,187959.8
2020-03-07,2020-03-07,Fuel purchase,REF54201132,321.36,0.0,187638.44
2020-03-07,2020-03-07,Business materials,REF28669191,479.04,0.0,187159.4
2020-03-12,2020-03-12,Fuel purchase,REF62134982,502.05,0.0,186657.35
2020-03-15,2020-03-15,Business insurance premium,REF35857083,211.56,0.0,186445.79
2020-03-15,2020-03-15,Payment from Jimenez-Singh,REF68360531,0.0,672.21,187118.0
2020-03-15,2020-03-15,Invoice payment - Hughes LLC,REF41244188,0.0,2101.33,189219.33
2020-03-15,2020-03-15,"Payment from Harris, Haney and Lewis",REF78209049,0.0,1244.69,190464.02
2020-03-15,2020-03-15,"Invoice payment - Jackson, Madden and Fernandez",REF15583908,0.0,939.93,191403.95
2020-03-15,2020-03-15,Business materials,REF20027485,523.88,0.0,190880.07
2020-03-15,2020-03-15,Tools expense,REF85215274,84.41,0.0,190795.66
2020-03-15,2020-03-15,Project payment - Lowe-James,REF67849937,0.0,788.74,191584.4
2020-03-16,2020-03-16,Business materials,REF91118363,870.72,0.0,190713.68
2020-03-28,2020-03-28,Fuel purchase,REF42591435,248.98,0.0,190464.7
2020-03-30,2020-03-30,Project payment - Lowe-James,REF46066864,0.0,701.52,191166.22
2020-03-30,2020-03-30,"Service payment - Jackson, Madden and Fernandez",REF19509901,0.0,1518.84,192685.06
2020-03-30,2020-03-30,Service payment - Hughes LLC,REF72712136,0.0,1929.95,194615.01
2020-03-30,2020-03-30,Project payment - Jimenez-Singh,REF15750437,0.0,751.32,195366.33
2020-03-30,2020-03-30,"Invoice payment - Harris, Haney and Lewis",REF72795615,0.0,815.31,196181.64
2020-04-04,2020-04-04,Fuel purchase,REF20827296,330.95,0.0,195850.69
2020-04-12,2020-04-12,Vehicle Maintenance expense,REF94710012,92.21,0.0,195758.48
2020-04-12,2020-04-12,Fuel purchase,REF29805535,280.35,0.0,195478.13
2020-04-15,2020-04-15,"Payment from Jackson, Madden and Fernandez",REF73962440,0.0,1217.14,196695.27
2020-04-15,2020-04-15,"Project payment - Harris, Haney and Lewis",REF40279465,0.0,995.66,197690.93
2020-04-15,2020-04-15,Payment from Lowe-James,REF55671623,0.0,856.68,198547.61
2020-04-15,2020-04-15,Business insurance premium,REF96395445,239.61,0.0,198308.0
2020-04-15,2020-04-15,Payment from Jimenez-Singh,REF86755366,0.0,594.1,198902.1
2020-04-15,2020-04-15,Project payment - Hughes LLC,REF39178471,0.0,2362.85,201264.95
2020-04-16,2020-04-16,Safety Equipment expense,REF99955824,106.74,0.0,201158.21
2020-04-19,2020-04-19,Equipment Rental expense,REF58113244,386.77,0.0,200771.44
2020-04-19,2020-04-19,Business materials,REF69526972,1086.03,0.0,199685.41
2020-04-22,2020-04-22,Equipment Rental expense,REF76859229,530.69,0.0,199154.72
2020-04-27,2020-04-27,Safety Equipment expense,REF20168972,77.16,0.0,199077.56
2020-04-30,2020-04-30,Invoice payment - Hughes LLC,REF85501186,0.0,2783.75,201861.31
2020-04-30,2020-04-30,Payment from Jimenez-Singh,REF70430807,0.0,796.62,202657.93
2020-04-30,2020-04-30,Service payment - Lowe-James,REF90966757,0.0,834.69,203492.62
2020-04-30,2020-04-30,"Project payment - Jackson, Madden and Fernandez",REF58280279,0.0,1116.67,204609.29
2020-04-30,2020-04-30,"Project payment - Harris, Haney and Lewis",REF90564081,0.0,1263.35,205872.64
2020-04-30,2020-04-30,Fuel purchase,REF55541303,488.59,0.0,205384.05
2020-05-04,2020-05-04,Business materials,REF14936225,819.49,0.0,204564.56
2020-05-08,2020-05-08,Tools expense,REF13443400,142.67,0.0,204421.89
2020-05-14,2020-05-14,Fuel purchase,REF85212164,244.02,0.0,204177.87
2020-05-15,2020-05-15,Payment from Hughes LLC,REF22723940,0.0,3015.84,207193.71
2020-05-15,2020-05-15,Project payment - Lowe-James,REF29263122,0.0,805.57,207999.28
2020-05-15,2020-05-15,"Project payment - Harris, Haney and Lewis",REF67492528,0.0,1032.51,209031.79
2020-05-15,2020-05-15,"Payment from Jackson, Madden and Fernandez",REF18969152,0.0,1528.5,210560.29
2020-05-15,2020-05-15,Business materials,REF84147905,1328.48,0.0,209231.81
2020-05-15,2020-05-15,Service payment - Jimenez-Singh,REF25229144,0.0,935.74,210167.55
2020-05-15,2020-05-15,Business insurance premium,REF64087726,248.6,0.0,209918.95
2020-05-15,2020-05-15,Fuel purchase,REF45801338,363.41,0.0,209555.54
2020-05-16,2020-05-16,Business materials,REF23446609,1296.06,0.0,208259.48
2020-05-23,2020-05-23,Business materials,REF47489542,908.69,0.0,207350.79
2020-05-25,2020-05-25,Fuel purchase,REF69653594,249.72,0.0,207101.07
2020-05-27,2020-05-27,Business materials,REF24364583,1018.19,0.0,206082.88
2020-05-30,2020-05-30,"Invoice payment - Harris, Haney and Lewis",REF75452052,0.0,1364.48,207447.36
2020-05-30,2020-05-30,Invoice payment - Hughes LLC,REF16561367,0.0,2949.36,210396.72
2020-05-30,2020-05-30,Invoice payment - Lowe-James,REF79141720,0.0,1017.42,211414.14
2020-05-30,2020-05-30,"Invoice payment - Jackson, Madden and Fernandez",REF27916256,0.0,1611.34,213025.48
2020-05-30,2020-05-30,Project payment - Jimenez-Singh,REF91033079,0.0,1130.16,214155.64
2020-06-02,2020-06-02,Subcontractors expense,REF27702988,1408.92,0.0,212746.72
2020-06-03,2020-06-03,Equipment Rental expense,REF61246512,591.54,0.0,212155.18
2020-06-05,2020-06-05,Fuel purchase,REF86077312,318.74,0.0,211836.44
2020-06-07,2020-06-07,Fuel purchase,REF67744641,355.5,0.0,211480.94
2020-06-07,2020-06-07,Vehicle Maintenance expense,REF29525130,104.58,0.0,211376.36
2020-06-10,2020-06-10,Vehicle Maintenance expense,REF63897972,222.99,0.0,211153.37
2020-06-10,2020-06-10,Safety Equipment expense,REF28710592,99.5,0.0,211053.87
2020-06-10,2020-06-10,Fuel purchase,REF59134100,477.01,0.0,210576.86
2020-06-12,2020-06-12,Fuel purchase,REF55810807,517.89,0.0,210058.97
2020-06-12,2020-06-12,Tools expense,REF23664454,162.17,0.0,209896.8
2020-06-15,2020-06-15,"Payment from Jackson, Madden and Fernandez",REF58311626,0.0,1788.73,211685.53
2020-06-15,2020-06-15,"Payment from Harris, Haney and Lewis",REF68724734,0.0,1495.92,213181.45
2020-06-15,2020-06-15,Project payment - Lowe-James,REF28229456,0.0,1035.72,214217.17
2020-06-15,2020-06-15,Service payment - Hughes LLC,REF15689173,0.0,2449.53,216666.7
2020-06-15,2020-06-15,Payment from Jimenez-Singh,REF86575827,0.0,873.79,217540.49
2020-06-15,2020-06-15,Business insurance premium,REF10552326,248.07,0.0,217292.42
2020-06-18,2020-06-18,Business materials,REF79821396,952.7,0.0,216339.72
2020-06-19,2020-06-19,Tools expense,REF78478129,201.93,0.0,216137.79
2020-06-20,2020-06-20,Fuel purchase,REF13795269,413.75,0.0,215724.04
2020-06-21,2020-06-21,Safety Equipment expense,REF63934350,108.45,0.0,215615.59
2020-06-28,2020-06-28,Business materials,REF48631717,836.18,0.0,214779.41
2020-06-28,2020-06-28,Safety Equipment expense,REF27071771,97.72,0.0,214681.69
2020-06-29,2020-06-29,Equipment Rental expense,REF28774327,650.3,0.0,214031.39
2020-06-30,2020-06-30,"Project payment - Harris, Haney and Lewis",REF44265069,0.0,1430.82,215462.21
2020-06-30,2020-06-30,Payment from Lowe-James,REF35899484,0.0,1076.74,216538.95
2020-06-30,2020-06-30,"Service payment - Jackson, Madden and Fernandez",REF11513101,0.0,1540.51,218079.46
2020-06-30,2020-06-30,Service payment - Jimenez-Singh,REF76600816,0.0,536.51,218615.97
2020-07-03,2020-07-03,Tools expense,REF83807315,135.93,0.0,218480.04
2020-07-04,2020-07-04,Business materials,REF26786557,1536.19,0.0,216943.85
2020-07-11,2020-07-11,Fuel purchase,REF54841240,275.69,0.0,216668.16
2020-07-12,2020-07-12,Safety Equipment expense,REF35844610,122.46,0.0,216545.7
2020-07-13,2020-07-13,Business materials,REF75975746,953.89,0.0,215591.81
2020-07-14,2020-07-14,Permits Licenses expense,REF36523853,115.74,0.0,215476.07
2020-07-15,2020-07-15,Project payment - Jimenez-Singh,REF21477754,0.0,919.17,216395.24
2020-07-15,2020-07-15,"Invoice payment - Harris, Haney and Lewis",REF14536068,0.0,1158.01,217553.25
2020-07-15,2020-07-15,"Project payment - Jackson, Madden and Fernandez",REF85820709,0.0,1620.48,219173.73
2020-07-15,2020-07-15,Payment from Hughes LLC,REF34250528,0.0,2193.18,221366.91
2020-07-15,2020-07-15,Business insurance premium,REF84167464,247.61,0.0,221119.3
2020-07-19,2020-07-19,Safety Equipment expense,REF99699052,91.82,0.0,221027.48
2020-07-22,2020-07-22,Business materials,REF33143743,572.11,0.0,220455.37
2020-07-30,2020-07-30,Invoice payment - Jimenez-Singh,REF31247258,0.0,644.88,221100.25
2020-07-30,2020-07-30,"Service payment - Harris, Haney and Lewis",REF24005603,0.0,1346.26,222446.51
2020-07-30,2020-07-30,Payment from Hughes LLC,REF95629338,0.0,2331.45,224777.96
2020-07-30,2020-07-30,"Project payment - Jackson, Madden and Fernandez",REF20848034,0.0,1331.17,226109.13
2020-07-30,2020-07-30,Subcontractors expense,REF72820607,923.18,0.0,225185.95
2020-07-31,2020-07-31,Fuel purchase,REF18640288,434.87,0.0,224751.08
2020-08-01,2020-08-01,Tools expense,REF46997589,139.46,0.0,224611.62
2020-08-02,2020-08-02,Fuel purchase,REF69538601,274.39,0.0,224337.23
2020-08-03,2020-08-03,Fuel purchase,REF12025176,88.54,0.0,224248.69
2020-08-04,2020-08-04,Tools expense,REF10159879,110.79,0.0,224137.9
2020-08-08,2020-08-08,Equipment Rental expense,REF96099005,613.92,0.0,223523.98
2020-08-08,2020-08-08,Business materials,REF27627586,532.15,0.0,222991.83
2020-08-10,2020-08-10,Business materials,REF48075144,658.86,0.0,222332.97
2020-08-15,2020-08-15,"Payment from Jackson, Madden and Fernandez",REF94471952,0.0,1074.29,223407.26
2020-08-15,2020-08-15,"Service payment - Harris, Haney and Lewis",REF42216910,0.0,1350.6,224757.86
2020-08-15,2020-08-15,Project payment - Lowe-James,REF53348411,0.0,871.28,225629.14
2020-08-15,2020-08-15,Service payment - Jimenez-Singh,REF57842583,0.0,826.44,226455.58
2020-08-15,2020-08-15,Invoice payment - Hughes LLC,REF75245031,0.0,2385.91,228841.49
2020-08-15,2020-08-15,Business insurance premium,REF65943326,252.43,0.0,228589.06
2020-08-17,2020-08-17,Business materials,REF86241455,1144.54,0.0,227444.52
2020-08-18,2020-08-18,Tools expense,REF43919802,113.45,0.0,227331.07
2020-08-18,2020-08-18,Fuel purchase,REF89156859,183.21,0.0,227147.86
2020-08-19,2020-08-19,Fuel purchase,REF72939010,344.17,0.0,226803.69
2020-08-20,2020-08-20,Fuel purchase,REF94415778,359.55,0.0,226444.14
2020-08-30,2020-08-30,Payment from Hughes LLC,REF37003135,0.0,2811.06,229255.2
2020-08-30,2020-08-30,"Invoice payment - Harris, Haney and Lewis",REF57434559,0.0,813.65,230068.85
2020-08-30,2020-08-30,Invoice payment - Jimenez-Singh,REF12078038,0.0,757.19,230826.04
2020-08-30,2020-08-30,"Service payment - Jackson, Madden and Fernandez",REF15064215,0.0,1881.51,232707.55
2020-08-30,2020-08-30,Service payment - Lowe-James,REF91491866,0.0,805.07,233512.62
2020-09-03,2020-09-03,Equipment Rental expense,REF77313667,358.75,0.0,233153.87
2020-09-03,2020-09-03,Vehicle Maintenance expense,REF48089527,73.55,0.0,233080.32
2020-09-05,2020-09-05,Business materials,REF76943188,994.27,0.0,232086.05
2020-09-07,2020-09-07,Equipment Rental expense,REF27618720,455.89,0.0,231630.16
2020-09-08,2020-09-08,Fuel purchase,REF98182355,194.47,0.0,231435.69
2020-09-13,2020-09-13,Equipment Rental expense,REF41018487,568.29,0.0,230867.4
2020-09-14,2020-09-14,Subcontractors expense,REF42463410,689.28,0.0,230178.12
2020-09-15,2020-09-15,Business insurance premium,REF72986152,223.28,0.0,229954.84
2020-09-15,2020-09-15,"Invoice payment - Jackson, Madden and Fernandez",REF21250707,0.0,1154.04,231108.88
2020-09-15,2020-09-15,Project payment - Lowe-James,REF64331576,0.0,910.13,232019.01
2020-09-15,2020-09-15,Payment from Jimenez-Singh,REF70494206,0.0,846.7,232865.71
2020-09-15,2020-09-15,Service payment - Hughes LLC,REF15637763,0.0,2610.48,235476.19
2020-09-15,2020-09-15,"Service payment - Harris, Haney and Lewis",REF69676707,0.0,1186.39,236662.58
2020-09-17,2020-09-17,Fuel purchase,REF97343511,194.93,0.0,236467.65
2020-09-21,2020-09-21,Tools expense,REF46557179,119.55,0.0,236348.1
2020-09-26,2020-09-26,Vehicle Maintenance expense,REF80218290,165.52,0.0,236182.58
2020-09-26,2020-09-26,Safety Equipment expense,REF54598683,91.61,0.0,236090.97
2020-09-29,2020-09-29,Tools expense,REF42064903,135.78,0.0,235955.19
2020-09-30,2020-09-30,Service payment - Jimenez-Singh,REF60723622,0.0,823.11,236778.3
2020-09-30,2020-09-30,"Project payment - Harris, Haney and Lewis",REF30131957,0.0,1015.59,237793.89
2020-09-30,2020-09-30,"Service payment - Jackson, Madden and Fernandez",REF48341280,0.0,920.38,238714.27
2020-09-30,2020-09-30,Payment from Lowe-James,REF29051349,0.0,535.59,239249.86
2020-10-02,2020-10-02,Fuel purchase,REF62515575,263.44,0.0,238986.42
2020-10-03,2020-10-03,Tools expense,REF57672181,131.88,0.0,238854.54
2020-10-05,2020-10-05,Vehicle Maintenance expense,REF23686527,162.07,0.0,238692.47
2020-10-05,2020-10-05,Business materials,REF74083075,625.29,0.0,238067.18
2020-10-08,2020-10-08,Fuel purchase,REF33557097,335.65,0.0,237731.53
2020-10-10,2020-10-10,Permits Licenses expense,REF75032580,81.89,0.0,237649.64
2020-10-15,2020-10-15,Business insurance premium,REF76271392,196.24,0.0,237453.4
2020-10-15,2020-10-15,Service payment - Jimenez-Singh,REF69998156,0.0,631.67,238085.07
2020-10-15,2020-10-15,Project payment - Hughes LLC,REF80637315,0.0,1640.02,239725.09
2020-10-15,2020-10-15,"Service payment - Harris, Haney and Lewis",REF26241311,0.0,1011.75,240736.84
2020-10-15,2020-10-15,"Payment from Jackson, Madden and Fernandez",REF62559281,0.0,1119.6,241856.44
2020-10-15,2020-10-15,Payment from Lowe-James,REF47330036,0.0,706.44,242562.88
2020-10-18,2020-10-18,Subcontractors expense,REF85682515,977.06,0.0,241585.82
2020-10-22,2020-10-22,Safety Equipment expense,REF42771433,67.0,0.0,241518.82
2020-10-23,2020-10-23,Fuel purchase,REF97164377,256.27,0.0,241262.55
2020-10-27,2020-10-27,Business materials,REF98437844,357.22,0.0,240905.33
2020-10-30,2020-10-30,Service payment - Lowe-James,REF55724893,0.0,746.96,241652.29
2020-10-30,2020-10-30,Service payment - Hughes LLC,REF35674928,0.0,2412.59,244064.88
2020-10-30,2020-10-30,"Project payment - Harris, Haney and Lewis",REF89039582,0.0,886.56,244951.44
2020-10-30,2020-10-30,Invoice payment - Jimenez-Singh,REF84679504,0.0,639.66,245591.1
2020-11-01,2020-11-01,Business materials,REF10848180,747.46,0.0,244843.64
2020-11-01,2020-11-01,Vehicle Maintenance expense,REF63591893,154.97,0.0,244688.67
2020-11-01,2020-11-01,Subcontractors expense,REF73071349,418.38,0.0,244270.29
2020-11-15,2020-11-15,Fuel purchase,REF94918924,336.17,0.0,243934.12
2020-11-15,2020-11-15,"Project payment - Jackson, Madden and Fernandez",REF86329872,0.0,1328.8,245262.92
2020-11-15,2020-11-15,Business insurance premium,REF88991913,166.94,0.0,245095.98
2020-11-15,2020-11-15,Payment from Hughes LLC,REF41486462,0.0,1500.02,246596.0
2020-11-15,2020-11-15,"Payment from Harris, Haney and Lewis",REF62391355,0.0,831.58,247427.58
2020-11-15,2020-11-15,Invoice payment - Jimenez-Singh,REF21720919,0.0,439.58,247867.16
2020-11-15,2020-11-15,Safety Equipment expense,REF25674979,35.78,0.0,247831.38
2020-11-15,2020-11-15,Business materials,REF96508560,473.79,0.0,247357.59
2020-11-17,2020-11-17,Permits Licenses expense,REF44421030,68.0,0.0,247289.59
2020-11-18,2020-11-18,Vehicle Maintenance expense,REF55456815,106.63,0.0,247182.96
2020-11-25,2020-11-25,Fuel purchase,REF36212235,312.63,0.0,246870.33
2020-11-27,2020-11-27,Equipment Rental expense,REF63950513,347.39,0.0,246522.94
2020-11-28,2020-11-28,Tools expense,REF33590043,84.83,0.0,246438.11
2020-11-28,2020-11-28,Vehicle Maintenance expense,REF88473236,109.89,0.0,246328.22
2020-11-29,2020-11-29,Tools expense,REF15966808,67.92,0.0,246260.3
2020-11-30,2020-11-30,Project payment - Hughes LLC,REF32460632,0.0,1548.97,247809.27
2020-11-30,2020-11-30,"Invoice payment - Jackson, Madden and Fernandez",REF92304632,0.0,903.21,248712.48
2020-11-30,2020-11-30,Invoice payment - Jimenez-Singh,REF61395705,0.0,565.79,249278.27
2020-12-02,2020-12-02,Safety Equipment expense,REF55697725,25.84,0.0,249252.43
2020-12-05,2020-12-05,Business materials,REF47633244,589.37,0.0,248663.06
2020-12-06,2020-12-06,Subcontractors expense,REF86552594,224.77,0.0,248438.29
2020-12-06,2020-12-06,Business materials,REF64357272,502.13,0.0,247936.16
2020-12-09,2020-12-09,Fuel purchase,REF51276005,111.27,0.0,247824.89
2020-12-15,2020-12-15,"Payment from Harris, Haney and Lewis",REF89452439,0.0,685.6,248510.49
2020-12-15,2020-12-15,Service payment - Hughes LLC,REF19856512,0.0,975.74,249486.23
2020-12-15,2020-12-15,"Service payment - Jackson, Madden and Fernandez",REF13470037,0.0,694.17,250180.4
2020-12-15,2020-12-15,Project payment - Jimenez-Singh,REF27638460,0.0,413.68,250594.08
2020-12-15,2020-12-15,Business insurance premium,REF71919342,115.54,0.0,250478.54
2020-12-18,2020-12-18,Fuel purchase,REF74894628,200.82,0.0,250277.72
2020-12-22,2020-12-22,Tools expense,REF21054288,33.91,0.0,250243.81
2020-12-26,2020-12-26,Subcontractors expense,REF15897295,476.51,0.0,249767.3
2020-12-27,2020-12-27,Business materials,REF96365006,765.17,0.0,249002.13
2020-12-29,2020-12-29,Business materials,REF85568766,311.52,0.0,248690.61
2020-12-30,2020-12-30,Project payment - Jimenez-Singh,REF23317707,0.0,340.8,249031.41
2020-12-30,2020-12-30,"Service payment - Harris, Haney and Lewis",REF84912006,0.0,506.39,249537.8
2020-12-30,2020-12-30,"Project payment - Jackson, Madden and Fernandez",REF10385818,0.0,764.42,250302.22
2020-12-30,2020-12-30,Subcontractors expense,REF50998831,445.49,0.0,249856.73
2020-12-30,2020-12-30,Payment from Lowe-James,REF42859231,0.0,455.14,250311.87
2021-01-01,2021-01-01,Fuel purchase,REF98474463,244.41,0.0,250067.46
2021-01-03,2021-01-03,Business materials,REF13627754,558.25,0.0,249509.21
2021-01-04,2021-01-04,Business materials,REF94145652,407.29,0.0,249101.92
2021-01-06,2021-01-06,Fuel purchase,REF99973630,181.17,0.0,248920.75
2021-01-07,2021-01-07,Fuel purchase,REF39889081,277.2,0.0,248643.55
2021-01-09,2021-01-09,Business materials,REF87943456,512.87,0.0,248130.68
2021-01-13,2021-01-13,Business materials,REF56070546,593.6,0.0,247537.08
2021-01-14,2021-01-14,Business materials,REF67852303,477.33,0.0,247059.75
2021-01-15,2021-01-15,"Service payment - Jackson, Madden and Fernandez",REF37065371,0.0,764.49,247824.24
2021-01-15,2021-01-15,"Service payment - Harris, Haney and Lewis",REF54115461,0.0,667.72,248491.96
2021-01-15,2021-01-15,Invoice payment - Jimenez-Singh,REF28449457,0.0,563.19,249055.15
2021-01-15,2021-01-15,Invoice payment - Lowe-James,REF49777062,0.0,534.04,249589.19
2021-01-15,2021-01-15,Business insurance premium,REF35907174,136.01,0.0,249453.18
2021-01-23,2021-01-23,Business materials,REF76431107,350.89,0.0,249102.29
2021-01-25,2021-01-25,Equipment Rental expense,REF44475332,391.69,0.0,248710.6
2021-01-25,2021-01-25,Business materials,REF49166724,762.66,0.0,247947.94
2021-01-27,2021-01-27,Permits Licenses expense,REF23684431,47.37,0.0,247900.57
2021-01-28,2021-01-28,Safety Equipment expense,REF25650666,69.88,0.0,247830.69
2021-01-29,2021-01-29,Equipment Rental expense,REF21286467,372.4,0.0,247458.29
2021-01-30,2021-01-30,"Payment from Jackson, Madden and Fernandez",REF78791085,0.0,745.81,248204.1
2021-01-30,2021-01-30,Payment from Lowe-James,REF58226564,0.0,462.23,248666.33
2021-01-30,2021-01-30,"Invoice payment - Harris, Haney and Lewis",REF95275826,0.0,759.04,249425.37
2021-01-30,2021-01-30,Invoice payment - Jimenez-Singh,REF12745563,0.0,493.16,249918.53
2021-01-30,2021-01-30,Project payment - Hughes LLC,REF25212813,0.0,1300.76,251219.29
2021-02-01,2021-02-01,Tools expense,REF54498697,70.7,0.0,251148.59
2021-02-02,2021-02-02,Fuel purchase,REF53892556,264.6,0.0,250883.99
2021-02-06,2021-02-06,Equipment Rental expense,REF32382841,303.44,0.0,250580.55
2021-02-07,2021-02-07,Permits Licenses expense,REF52839590,51.67,0.0,250528.88
2021-02-12,2021-02-12,Fuel purchase,REF98113457,75.61,0.0,250453.27
2021-02-12,2021-02-12,Subcontractors expense,REF65895058,766.57,0.0,249686.7
2021-02-13,2021-02-13,Tools expense,REF62706566,56.98,0.0,249629.72
2021-02-15,2021-02-15,"Invoice payment - Harris, Haney and Lewis",REF45130166,0.0,721.36,250351.08
2021-02-15,2021-02-15,Fuel purchase,REF13529331,290.09,0.0,250060.99
2021-02-15,2021-02-15,"Service payment - Jackson, Madden and Fernandez",REF79889608,0.0,997.88,251058.87
2021-02-15,2021-02-15,Invoice payment - Hughes LLC,REF84946379,0.0,1946.11,253004.98
2021-02-15,2021-02-15,Service payment - Jimenez-Singh,REF31652633,0.0,667.9,253672.88
2021-02-15,2021-02-15,Project payment - Lowe-James,REF95936866,0.0,609.71,254282.59
2021-02-15,2021-02-15,Business insurance premium,REF63392991,154.17,0.0,254128.42
2021-02-16,2021-02-16,Subcontractors expense,REF48522513,690.07,0.0,253438.35
2021-02-22,2021-02-22,Business materials,REF57537577,521.62,0.0,252916.73
2021-02-24,2021-02-24,Tools expense,REF61872110,73.63,0.0,252843.1
2021-02-25,2021-02-25,Business materials,REF73458468,572.21,0.0,252270.89
2021-02-26,2021-02-26,Tools expense,REF91003366,90.64,0.0,252180.25
2021-02-27,2021-02-27,Fuel purchase,REF65329732,174.42,0.0,252005.83
2021-02-27,2021-02-27,Business materials,REF96146551,727.63,0.0,251278.2
2021-02-28,2021-02-28,Invoice payment - Jimenez-Singh,REF78782302,0.0,359.3,251637.5
2021-02-28,2021-02-28,Project payment - Lowe-James,REF91109643,0.0,680.75,252318.25
2021-02-28,2021-02-28,"Service payment - Harris, Haney and Lewis",REF17332930,0.0,843.62,253161.87
2021-02-28,2021-02-28,"Project payment - Jackson, Madden and Fernandez",REF94567258,0.0,1171.2,254333.07
2021-03-04,2021-03-04,Business materials,REF67191956,895.2,0.0,253437.87
2021-03-10,2021-03-10,Permits Licenses expense,REF61524941,47.01,0.0,253390.86
2021-03-10,2021-03-10,Fuel purchase,REF94811296,285.69,0.0,253105.17
2021-03-15,2021-03-15,Project payment - Lowe-James,REF14701396,0.0,906.69,254011.86
2021-03-15,2021-03-15,Project payment - Jimenez-Singh,REF27257397,0.0,542.38,254554.24
2021-03-15,2021-03-15,Business insurance premium,REF60513825,205.31,0.0,254348.93
2021-03-15,2021-03-15,"Payment from Jackson, Madden and Fernandez",REF37135395,0.0,1041.96,255390.89
2021-03-15,2021-03-15,Service payment - Hughes LLC,REF54476472,0.0,2090.85,257481.74
2021-03-17,2021-03-17,Permits Licenses expense,REF43629583,61.26,0.0,257420.48
2021-03-18,2021-03-18,Fuel purchase,REF65647109,263.14,0.0,257157.34
2021-03-19,2021-03-19,Fuel purchase,REF52601817,383.87,0.0,256773.47
2021-03-20,2021-03-20,Safety Equipment expense,REF50642319,60.48,0.0,256712.99
2021-03-21,2021-03-21,Fuel purchase,REF49078315,215.78,0.0,256497.21
2021-03-22,2021-03-22,Tools expense,REF26683851,122.7,0.0,256374.51
2021-03-25,2021-03-25,Fuel purchase,REF52626409,508.75,0.0,255865.76
2021-03-30,2021-03-30,Service payment - Lowe-James,REF78338818,0.0,1041.87,256907.63
2021-03-30,2021-03-30,Subcontractors expense,REF50835925,615.05,0.0,256292.58
2021-03-30,2021-03-30,Project payment - Hughes LLC,REF88225028,0.0,1839.65,258132.23
2021-03-30,2021-03-30,"Payment from Jackson, Madden and Fernandez",REF22709335,0.0,1555.55,259687.78
2021-03-30,2021-03-30,"Project payment - Harris, Haney and Lewis",REF40383554,0.0,986.02,260673.8
2021-04-04,2021-04-04,Permits Licenses expense,REF16287537,148.5,0.0,260525.3
2021-04-12,2021-04-12,Permits Licenses expense,REF50231823,72.52,0.0,260452.78
2021-04-12,2021-04-12,Subcontractors expense,REF84735581,590.85,0.0,259861.93
2021-04-15,2021-04-15,Business insurance premium,REF20513032,225.15,0.0,259636.78
2021-04-15,2021-04-15,"Service payment - Harris, Haney and Lewis",REF26247042,0.0,1466.13,261102.91
2021-04-15,2021-04-15,"Invoice payment - Jackson, Madden and Fernandez",REF18339790,0.0,1590.23,262693.14
2021-04-15,2021-04-15,Project payment - Jimenez-Singh,REF20934748,0.0,599.74,263292.88
2021-04-15,2021-04-15,Invoice payment - Lowe-James,REF99254031,0.0,868.75,264161.63
2021-04-15,2021-04-15,Business materials,REF46684014,821.25,0.0,263340.38
2021-04-15,2021-04-15,Invoice payment - Hughes LLC,REF73378130,0.0,3026.46,266366.84
2021-04-18,2021-04-18,Business materials,REF25771598,1108.64,0.0,265258.2
2021-04-23,2021-04-23,Vehicle Maintenance expense,REF32998221,242.31,0.0,265015.89
2021-04-23,2021-04-23,Safety Equipment expense,REF56963573,135.95,0.0,264879.94
2021-04-25,2021-04-25,Fuel purchase,REF66504757,285.91,0.0,264594.03
2021-04-30,2021-04-30,Service payment - Lowe-James,REF57241796,0.0,471.77,265065.8
2021-04-30,2021-04-30,"Invoice payment - Harris, Haney and Lewis",REF62213036,0.0,1465.84,266531.64
2021-04-30,2021-04-30,Service payment - Hughes LLC,REF55857477,0.0,2296.02,268827.66
2021-04-30,2021-04-30,Invoice payment - Jimenez-Singh,REF32010055,0.0,831.07,269658.73
2021-04-30,2021-04-30,"Service payment - Jackson, Madden and Fernandez",REF12248484,0.0,1058.7,270717.43
2021-05-01,2021-05-01,Permits Licenses expense,REF43676001,76.08,0.0,270641.35
2021-05-01,2021-05-01,Business materials,REF75652431,686.23,0.0,269955.12
2021-05-06,2021-05-06,Vehicle Maintenance expense,REF33739291,226.47,0.0,269728.65
2021-05-06,2021-05-06,Tools expense,REF34265942,122.44,0.0,269606.21
2021-05-08,2021-05-08,Vehicle Maintenance expense,REF52727688,168.41,0.0,269437.8
2021-05-08,2021-05-08,Equipment Rental expense,REF18953080,283.1,0.0,269154.7
2021-05-11,2021-05-11,Subcontractors expense,REF32944765,1542.17,0.0,267612.53
2021-05-13,2021-05-13,Subcontractors expense,REF32483067,1422.51,0.0,266190.02
2021-05-15,2021-05-15,Project payment - Lowe-James,REF55696693,0.0,908.81,267098.83
2021-05-15,2021-05-15,Project payment - Jimenez-Singh,REF96974782,0.0,976.48,268075.31
2021-05-15,2021-05-15,"Service payment - Jackson, Madden and Fernandez",REF93023700,0.0,2025.53,270100.84
2021-05-15,2021-05-15,"Service payment - Harris, Haney and Lewis",REF42557205,0.0,1454.93,271555.77
2021-05-15,2021-05-15,Business insurance premium,REF40468140,277.99,0.0,271277.78
2021-05-15,2021-05-15,Fuel purchase,REF99120121,198.9,0.0,271078.88
2021-05-17,2021-05-17,Fuel purchase,REF36268295,559.36,0.0,270519.52
2021-05-21,2021-05-21,Permits Licenses expense,REF93948973,71.18,0.0,270448.34
2021-05-24,2021-05-24,Business materials,REF93587787,1268.8,0.0,269179.54
2021-05-25,2021-05-25,Business materials,REF46354812,864.42,0.0,268315.12
2021-05-27,2021-05-27,Subcontractors expense,REF18390769,1609.8,0.0,266705.32
2021-05-30,2021-05-30,Project payment - Jimenez-Singh,REF58395696,0.0,1081.94,267787.26
2021-05-30,2021-05-30,"Payment from Harris, Haney and Lewis",REF24791112,0.0,1424.42,269211.68
2021-05-30,2021-05-30,"Payment from Jackson, Madden and Fernandez",REF41901280,0.0,2001.68,271213.36
2021-05-30,2021-05-30,Service payment - Lowe-James,REF89163036,0.0,780.71,271994.07
2021-06-02,2021-06-02,Fuel purchase,REF51492181,463.32,0.0,271530.75
2021-06-03,2021-06-03,Safety Equipment expense,REF10534728,80.93,0.0,271449.82
2021-06-04,2021-06-04,Business materials,REF92049413,870.78,0.0,270579.04
2021-06-05,2021-06-05,Business materials,REF12465722,1279.72,0.0,269299.32
2021-06-12,2021-06-12,Permits Licenses expense,REF35985302,156.72,0.0,269142.6
2021-06-12,2021-06-12,Safety Equipment expense,REF57403888,119.98,0.0,269022.62
2021-06-13,2021-06-13,Business materials,REF99320616,817.17,0.0,268205.45
2021-06-13,2021-06-13,Fuel purchase,REF61627570,470.49,0.0,267734.96
2021-06-14,2021-06-14,Fuel purchase,REF70703652,311.91,0.0,267423.05
2021-06-15,2021-06-15,Permits Licenses expense,REF23533161,72.85,0.0,267350.2
2021-06-15,2021-06-15,"Payment from Harris, Haney and Lewis",REF47521210,0.0,1580.46,268930.66
2021-06-15,2021-06-15,Invoice payment - Lowe-James,REF87411563,0.0,1185.79,270116.45
2021-06-15,2021-06-15,Business insurance premium,REF94547899,246.16,0.0,269870.29
2021-06-15,2021-06-15,Project payment - Jimenez-Singh,REF88909206,0.0,885.51,270755.8
2021-06-15,2021-06-15,"Payment from Jackson, Madden and Fernandez",REF98429463,0.0,1407.78,272163.58
2021-06-15,2021-06-15,Service payment - Hughes LLC,REF55229717,0.0,2068.22,274231.8
2021-06-17,2021-06-17,Business materials,REF65878434,775.74,0.0,273456.06
2021-06-18,2021-06-18,Business materials,REF33599147,974.64,0.0,272481.42
2021-06-19,2021-06-19,Fuel purchase,REF65173158,364.18,0.0,272117.24
2021-06-20,2021-06-20,Fuel purchase,REF65439462,259.82,0.0,271857.42
2021-06-24,2021-06-24,Permits Licenses expense,REF70525516,118.33,0.0,271739.09
2021-06-25,2021-06-25,Permits Licenses expense,REF23217133,45.61,0.0,271693.48
2021-06-26,2021-06-26,Business materials,REF30457886,987.32,0.0,270706.16
2021-06-30,2021-06-30,Project payment - Hughes LLC,REF67558456,0.0,2574.25,273280.41
2021-06-30,2021-06-30,Service payment - Jimenez-Singh,REF65226599,0.0,848.2,274128.61
2021-06-30,2021-06-30,"Invoice payment - Jackson, Madden and Fernandez",REF78999550,0.0,1245.68,275374.29
2021-06-30,2021-06-30,"Project payment - Harris, Haney and Lewis",REF69139666,0.0,1321.04,276695.33
2021-07-01,2021-07-01,Permits Licenses expense,REF99708979,75.97,0.0,276619.36
2021-07-02,2021-07-02,Fuel purchase,REF36698177,427.61,0.0,276191.75
2021-07-05,2021-07-05,Business materials,REF47509197,1231.01,0.0,274960.74
2021-07-06,2021-07-06,Tools expense,REF63448241,91.9,0.0,274868.84
2021-07-14,2021-07-14,Permits Licenses expense,REF99053433,120.02,0.0,274748.82
2021-07-15,2021-07-15,Invoice payment - Lowe-James,REF75625026,0.0,941.29,275690.11
2021-07-15,2021-07-15,Business insurance premium,REF93002120,240.7,0.0,275449.41
2021-07-15,2021-07-15,Safety Equipment expense,REF96205120,64.21,0.0,275385.2
2021-07-15,2021-07-15,"Service payment - Jackson, Madden and Fernandez",REF68048596,0.0,1394.05,276779.25
2021-07-17,2021-07-17,Fuel purchase,REF91499773,241.67,0.0,276537.58
2021-07-19,2021-07-19,Fuel purchase,REF85336195,387.37,0.0,276150.21
2021-07-20,2021-07-20,Vehicle Maintenance expense,REF40536920,256.17,0.0,275894.04
2021-07-27,2021-07-27,Fuel purchase,REF68124707,210.04,0.0,275684.0
2021-07-27,2021-07-27,Tools expense,REF24574439,199.01,0.0,275484.99
2021-07-30,2021-07-30,Fuel purchase,REF38153625,308.44,0.0,275176.55
2021-07-30,2021-07-30,Project payment - Hughes LLC,REF71581014,0.0,1842.72,277019.27
2021-07-30,2021-07-30,Payment from Lowe-James,REF71590548,0.0,1047.1,278066.37
2021-07-30,2021-07-30,"Payment from Harris, Haney and Lewis",REF30023577,0.0,1301.41,279367.78
2021-07-30,2021-07-30,Payment from Jimenez-Singh,REF80709668,0.0,610.67,279978.45
2021-07-31,2021-07-31,Fuel purchase,REF56385040,391.97,0.0,279586.48
2021-08-02,2021-08-02,Fuel purchase,REF64523956,336.39,0.0,279250.09
2021-08-04,2021-08-04,Business materials,REF41169708,1055.35,0.0,278194.74
2021-08-10,2021-08-10,Business materials,REF44317495,1180.22,0.0,277014.52
2021-08-13,2021-08-13,Subcontractors expense,REF31440114,1287.23,0.0,275727.29
2021-08-15,2021-08-15,Business insurance premium,REF54530114,251.65,0.0,275475.64
2021-08-15,2021-08-15,Invoice payment - Jimenez-Singh,REF14583354,0.0,885.23,276360.87
2021-08-15,2021-08-15,Invoice payment - Hughes LLC,REF76387471,0.0,2753.69,279114.56
2021-08-15,2021-08-15,"Service payment - Harris, Haney and Lewis",REF66696611,0.0,1170.81,280285.37
2021-08-15,2021-08-15,"Payment from Jackson, Madden and Fernandez",REF16687405,0.0,1626.91,281912.28
2021-08-15,2021-08-15,Service payment - Lowe-James,REF14380032,0.0,867.18,282779.46
2021-08-16,2021-08-16,Vehicle Maintenance expense,REF84683424,192.88,0.0,282586.58
2021-08-18,2021-08-18,Business materials,REF22361326,710.74,0.0,281875.84
2021-08-18,2021-08-18,Fuel purchase,REF49836851,353.68,0.0,281522.16
2021-08-19,2021-08-19,Business materials,REF57007140,1098.7,0.0,280423.46
2021-08-23,2021-08-23,Permits Licenses expense,REF93792420,75.21,0.0,280348.25
2021-08-24,2021-08-24,Subcontractors expense,REF51561987,620.56,0.0,279727.69
2021-08-29,2021-08-29,Tools expense,REF86228379,38.52,0.0,279689.17
2021-08-29,2021-08-29,Business materials,REF12550723,1068.23,0.0,278620.94
2021-08-30,2021-08-30,"Invoice payment - Harris, Haney and Lewis",REF55883745,0.0,958.54,279579.48
2021-08-30,2021-08-30,Tools expense,REF58275583,176.66,0.0,279402.82
2021-08-30,2021-08-30,Service payment - Hughes LLC,REF82684890,0.0,2160.0,281562.82
2021-08-30,2021-08-30,"Payment from Jackson, Madden and Fernandez",REF43441014,0.0,1253.51,282816.33
2021-08-30,2021-08-30,Service payment - Jimenez-Singh,REF72356998,0.0,893.12,283709.45
2021-08-30,2021-08-30,Service payment - Lowe-James,REF98744787,0.0,984.28,284693.73
2021-09-03,2021-09-03,Fuel purchase,REF77604450,175.44,0.0,284518.29
2021-09-03,2021-09-03,Business materials,REF29804778,283.61,0.0,284234.68
2021-09-05,2021-09-05,Fuel purchase,REF17982993,440.92,0.0,283793.76
2021-09-06,2021-09-06,Vehicle Maintenance expense,REF85503989,141.23,0.0,283652.53
2021-09-06,2021-09-06,Business materials,REF22855674,630.11,0.0,283022.42
2021-09-07,2021-09-07,Permits Licenses expense,REF20237124,108.41,0.0,282914.01
2021-09-10,2021-09-10,Fuel purchase,REF46956714,262.32,0.0,282651.69
2021-09-12,2021-09-12,Vehicle Maintenance expense,REF72720300,204.06,0.0,282447.63
2021-09-12,2021-09-12,Business materials,REF55543102,695.57,0.0,281752.06
2021-09-15,2021-09-15,Business insurance premium,REF50161037,225.33,0.0,281526.73
2021-09-15,2021-09-15,Invoice payment - Lowe-James,REF72895543,0.0,963.89,282490.62
2021-09-15,2021-09-15,Payment from Jimenez-Singh,REF75860609,0.0,688.2,283178.82
2021-09-15,2021-09-15,Service payment - Hughes LLC,REF57453353,0.0,2057.61,285236.43
2021-09-15,2021-09-15,Vehicle Maintenance expense,REF13775018,138.94,0.0,285097.49
2021-09-15,2021-09-15,"Invoice payment - Jackson, Madden and Fernandez",REF84389484,0.0,1447.62,286545.11
2021-09-18,2021-09-18,Business materials,REF12015927,481.8,0.0,286063.31
2021-09-19,2021-09-19,Fuel purchase,REF53519185,428.36,0.0,285634.95
2021-09-24,2021-09-24,Tools expense,REF17205942,105.73,0.0,285529.22
2021-09-25,2021-09-25,Safety Equipment expense,REF80289662,103.8,0.0,285425.42
2021-09-30,2021-09-30,Service payment - Hughes LLC,REF44378970,0.0,2021.36,287446.78
2021-09-30,2021-09-30,"Service payment - Harris, Haney and Lewis",REF85123953,0.0,1029.94,288476.72
2021-10-02,2021-10-02,Safety Equipment expense,REF11934506,61.86,0.0,288414.86
2021-10-05,2021-10-05,Permits Licenses expense,REF62784870,96.47,0.0,288318.39
2021-10-12,2021-10-12,Permits Licenses expense,REF24859124,56.84,0.0,288261.55
2021-10-13,2021-10-13,Business materials,REF59338025,1202.02,0.0,287059.53
2021-10-15,2021-10-15,"Payment from Jackson, Madden and Fernandez",REF45754747,0.0,1295.84,288355.37
2021-10-15,2021-10-15,Project payment - Hughes LLC,REF26757206,0.0,2126.21,290481.58
2021-10-15,2021-10-15,Payment from Lowe-James,REF83956324,0.0,815.64,291297.22
2021-10-15,2021-10-15,Business insurance premium,REF87575804,196.5,0.0,291100.72
2021-10-15,2021-10-15,Invoice payment - Jimenez-Singh,REF45879815,0.0,781.36,291882.08
2021-10-15,2021-10-15,"Project payment - Harris, Haney and Lewis",REF55832012,0.0,1016.08,292898.16
2021-10-17,2021-10-17,Business materials,REF17133412,1208.7,0.0,291689.46
2021-10-19,2021-10-19,Permits Licenses expense,REF63194591,103.38,0.0,291586.08
2021-10-19,2021-10-19,Business materials,REF50270286,592.9,0.0,290993.18
2021-10-23,2021-10-23,Tools expense,REF71578712,86.51,0.0,290906.67
2021-10-30,2021-10-30,Business materials,REF16675783,990.06,0.0,289916.61
2021-10-30,2021-10-30,"Invoice payment - Harris, Haney and Lewis",REF10952823,0.0,909.31,290825.92
2021-10-30,2021-10-30,"Invoice payment - Jackson, Madden and Fernandez",REF56804382,0.0,1203.68,292029.6
2021-10-30,2021-10-30,Project payment - Lowe-James,REF95790059,0.0,822.19,292851.79
2021-10-30,2021-10-30,Payment from Hughes LLC,REF64899850,0.0,1954.44,294806.23
2021-11-05,2021-11-05,Business materials,REF74710543,739.49,0.0,294066.74
2021-11-06,2021-11-06,Tools expense,REF49596413,106.13,0.0,293960.61
2021-11-11,2021-11-11,Fuel purchase,REF19030608,189.62,0.0,293770.99
2021-11-15,2021-11-15,Business insurance premium,REF66855562,163.45,0.0,293607.54
2021-11-15,2021-11-15,Fuel purchase,REF77184027,246.71,0.0,293360.83
2021-11-15,2021-11-15,Payment from Lowe-James,REF77134225,0.0,744.53,294105.36
2021-11-15,2021-11-15,Invoice payment - Jimenez-Singh,REF74845993,0.0,515.69,294621.05
2021-11-15,2021-11-15,"Project payment - Jackson, Madden and Fernandez",REF39959181,0.0,984.58,295605.63
2021-11-15,2021-11-15,"Invoice payment - Harris, Haney and Lewis",REF35670807,0.0,718.37,296324.0
2021-11-15,2021-11-15,Invoice payment - Hughes LLC,REF13956824,0.0,1483.29,297807.29
2021-11-16,2021-11-16,Fuel purchase,REF17647752,189.28,0.0,297618.01
2021-11-19,2021-11-19,Fuel purchase,REF75038263,237.66,0.0,297380.35
2021-11-20,2021-11-20,Permits Licenses expense,REF82252967,33.55,0.0,297346.8
2021-11-22,2021-11-22,Business materials,REF22720251,684.94,0.0,296661.86
2021-11-23,2021-11-23,Permits Licenses expense,REF35764644,47.45,0.0,296614.41
2021-11-23,2021-11-23,Subcontractors expense,REF14201002,949.67,0.0,295664.74
2021-11-27,2021-11-27,Business materials,REF34611350,385.64,0.0,295279.1
2021-11-30,2021-11-30,"Payment from Jackson, Madden and Fernandez",REF89975365,0.0,794.14,296073.24
2021-11-30,2021-11-30,"Invoice payment - Harris, Haney and Lewis",REF41776101,0.0,883.68,296956.92
2021-11-30,2021-11-30,Payment from Jimenez-Singh,REF42980570,0.0,580.83,297537.75
2021-11-30,2021-11-30,Invoice payment - Lowe-James,REF94480728,0.0,586.75,298124.5
2021-12-02,2021-12-02,Business materials,REF63274803,446.44,0.0,297678.06
2021-12-02,2021-12-02,Fuel purchase,REF22168482,179.64,0.0,297498.42
2021-12-07,2021-12-07,Permits Licenses expense,REF49335817,46.33,0.0,297452.09
2021-12-13,2021-12-13,Tools expense,REF76500435,57.84,0.0,297394.25
2021-12-14,2021-12-14,Business materials,REF52129289,506.8,0.0,296887.45
2021-12-15,2021-12-15,Payment from Jimenez-Singh,REF12349840,0.0,376.23,297263.68
2021-12-15,2021-12-15,Business insurance premium,REF60420102,123.22,0.0,297140.46
2021-12-15,2021-12-15,Invoice payment - Hughes LLC,REF25177495,0.0,1343.75,298484.21
2021-12-15,2021-12-15,"Invoice payment - Harris, Haney and Lewis",REF34216177,0.0,572.32,299056.53
2021-12-15,2021-12-15,"Payment from Jackson, Madden and Fernandez",REF94555324,0.0,658.41,299714.94
2021-12-17,2021-12-17,Fuel purchase,REF47606416,191.2,0.0,299523.74
2021-12-17,2021-12-17,Business materials,REF51271455,547.13,0.0,298976.61
2021-12-19,2021-12-19,Subcontractors expense,REF97321556,560.36,0.0,298416.25
2021-12-21,2021-12-21,Equipment Rental expense,REF65120443,90.0,0.0,298326.25
2021-12-21,2021-12-21,Fuel purchase,REF79536068,173.87,0.0,298152.38
2021-12-22,2021-12-22,Permits Licenses expense,REF76043916,73.97,0.0,298078.41
2021-12-25,2021-12-25,Subcontractors expense,REF87551779,491.86,0.0,297586.55
2021-12-30,2021-12-30,Invoice payment - Lowe-James,REF89389095,0.0,468.54,298055.09
2021-12-30,2021-12-30,"Payment from Jackson, Madden and Fernandez",REF26706434,0.0,814.36,298869.45
2021-12-30,2021-12-30,Payment from Jimenez-Singh,REF98868382,0.0,362.54,299231.99
2021-12-30,2021-12-30,"Service payment - Harris, Haney and Lewis",REF87714533,0.0,615.72,299847.71
2021-12-30,2021-12-30,Invoice payment - Hughes LLC,REF20286137,0.0,878.53,300726.24
2021-12-30,2021-12-30,Tools expense,REF14084249,75.34,0.0,300650.9
2022-01-05,2022-01-05,Equipment Rental expense,REF73065004,286.24,0.0,300364.66
2022-01-06,2022-01-06,Business materials,REF30468667,365.73,0.0,299998.93
2022-01-13,2022-01-13,Equipment Rental expense,REF53695816,321.44,0.0,299677.49
2022-01-15,2022-01-15,"Project payment - Jackson, Madden and Fernandez",REF89245994,0.0,877.92,300555.41
2022-01-15,2022-01-15,"Project payment - Harris, Haney and Lewis",REF56991483,0.0,879.21,301434.62
2022-01-15,2022-01-15,Payment from Lowe-James,REF71446514,0.0,555.12,301989.74
2022-01-15,2022-01-15,Payment from Jimenez-Singh,REF83790058,0.0,475.4,302465.14
2022-01-15,2022-01-15,Business insurance premium,REF49115181,151.0,0.0,302314.14
2022-01-15,2022-01-15,Invoice payment - Hughes LLC,REF94170983,0.0,1105.9,303420.04
2022-01-21,2022-01-21,Subcontractors expense,REF37405775,1026.63,0.0,302393.41
2022-01-23,2022-01-23,Business materials,REF93851614,647.19,0.0,301746.22
2022-01-25,2022-01-25,Permits Licenses expense,REF10369366,45.81,0.0,301700.41
2022-01-25,2022-01-25,Fuel purchase,REF99971975,187.44,0.0,301512.97
2022-01-28,2022-01-28,Business materials,REF92520595,486.69,0.0,301026.28
2022-01-28,2022-01-28,Fuel purchase,REF16114092,232.63,0.0,300793.65
2022-01-29,2022-01-29,Tools expense,REF58072127,43.59,0.0,300750.06
2022-01-30,2022-01-30,Project payment - Jimenez-Singh,REF91800221,0.0,365.92,301115.98
2022-01-30,2022-01-30,Invoice payment - Hughes LLC,REF45719069,0.0,1211.24,302327.22
2022-01-30,2022-01-30,"Project payment - Harris, Haney and Lewis",REF20300307,0.0,685.99,303013.21
2022-01-30,2022-01-30,Invoice payment - Lowe-James,REF36377116,0.0,396.65,303409.86
2022-01-30,2022-01-30,"Service payment - Jackson, Madden and Fernandez",REF95301794,0.0,915.3,304325.16
2022-01-30,2022-01-30,Tools expense,REF70574478,82.71,0.0,304242.45
2022-02-02,2022-02-02,Business materials,REF59064117,361.39,0.0,303881.06
2022-02-03,2022-02-03,Business materials,REF77373642,636.75,0.0,303244.31
2022-02-03,2022-02-03,Fuel purchase,REF45746348,339.41,0.0,302904.9
2022-02-08,2022-02-08,Fuel purchase,REF71719200,204.82,0.0,302700.08
2022-02-10,2022-02-10,Safety Equipment expense,REF86205287,109.15,0.0,302590.93
2022-02-11,2022-02-11,Vehicle Maintenance expense,REF42745859,132.92,0.0,302458.01
2022-02-11,2022-02-11,Business materials,REF17567694,451.93,0.0,302006.08
2022-02-15,2022-02-15,Invoice payment - Lowe-James,REF70133043,0.0,619.32,302625.4
2022-02-15,2022-02-15,Project payment - Hughes LLC,REF47495199,0.0,1558.18,304183.58
2022-02-15,2022-02-15,Business insurance premium,REF85365227,164.54,0.0,304019.04
2022-02-15,2022-02-15,"Payment from Jackson, Madden and Fernandez",REF74040202,0.0,863.94,304882.98
2022-02-15,2022-02-15,"Service payment - Harris, Haney and Lewis",REF82711608,0.0,1067.6,305950.58
2022-02-15,2022-02-15,Project payment - Jimenez-Singh,REF41644938,0.0,554.5,306505.08
2022-02-16,2022-02-16,Equipment Rental expense,REF87996797,318.22,0.0,306186.86
2022-02-20,2022-02-20,Business materials,REF26389661,587.84,0.0,305599.02
2022-02-20,2022-02-20,Fuel purchase,REF19299155,241.16,0.0,305357.86
2022-02-25,2022-02-25,Fuel purchase,REF19872074,345.24,0.0,305012.62
2022-02-27,2022-02-27,Business materials,REF11138287,586.1,0.0,304426.52
2022-02-28,2022-02-28,Safety Equipment expense,REF53278261,47.49,0.0,304379.03
2022-02-28,2022-02-28,Payment from Lowe-James,REF72551639,0.0,766.13,305145.16
2022-02-28,2022-02-28,"Service payment - Harris, Haney and Lewis",REF95911625,0.0,981.28,306126.44
2022-02-28,2022-02-28,"Payment from Jackson, Madden and Fernandez",REF18216355,0.0,957.2,307083.64
2022-02-28,2022-02-28,Payment from Hughes LLC,REF64268820,0.0,1715.47,308799.11
2022-02-28,2022-02-28,Business materials,REF16125200,767.7,0.0,308031.41
2022-03-01,2022-03-01,Business materials,REF77973428,882.78,0.0,307148.63
2022-03-04,2022-03-04,Fuel purchase,REF59951021,341.13,0.0,306807.5
2022-03-11,2022-03-11,Fuel purchase,REF95467473,225.65,0.0,306581.85
2022-03-13,2022-03-13,Fuel purchase,REF62800903,536.21,0.0,306045.64
2022-03-15,2022-03-15,"Service payment - Jackson, Madden and Fernandez",REF34131751,0.0,1399.71,307445.35
2022-03-15,2022-03-15,Business insurance premium,REF58621729,200.63,0.0,307244.72
2022-03-15,2022-03-15,Service payment - Lowe-James,REF62987435,0.0,548.4,307793.12
2022-03-15,2022-03-15,"Service payment - Harris, Haney and Lewis",REF99552371,0.0,1310.7,309103.82
2022-03-15,2022-03-15,Vehicle Maintenance expense,REF35317101,120.97,0.0,308982.85
2022-03-15,2022-03-15,Service payment - Jimenez-Singh,REF91540637,0.0,722.55,309705.4
2022-03-21,2022-03-21,Tools expense,REF34071297,46.29,0.0,309659.11
2022-03-24,2022-03-24,Business materials,REF95717887,558.72,0.0,309100.39
2022-03-28,2022-03-28,Permits Licenses expense,REF12415427,83.84,0.0,309016.55
2022-03-29,2022-03-29,Tools expense,REF10779933,94.95,0.0,308921.6
2022-03-30,2022-03-30,"Invoice payment - Harris, Haney and Lewis",REF13900233,0.0,1114.92,310036.52
2022-03-30,2022-03-30,Payment from Lowe-James,REF84973662,0.0,665.41,310701.93
2022-03-30,2022-03-30,Service payment - Jimenez-Singh,REF60532804,0.0,618.91,311320.84
2022-03-30,2022-03-30,"Invoice payment - Jackson, Madden and Fernandez",REF44819766,0.0,1136.0,312456.84
2022-03-30,2022-03-30,Service payment - Hughes LLC,REF31421995,0.0,2070.2,314527.04
2022-04-09,2022-04-09,Business materials,REF93643641,1211.94,0.0,313315.1
2022-04-12,2022-04-12,Business materials,REF95292366,1717.35,0.0,311597.75
2022-04-13,2022-04-13,Business materials,REF11171765,320.0,0.0,311277.75
2022-04-14,2022-04-14,Safety Equipment expense,REF41114766,110.05,0.0,311167.7
2022-04-15,2022-04-15,Business insurance premium,REF37919292,235.89,0.0,310931.81
2022-04-15,2022-04-15,Business materials,REF90661567,365.11,0.0,310566.7
2022-04-15,2022-04-15,Project payment - Hughes LLC,REF68854428,0.0,3022.58,313589.28
2022-04-15,2022-04-15,Payment from Lowe-James,REF21399689,0.0,830.41,314419.69
2022-04-15,2022-04-15,"Invoice payment - Jackson, Madden and Fernandez",REF72876102,0.0,1624.16,316043.85
2022-04-15,2022-04-15,"Payment from Harris, Haney and Lewis",REF26450327,0.0,1245.29,317289.14
2022-04-15,2022-04-15,Payment from Jimenez-Singh,REF87191168,0.0,718.36,318007.5
2022-04-16,2022-04-16,Vehicle Maintenance expense,REF52902633,156.17,0.0,317851.33
2022-04-17,2022-04-17,Subcontractors expense,REF45886383,654.92,0.0,317196.41
2022-04-22,2022-04-22,Permits Licenses expense,REF74433169,103.77,0.0,317092.64
2022-04-23,2022-04-23,Business materials,REF80607674,810.28,0.0,316282.36
2022-04-23,2022-04-23,Tools expense,REF26591486,88.63,0.0,316193.73
2022-04-26,2022-04-26,Fuel purchase,REF59837927,438.45,0.0,315755.28
2022-04-26,2022-04-26,Business materials,REF38964409,662.59,0.0,315092.69
2022-04-27,2022-04-27,Vehicle Maintenance expense,REF82614247,210.94,0.0,314881.75
2022-04-30,2022-04-30,Payment from Lowe-James,REF49930917,0.0,788.59,315670.34
2022-04-30,2022-04-30,Invoice payment - Jimenez-Singh,REF84426433,0.0,802.76,316473.1
2022-04-30,2022-04-30,Fuel purchase,REF69716628,191.02,0.0,316282.08
2022-04-30,2022-04-30,"Project payment - Harris, Haney and Lewis",REF70342707,0.0,1342.87,317624.95
2022-04-30,2022-04-30,"Invoice payment - Jackson, Madden and Fernandez",REF52992582,0.0,1619.05,319244.0
2022-05-11,2022-05-11,Business materials,REF95197491,1234.13,0.0,318009.87
2022-05-14,2022-05-14,Fuel purchase,REF10750581,508.09,0.0,317501.78
2022-05-15,2022-05-15,Business insurance premium,REF59381683,251.3,0.0,317250.48
2022-05-15,2022-05-15,"Project payment - Harris, Haney and Lewis",REF20978181,0.0,1232.09,318482.57
2022-05-15,2022-05-15,"Service payment - Jackson, Madden and Fernandez",REF22697946,0.0,1603.96,320086.53
2022-05-15,2022-05-15,Invoice payment - Hughes LLC,REF78377534,0.0,3294.01,323380.54
2022-05-17,2022-05-17,Permits Licenses expense,REF81427474,79.88,0.0,323300.66
2022-05-20,2022-05-20,Business materials,REF65927969,1072.15,0.0,322228.51
2022-05-21,2022-05-21,Permits Licenses expense,REF91186734,88.14,0.0,322140.37
2022-05-22,2022-05-22,Equipment Rental expense,REF35160679,631.26,0.0,321509.11
2022-05-25,2022-05-25,Safety Equipment expense,REF54299002,108.96,0.0,321400.15
2022-05-25,2022-05-25,Fuel purchase,REF78533008,205.89,0.0,321194.26
2022-05-28,2022-05-28,Tools expense,REF51713220,127.68,0.0,321066.58
2022-05-30,2022-05-30,"Service payment - Harris, Haney and Lewis",REF18581669,0.0,1327.05,322393.63
2022-05-30,2022-05-30,"Payment from Jackson, Madden and Fernandez",REF95707264,0.0,1758.72,324152.35
2022-05-30,2022-05-30,Project payment - Lowe-James,REF93314116,0.0,998.13,325150.48
2022-05-30,2022-05-30,Project payment - Jimenez-Singh,REF72437608,0.0,666.24,325816.72
2022-05-31,2022-05-31,Tools expense,REF81647196,118.57,0.0,325698.15
2022-06-03,2022-06-03,Tools expense,REF42982140,137.11,0.0,325561.04
2022-06-05,2022-06-05,Business materials,REF98033959,1606.2,0.0,323954.84
2022-06-07,2022-06-07,Business materials,REF59121942,1243.12,0.0,322711.72
2022-06-08,2022-06-08,Fuel purchase,REF89233683,380.12,0.0,322331.6
2022-06-08,2022-06-08,Permits Licenses expense,REF11470845,45.35,0.0,322286.25
2022-06-10,2022-06-10,Fuel purchase,REF47656278,357.3,0.0,321928.95
2022-06-11,2022-06-11,Vehicle Maintenance expense,REF35390610,203.05,0.0,321725.9
2022-06-14,2022-06-14,Fuel purchase,REF85100889,180.52,0.0,321545.38
2022-06-15,2022-06-15,Service payment - Hughes LLC,REF49179490,0.0,2395.71,323941.09
2022-06-15,2022-06-15,Invoice payment - Lowe-James,REF89249759,0.0,852.52,324793.61
2022-06-15,2022-06-15,Payment from Jimenez-Singh,REF13661034,0.0,747.19,325540.8
2022-06-15,2022-06-15,"Project payment - Jackson, Madden and Fernandez",REF31995483,0.0,1635.82,327176.62
2022-06-15,2022-06-15,"Invoice payment - Harris, Haney and Lewis",REF58865439,0.0,1250.81,328427.43
2022-06-15,2022-06-15,Business insurance premium,REF40744097,243.02,0.0,328184.41
2022-06-16,2022-06-16,Business materials,REF33896292,835.44,0.0,327348.97
2022-06-17,2022-06-17,Vehicle Maintenance expense,REF80223520,184.75,0.0,327164.22
2022-06-18,2022-06-18,Fuel purchase,REF73328346,495.03,0.0,326669.19
2022-06-21,2022-06-21,Business materials,REF16158358,1563.36,0.0,325105.83
2022-06-22,2022-06-22,Permits Licenses expense,REF97412657,68.47,0.0,325037.36
2022-06-23,2022-06-23,Permits Licenses expense,REF99294328,149.65,0.0,324887.71
2022-06-28,2022-06-28,Permits Licenses expense,REF33614297,133.64,0.0,324754.07
2022-06-30,2022-06-30,"Service payment - Jackson, Madden and Fernandez",REF39375961,0.0,1333.35,326087.42
2022-06-30,2022-06-30,Project payment - Lowe-James,REF52387000,0.0,820.58,326908.0
2022-06-30,2022-06-30,"Project payment - Harris, Haney and Lewis",REF50100185,0.0,1474.02,328382.02
2022-06-30,2022-06-30,Invoice payment - Jimenez-Singh,REF57045349,0.0,697.67,329079.69
2022-06-30,2022-06-30,Payment from Hughes LLC,REF91756782,0.0,2856.12,331935.81
2022-07-06,2022-07-06,Safety Equipment expense,REF53433536,87.92,0.0,331847.89
2022-07-11,2022-07-11,Subcontractors expense,REF33558907,959.81,0.0,330888.08
2022-07-11,2022-07-11,Fuel purchase,REF92733015,195.83,0.0,330692.25
2022-07-15,2022-07-15,"Project payment - Harris, Haney and Lewis",REF86896683,0.0,1685.43,332377.68
2022-07-15,2022-07-15,Invoice payment - Lowe-James,REF26969030,0.0,818.12,333195.8
2022-07-15,2022-07-15,"Payment from Jackson, Madden and Fernandez",REF78458311,0.0,1521.22,334717.02
2022-07-15,2022-07-15,Invoice payment - Jimenez-Singh,REF75854214,0.0,755.5,335472.52
2022-07-15,2022-07-15,Payment from Hughes LLC,REF47662695,0.0,1958.48,337431.0
2022-07-15,2022-07-15,Tools expense,REF87527274,142.12,0.0,337288.88
2022-07-15,2022-07-15,Business insurance premium,REF17834449,264.12,0.0,337024.76
2022-07-16,2022-07-16,Fuel purchase,REF93886319,333.3,0.0,336691.46
2022-07-23,2022-07-23,Equipment Rental expense,REF15155623,225.16,0.0,336466.3
2022-07-27,2022-07-27,Business materials,REF62851000,819.19,0.0,335647.11
2022-07-27,2022-07-27,Fuel purchase,REF37836266,362.78,0.0,335284.33
2022-07-28,2022-07-28,Business materials,REF98468370,1193.17,0.0,334091.16
2022-07-30,2022-07-30,Service payment - Jimenez-Singh,REF41826013,0.0,698.67,334789.83
2022-07-30,2022-07-30,Service payment - Hughes LLC,REF90308021,0.0,2096.33,336886.16
2022-07-30,2022-07-30,"Project payment - Jackson, Madden and Fernandez",REF19961811,0.0,1162.33,338048.49
2022-07-30,2022-07-30,Invoice payment - Lowe-James,REF95341004,0.0,934.82,338983.31
2022-08-02,2022-08-02,Safety Equipment expense,REF28161267,123.6,0.0,338859.71
2022-08-04,2022-08-04,Tools expense,REF23174949,72.49,0.0,338787.22
2022-08-05,2022-08-05,Business materials,REF66375003,572.54,0.0,338214.68
2022-08-07,2022-08-07,Equipment Rental expense,REF86460735,376.33,0.0,337838.35
2022-08-08,2022-08-08,Subcontractors expense,REF77127178,1954.63,0.0,335883.72
2022-08-10,2022-08-10,Fuel purchase,REF86125357,288.76,0.0,335594.96
2022-08-15,2022-08-15,"Service payment - Jackson, Madden and Fernandez",REF60981880,0.0,1608.1,337203.06
2022-08-15,2022-08-15,Project payment - Jimenez-Singh,REF67921057,0.0,987.1,338190.16
2022-08-15,2022-08-15,Business insurance premium,REF74627650,252.36,0.0,337937.8
2022-08-15,2022-08-15,Invoice payment - Hughes LLC,REF92879513,0.0,2739.58,340677.38
2022-08-15,2022-08-15,Payment from Lowe-James,REF36076866,0.0,910.69,341588.07
2022-08-15,2022-08-15,"Service payment - Harris, Haney and Lewis",REF32920582,0.0,834.85,342422.92
2022-08-18,2022-08-18,Vehicle Maintenance expense,REF21106692,161.79,0.0,342261.13
2022-08-25,2022-08-25,Safety Equipment expense,REF81330042,70.03,0.0,342191.1
2022-08-30,2022-08-30,"Payment from Harris, Haney and Lewis",REF97443926,0.0,1377.36,343568.46
2022-08-30,2022-08-30,Service payment - Hughes LLC,REF59973184,0.0,2234.47,345802.93
2022-09-01,2022-09-01,Tools expense,REF15497605,66.2,0.0,345736.73
2022-09-03,2022-09-03,Subcontractors expense,REF45312357,958.19,0.0,344778.54
2022-09-05,2022-09-05,Fuel purchase,REF21588673,215.04,0.0,344563.5
2022-09-06,2022-09-06,Fuel purchase,REF93552963,240.02,0.0,344323.48
2022-09-12,2022-09-12,Fuel purchase,REF68930671,255.85,0.0,344067.63
2022-09-15,2022-09-15,"Service payment - Harris, Haney and Lewis",REF39616693,0.0,1308.33,345375.96
2022-09-15,2022-09-15,Service payment - Hughes LLC,REF10344780,0.0,1952.96,347328.92
2022-09-15,2022-09-15,Business insurance premium,REF85029548,232.6,0.0,347096.32
2022-09-15,2022-09-15,"Project payment - Jackson, Madden and Fernandez",REF24040371,0.0,1499.91,348596.23
2022-09-16,2022-09-16,Safety Equipment expense,REF82714072,100.53,0.0,348495.7
2022-09-19,2022-09-19,Subcontractors expense,REF57468778,1223.96,0.0,347271.74
2022-09-21,2022-09-21,Business materials,REF67803128,703.98,0.0,346567.76
2022-09-21,2022-09-21,Equipment Rental expense,REF21498541,385.84,0.0,346181.92
2022-09-22,2022-09-22,Tools expense,REF84571925,59.79,0.0,346122.13
2022-09-26,2022-09-26,Business materials,REF72030200,1152.95,0.0,344969.18
2022-09-29,2022-09-29,Business materials,REF51021874,138.78,0.0,344830.4
2022-09-30,2022-09-30,"Project payment - Jackson, Madden and Fernandez",REF62002176,0.0,1151.85,345982.25
2022-09-30,2022-09-30,Tools expense,REF99356795,95.56,0.0,345886.69
2022-09-30,2022-09-30,Payment from Lowe-James,REF67889761,0.0,864.03,346750.72
2022-09-30,2022-09-30,Service payment - Jimenez-Singh,REF62875127,0.0,754.02,347504.74
2022-09-30,2022-09-30,"Invoice payment - Harris, Haney and Lewis",REF78544585,0.0,1428.23,348932.97
2022-09-30,2022-09-30,Payment from Hughes LLC,REF84977068,0.0,2623.18,351556.15
2022-10-02,2022-10-02,Business materials,REF24268658,918.5,0.0,350637.65
2022-10-08,2022-10-08,Tools expense,REF89297624,81.76,0.0,350555.89
2022-10-09,2022-10-09,Fuel purchase,REF29307770,463.43,0.0,350092.46
2022-10-11,2022-10-11,Tools expense,REF48320080,82.11,0.0,350010.35
2022-10-12,2022-10-12,Permits Licenses expense,REF84918835,109.62,0.0,349900.73
2022-10-14,2022-10-14,Subcontractors expense,REF15380918,801.52,0.0,349099.21
2022-10-15,2022-10-15,"Invoice payment - Jackson, Madden and Fernandez",REF97473105,0.0,1208.43,350307.64
2022-10-15,2022-10-15,"Payment from Harris, Haney and Lewis",REF27847018,0.0,881.93,351189.57
2022-10-15,2022-10-15,Payment from Hughes LLC,REF75236034,0.0,2720.61,353910.18
2022-10-15,2022-10-15,Service payment - Lowe-James,REF78063997,0.0,890.12,354800.3
2022-10-15,2022-10-15,Business insurance premium,REF20333982,182.96,0.0,354617.34
2022-10-16,2022-10-16,Safety Equipment expense,REF73371267,69.57,0.0,354547.77
2022-10-17,2022-10-17,Fuel purchase,REF78076012,395.95,0.0,354151.82
2022-10-19,2022-10-19,Subcontractors expense,REF85663483,1185.45,0.0,352966.37
2022-10-21,2022-10-21,Safety Equipment expense,REF66406476,39.96,0.0,352926.41
2022-10-21,2022-10-21,Fuel purchase,REF85575586,200.55,0.0,352725.86
2022-10-24,2022-10-24,Business materials,REF86269239,792.77,0.0,351933.09
2022-10-25,2022-10-25,Equipment Rental expense,REF94968026,272.63,0.0,351660.46
2022-10-25,2022-10-25,Vehicle Maintenance expense,REF19319077,160.52,0.0,351499.94
2022-10-26,2022-10-26,Business materials,REF15031565,979.52,0.0,350520.42
2022-10-27,2022-10-27,Safety Equipment expense,REF57007110,92.42,0.0,350428.0
2022-10-30,2022-10-30,"Invoice payment - Harris, Haney and Lewis",REF40124802,0.0,975.61,351403.61
2022-10-30,2022-10-30,Service payment - Hughes LLC,REF40385621,0.0,1948.5,353352.11
2022-10-30,2022-10-30,Project payment - Lowe-James,REF65818774,0.0,710.22,354062.33
2022-10-30,2022-10-30,Service payment - Jimenez-Singh,REF31169973,0.0,662.26,354724.59
2022-10-30,2022-10-30,"Payment from Jackson, Madden and Fernandez",REF30101456,0.0,1105.11,355829.7
2022-11-08,2022-11-08,Equipment Rental expense,REF45936884,328.03,0.0,355501.67
2022-11-10,2022-11-10,Fuel purchase,REF18460242,173.54,0.0,355328.13
2022-11-10,2022-11-10,Subcontractors expense,REF97389284,626.35,0.0,354701.78
2022-11-10,2022-11-10,Business materials,REF61910667,760.21,0.0,353941.57
2022-11-11,2022-11-11,Fuel purchase,REF71418914,154.61,0.0,353786.96
2022-11-11,2022-11-11,Business materials,REF17100020,651.77,0.0,353135.19
2022-11-15,2022-11-15,Invoice payment - Lowe-James,REF93086533,0.0,621.86,353757.05
2022-11-15,2022-11-15,Payment from Hughes LLC,REF80732972,0.0,1487.36,355244.41
2022-11-15,2022-11-15,Invoice payment - Jimenez-Singh,REF71772145,0.0,499.46,355743.87
2022-11-15,2022-11-15,"Invoice payment - Harris, Haney and Lewis",REF46325661,0.0,762.1,356505.97
2022-11-15,2022-11-15,Business insurance premium,REF58837732,150.11,0.0,356355.86
2022-11-15,2022-11-15,"Payment from Jackson, Madden and Fernandez",REF60913711,0.0,888.53,357244.39
2022-11-19,2022-11-19,Equipment Rental expense,REF77221831,341.42,0.0,356902.97
2022-11-19,2022-11-19,Fuel purchase,REF62213222,242.46,0.0,356660.51
2022-11-21,2022-11-21,Fuel purchase,REF50337131,366.53,0.0,356293.98
2022-11-22,2022-11-22,Fuel purchase,REF92359905,169.25,0.0,356124.73
2022-11-22,2022-11-22,Business materials,REF39763992,474.29,0.0,355650.44
2022-11-23,2022-11-23,Vehicle Maintenance expense,REF85198640,116.01,0.0,355534.43
2022-11-28,2022-11-28,Business materials,REF88309516,421.66,0.0,355112.77
2022-11-30,2022-11-30,"Payment from Harris, Haney and Lewis",REF45600667,0.0,859.26,355972.03
2022-11-30,2022-11-30,Service payment - Lowe-James,REF34078674,0.0,479.15,356451.18
2022-11-30,2022-11-30,"Project payment - Jackson, Madden and Fernandez",REF84770527,0.0,895.98,357347.16
2022-11-30,2022-11-30,Payment from Jimenez-Singh,REF60231839,0.0,469.01,357816.17
2022-12-01,2022-12-01,Fuel purchase,REF71711445,267.86,0.0,357548.31
2022-12-01,2022-12-01,Subcontractors expense,REF72686685,703.22,0.0,356845.09
2022-12-03,2022-12-03,Subcontractors expense,REF42946074,333.92,0.0,356511.17
2022-12-06,2022-12-06,Business materials,REF97200857,678.45,0.0,355832.72
2022-12-07,2022-12-07,Safety Equipment expense,REF68790231,68.9,0.0,355763.82
2022-12-09,2022-12-09,Subcontractors expense,REF64563542,931.22,0.0,354832.6
2022-12-10,2022-12-10,Tools expense,REF72125496,59.27,0.0,354773.33
2022-12-13,2022-12-13,Permits Licenses expense,REF59269995,47.02,0.0,354726.31
2022-12-15,2022-12-15,Business insurance premium,REF61766028,117.17,0.0,354609.14
2022-12-15,2022-12-15,"Invoice payment - Jackson, Madden and Fernandez",REF37242753,0.0,884.29,355493.43
2022-12-15,2022-12-15,"Service payment - Harris, Haney and Lewis",REF88901936,0.0,578.03,356071.46
2022-12-15,2022-12-15,Project payment - Lowe-James,REF17514729,0.0,290.81,356362.27
2022-12-15,2022-12-15,Project payment - Jimenez-Singh,REF70971108,0.0,432.61,356794.88
2022-12-15,2022-12-15,Payment from Hughes LLC,REF92553035,0.0,1210.17,358005.05
2022-12-19,2022-12-19,Vehicle Maintenance expense,REF46993003,122.33,0.0,357882.72
2022-12-19,2022-12-19,Subcontractors expense,REF80734404,776.27,0.0,357106.45
2022-12-19,2022-12-19,Fuel purchase,REF84132374,79.59,0.0,357026.86
2022-12-21,2022-12-21,Business materials,REF86771019,498.76,0.0,356528.1
2022-12-23,2022-12-23,Safety Equipment expense,REF46788875,8.4,0.0,356519.7
2022-12-26,2022-12-26,Equipment Rental expense,REF21480374,190.58,0.0,356329.12
2022-12-27,2022-12-27,Equipment Rental expense,REF28431648,217.74,0.0,356111.38
2022-12-29,2022-12-29,Safety Equipment expense,REF15836977,26.28,0.0,356085.1
2022-12-30,2022-12-30,"Invoice payment - Jackson, Madden and Fernandez",REF25055260,0.0,830.24,356915.34
2022-12-30,2022-12-30,Service payment - Lowe-James,REF26183089,0.0,362.39,357277.73
2022-12-30,2022-12-30,Service payment - Jimenez-Singh,REF55338226,0.0,394.82,357672.55
2022-12-30,2022-12-30,Project payment - Hughes LLC,REF12412991,0.0,1112.84,358785.39
2022-12-30,2022-12-30,"Invoice payment - Harris, Haney and Lewis",REF61718818,0.0,721.79,359507.18
2023-01-01,2023-01-01,Tools expense,REF62347270,32.08,0.0,359475.1
2023-01-04,2023-01-04,Permits Licenses expense,REF12316266,59.14,0.0,359415.96
2023-01-04,2023-01-04,Fuel purchase,REF80804046,145.63,0.0,359270.33
2023-01-04,2023-01-04,Tools expense,REF37720026,78.66,0.0,359191.67
2023-01-06,2023-01-06,Equipment Rental expense,REF76222544,405.5,0.0,358786.17
2023-01-07,2023-01-07,Equipment Rental expense,REF10427445,143.14,0.0,358643.03
2023-01-08,2023-01-08,Vehicle Maintenance expense,REF85868155,115.26,0.0,358527.77
2023-01-13,2023-01-13,Fuel purchase,REF42272108,285.63,0.0,358242.14
2023-01-15,2023-01-15,Business insurance premium,REF58852021,135.84,0.0,358106.3
2023-01-15,2023-01-15,Project payment - Jimenez-Singh,REF17553620,0.0,493.91,358600.21
2023-01-15,2023-01-15,"Service payment - Jackson, Madden and Fernandez",REF99201663,0.0,835.89,359436.1
2023-01-15,2023-01-15,Payment from Hughes LLC,REF46641542,0.0,1257.08,360693.18
2023-01-15,2023-01-15,"Invoice payment - Harris, Haney and Lewis",REF35477638,0.0,552.3,361245.48
2023-01-16,2023-01-16,Safety Equipment expense,REF69070679,57.75,0.0,361187.73
2023-01-16,2023-01-16,Business materials,REF21423951,540.34,0.0,360647.39
2023-01-18,2023-01-18,Subcontractors expense,REF54024636,793.89,0.0,359853.5
2023-01-19,2023-01-19,Tools expense,REF75720192,106.71,0.0,359746.79
2023-01-19,2023-01-19,Subcontractors expense,REF18031831,366.3,0.0,359380.49
2023-01-22,2023-01-22,Fuel purchase,REF24246003,267.04,0.0,359113.45
2023-01-25,2023-01-25,Business materials,REF62543254,462.85,0.0,358650.6
2023-01-29,2023-01-29,Fuel purchase,REF96584857,139.63,0.0,358510.97
2023-01-30,2023-01-30,"Invoice payment - Harris, Haney and Lewis",REF82194658,0.0,711.0,359221.97
2023-01-30,2023-01-30,Project payment - Lowe-James,REF50118058,0.0,439.2,359661.17
2023-01-30,2023-01-30,Invoice payment - Jimenez-Singh,REF92558236,0.0,472.48,360133.65
2023-01-30,2023-01-30,"Payment from Jackson, Madden and Fernandez",REF35381076,0.0,765.13,360898.78
2023-02-01,2023-02-01,Business materials,REF60028504,516.14,0.0,360382.64
2023-02-03,2023-02-03,Safety Equipment expense,REF42208831,24.39,0.0,360358.25
2023-02-09,2023-02-09,Tools expense,REF26103232,90.33,0.0,360267.92
2023-02-11,2023-02-11,Equipment Rental expense,REF28551225,336.8,0.0,359931.12
2023-02-12,2023-02-12,Fuel purchase,REF87563622,339.38,0.0,359591.74
2023-02-14,2023-02-14,Fuel purchase,REF52422161,240.43,0.0,359351.31
2023-02-15,2023-02-15,Business insurance premium,REF38353566,158.89,0.0,359192.42
2023-02-15,2023-02-15,"Project payment - Harris, Haney and Lewis",REF74673384,0.0,801.65,359994.07
2023-02-15,2023-02-15,Fuel purchase,REF84589845,270.7,0.0,359723.37
2023-02-15,2023-02-15,"Service payment - Jackson, Madden and Fernandez",REF64645359,0.0,795.65,360519.02
2023-02-21,2023-02-21,Equipment Rental expense,REF19358049,205.91,0.0,360313.11
2023-02-21,2023-02-21,Vehicle Maintenance expense,REF55088954,132.99,0.0,360180.12
2023-02-23,2023-02-23,Business materials,REF55615791,737.83,0.0,359442.29
2023-02-24,2023-02-24,Business materials,REF22102587,739.71,0.0,358702.58
2023-02-25,2023-02-25,Equipment Rental expense,REF53186411,291.81,0.0,358410.77
2023-02-27,2023-02-27,Equipment Rental expense,REF56662368,437.17,0.0,357973.6
2023-02-27,2023-02-27,Fuel purchase,REF17619313,170.98,0.0,357802.62
2023-02-28,2023-02-28,Permits Licenses expense,REF15426255,83.92,0.0,357718.7
2023-02-28,2023-02-28,"Invoice payment - Harris, Haney and Lewis",REF35266227,0.0,748.84,358467.54
2023-02-28,2023-02-28,Service payment - Jimenez-Singh,REF49015466,0.0,454.21,358921.75
2023-02-28,2023-02-28,Project payment - Lowe-James,REF59352830,0.0,565.13,359486.88
2023-02-28,2023-02-28,Business materials,REF22406356,820.17,0.0,358666.71
2023-02-28,2023-02-28,Service payment - Hughes LLC,REF21764257,0.0,1522.1,360188.81
2023-03-05,2023-03-05,Business materials,REF83426322,851.65,0.0,359337.16
2023-03-07,2023-03-07,Subcontractors expense,REF99386261,1296.59,0.0,358040.57
2023-03-09,2023-03-09,Fuel purchase,REF55410919,336.42,0.0,357704.15
2023-03-10,2023-03-10,Permits Licenses expense,REF79749027,99.56,0.0,357604.59
2023-03-10,2023-03-10,Vehicle Maintenance expense,REF26025814,127.46,0.0,357477.13
2023-03-11,2023-03-11,Business materials,REF17428938,511.03,0.0,356966.1
2023-03-11,2023-03-11,Fuel purchase,REF91451032,286.16,0.0,356679.94
2023-03-13,2023-03-13,Fuel purchase,REF87696662,377.38,0.0,356302.56
2023-03-14,2023-03-14,Fuel purchase,REF99236960,368.47,0.0,355934.09
2023-03-15,2023-03-15,Business insurance premium,REF43140488,201.73,0.0,355732.36
2023-03-15,2023-03-15,Service payment - Lowe-James,REF69750944,0.0,598.34,356330.7
2023-03-15,2023-03-15,"Payment from Harris, Haney and Lewis",REF18162490,0.0,1035.24,357365.94
2023-03-15,2023-03-15,"Service payment - Jackson, Madden and Fernandez",REF32782753,0.0,921.19,358287.13
2023-03-15,2023-03-15,Safety Equipment expense,REF35017643,83.85,0.0,358203.28
2023-03-15,2023-03-15,Project payment - Hughes LLC,REF22492340,0.0,1826.2,360029.48
2023-03-15,2023-03-15,Payment from Jimenez-Singh,REF84745058,0.0,546.74,360576.22
2023-03-16,2023-03-16,Fuel purchase,REF34300446,300.63,0.0,360275.59
2023-03-18,2023-03-18,Business materials,REF38273057,766.29,0.0,359509.3
2023-03-21,2023-03-21,Equipment Rental expense,REF89965009,507.06,0.0,359002.24
2023-03-25,2023-03-25,Business materials,REF82341011,939.95,0.0,358062.29
2023-03-25,2023-03-25,Fuel purchase,REF69871964,285.56,0.0,357776.73
2023-03-26,2023-03-26,Business materials,REF71839835,795.16,0.0,356981.57
2023-03-28,2023-03-28,Business materials,REF91703486,634.77,0.0,356346.8
2023-03-29,2023-03-29,Safety Equipment expense,REF41259923,97.38,0.0,356249.42
2023-03-29,2023-03-29,Permits Licenses expense,REF79909991,122.23,0.0,356127.19
2023-03-30,2023-03-30,Payment from Hughes LLC,REF98059734,0.0,1505.34,357632.53
2023-03-30,2023-03-30,Payment from Jimenez-Singh,REF40072765,0.0,746.47,358379.0
2023-03-30,2023-03-30,"Project payment - Harris, Haney and Lewis",REF13865193,0.0,1251.29,359630.29
2023-03-30,2023-03-30,"Invoice payment - Jackson, Madden and Fernandez",REF76864280,0.0,1115.54,360745.83
2023-04-01,2023-04-01,Fuel purchase,REF22956017,204.32,0.0,360541.51
2023-04-07,2023-04-07,Subcontractors expense,REF99271490,906.96,0.0,359634.55
2023-04-08,2023-04-08,Business materials,REF63755762,530.11,0.0,359104.44
2023-04-09,2023-04-09,Fuel purchase,REF20197062,390.22,0.0,358714.22
2023-04-11,2023-04-11,Safety Equipment expense,REF56194938,153.95,0.0,358560.27
2023-04-12,2023-04-12,Fuel purchase,REF39831419,300.2,0.0,358260.07
2023-04-15,2023-04-15,Business insurance premium,REF40595062,218.78,0.0,358041.29
2023-04-15,2023-04-15,"Service payment - Harris, Haney and Lewis",REF66921001,0.0,1374.14,359415.43
2023-04-15,2023-04-15,"Service payment - Jackson, Madden and Fernandez",REF29429237,0.0,1349.05,360764.48
2023-04-15,2023-04-15,Fuel purchase,REF66223895,311.49,0.0,360452.99
2023-04-15,2023-04-15,Subcontractors expense,REF96575611,1316.11,0.0,359136.88
2023-04-15,2023-04-15,Service payment - Lowe-James,REF94604719,0.0,1051.89,360188.77
2023-04-15,2023-04-15,Service payment - Hughes LLC,REF29944097,0.0,2344.04,362532.81
2023-04-15,2023-04-15,Vehicle Maintenance expense,REF62983622,115.72,0.0,362417.09
2023-04-15,2023-04-15,Service payment - Jimenez-Singh,REF85203676,0.0,804.48,363221.57
2023-04-20,2023-04-20,Subcontractors expense,REF29243157,1133.66,0.0,362087.91
2023-04-27,2023-04-27,Tools expense,REF70849619,136.31,0.0,361951.6
2023-04-29,2023-04-29,Equipment Rental expense,REF16352636,357.5,0.0,361594.1
2023-04-30,2023-04-30,"Service payment - Jackson, Madden and Fernandez",REF37216449,0.0,1481.33,363075.43
2023-04-30,2023-04-30,Payment from Lowe-James,REF41987132,0.0,695.27,363770.7
2023-04-30,2023-04-30,Project payment - Jimenez-Singh,REF63744501,0.0,1026.98,364797.68
2023-04-30,2023-04-30,Service payment - Hughes LLC,REF50289425,0.0,2291.98,367089.66
2023-05-02,2023-05-02,Permits Licenses expense,REF88236782,122.28,0.0,366967.38
2023-05-10,2023-05-10,Equipment Rental expense,REF96042635,472.39,0.0,366494.99
2023-05-15,2023-05-15,Payment from Lowe-James,REF51277704,0.0,1163.73,367658.72
2023-05-15,2023-05-15,Project payment - Jimenez-Singh,REF27505283,0.0,805.01,368463.73
2023-05-15,2023-05-15,"Invoice payment - Harris, Haney and Lewis",REF20909170,0.0,1208.19,369671.92
2023-05-15,2023-05-15,Project payment - Hughes LLC,REF60983047,0.0,3079.01,372750.93
2023-05-15,2023-05-15,"Service payment - Jackson, Madden and Fernandez",REF39184014,0.0,1414.27,374165.2
2023-05-15,2023-05-15,Business insurance premium,REF53153891,256.15,0.0,373909.05
2023-05-18,2023-05-18,Subcontractors expense,REF17808943,1090.94,0.0,372818.11
2023-05-19,2023-05-19,Equipment Rental expense,REF60484304,359.08,0.0,372459.03
2023-05-19,2023-05-19,Tools expense,REF48450734,148.48,0.0,372310.55
2023-05-19,2023-05-19,Permits Licenses expense,REF75014660,131.33,0.0,372179.22
2023-05-21,2023-05-21,Business materials,REF86003939,1290.8,0.0,370888.42
2023-05-24,2023-05-24,Business materials,REF66654834,764.04,0.0,370124.38
2023-05-27,2023-05-27,Business materials,REF37746465,1346.72,0.0,368777.66
2023-05-29,2023-05-29,Fuel purchase,REF80937709,366.62,0.0,368411.04
2023-05-29,2023-05-29,Subcontractors expense,REF44995264,1610.93,0.0,366800.11
2023-05-29,2023-05-29,Equipment Rental expense,REF95628732,690.08,0.0,366110.03
2023-05-30,2023-05-30,Permits Licenses expense,REF99026504,121.75,0.0,365988.28
2023-05-30,2023-05-30,"Invoice payment - Harris, Haney and Lewis",REF76989314,0.0,1414.27,367402.55
2023-05-30,2023-05-30,Service payment - Hughes LLC,REF63875486,0.0,2708.96,370111.51
2023-05-30,2023-05-30,Payment from Lowe-James,REF80796157,0.0,1148.87,371260.38
2023-05-30,2023-05-30,"Service payment - Jackson, Madden and Fernandez",REF98688549,0.0,1642.43,372902.81
2023-05-30,2023-05-30,Service payment - Jimenez-Singh,REF79566618,0.0,735.51,373638.32
2023-05-31,2023-05-31,Fuel purchase,REF96065079,388.42,0.0,373249.9
2023-06-01,2023-06-01,Tools expense,REF92462927,132.24,0.0,373117.66
2023-06-02,2023-06-02,Fuel purchase,REF89584537,351.96,0.0,372765.7
2023-06-03,2023-06-03,Tools expense,REF56293270,137.92,0.0,372627.78
2023-06-05,2023-06-05,Permits Licenses expense,REF19968297,158.52,0.0,372469.26
2023-06-08,2023-06-08,Permits Licenses expense,REF23410295,109.11,0.0,372360.15
2023-06-08,2023-06-08,Subcontractors expense,REF86322763,839.16,0.0,371520.99
2023-06-11,2023-06-11,Tools expense,REF71411470,173.49,0.0,371347.5
2023-06-12,2023-06-12,Fuel purchase,REF50260178,259.06,0.0,371088.44
2023-06-15,2023-06-15,Permits Licenses expense,REF27633033,111.39,0.0,370977.05
2023-06-15,2023-06-15,Invoice payment - Lowe-James,REF76381868,0.0,1022.53,371999.58
2023-06-15,2023-06-15,Payment from Jimenez-Singh,REF60807925,0.0,738.37,372737.95
2023-06-15,2023-06-15,"Project payment - Jackson, Madden and Fernandez",REF59522500,0.0,1532.28,374270.23
2023-06-15,2023-06-15,"Service payment - Harris, Haney and Lewis",REF11064119,0.0,1075.02,375345.25
2023-06-15,2023-06-15,Invoice payment - Hughes LLC,REF10186982,0.0,2501.72,377846.97
2023-06-15,2023-06-15,Business insurance premium,REF34881543,256.55,0.0,377590.42
2023-06-16,2023-06-16,Business materials,REF56926755,974.87,0.0,376615.55
2023-06-16,2023-06-16,Safety Equipment expense,REF18327420,93.38,0.0,376522.17
2023-06-21,2023-06-21,Vehicle Maintenance expense,REF53757714,274.43,0.0,376247.74
2023-06-22,2023-06-22,Vehicle Maintenance expense,REF84290018,200.53,0.0,376047.21
2023-06-25,2023-06-25,Safety Equipment expense,REF13102474,96.29,0.0,375950.92
2023-06-30,2023-06-30,Permits Licenses expense,REF57627778,54.76,0.0,375896.16
2023-06-30,2023-06-30,Payment from Lowe-James,REF50391343,0.0,891.79,376787.95
2023-06-30,2023-06-30,"Project payment - Jackson, Madden and Fernandez",REF85617681,0.0,1646.01,378433.96
2023-06-30,2023-06-30,Service payment - Hughes LLC,REF98029654,0.0,2739.29,381173.25
2023-06-30,2023-06-30,Payment from Jimenez-Singh,REF94627304,0.0,786.83,381960.08
2023-07-04,2023-07-04,Safety Equipment expense,REF60560787,118.3,0.0,381841.78
2023-07-05,2023-07-05,Tools expense,REF35501547,94.13,0.0,381747.65
2023-07-06,2023-07-06,Permits Licenses expense,REF15450713,75.61,0.0,381672.04
2023-07-08,2023-07-08,Equipment Rental expense,REF64277377,761.56,0.0,380910.48
2023-07-14,2023-07-14,Business materials,REF95455054,920.48,0.0,379990.0
2023-07-15,2023-07-15,Business insurance premium,REF34063069,242.41,0.0,379747.59
2023-07-15,2023-07-15,Service payment - Lowe-James,REF24888258,0.0,795.51,380543.1
2023-07-15,2023-07-15,"Invoice payment - Jackson, Madden and Fernandez",REF88330002,0.0,1039.73,381582.83
2023-07-15,2023-07-15,"Payment from Harris, Haney and Lewis",REF64098841,0.0,1280.8,382863.63
2023-07-15,2023-07-15,Invoice payment - Hughes LLC,REF37618885,0.0,2337.96,385201.59
2023-07-15,2023-07-15,Invoice payment - Jimenez-Singh,REF44961570,0.0,631.23,385832.82
2023-07-16,2023-07-16,Fuel purchase,REF73012361,444.45,0.0,385388.37
2023-07-17,2023-07-17,Fuel purchase,REF10968505,436.21,0.0,384952.16
2023-07-18,2023-07-18,Business materials,REF29535755,1014.61,0.0,383937.55
2023-07-22,2023-07-22,Tools expense,REF94817319,95.6,0.0,383841.95
2023-07-24,2023-07-24,Equipment Rental expense,REF26935864,353.12,0.0,383488.83
2023-07-30,2023-07-30,Invoice payment - Hughes LLC,REF82618338,0.0,2601.83,386090.66
2023-07-30,2023-07-30,"Invoice payment - Jackson, Madden and Fernandez",REF18146179,0.0,1178.94,387269.6
2023-07-30,2023-07-30,"Invoice payment - Harris, Haney and Lewis",REF42996261,0.0,1108.55,388378.15
2023-08-01,2023-08-01,Tools expense,REF92108339,178.4,0.0,388199.75
2023-08-02,2023-08-02,Tools expense,REF48118924,109.94,0.0,388089.81
2023-08-05,2023-08-05,Business materials,REF70190837,1422.1,0.0,386667.71
2023-08-06,2023-08-06,Tools expense,REF85315693,141.81,0.0,386525.9
2023-08-06,2023-08-06,Business materials,REF15965954,918.86,0.0,385607.04
2023-08-11,2023-08-11,Safety Equipment expense,REF19509698,87.73,0.0,385519.31
2023-08-15,2023-08-15,Business insurance premium,REF67117443,250.76,0.0,385268.55
2023-08-15,2023-08-15,"Service payment - Harris, Haney and Lewis",REF81251569,0.0,1148.54,386417.09
2023-08-15,2023-08-15,Invoice payment - Lowe-James,REF67457863,0.0,748.38,387165.47
2023-08-15,2023-08-15,Payment from Hughes LLC,REF35725777,0.0,2079.74,389245.21
2023-08-15,2023-08-15,Service payment - Jimenez-Singh,REF58689994,0.0,986.89,390232.1
2023-08-15,2023-08-15,Safety Equipment expense,REF65296721,64.59,0.0,390167.51
2023-08-18,2023-08-18,Fuel purchase,REF35935152,174.82,0.0,389992.69
2023-08-18,2023-08-18,Subcontractors expense,REF45453416,1082.1,0.0,388910.59
2023-08-25,2023-08-25,Fuel purchase,REF69845591,299.33,0.0,388611.26
2023-08-25,2023-08-25,Equipment Rental expense,REF99731945,385.99,0.0,388225.27
2023-08-26,2023-08-26,Tools expense,REF57811523,142.32,0.0,388082.95
2023-08-27,2023-08-27,Business materials,REF77264503,923.91,0.0,387159.04
2023-08-30,2023-08-30,Service payment - Hughes LLC,REF39514899,0.0,2593.12,389752.16
2023-08-30,2023-08-30,Service payment - Jimenez-Singh,REF51739884,0.0,850.65,390602.81
2023-08-30,2023-08-30,Payment from Lowe-James,REF18131841,0.0,886.05,391488.86
2023-08-30,2023-08-30,"Service payment - Harris, Haney and Lewis",REF34351034,0.0,1125.49,392614.35
2023-08-30,2023-08-30,"Payment from Jackson, Madden and Fernandez",REF96969021,0.0,1336.52,393950.87
2023-08-31,2023-08-31,Fuel purchase,REF31118558,394.15,0.0,393556.72
2023-09-01,2023-09-01,Subcontractors expense,REF62564792,1171.27,0.0,392385.45
2023-09-02,2023-09-02,Tools expense,REF55179091,167.75,0.0,392217.7
2023-09-04,2023-09-04,Safety Equipment expense,REF29579612,105.16,0.0,392112.54
2023-09-05,2023-09-05,Tools expense,REF75833557,91.25,0.0,392021.29
2023-09-08,2023-09-08,Fuel purchase,REF17656524,359.64,0.0,391661.65
2023-09-08,2023-09-08,Business materials,REF30030571,421.26,0.0,391240.39
2023-09-11,2023-09-11,Business materials,REF65426022,1407.96,0.0,389832.43
2023-09-15,2023-09-15,Payment from Hughes LLC,REF92990131,0.0,2324.81,392157.24
2023-09-15,2023-09-15,"Service payment - Jackson, Madden and Fernandez",REF24190816,0.0,1163.61,393320.85
2023-09-15,2023-09-15,Business insurance premium,REF15746175,223.65,0.0,393097.2
2023-09-15,2023-09-15,Invoice payment - Lowe-James,REF49918586,0.0,880.62,393977.82
2023-09-15,2023-09-15,"Project payment - Harris, Haney and Lewis",REF64201345,0.0,1299.45,395277.27
2023-09-15,2023-09-15,Payment from Jimenez-Singh,REF55675735,0.0,773.39,396050.66
2023-09-25,2023-09-25,Permits Licenses expense,REF28325526,47.41,0.0,396003.25
2023-09-30,2023-09-30,Payment from Lowe-James,REF26421589,0.0,702.57,396705.82
2023-09-30,2023-09-30,Payment from Hughes LLC,REF96677582,0.0,2833.62,399539.44
2023-09-30,2023-09-30,Service payment - Jimenez-Singh,REF67929305,0.0,749.2,400288.64
2023-09-30,2023-09-30,"Invoice payment - Jackson, Madden and Fernandez",REF96698891,0.0,1171.1,401459.74
2023-10-01,2023-10-01,Business materials,REF50655250,1300.12,0.0,400159.62
2023-10-02,2023-10-02,Business materials,REF98987068,1078.26,0.0,399081.36
2023-10-05,2023-10-05,Fuel purchase,REF34153026,177.11,0.0,398904.25
2023-10-07,2023-10-07,Vehicle Maintenance expense,REF82277944,94.36,0.0,398809.89
2023-10-08,2023-10-08,Business materials,REF85228258,1136.17,0.0,397673.72
2023-10-10,2023-10-10,Business materials,REF25215793,731.06,0.0,396942.66
2023-10-12,2023-10-12,Safety Equipment expense,REF70721061,123.2,0.0,396819.46
2023-10-15,2023-10-15,Business insurance premium,REF94163912,190.86,0.0,396628.6
2023-10-15,2023-10-15,Service payment - Jimenez-Singh,REF26819382,0.0,701.83,397330.43
2023-10-15,2023-10-15,Project payment - Lowe-James,REF74342290,0.0,636.0,397966.43
2023-10-15,2023-10-15,"Invoice payment - Harris, Haney and Lewis",REF50013480,0.0,1120.05,399086.48
2023-10-15,2023-10-15,Payment from Hughes LLC,REF63059692,0.0,1646.29,400732.77
2023-10-15,2023-10-15,"Payment from Jackson, Madden and Fernandez",REF77397782,0.0,1596.54,402329.31
2023-10-18,2023-10-18,Fuel purchase,REF29246075,283.75,0.0,402045.56
2023-10-19,2023-10-19,Fuel purchase,REF61333506,347.7,0.0,401697.86
2023-10-25,2023-10-25,Equipment Rental expense,REF95831965,421.99,0.0,401275.87
2023-10-28,2023-10-28,Tools expense,REF44918149,77.39,0.0,401198.48
2023-10-30,2023-10-30,Payment from Jimenez-Singh,REF52585683,0.0,747.6,401946.08
2023-10-30,2023-10-30,Project payment - Hughes LLC,REF67176169,0.0,2127.55,404073.63
2023-10-30,2023-10-30,"Payment from Jackson, Madden and Fernandez",REF57054217,0.0,1541.78,405615.41
2023-10-31,2023-10-31,Tools expense,REF65920788,113.32,0.0,405502.09
2023-10-31,2023-10-31,Fuel purchase,REF83613938,282.23,0.0,405219.86
2023-11-04,2023-11-04,Business materials,REF77278311,659.32,0.0,404560.54
2023-11-05,2023-11-05,Permits Licenses expense,REF94009165,37.92,0.0,404522.62
2023-11-06,2023-11-06,Fuel purchase,REF15051316,345.35,0.0,404177.27
2023-11-06,2023-11-06,Subcontractors expense,REF40768812,412.77,0.0,403764.5
2023-11-08,2023-11-08,Tools expense,REF70278311,119.9,0.0,403644.6
2023-11-11,2023-11-11,Business materials,REF10074206,398.94,0.0,403245.66
2023-11-11,2023-11-11,Vehicle Maintenance expense,REF48687078,111.37,0.0,403134.29
2023-11-15,2023-11-15,Service payment - Lowe-James,REF38027509,0.0,707.23,403841.52
2023-11-15,2023-11-15,Project payment - Hughes LLC,REF29453967,0.0,1985.89,405827.41
2023-11-15,2023-11-15,"Payment from Harris, Haney and Lewis",REF99961540,0.0,592.57,406419.98
2023-11-15,2023-11-15,Fuel purchase,REF50444423,156.65,0.0,406263.33
2023-11-15,2023-11-15,Business insurance premium,REF76576529,162.35,0.0,406100.98
2023-11-16,2023-11-16,Permits Licenses expense,REF46931320,69.74,0.0,406031.24
2023-11-16,2023-11-16,Business materials,REF36234925,422.05,0.0,405609.19
2023-11-17,2023-11-17,Fuel purchase,REF81827386,233.81,0.0,405375.38
2023-11-17,2023-11-17,Business materials,REF30232587,217.31,0.0,405158.07
2023-11-20,2023-11-20,Permits Licenses expense,REF10615263,74.62,0.0,405083.45
2023-11-21,2023-11-21,Business materials,REF19525442,694.09,0.0,404389.36
2023-11-27,2023-11-27,Business materials,REF29921394,873.45,0.0,403515.91
2023-11-27,2023-11-27,Vehicle Maintenance expense,REF68883713,129.56,0.0,403386.35
2023-11-28,2023-11-28,Subcontractors expense,REF40183417,1052.69,0.0,402333.66
2023-11-29,2023-11-29,Equipment Rental expense,REF16976001,333.24,0.0,402000.42
2023-11-29,2023-11-29,Permits Licenses expense,REF19121348,39.36,0.0,401961.06
2023-11-30,2023-11-30,Invoice payment - Lowe-James,REF15583567,0.0,610.03,402571.09
2023-11-30,2023-11-30,"Service payment - Jackson, Madden and Fernandez",REF16976394,0.0,826.96,403398.05
2023-11-30,2023-11-30,"Project payment - Harris, Haney and Lewis",REF97074862,0.0,832.41,404230.46
2023-11-30,2023-11-30,Project payment - Hughes LLC,REF17881834,0.0,1800.67,406031.13
2023-12-02,2023-12-02,Tools expense,REF58530400,41.48,0.0,405989.65
2023-12-03,2023-12-03,Business materials,REF48398529,344.57,0.0,405645.08
2023-12-07,2023-12-07,Equipment Rental expense,REF88909480,310.86,0.0,405334.22
2023-12-08,2023-12-08,Permits Licenses expense,REF10124841,35.19,0.0,405299.03
2023-12-10,2023-12-10,Subcontractors expense,REF59279866,821.63,0.0,404477.4
2023-12-15,2023-12-15,Business insurance premium,REF39089570,115.38,0.0,404362.02
2023-12-15,2023-12-15,Fuel purchase,REF83338929,206.24,0.0,404155.78
2023-12-15,2023-12-15,Payment from Lowe-James,REF42815200,0.0,402.03,404557.81
2023-12-15,2023-12-15,Service payment - Hughes LLC,REF74844551,0.0,1227.14,405784.95
2023-12-15,2023-12-15,Project payment - Jimenez-Singh,REF48280303,0.0,366.31,406151.26
2023-12-15,2023-12-15,"Service payment - Jackson, Madden and Fernandez",REF60486825,0.0,602.73,406753.99
2023-12-15,2023-12-15,"Invoice payment - Harris, Haney and Lewis",REF35097437,0.0,698.82,407452.81
2023-12-22,2023-12-22,Fuel purchase,REF14629902,183.34,0.0,407269.47
2023-12-23,2023-12-23,Business materials,REF10988309,423.72,0.0,406845.75
2023-12-25,2023-12-25,Equipment Rental expense,REF35144557,234.03,0.0,406611.72
2023-12-28,2023-12-28,Fuel purchase,REF44516210,138.44,0.0,406473.28
2023-12-30,2023-12-30,Permits Licenses expense,REF71064345,34.48,0.0,406438.8
2023-12-30,2023-12-30,Payment from Lowe-James,REF13271344,0.0,440.97,406879.77
2023-12-30,2023-12-30,Project payment - Jimenez-Singh,REF22383268,0.0,451.21,407330.98
2023-12-30,2023-12-30,"Payment from Jackson, Madden and Fernandez",REF96087406,0.0,512.96,407843.94
2023-12-30,2023-12-30,Project payment - Hughes LLC,REF60936404,0.0,994.66,408838.6
2023-12-30,2023-12-30,"Payment from Harris, Haney and Lewis",REF39968756,0.0,487.6,409326.2
2024-01-07,2024-01-07,Fuel purchase,REF75599281,333.9,0.0,408992.3
2024-01-09,2024-01-09,Fuel purchase,REF38653047,230.92,0.0,408761.38
2024-01-12,2024-01-12,Tools expense,REF72879028,29.44,0.0,408731.94
2024-01-15,2024-01-15,"Project payment - Jackson, Madden and Fernandez",REF63543855,0.0,828.98,409560.92
2024-01-15,2024-01-15,Payment from Lowe-James,REF98142466,0.0,571.34,410132.26
2024-01-15,2024-01-15,Equipment Rental expense,REF35957824,258.96,0.0,409873.3
2024-01-15,2024-01-15,Business insurance premium,REF95982124,139.86,0.0,409733.44
2024-01-15,2024-01-15,Invoice payment - Jimenez-Singh,REF34909510,0.0,513.93,410247.37
2024-01-15,2024-01-15,"Service payment - Harris, Haney and Lewis",REF16883504,0.0,911.14,411158.51
2024-01-15,2024-01-15,Service payment - Hughes LLC,REF82834423,0.0,1642.28,412800.79
2024-01-18,2024-01-18,Subcontractors expense,REF22487954,830.9,0.0,411969.89
2024-01-19,2024-01-19,Permits Licenses expense,REF23503711,56.82,0.0,411913.07
2024-01-20,2024-01-20,Business materials,REF10241828,555.77,0.0,411357.3
2024-01-21,2024-01-21,Equipment Rental expense,REF11003659,239.97,0.0,411117.33
2024-01-27,2024-01-27,Equipment Rental expense,REF53732058,316.63,0.0,410800.7
2024-01-27,2024-01-27,Fuel purchase,REF96775457,155.14,0.0,410645.56
2024-01-28,2024-01-28,Business materials,REF82352763,687.49,0.0,409958.07
2024-01-29,2024-01-29,Safety Equipment expense,REF73807922,50.11,0.0,409907.96
2024-01-30,2024-01-30,Tools expense,REF67772222,68.11,0.0,409839.85
2024-01-30,2024-01-30,Project payment - Hughes LLC,REF67394253,0.0,1454.04,411293.89
2024-01-30,2024-01-30,"Project payment - Jackson, Madden and Fernandez",REF89697765,0.0,986.29,412280.18
2024-01-30,2024-01-30,Project payment - Jimenez-Singh,REF11154501,0.0,409.99,412690.17
2024-01-30,2024-01-30,Payment from Lowe-James,REF37117252,0.0,531.14,413221.31
2024-01-30,2024-01-30,"Payment from Harris, Haney and Lewis",REF53261881,0.0,794.51,414015.82
2024-01-31,2024-01-31,Equipment Rental expense,REF65242198,233.2,0.0,413782.62
2024-02-02,2024-02-02,Vehicle Maintenance expense,REF77034891,129.31,0.0,413653.31
2024-02-03,2024-02-03,Business materials,REF48083551,700.63,0.0,412952.68
2024-02-03,2024-02-03,Equipment Rental expense,REF29556977,266.61,0.0,412686.07
2024-02-07,2024-02-07,Vehicle Maintenance expense,REF86164297,111.89,0.0,412574.18
2024-02-12,2024-02-12,Vehicle Maintenance expense,REF84394763,108.6,0.0,412465.58
2024-02-12,2024-02-12,Business materials,REF86643883,433.69,0.0,412031.89
2024-02-12,2024-02-12,Permits Licenses expense,REF13806725,74.73,0.0,411957.16
2024-02-15,2024-02-15,Payment from Jimenez-Singh,REF18295732,0.0,463.58,412420.74
2024-02-15,2024-02-15,"Service payment - Jackson, Madden and Fernandez",REF60761796,0.0,1006.4,413427.14
2024-02-15,2024-02-15,"Payment from Harris, Haney and Lewis",REF51342670,0.0,1130.06,414557.2
2024-02-15,2024-02-15,Invoice payment - Hughes LLC,REF94700056,0.0,1305.19,415862.39
2024-02-15,2024-02-15,Business insurance premium,REF72204330,166.41,0.0,415695.98
2024-02-15,2024-02-15,Equipment Rental expense,REF76359970,379.08,0.0,415316.9
2024-02-25,2024-02-25,Fuel purchase,REF54801319,211.85,0.0,415105.05
2024-02-28,2024-02-28,Business materials,REF62436941,744.95,0.0,414360.1
2024-02-28,2024-02-28,Invoice payment - Lowe-James,REF72595711,0.0,773.05,415133.15
2024-02-28,2024-02-28,Service payment - Jimenez-Singh,REF70190239,0.0,454.42,415587.57
2024-02-28,2024-02-28,Service payment - Hughes LLC,REF67940004,0.0,1381.7,416969.27
2024-02-28,2024-02-28,"Payment from Harris, Haney and Lewis",REF81410647,0.0,797.58,417766.85
2024-02-28,2024-02-28,"Payment from Jackson, Madden and Fernandez",REF35639021,0.0,847.99,418614.84
2024-02-29,2024-02-29,Business materials,REF82618012,1070.02,0.0,417544.82
2024-02-29,2024-02-29,Vehicle Maintenance expense,REF96836935,104.75,0.0,417440.07
2024-03-02,2024-03-02,Equipment Rental expense,REF13973483,227.52,0.0,417212.55
2024-03-07,2024-03-07,Business materials,REF59640697,718.76,0.0,416493.79
2024-03-07,2024-03-07,Fuel purchase,REF55682716,327.67,0.0,416166.12
2024-03-08,2024-03-08,Fuel purchase,REF23442962,418.21,0.0,415747.91
2024-03-09,2024-03-09,Permits Licenses expense,REF66538272,80.36,0.0,415667.55
2024-03-09,2024-03-09,Fuel purchase,REF86276938,273.63,0.0,415393.92
2024-03-10,2024-03-10,Business materials,REF99148566,824.76,0.0,414569.16
2024-03-12,2024-03-12,Fuel purchase,REF18644033,362.17,0.0,414206.99
2024-03-12,2024-03-12,Permits Licenses expense,REF81638425,49.95,0.0,414157.04
2024-03-14,2024-03-14,Equipment Rental expense,REF92035073,434.1,0.0,413722.94
2024-03-15,2024-03-15,Business insurance premium,REF99102624,191.14,0.0,413531.8
2024-03-15,2024-03-15,Payment from Hughes LLC,REF65863817,0.0,1788.49,415320.29
2024-03-15,2024-03-15,Invoice payment - Jimenez-Singh,REF82758520,0.0,478.42,415798.71
2024-03-15,2024-03-15,"Invoice payment - Harris, Haney and Lewis",REF70117850,0.0,1026.71,416825.42
2024-03-15,2024-03-15,Safety Equipment expense,REF60483391,79.45,0.0,416745.97
2024-03-15,2024-03-15,"Invoice payment - Jackson, Madden and Fernandez",REF82797947,0.0,1562.85,418308.82
2024-03-21,2024-03-21,Safety Equipment expense,REF67379648,80.66,0.0,418228.16
2024-03-24,2024-03-24,Subcontractors expense,REF31229486,1240.4,0.0,416987.76
2024-03-30,2024-03-30,Permits Licenses expense,REF71034069,69.27,0.0,416918.49
2024-03-30,2024-03-30,"Payment from Jackson, Madden and Fernandez",REF86302738,0.0,1186.7,418105.19
2024-03-30,2024-03-30,Service payment - Lowe-James,REF86933116,0.0,796.99,418902.18
2024-03-30,2024-03-30,Project payment - Hughes LLC,REF26659532,0.0,2500.75,421402.93
2024-03-30,2024-03-30,Project payment - Jimenez-Singh,REF99231521,0.0,692.04,422094.97
2024-03-30,2024-03-30,"Service payment - Harris, Haney and Lewis",REF26849489,0.0,1057.44,423152.41
2024-04-02,2024-04-02,Fuel purchase,REF82589542,348.94,0.0,422803.47
2024-04-02,2024-04-02,Business materials,REF62998171,632.41,0.0,422171.06
2024-04-05,2024-04-05,Business materials,REF34482653,547.39,0.0,421623.67
2024-04-07,2024-04-07,Vehicle Maintenance expense,REF58338808,197.44,0.0,421426.23
2024-04-08,2024-04-08,Fuel purchase,REF51000428,287.79,0.0,421138.44
2024-04-15,2024-04-15,Service payment - Lowe-James,REF70897954,0.0,928.71,422067.15
2024-04-15,2024-04-15,Invoice payment - Hughes LLC,REF86812767,0.0,2032.39,424099.54
2024-04-15,2024-04-15,"Service payment - Harris, Haney and Lewis",REF70990157,0.0,1503.99,425603.53
2024-04-15,2024-04-15,"Invoice payment - Jackson, Madden and Fernandez",REF31747469,0.0,1747.28,427350.81
2024-04-15,2024-04-15,Invoice payment - Jimenez-Singh,REF17842929,0.0,801.7,428152.51
2024-04-15,2024-04-15,Business insurance premium,REF81844856,234.77,0.0,427917.74
2024-04-19,2024-04-19,Fuel purchase,REF25297932,310.9,0.0,427606.84
2024-04-30,2024-04-30,Invoice payment - Lowe-James,REF60519402,0.0,675.75,428282.59
2024-04-30,2024-04-30,"Payment from Harris, Haney and Lewis",REF64773963,0.0,1153.72,429436.31
2024-04-30,2024-04-30,Service payment - Jimenez-Singh,REF50113826,0.0,1001.93,430438.24
2024-04-30,2024-04-30,Service payment - Hughes LLC,REF97084949,0.0,2419.4,432857.64
2024-04-30,2024-04-30,"Payment from Jackson, Madden and Fernandez",REF21043874,0.0,1433.05,434290.69
2024-04-30,2024-04-30,Fuel purchase,REF32417146,384.62,0.0,433906.07
2024-05-03,2024-05-03,Equipment Rental expense,REF25680621,681.06,0.0,433225.01
2024-05-03,2024-05-03,Business materials,REF14860870,654.78,0.0,432570.23
2024-05-04,2024-05-04,Fuel purchase,REF26553726,409.32,0.0,432160.91
2024-05-05,2024-05-05,Tools expense,REF84672457,157.12,0.0,432003.79
2024-05-06,2024-05-06,Business materials,REF70338274,1154.57,0.0,430849.22
2024-05-08,2024-05-08,Tools expense,REF62385224,138.61,0.0,430710.61
2024-05-09,2024-05-09,Business materials,REF10309234,289.6,0.0,430421.01
2024-05-10,2024-05-10,Business materials,REF62767079,1114.47,0.0,429306.54
2024-05-12,2024-05-12,Business materials,REF34707060,470.76,0.0,428835.78
2024-05-15,2024-05-15,Invoice payment - Lowe-James,REF97545296,0.0,892.49,429728.27
2024-05-15,2024-05-15,Vehicle Maintenance expense,REF66782145,237.68,0.0,429490.59
2024-05-15,2024-05-15,Business insurance premium,REF40617309,259.72,0.0,429230.87
2024-05-15,2024-05-15,Service payment - Hughes LLC,REF83395831,0.0,2643.81,431874.68
2024-05-15,2024-05-15,"Service payment - Harris, Haney and Lewis",REF25395374,0.0,1469.31,433343.99
2024-05-15,2024-05-15,"Project payment - Jackson, Madden and Fernandez",REF57315966,0.0,1785.94,435129.93
2024-05-15,2024-05-15,Business materials,REF55124788,1051.56,0.0,434078.37
2024-05-18,2024-05-18,Tools expense,REF41263452,138.85,0.0,433939.52
2024-05-19,2024-05-19,Business materials,REF48880533,1458.36,0.0,432481.16
2024-05-22,2024-05-22,Equipment Rental expense,REF18278792,322.06,0.0,432159.1
2024-05-24,2024-05-24,Subcontractors expense,REF64938144,1308.88,0.0,430850.22
2024-05-27,2024-05-27,Business materials,REF28186534,1405.59,0.0,429444.63
2024-05-28,2024-05-28,Permits Licenses expense,REF79244281,137.65,0.0,429306.98
2024-05-30,2024-05-30,"Project payment - Jackson, Madden and Fernandez",REF45892498,0.0,1444.37,430751.35
2024-05-30,2024-05-30,Fuel purchase,REF81631642,380.76,0.0,430370.59
2024-05-30,2024-05-30,Payment from Jimenez-Singh,REF48649934,0.0,836.13,431206.72
2024-05-30,2024-05-30,Payment from Lowe-James,REF98633593,0.0,1073.72,432280.44
2024-05-30,2024-05-30,Invoice payment - Hughes LLC,REF93705651,0.0,2681.05,434961.49
2024-06-02,2024-06-02,Fuel purchase,REF78629955,286.33,0.0,434675.16
2024-06-07,2024-06-07,Equipment Rental expense,REF88100528,684.25,0.0,433990.91
2024-06-08,2024-06-08,Business materials,REF81938527,1007.64,0.0,432983.27
2024-06-13,2024-06-13,Equipment Rental expense,REF48210657,576.02,0.0,432407.25
2024-06-15,2024-06-15,Payment from Lowe-James,REF25600355,0.0,696.97,433104.22
2024-06-15,2024-06-15,Service payment - Jimenez-Singh,REF39276746,0.0,766.56,433870.78
2024-06-15,2024-06-15,"Invoice payment - Jackson, Madden and Fernandez",REF37838165,0.0,1656.37,435527.15
2024-06-15,2024-06-15,Payment from Hughes LLC,REF71228743,0.0,2991.59,438518.74
2024-06-15,2024-06-15,Business insurance premium,REF98111641,258.66,0.0,438260.08
2024-06-15,2024-06-15,"Project payment - Harris, Haney and Lewis",REF37109424,0.0,1378.66,439638.74
2024-06-16,2024-06-16,Subcontractors expense,REF19154136,988.01,0.0,438650.73
2024-06-19,2024-06-19,Fuel purchase,REF54323194,389.87,0.0,438260.86
2024-06-22,2024-06-22,Equipment Rental expense,REF99135190,560.61,0.0,437700.25
2024-06-26,2024-06-26,Tools expense,REF11562628,173.8,0.0,437526.45
2024-06-30,2024-06-30,Service payment - Hughes LLC,REF34416168,0.0,3206.54,440732.99
2024-06-30,2024-06-30,"Project payment - Harris, Haney and Lewis",REF11388686,0.0,1372.26,442105.25
2024-06-30,2024-06-30,Project payment - Jimenez-Singh,REF40186563,0.0,914.48,443019.73
2024-06-30,2024-06-30,"Service payment - Jackson, Madden and Fernandez",REF93475566,0.0,1797.48,444817.21
2024-06-30,2024-06-30,Business materials,REF93423148,1616.68,0.0,443200.53
2024-06-30,2024-06-30,Vehicle Maintenance expense,REF12657139,103.8,0.0,443096.73
2024-06-30,2024-06-30,Service payment - Lowe-James,REF82173040,0.0,774.05,443870.78
2024-07-01,2024-07-01,Subcontractors expense,REF28237191,1215.09,0.0,442655.69
2024-07-02,2024-07-02,Fuel purchase,REF57139425,219.02,0.0,442436.67
2024-07-09,2024-07-09,Fuel purchase,REF66640315,294.71,0.0,442141.96
2024-07-09,2024-07-09,Permits Licenses expense,REF25565812,85.51,0.0,442056.45
2024-07-12,2024-07-12,Equipment Rental expense,REF99000339,574.35,0.0,441482.1
2024-07-14,2024-07-14,Subcontractors expense,REF54047072,721.99,0.0,440760.11
2024-07-15,2024-07-15,Payment from Hughes LLC,REF13777032,0.0,2269.92,443030.03
2024-07-15,2024-07-15,Business insurance premium,REF72304605,243.71,0.0,442786.32
2024-07-15,2024-07-15,"Payment from Harris, Haney and Lewis",REF95989728,0.0,1045.3,443831.62
2024-07-15,2024-07-15,Payment from Lowe-James,REF67469482,0.0,836.76,444668.38
2024-07-15,2024-07-15,Service payment - Jimenez-Singh,REF60781490,0.0,1031.7,445700.08
2024-07-15,2024-07-15,"Service payment - Jackson, Madden and Fernandez",REF15791536,0.0,1328.48,447028.56
2024-07-24,2024-07-24,Fuel purchase,REF78122674,445.66,0.0,446582.9
2024-07-24,2024-07-24,Vehicle Maintenance expense,REF57500745,170.33,0.0,446412.57
2024-07-26,2024-07-26,Subcontractors expense,REF47169779,991.99,0.0,445420.58
2024-07-28,2024-07-28,Fuel purchase,REF22724846,358.83,0.0,445061.75
2024-07-30,2024-07-30,Service payment - Lowe-James,REF89663194,0.0,1152.48,446214.23
2024-07-30,2024-07-30,Project payment - Hughes LLC,REF87912818,0.0,2653.1,448867.33
2024-07-30,2024-07-30,Invoice payment - Jimenez-Singh,REF21998357,0.0,779.85,449647.18
2024-07-30,2024-07-30,"Service payment - Jackson, Madden and Fernandez",REF79364989,0.0,1438.89,451086.07
2024-07-31,2024-07-31,Fuel purchase,REF48609098,466.52,0.0,450619.55
2024-08-02,2024-08-02,Tools expense,REF91942536,116.92,0.0,450502.63
2024-08-03,2024-08-03,Business materials,REF50040037,620.62,0.0,449882.01
2024-08-05,2024-08-05,Tools expense,REF89858381,152.75,0.0,449729.26
2024-08-06,2024-08-06,Tools expense,REF96844824,91.03,0.0,449638.23
2024-08-06,2024-08-06,Subcontractors expense,REF53348320,1409.74,0.0,448228.49
2024-08-07,2024-08-07,Fuel purchase,REF57171880,368.24,0.0,447860.25
2024-08-10,2024-08-10,Business materials,REF78552509,637.22,0.0,447223.03
2024-08-14,2024-08-14,Business materials,REF87771421,795.26,0.0,446427.77
2024-08-14,2024-08-14,Fuel purchase,REF13143819,260.43,0.0,446167.34
2024-08-15,2024-08-15,Service payment - Hughes LLC,REF36947948,0.0,2412.15,448579.49
2024-08-15,2024-08-15,"Invoice payment - Harris, Haney and Lewis",REF65751135,0.0,1428.1,450007.59
2024-08-15,2024-08-15,Project payment - Jimenez-Singh,REF98437194,0.0,920.03,450927.62
2024-08-15,2024-08-15,Business insurance premium,REF45467301,238.46,0.0,450689.16
2024-08-15,2024-08-15,Project payment - Lowe-James,REF51289438,0.0,1129.45,451818.61
2024-08-15,2024-08-15,Business materials,REF17330073,1466.2,0.0,450352.41
2024-08-17,2024-08-17,Fuel purchase,REF53441107,357.39,0.0,449995.02
2017-08-26,2017-08-26,Business materials,REF32731923,930.74,0.0,4451.85
2017-08-30,2017-08-30,Service payment - Smith-Rowe,REF83837842,0.0,1027.53,5479.38
2017-08-30,2017-08-30,"Invoice payment - Brown, Smith and Sanchez",REF96438997,0.0,1709.75,7189.13
2017-08-30,2017-08-30,Service payment - Moreno PLC,REF77061104,0.0,1900.35,9089.48
2017-09-01,2017-09-01,Business materials,REF65445548,237.99,0.0,8851.49
2017-09-01,2017-09-01,Equipment Rental expense,REF50483960,569.94,0.0,8281.55
2017-09-04,2017-09-04,Business materials,REF96847402,741.43,0.0,7540.12
2017-09-08,2017-09-08,Business materials,REF36564954,680.05,0.0,6860.07
2017-09-10,2017-09-10,Safety Equipment expense,REF33258182,41.74,0.0,6818.33
2017-09-11,2017-09-11,Permits Licenses expense,REF96533465,108.96,0.0,6709.37
2017-09-14,2017-09-14,Safety Equipment expense,REF70906513,34.75,0.0,6674.62
2017-09-15,2017-09-15,Vehicle Maintenance expense,REF99343299,159.3,0.0,6515.32
2017-09-15,2017-09-15,Project payment - Smith-Rowe,REF49877366,0.0,1142.61,7657.93
2017-09-15,2017-09-15,Service payment - Hoover-Camacho,REF68610882,0.0,1562.32,9220.25
2017-09-15,2017-09-15,Business insurance premium,REF34084961,241.23,0.0,8979.02
2017-09-16,2017-09-16,Business materials,REF48202064,555.03,0.0,8423.99
2017-09-16,2017-09-16,Subcontractors expense,REF79178607,1117.82,0.0,7306.17
2017-09-18,2017-09-18,Vehicle Maintenance expense,REF96869698,159.23,0.0,7146.94
2017-09-18,2017-09-18,Permits Licenses expense,REF54891153,83.96,0.0,7062.98
2017-09-19,2017-09-19,Vehicle Maintenance expense,REF29720814,108.4,0.0,6954.58
2017-09-19,2017-09-19,Equipment Rental expense,REF97165349,377.78,0.0,6576.8
2017-09-20,2017-09-20,Fuel purchase,REF35445335,329.38,0.0,6247.42
2017-09-21,2017-09-21,Business materials,REF94562252,522.18,0.0,5725.24
2017-09-22,2017-09-22,Tools expense,REF84367610,127.27,0.0,5597.97
2017-09-22,2017-09-22,Fuel purchase,REF82064779,329.11,0.0,5268.86
2017-09-23,2017-09-23,Business materials,REF99729912,854.05,0.0,4414.81
2017-09-24,2017-09-24,Business materials,REF35658596,705.99,0.0,3708.82
2017-09-28,2017-09-28,Vehicle Maintenance expense,REF86368090,181.91,0.0,3526.91
2017-09-30,2017-09-30,Service payment - Solis and Sons,REF91113518,0.0,275.76,3802.67
2017-09-30,2017-09-30,"Invoice payment - Brown, Smith and Sanchez",REF21459097,0.0,1521.28,5323.95
2017-09-30,2017-09-30,Project payment - Hoover-Camacho,REF12653855,0.0,1571.29,6895.24
2017-09-30,2017-09-30,Service payment - Moreno PLC,REF70593676,0.0,1388.41,8283.65
2017-09-30,2017-09-30,Permits Licenses expense,REF79574944,78.68,0.0,8204.97
2017-10-03,2017-10-03,Fuel purchase,REF17541393,235.09,0.0,7969.88
2017-10-05,2017-10-05,Equipment Rental expense,REF82094697,399.97,0.0,7569.91
2017-10-11,2017-10-11,Equipment Rental expense,REF95388790,331.71,0.0,7238.2
2017-10-12,2017-10-12,Business materials,REF29765388,401.8,0.0,6836.4
2017-10-14,2017-10-14,Fuel purchase,REF60075560,282.52,0.0,6553.88
2017-10-15,2017-10-15,Business insurance premium,REF48761668,181.82,0.0,6372.06
2017-10-15,2017-10-15,Payment from Smith-Rowe,REF53625047,0.0,854.06,7226.12
2017-10-15,2017-10-15,"Invoice payment - Brown, Smith and Sanchez",REF16481937,0.0,1104.49,8330.61
2017-10-15,2017-10-15,Fuel purchase,REF61153453,198.82,0.0,8131.79
2017-10-15,2017-10-15,Payment from Solis and Sons,REF70839376,0.0,283.17,8414.96
2017-10-15,2017-10-15,Service payment - Moreno PLC,REF37962848,0.0,1339.62,9754.58
2017-10-15,2017-10-15,Payment from Hoover-Camacho,REF59248636,0.0,1812.97,11567.55
2017-10-19,2017-10-19,Permits Licenses expense,REF57304539,96.19,0.0,11471.36
2017-10-21,2017-10-21,Fuel purchase,REF74224904,225.25,0.0,11246.11
2017-10-25,2017-10-25,Fuel purchase,REF85360622,293.58,0.0,10952.53
2017-10-26,2017-10-26,Tools expense,REF70628645,104.27,0.0,10848.26
2017-10-28,2017-10-28,Tools expense,REF88143027,162.35,0.0,10685.91
2017-10-30,2017-10-30,Project payment - Moreno PLC,REF66797485,0.0,1063.14,11749.05
2017-10-30,2017-10-30,Service payment - Hoover-Camacho,REF41680890,0.0,1534.57,13283.62
2017-10-30,2017-10-30,Project payment - Solis and Sons,REF38917833,0.0,223.46,13507.08
2017-10-30,2017-10-30,"Service payment - Brown, Smith and Sanchez",REF55011057,0.0,1346.99,14854.07
2017-10-30,2017-10-30,Fuel purchase,REF41364477,349.15,0.0,14504.92
2017-10-31,2017-10-31,Business materials,REF54253427,929.93,0.0,13574.99
2017-11-10,2017-11-10,Business materials,REF58797548,455.84,0.0,13119.15
2017-11-12,2017-11-12,Fuel purchase,REF59892116,274.59,0.0,12844.56
2017-11-12,2017-11-12,Vehicle Maintenance expense,REF84326173,117.88,0.0,12726.68
2017-11-14,2017-11-14,Business materials,REF43256213,610.5,0.0,12116.18
2017-11-15,2017-11-15,"Invoice payment - Brown, Smith and Sanchez",REF85631274,0.0,841.76,12957.94
2017-11-15,2017-11-15,Business insurance premium,REF74171597,159.51,0.0,12798.43
2017-11-15,2017-11-15,Service payment - Smith-Rowe,REF11238123,0.0,883.68,13682.11
2017-11-15,2017-11-15,Project payment - Moreno PLC,REF54155129,0.0,881.97,14564.08
2017-11-15,2017-11-15,Invoice payment - Hoover-Camacho,REF69415320,0.0,1179.71,15743.79
2017-11-15,2017-11-15,Vehicle Maintenance expense,REF89003601,140.55,0.0,15603.24
2017-11-16,2017-11-16,Equipment Rental expense,REF97739357,372.61,0.0,15230.63
2017-11-16,2017-11-16,Business materials,REF10052515,662.63,0.0,14568.0
2017-11-18,2017-11-18,Equipment Rental expense,REF40003257,320.29,0.0,14247.71
2017-11-18,2017-11-18,Business materials,REF44448583,996.26,0.0,13251.45
2017-11-22,2017-11-22,Business materials,REF48345881,893.19,0.0,12358.26
2017-11-28,2017-11-28,Tools expense,REF58837929,101.02,0.0,12257.24
2017-11-28,2017-11-28,Business materials,REF95737725,933.63,0.0,11323.61
2017-11-30,2017-11-30,Invoice payment - Moreno PLC,REF70401106,0.0,973.13,12296.74
2017-11-30,2017-11-30,Project payment - Solis and Sons,REF49459667,0.0,171.41,12468.15
2017-11-30,2017-11-30,Payment from Hoover-Camacho,REF42882674,0.0,1144.54,13612.69
2017-11-30,2017-11-30,Invoice payment - Smith-Rowe,REF63471134,0.0,816.5,14429.19
2017-11-30,2017-11-30,"Payment from Brown, Smith and Sanchez",REF83420776,0.0,768.93,15198.12
2017-12-03,2017-12-03,Tools expense,REF80952374,52.66,0.0,15145.46
2017-12-05,2017-12-05,Business materials,REF45478687,620.37,0.0,14525.09
2017-12-06,2017-12-06,Business materials,REF20469638,340.77,0.0,14184.32
2017-12-07,2017-12-07,Business materials,REF37059912,512.9,0.0,13671.42
2017-12-15,2017-12-15,Business insurance premium,REF17372281,120.34,0.0,13551.08
2017-12-15,2017-12-15,Payment from Hoover-Camacho,REF72339317,0.0,875.16,14426.24
2017-12-15,2017-12-15,Project payment - Smith-Rowe,REF99177057,0.0,388.44,14814.68
2017-12-15,2017-12-15,"Invoice payment - Brown, Smith and Sanchez",REF29547183,0.0,869.66,15684.34
2017-12-15,2017-12-15,Payment from Moreno PLC,REF23066905,0.0,709.52,16393.86
2017-12-18,2017-12-18,Business materials,REF71157167,414.15,0.0,15979.71
2017-12-19,2017-12-19,Fuel purchase,REF75984793,150.68,0.0,15829.03
2017-12-22,2017-12-22,Equipment Rental expense,REF22821346,321.16,0.0,15507.87
2017-12-24,2017-12-24,Business materials,REF47573577,356.3,0.0,15151.57
2017-12-24,2017-12-24,Fuel purchase,REF11973631,192.24,0.0,14959.33
2017-12-26,2017-12-26,Business materials,REF51949655,327.99,0.0,14631.34
2017-12-30,2017-12-30,Payment from Smith-Rowe,REF93334563,0.0,651.68,15283.02
2017-12-30,2017-12-30,Payment from Moreno PLC,REF31889710,0.0,733.42,16016.44
2017-12-30,2017-12-30,"Project payment - Brown, Smith and Sanchez",REF98177221,0.0,775.37,16791.81
2017-12-30,2017-12-30,Invoice payment - Solis and Sons,REF48938926,0.0,158.93,16950.74
2017-12-30,2017-12-30,Project payment - Hoover-Camacho,REF53602396,0.0,640.99,17591.73
2018-01-06,2018-01-06,Tools expense,REF76389823,79.64,0.0,17512.09
2018-01-06,2018-01-06,Permits Licenses expense,REF85658966,46.35,0.0,17465.74
2018-01-15,2018-01-15,"Project payment - Brown, Smith and Sanchez",REF92936748,0.0,928.61,18394.35
2018-01-15,2018-01-15,Business insurance premium,REF40589378,144.8,0.0,18249.55
2018-01-15,2018-01-15,Project payment - Smith-Rowe,REF54698344,0.0,691.99,18941.54
2018-01-15,2018-01-15,Service payment - Moreno PLC,REF14930001,0.0,1108.52,20050.06
2018-01-16,2018-01-16,Fuel purchase,REF83578613,303.43,0.0,19746.63
2018-01-23,2018-01-23,Equipment Rental expense,REF39630685,365.91,0.0,19380.72
2018-01-23,2018-01-23,Fuel purchase,REF85878271,185.3,0.0,19195.42
2018-01-25,2018-01-25,Tools expense,REF12635916,82.81,0.0,19112.61
2018-01-25,2018-01-25,Safety Equipment expense,REF52302390,33.74,0.0,19078.87
2018-01-30,2018-01-30,Payment from Solis and Sons,REF48176103,0.0,155.53,19234.4
2018-01-30,2018-01-30,Payment from Hoover-Camacho,REF45360896,0.0,1073.53,20307.93
2018-01-30,2018-01-30,"Service payment - Brown, Smith and Sanchez",REF23417155,0.0,770.32,21078.25
2018-01-30,2018-01-30,Payment from Smith-Rowe,REF75863217,0.0,658.58,21736.83
2018-01-30,2018-01-30,Project payment - Moreno PLC,REF64555162,0.0,739.41,22476.24
2018-01-31,2018-01-31,Fuel purchase,REF56144374,254.06,0.0,22222.18
2018-02-01,2018-02-01,Fuel purchase,REF97848477,101.12,0.0,22121.06
2018-02-02,2018-02-02,Fuel purchase,REF30517251,225.79,0.0,21895.27
2018-02-03,2018-02-03,Vehicle Maintenance expense,REF45179306,139.99,0.0,21755.28
2018-02-06,2018-02-06,Safety Equipment expense,REF27817979,22.48,0.0,21732.8
2018-02-06,2018-02-06,Equipment Rental expense,REF34705705,421.73,0.0,21311.07
2018-02-08,2018-02-08,Equipment Rental expense,REF57585562,288.19,0.0,21022.88
2018-02-08,2018-02-08,Safety Equipment expense,REF57188489,62.14,0.0,20960.74
2018-02-09,2018-02-09,Safety Equipment expense,REF59614284,46.81,0.0,20913.93
2018-02-12,2018-02-12,Subcontractors expense,REF32430483,394.23,0.0,20519.7
2018-02-13,2018-02-13,Fuel purchase,REF14892629,255.95,0.0,20263.75
2018-02-14,2018-02-14,Permits Licenses expense,REF84682408,70.38,0.0,20193.37
2018-02-15,2018-02-15,Invoice payment - Smith-Rowe,REF44188564,0.0,525.29,20718.66
2018-02-15,2018-02-15,Business insurance premium,REF91121800,154.42,0.0,20564.24
2018-02-15,2018-02-15,Service payment - Solis and Sons,REF47773147,0.0,186.35,20750.59
2018-02-15,2018-02-15,Invoice payment - Hoover-Camacho,REF16845449,0.0,1248.76,21999.35
2018-02-15,2018-02-15,"Payment from Brown, Smith and Sanchez",REF83855619,0.0,1098.08,23097.43
2018-02-15,2018-02-15,Payment from Moreno PLC,REF20323819,0.0,1164.54,24261.97
2018-02-16,2018-02-16,Equipment Rental expense,REF60127299,306.93,0.0,23955.04
2018-02-19,2018-02-19,Equipment Rental expense,REF82283602,372.78,0.0,23582.26
2018-02-20,2018-02-20,Equipment Rental expense,REF18691533,530.48,0.0,23051.78
2018-02-20,2018-02-20,Subcontractors expense,REF40945519,894.66,0.0,22157.12
2018-02-21,2018-02-21,Equipment Rental expense,REF27896584,295.84,0.0,21861.28
2018-02-23,2018-02-23,Fuel purchase,REF77262473,159.93,0.0,21701.35
2018-02-28,2018-02-28,Service payment - Solis and Sons,REF66081072,0.0,184.78,21886.13
2018-02-28,2018-02-28,"Invoice payment - Brown, Smith and Sanchez",REF30407034,0.0,1139.77,23025.9
2018-02-28,2018-02-28,Permits Licenses expense,REF98023192,63.67,0.0,22962.23
2018-02-28,2018-02-28,Service payment - Hoover-Camacho,REF50937427,0.0,890.12,23852.35
2018-02-28,2018-02-28,Project payment - Smith-Rowe,REF57308919,0.0,827.33,24679.68
2018-02-28,2018-02-28,Project payment - Moreno PLC,REF89444638,0.0,1055.19,25734.87
2018-03-02,2018-03-02,Business materials,REF84516631,691.59,0.0,25043.28
2018-03-03,2018-03-03,Fuel purchase,REF61233956,388.12,0.0,24655.16
2018-03-04,2018-03-04,Fuel purchase,REF13144163,289.98,0.0,24365.18
2018-03-06,2018-03-06,Subcontractors expense,REF74107531,1043.22,0.0,23321.96
2018-03-07,2018-03-07,Subcontractors expense,REF80931149,1469.33,0.0,21852.63
2018-03-09,2018-03-09,Business materials,REF32177674,648.65,0.0,21203.98
2018-03-15,2018-03-15,Business insurance premium,REF68000384,204.88,0.0,20999.1
2018-03-15,2018-03-15,Service payment - Solis and Sons,REF97401467,0.0,265.98,21265.08
2018-03-15,2018-03-15,"Project payment - Brown, Smith and Sanchez",REF81068617,0.0,1182.38,22447.46
2018-03-15,2018-03-15,Service payment - Hoover-Camacho,REF47662106,0.0,1583.31,24030.77
2018-03-15,2018-03-15,Service payment - Smith-Rowe,REF14012768,0.0,1078.3,25109.07
2018-03-15,2018-03-15,Payment from Moreno PLC,REF93916162,0.0,995.84,26104.91
2018-03-19,2018-03-19,Safety Equipment expense,REF40432675,70.55,0.0,26034.36
2018-03-20,2018-03-20,Equipment Rental expense,REF47954882,130.51,0.0,25903.85
2018-03-23,2018-03-23,Subcontractors expense,REF77293504,776.76,0.0,25127.09
2018-03-25,2018-03-25,Fuel purchase,REF86489759,140.1,0.0,24986.99
2018-03-25,2018-03-25,Business materials,REF27714047,964.86,0.0,24022.13
2018-03-26,2018-03-26,Business materials,REF88838002,650.81,0.0,23371.32
2018-03-30,2018-03-30,Service payment - Moreno PLC,REF76882389,0.0,1403.17,24774.49
2018-03-30,2018-03-30,Payment from Solis and Sons,REF91637258,0.0,168.52,24943.01
2018-03-30,2018-03-30,Payment from Smith-Rowe,REF77588700,0.0,1038.03,25981.04
2018-04-01,2018-04-01,Business materials,REF33837391,1025.17,0.0,24955.87
2018-04-08,2018-04-08,Fuel purchase,REF41409446,513.12,0.0,24442.75
2018-04-08,2018-04-08,Equipment Rental expense,REF34886393,658.12,0.0,23784.63
2018-04-14,2018-04-14,Tools expense,REF17990443,93.87,0.0,23690.76
2018-04-15,2018-04-15,Business insurance premium,REF60295072,236.81,0.0,23453.95
2018-04-15,2018-04-15,"Project payment - Brown, Smith and Sanchez",REF98952502,0.0,1675.79,25129.74
2018-04-15,2018-04-15,Project payment - Moreno PLC,REF62016999,0.0,1722.73,26852.47
2018-04-15,2018-04-15,Payment from Smith-Rowe,REF66497690,0.0,945.17,27797.64
2018-04-15,2018-04-15,Invoice payment - Hoover-Camacho,REF50840278,0.0,1372.53,29170.17
2018-04-15,2018-04-15,Invoice payment - Solis and Sons,REF24498944,0.0,284.8,29454.97
2018-04-17,2018-04-17,Subcontractors expense,REF59657309,1805.93,0.0,27649.04
2018-04-19,2018-04-19,Vehicle Maintenance expense,REF92946129,129.88,0.0,27519.16
2018-04-21,2018-04-21,Tools expense,REF10185426,174.26,0.0,27344.9
2018-04-21,2018-04-21,Fuel purchase,REF91441850,336.49,0.0,27008.41
2018-04-22,2018-04-22,Business materials,REF91773019,577.63,0.0,26430.78
2018-04-24,2018-04-24,Fuel purchase,REF81297895,230.88,0.0,26199.9
2018-04-29,2018-04-29,Subcontractors expense,REF20032898,1608.01,0.0,24591.89
2018-04-29,2018-04-29,Tools expense,REF55246136,161.11,0.0,24430.78
2018-04-30,2018-04-30,Business materials,REF74556276,1232.35,0.0,23198.43
2018-04-30,2018-04-30,Service payment - Moreno PLC,REF58796208,0.0,1118.21,24316.64
2018-04-30,2018-04-30,Payment from Hoover-Camacho,REF72927391,0.0,1812.78,26129.42
2018-04-30,2018-04-30,"Service payment - Brown, Smith and Sanchez",REF99199356,0.0,1493.1,27622.52
2018-04-30,2018-04-30,Project payment - Solis and Sons,REF66522913,0.0,276.74,27899.26
2018-04-30,2018-04-30,Invoice payment - Smith-Rowe,REF62053533,0.0,1166.36,29065.62
2018-05-05,2018-05-05,Business materials,REF77006885,1428.53,0.0,27637.09
2018-05-06,2018-05-06,Safety Equipment expense,REF78985601,113.92,0.0,27523.17
2018-05-08,2018-05-08,Business materials,REF24643826,1272.33,0.0,26250.84
2018-05-11,2018-05-11,Equipment Rental expense,REF33233351,704.68,0.0,25546.16
2018-05-15,2018-05-15,Project payment - Moreno PLC,REF57778476,0.0,1531.72,27077.88
2018-05-15,2018-05-15,"Service payment - Brown, Smith and Sanchez",REF52501294,0.0,1005.24,28083.12
2018-05-15,2018-05-15,Service payment - Smith-Rowe,REF85489561,0.0,1268.4,29351.52
2018-05-15,2018-05-15,Fuel purchase,REF78606832,309.7,0.0,29041.82
2018-05-15,2018-05-15,Project payment - Hoover-Camacho,REF21552181,0.0,1714.64,30756.46
2018-05-15,2018-05-15,Invoice payment - Solis and Sons,REF78542708,0.0,322.11,31078.57
2018-05-15,2018-05-15,Business insurance premium,REF70102139,246.68,0.0,30831.89
2018-05-17,2018-05-17,Equipment Rental expense,REF36275922,576.4,0.0,30255.49
2018-05-20,2018-05-20,Fuel purchase,REF45493316,424.47,0.0,29831.02
2018-05-21,2018-05-21,Business materials,REF13020863,740.89,0.0,29090.13
2018-05-26,2018-05-26,Vehicle Maintenance expense,REF48791373,194.17,0.0,28895.96
2018-05-27,2018-05-27,Equipment Rental expense,REF22648993,490.43,0.0,28405.53
2018-05-28,2018-05-28,Fuel purchase,REF13155651,498.17,0.0,27907.36
2018-05-30,2018-05-30,Service payment - Smith-Rowe,REF55532010,0.0,1394.6,29301.96
2018-05-30,2018-05-30,Invoice payment - Moreno PLC,REF40533912,0.0,1681.93,30983.89
2018-05-30,2018-05-30,Invoice payment - Solis and Sons,REF12229289,0.0,313.05,31296.94
2018-05-30,2018-05-30,"Service payment - Brown, Smith and Sanchez",REF74073918,0.0,2256.64,33553.58
2018-05-31,2018-05-31,Permits Licenses expense,REF51081039,111.7,0.0,33441.88
2018-05-31,2018-05-31,Subcontractors expense,REF88376000,1139.63,0.0,32302.25
2018-06-02,2018-06-02,Vehicle Maintenance expense,REF45538354,181.9,0.0,32120.35
2018-06-02,2018-06-02,Equipment Rental expense,REF30969209,722.67,0.0,31397.68
2018-06-03,2018-06-03,Business materials,REF23120321,1125.32,0.0,30272.36
2018-06-05,2018-06-05,Equipment Rental expense,REF29198489,490.35,0.0,29782.01
2018-06-05,2018-06-05,Fuel purchase,REF76866790,382.59,0.0,29399.42
2018-06-14,2018-06-14,Business materials,REF46094648,1082.11,0.0,28317.31
2018-06-15,2018-06-15,Invoice payment - Smith-Rowe,REF84048367,0.0,1424.64,29741.95
2018-06-15,2018-06-15,Project payment - Moreno PLC,REF61027826,0.0,1869.16,31611.11
2018-06-15,2018-06-15,"Project payment - Brown, Smith and Sanchez",REF79627176,0.0,1734.87,33345.98
2018-06-15,2018-06-15,Invoice payment - Solis and Sons,REF17603828,0.0,290.83,33636.81
2018-06-15,2018-06-15,Payment from Hoover-Camacho,REF51697418,0.0,1731.38,35368.19
2018-06-15,2018-06-15,Business insurance premium,REF30914498,286.63,0.0,35081.56
2018-06-16,2018-06-16,Business materials,REF57057135,817.33,0.0,34264.23
2018-06-18,2018-06-18,Fuel purchase,REF77565773,353.97,0.0,33910.26
2018-06-18,2018-06-18,Permits Licenses expense,REF39905913,138.57,0.0,33771.69
2018-06-19,2018-06-19,Subcontractors expense,REF91295020,1568.85,0.0,32202.84
2018-06-20,2018-06-20,Business materials,REF19221149,1025.29,0.0,31177.55
2018-06-25,2018-06-25,Subcontractors expense,REF77944316,1594.46,0.0,29583.09
2018-06-30,2018-06-30,Service payment - Hoover-Camacho,REF66937609,0.0,1776.08,31359.17
2018-06-30,2018-06-30,"Invoice payment - Brown, Smith and Sanchez",REF49148993,0.0,1792.33,33151.5
2018-06-30,2018-06-30,Project payment - Moreno PLC,REF68653948,0.0,1322.96,34474.46
2018-06-30,2018-06-30,Service payment - Solis and Sons,REF51214043,0.0,316.67,34791.13
2018-06-30,2018-06-30,Invoice payment - Smith-Rowe,REF22199497,0.0,1089.89,35881.02
2018-07-04,2018-07-04,Fuel purchase,REF41976984,164.26,0.0,35716.76
2018-07-08,2018-07-08,Business materials,REF17929036,988.64,0.0,34728.12
2018-07-09,2018-07-09,Safety Equipment expense,REF73960154,83.06,0.0,34645.06
2018-07-15,2018-07-15,Service payment - Hoover-Camacho,REF60132620,0.0,1403.27,36048.33
2018-07-15,2018-07-15,"Invoice payment - Brown, Smith and Sanchez",REF82420726,0.0,1578.08,37626.41
2018-07-15,2018-07-15,Payment from Smith-Rowe,REF13404052,0.0,1035.64,38662.05
2018-07-15,2018-07-15,Payment from Solis and Sons,REF60284975,0.0,198.41,38860.46
2018-07-15,2018-07-15,Service payment - Moreno PLC,REF22585491,0.0,1935.51,40795.97
2018-07-15,2018-07-15,Business insurance premium,REF37080594,247.16,0.0,40548.81
2018-07-19,2018-07-19,Business materials,REF20432583,1461.05,0.0,39087.76
2018-07-20,2018-07-20,Vehicle Maintenance expense,REF20560991,138.97,0.0,38948.79
2018-07-21,2018-07-21,Business materials,REF79090837,728.87,0.0,38219.92
2018-07-21,2018-07-21,Fuel purchase,REF61821863,368.39,0.0,37851.53
2018-07-22,2018-07-22,Subcontractors expense,REF59222117,1250.97,0.0,36600.56
2018-07-24,2018-07-24,Business materials,REF91802499,704.37,0.0,35896.19
2018-07-27,2018-07-27,Safety Equipment expense,REF48159186,70.12,0.0,35826.07
2018-07-30,2018-07-30,Service payment - Hoover-Camacho,REF44006726,0.0,1769.92,37595.99
2018-07-30,2018-07-30,Invoice payment - Smith-Rowe,REF56974589,0.0,1179.25,38775.24
2018-07-30,2018-07-30,"Invoice payment - Brown, Smith and Sanchez",REF53096738,0.0,1561.59,40336.83
2018-07-30,2018-07-30,Payment from Moreno PLC,REF83473768,0.0,1486.84,41823.67
2018-07-30,2018-07-30,Payment from Solis and Sons,REF58117066,0.0,316.11,42139.78
2018-08-05,2018-08-05,Business materials,REF68580390,842.35,0.0,41297.43
2018-08-07,2018-08-07,Permits Licenses expense,REF96091571,87.87,0.0,41209.56
2018-08-07,2018-08-07,Business materials,REF72667823,547.89,0.0,40661.67
2018-08-08,2018-08-08,Vehicle Maintenance expense,REF91249315,207.14,0.0,40454.53
2018-08-08,2018-08-08,Fuel purchase,REF42873848,451.3,0.0,40003.23
2018-08-15,2018-08-15,Business insurance premium,REF47188185,257.18,0.0,39746.05
2018-08-15,2018-08-15,Service payment - Solis and Sons,REF18194045,0.0,226.34,39972.39
2018-08-15,2018-08-15,Payment from Smith-Rowe,REF58844728,0.0,1253.03,41225.42
2018-08-15,2018-08-15,Invoice payment - Moreno PLC,REF91405954,0.0,1110.44,42335.86
2018-08-15,2018-08-15,"Service payment - Brown, Smith and Sanchez",REF70842160,0.0,1439.85,43775.71
2018-08-15,2018-08-15,Payment from Hoover-Camacho,REF61856288,0.0,1744.0,45519.71
2018-08-19,2018-08-19,Business materials,REF34560467,1392.61,0.0,44127.1
2018-08-20,2018-08-20,Business materials,REF97086545,1050.89,0.0,43076.21
2018-08-25,2018-08-25,Business materials,REF26666307,626.49,0.0,42449.72
2018-08-30,2018-08-30,Vehicle Maintenance expense,REF83156276,151.37,0.0,42298.35
2018-08-30,2018-08-30,"Project payment - Brown, Smith and Sanchez",REF65604976,0.0,1441.78,43740.13
2018-08-30,2018-08-30,Payment from Solis and Sons,REF47789987,0.0,238.7,43978.83
2018-08-30,2018-08-30,Invoice payment - Hoover-Camacho,REF30591613,0.0,1391.93,45370.76
2018-08-30,2018-08-30,Project payment - Moreno PLC,REF56793844,0.0,1775.13,47145.89
2018-08-30,2018-08-30,Invoice payment - Smith-Rowe,REF76096800,0.0,1098.45,48244.34
2018-09-05,2018-09-05,Safety Equipment expense,REF89467216,111.01,0.0,48133.33
2018-09-06,2018-09-06,Fuel purchase,REF23058879,356.44,0.0,47776.89
2018-09-07,2018-09-07,Fuel purchase,REF37053682,341.26,0.0,47435.63
2018-09-08,2018-09-08,Fuel purchase,REF23234847,410.29,0.0,47025.34
2018-09-08,2018-09-08,Permits Licenses expense,REF21154397,91.51,0.0,46933.83
2018-09-09,2018-09-09,Tools expense,REF12762612,73.61,0.0,46860.22
2018-09-10,2018-09-10,Business materials,REF58215057,519.18,0.0,46341.04
2018-09-11,2018-09-11,Permits Licenses expense,REF59208317,118.83,0.0,46222.21
2018-09-12,2018-09-12,Equipment Rental expense,REF43232093,516.0,0.0,45706.21
2018-09-14,2018-09-14,Fuel purchase,REF96519879,520.14,0.0,45186.07
2018-09-15,2018-09-15,Service payment - Smith-Rowe,REF31725025,0.0,1145.36,46331.43
2018-09-15,2018-09-15,Service payment - Moreno PLC,REF42570987,0.0,1498.39,47829.82
2018-09-15,2018-09-15,Invoice payment - Hoover-Camacho,REF67573210,0.0,1210.9,49040.72
2018-09-15,2018-09-15,"Service payment - Brown, Smith and Sanchez",REF38974706,0.0,1584.48,50625.2
2018-09-15,2018-09-15,Business insurance premium,REF18701940,228.93,0.0,50396.27
2018-09-16,2018-09-16,Fuel purchase,REF64603715,419.59,0.0,49976.68
2018-09-17,2018-09-17,Business materials,REF22374699,760.68,0.0,49216.0
2018-09-19,2018-09-19,Tools expense,REF17038583,149.48,0.0,49066.52
2018-09-22,2018-09-22,Fuel purchase,REF28117908,406.91,0.0,48659.61
2018-09-23,2018-09-23,Subcontractors expense,REF28502743,747.37,0.0,47912.24
2018-09-26,2018-09-26,Subcontractors expense,REF70242657,1268.34,0.0,46643.9
2018-09-28,2018-09-28,Fuel purchase,REF11343532,143.42,0.0,46500.48
2018-09-28,2018-09-28,Business materials,REF69245317,1084.14,0.0,45416.34
2018-09-30,2018-09-30,Project payment - Hoover-Camacho,REF68433529,0.0,1621.53,47037.87
2018-09-30,2018-09-30,Service payment - Smith-Rowe,REF98993038,0.0,926.89,47964.76
2018-09-30,2018-09-30,"Project payment - Brown, Smith and Sanchez",REF28779120,0.0,1239.11,49203.87
2018-09-30,2018-09-30,Invoice payment - Solis and Sons,REF72587335,0.0,265.06,49468.93
2018-09-30,2018-09-30,Service payment - Moreno PLC,REF24108701,0.0,1788.74,51257.67
2018-10-01,2018-10-01,Tools expense,REF97621346,57.37,0.0,51200.3
2018-10-02,2018-10-02,Permits Licenses expense,REF19778988,42.55,0.0,51157.75
2018-10-03,2018-10-03,Fuel purchase,REF36876004,214.51,0.0,50943.24
2018-10-06,2018-10-06,Fuel purchase,REF60366569,222.1,0.0,50721.14
2018-10-09,2018-10-09,Equipment Rental expense,REF67351812,339.54,0.0,50381.6
2018-10-12,2018-10-12,Fuel purchase,REF91256468,472.97,0.0,49908.63
2018-10-15,2018-10-15,Business insurance premium,REF99605006,184.64,0.0,49723.99
2018-10-15,2018-10-15,Payment from Smith-Rowe,REF98464063,0.0,850.12,50574.11
2018-10-15,2018-10-15,Payment from Hoover-Camacho,REF74585632,0.0,1462.7,52036.81
2018-10-15,2018-10-15,"Project payment - Brown, Smith and Sanchez",REF46135557,0.0,1196.27,53233.08
2018-10-15,2018-10-15,Project payment - Solis and Sons,REF31537816,0.0,252.85,53485.93
2018-10-15,2018-10-15,Project payment - Moreno PLC,REF83877275,0.0,1283.31,54769.24
2018-10-16,2018-10-16,Fuel purchase,REF40528697,204.55,0.0,54564.69
2018-10-17,2018-10-17,Fuel purchase,REF48314327,171.71,0.0,54392.98
2018-10-17,2018-10-17,Vehicle Maintenance expense,REF82814665,150.03,0.0,54242.95
2018-10-19,2018-10-19,Vehicle Maintenance expense,REF82452794,203.48,0.0,54039.47
2018-10-20,2018-10-20,Equipment Rental expense,REF60125557,353.7,0.0,53685.77
2018-10-22,2018-10-22,Fuel purchase,REF92502405,340.23,0.0,53345.54
2018-10-24,2018-10-24,Vehicle Maintenance expense,REF63132654,256.17,0.0,53089.37
2018-10-27,2018-10-27,Equipment Rental expense,REF13239459,251.9,0.0,52837.47
2018-10-28,2018-10-28,Vehicle Maintenance expense,REF77773483,222.96,0.0,52614.51
2018-10-29,2018-10-29,Equipment Rental expense,REF97336857,614.54,0.0,51999.97
2018-10-29,2018-10-29,Business materials,REF83301988,957.32,0.0,51042.65
2018-10-30,2018-10-30,Equipment Rental expense,REF56453283,551.51,0.0,50491.14
2018-10-30,2018-10-30,Invoice payment - Solis and Sons,REF79574857,0.0,232.81,50723.95
2018-10-30,2018-10-30,Tools expense,REF83138825,73.29,0.0,50650.66
2018-10-30,2018-10-30,Service payment - Smith-Rowe,REF97491949,0.0,936.95,51587.61
2018-10-30,2018-10-30,Project payment - Moreno PLC,REF25663366,0.0,1383.84,52971.45
2018-10-30,2018-10-30,Invoice payment - Hoover-Camacho,REF19155853,0.0,1377.04,54348.49
2018-10-30,2018-10-30,"Service payment - Brown, Smith and Sanchez",REF64581357,0.0,1300.42,55648.91
2018-11-08,2018-11-08,Fuel purchase,REF50336624,190.03,0.0,55458.88
2018-11-09,2018-11-09,Equipment Rental expense,REF27756829,295.51,0.0,55163.37
2018-11-15,2018-11-15,Project payment - Smith-Rowe,REF55466299,0.0,691.95,55855.32
2018-11-15,2018-11-15,"Payment from Brown, Smith and Sanchez",REF52760981,0.0,975.87,56831.19
2018-11-15,2018-11-15,Service payment - Moreno PLC,REF69608610,0.0,868.9,57700.09
2018-11-15,2018-11-15,Service payment - Solis and Sons,REF95305421,0.0,161.88,57861.97
2018-11-15,2018-11-15,Project payment - Hoover-Camacho,REF32988232,0.0,1049.43,58911.4
2018-11-15,2018-11-15,Business insurance premium,REF62166893,160.63,0.0,58750.77
2018-11-18,2018-11-18,Fuel purchase,REF52827777,265.54,0.0,58485.23
2018-11-18,2018-11-18,Safety Equipment expense,REF25260326,44.52,0.0,58440.71
2018-11-18,2018-11-18,Vehicle Maintenance expense,REF90205858,96.02,0.0,58344.69
2018-11-19,2018-11-19,Equipment Rental expense,REF41612885,300.43,0.0,58044.26
2018-11-19,2018-11-19,Business materials,REF29532072,821.2,0.0,57223.06
2018-11-23,2018-11-23,Fuel purchase,REF16862864,273.27,0.0,56949.79
2018-11-25,2018-11-25,Permits Licenses expense,REF31352302,63.08,0.0,56886.71
2018-11-25,2018-11-25,Business materials,REF10719755,608.04,0.0,56278.67
2018-11-26,2018-11-26,Vehicle Maintenance expense,REF52868777,120.68,0.0,56157.99
2018-11-30,2018-11-30,Invoice payment - Moreno PLC,REF61765912,0.0,1516.56,57674.55
2018-11-30,2018-11-30,Invoice payment - Hoover-Camacho,REF17873034,0.0,1102.42,58776.97
2018-11-30,2018-11-30,Invoice payment - Solis and Sons,REF64608127,0.0,161.8,58938.77
2018-11-30,2018-11-30,"Payment from Brown, Smith and Sanchez",REF46432686,0.0,900.84,59839.61
2018-12-04,2018-12-04,Business materials,REF74113459,452.08,0.0,59387.53
2018-12-06,2018-12-06,Business materials,REF97610402,736.41,0.0,58651.12
2018-12-07,2018-12-07,Permits Licenses expense,REF87200697,36.87,0.0,58614.25
2018-12-10,2018-12-10,Tools expense,REF51060353,39.0,0.0,58575.25
2018-12-10,2018-12-10,Safety Equipment expense,REF95176898,44.98,0.0,58530.27
2018-12-10,2018-12-10,Equipment Rental expense,REF51942449,312.24,0.0,58218.03
2018-12-12,2018-12-12,Tools expense,REF57840490,38.6,0.0,58179.43
2018-12-13,2018-12-13,Tools expense,REF98252979,62.16,0.0,58117.27
2018-12-14,2018-12-14,Vehicle Maintenance expense,REF14575911,60.78,0.0,58056.49
2018-12-15,2018-12-15,"Project payment - Brown, Smith and Sanchez",REF62046226,0.0,784.49,58840.98
2018-12-15,2018-12-15,Invoice payment - Hoover-Camacho,REF76289672,0.0,782.15,59623.13
2018-12-15,2018-12-15,Invoice payment - Moreno PLC,REF29560549,0.0,748.21,60371.34
2018-12-15,2018-12-15,Business insurance premium,REF80290108,122.0,0.0,60249.34
2018-12-15,2018-12-15,Invoice payment - Solis and Sons,REF89201108,0.0,167.41,60416.75
2018-12-15,2018-12-15,Equipment Rental expense,REF61084112,297.94,0.0,60118.81
2018-12-16,2018-12-16,Vehicle Maintenance expense,REF54876899,76.97,0.0,60041.84
2018-12-18,2018-12-18,Subcontractors expense,REF87825634,487.25,0.0,59554.59
2018-12-19,2018-12-19,Vehicle Maintenance expense,REF56323172,140.67,0.0,59413.92
2018-12-23,2018-12-23,Permits Licenses expense,REF48975394,52.8,0.0,59361.12
2018-12-24,2018-12-24,Subcontractors expense,REF13867809,641.29,0.0,58719.83
2018-12-24,2018-12-24,Tools expense,REF97704279,88.05,0.0,58631.78
2018-12-25,2018-12-25,Fuel purchase,REF45643189,196.2,0.0,58435.58
2018-12-29,2018-12-29,Tools expense,REF37154375,50.85,0.0,58384.73
2018-12-30,2018-12-30,Project payment - Smith-Rowe,REF72344049,0.0,559.47,58944.2
2018-12-30,2018-12-30,Service payment - Solis and Sons,REF23710309,0.0,129.55,59073.75
2018-12-30,2018-12-30,Invoice payment - Moreno PLC,REF91809758,0.0,834.44,59908.19
2018-12-30,2018-12-30,Invoice payment - Hoover-Camacho,REF29102715,0.0,903.68,60811.87
2018-12-30,2018-12-30,"Service payment - Brown, Smith and Sanchez",REF72886207,0.0,735.4,61547.27
2018-12-30,2018-12-30,Business materials,REF16350726,242.75,0.0,61304.52
2019-01-01,2019-01-01,Business materials,REF72558629,529.7,0.0,60774.82
2019-01-01,2019-01-01,Vehicle Maintenance expense,REF38158841,117.51,0.0,60657.31
2019-01-02,2019-01-02,Permits Licenses expense,REF65097478,80.13,0.0,60577.18
2019-01-04,2019-01-04,Fuel purchase,REF90724442,260.52,0.0,60316.66
2019-01-08,2019-01-08,Business materials,REF96236390,635.68,0.0,59680.98
2019-01-09,2019-01-09,Business materials,REF48719799,317.52,0.0,59363.46
2019-01-15,2019-01-15,Invoice payment - Hoover-Camacho,REF80868321,0.0,914.23,60277.69
2019-01-15,2019-01-15,Business insurance premium,REF73023251,145.83,0.0,60131.86
2019-01-15,2019-01-15,Safety Equipment expense,REF29903486,88.39,0.0,60043.47
2019-01-15,2019-01-15,"Project payment - Brown, Smith and Sanchez",REF56034094,0.0,882.22,60925.69
2019-01-15,2019-01-15,Project payment - Smith-Rowe,REF85422580,0.0,910.31,61836.0
2019-01-15,2019-01-15,Invoice payment - Moreno PLC,REF77200507,0.0,846.21,62682.21
2019-01-17,2019-01-17,Business materials,REF85674885,182.92,0.0,62499.29
2019-01-20,2019-01-20,Fuel purchase,REF60622880,209.78,0.0,62289.51
2019-01-22,2019-01-22,Business materials,REF86537515,417.2,0.0,61872.31
2019-01-22,2019-01-22,Vehicle Maintenance expense,REF97765282,109.53,0.0,61762.78
2019-01-30,2019-01-30,"Service payment - Brown, Smith and Sanchez",REF67463793,0.0,925.33,62688.11
2019-01-30,2019-01-30,Project payment - Hoover-Camacho,REF63689816,0.0,976.32,63664.43
2019-01-30,2019-01-30,Invoice payment - Moreno PLC,REF86339853,0.0,835.28,64499.71
2019-01-30,2019-01-30,Invoice payment - Smith-Rowe,REF59644076,0.0,762.85,65262.56
2019-01-31,2019-01-31,Vehicle Maintenance expense,REF10059917,122.76,0.0,65139.8
2019-02-09,2019-02-09,Fuel purchase,REF69543280,223.26,0.0,64916.54
2019-02-12,2019-02-12,Business materials,REF44869375,920.63,0.0,63995.91
2019-02-13,2019-02-13,Fuel purchase,REF28139459,330.48,0.0,63665.43
2019-02-14,2019-02-14,Safety Equipment expense,REF92693977,98.23,0.0,63567.2
2019-02-15,2019-02-15,Business insurance premium,REF97602677,165.07,0.0,63402.13
2019-02-15,2019-02-15,Project payment - Smith-Rowe,REF60475386,0.0,731.85,64133.98
2019-02-15,2019-02-15,"Payment from Brown, Smith and Sanchez",REF47269036,0.0,998.57,65132.55
2019-02-15,2019-02-15,Project payment - Hoover-Camacho,REF42611516,0.0,1067.64,66200.19
2019-02-15,2019-02-15,Invoice payment - Solis and Sons,REF91717864,0.0,167.17,66367.36
2019-02-15,2019-02-15,Project payment - Moreno PLC,REF89291033,0.0,1070.63,67437.99
2019-02-16,2019-02-16,Fuel purchase,REF49689714,329.19,0.0,67108.8
2019-02-17,2019-02-17,Tools expense,REF53696394,49.97,0.0,67058.83
2019-02-19,2019-02-19,Permits Licenses expense,REF99383530,66.24,0.0,66992.59
2019-02-20,2019-02-20,Business materials,REF13195729,663.26,0.0,66329.33
2019-02-21,2019-02-21,Safety Equipment expense,REF16538459,67.9,0.0,66261.43
2019-02-22,2019-02-22,Business materials,REF15005139,784.3,0.0,65477.13
2019-02-22,2019-02-22,Tools expense,REF82508242,77.52,0.0,65399.61
2019-02-23,2019-02-23,Fuel purchase,REF28533298,250.27,0.0,65149.34
2019-02-24,2019-02-24,Fuel purchase,REF66555087,288.01,0.0,64861.33
2019-02-28,2019-02-28,Invoice payment - Moreno PLC,REF32899821,0.0,1208.23,66069.56
2019-02-28,2019-02-28,"Project payment - Brown, Smith and Sanchez",REF25230405,0.0,1186.75,67256.31
2019-02-28,2019-02-28,Invoice payment - Solis and Sons,REF40925945,0.0,216.39,67472.7
2019-02-28,2019-02-28,Payment from Hoover-Camacho,REF54282763,0.0,951.99,68424.69
2019-03-04,2019-03-04,Fuel purchase,REF37344007,248.13,0.0,68176.56
2019-03-06,2019-03-06,Business materials,REF97615491,720.52,0.0,67456.04
2019-03-12,2019-03-12,Permits Licenses expense,REF18723825,58.26,0.0,67397.78
2019-03-15,2019-03-15,Invoice payment - Solis and Sons,REF76242012,0.0,189.72,67587.5
2019-03-15,2019-03-15,Service payment - Moreno PLC,REF95778262,0.0,1578.04,69165.54
2019-03-15,2019-03-15,Service payment - Smith-Rowe,REF52850646,0.0,870.24,70035.78
2019-03-15,2019-03-15,"Invoice payment - Brown, Smith and Sanchez",REF61427931,0.0,1617.44,71653.22
2019-03-15,2019-03-15,Payment from Hoover-Camacho,REF55934686,0.0,1409.49,73062.71
2019-03-15,2019-03-15,Business insurance premium,REF75275481,196.1,0.0,72866.61
2019-03-17,2019-03-17,Business materials,REF11006677,587.63,0.0,72278.98
2019-03-18,2019-03-18,Business materials,REF71308885,675.52,0.0,71603.46
2019-03-24,2019-03-24,Fuel purchase,REF98952997,251.09,0.0,71352.37
2019-03-24,2019-03-24,Subcontractors expense,REF31992304,937.16,0.0,70415.21
2019-03-27,2019-03-27,Fuel purchase,REF33339364,275.28,0.0,70139.93
2019-03-30,2019-03-30,"Project payment - Brown, Smith and Sanchez",REF44586325,0.0,1132.59,71272.52
2019-03-30,2019-03-30,Service payment - Smith-Rowe,REF82524531,0.0,1043.92,72316.44
2019-03-30,2019-03-30,Project payment - Solis and Sons,REF56322799,0.0,227.53,72543.97
2019-03-30,2019-03-30,Equipment Rental expense,REF22514357,241.96,0.0,72302.01
2019-03-30,2019-03-30,Payment from Hoover-Camacho,REF78270272,0.0,1137.92,73439.93
2019-03-30,2019-03-30,Project payment - Moreno PLC,REF48632872,0.0,1368.33,74808.26
2019-04-01,2019-04-01,Safety Equipment expense,REF56846731,114.85,0.0,74693.41
2019-04-02,2019-04-02,Tools expense,REF37768891,182.68,0.0,74510.73
2019-04-05,2019-04-05,Safety Equipment expense,REF18164727,69.94,0.0,74440.79
2019-04-07,2019-04-07,Safety Equipment expense,REF84722968,80.14,0.0,74360.65
2019-04-09,2019-04-09,Fuel purchase,REF65513232,216.6,0.0,74144.05
2019-04-09,2019-04-09,Vehicle Maintenance expense,REF40614059,97.12,0.0,74046.93
2019-04-12,2019-04-12,Permits Licenses expense,REF65116843,72.25,0.0,73974.68
2019-04-12,2019-04-12,Vehicle Maintenance expense,REF87852896,192.7,0.0,73781.98
2019-04-15,2019-04-15,Business insurance premium,REF68807724,237.52,0.0,73544.46
2019-04-15,2019-04-15,Payment from Hoover-Camacho,REF70559264,0.0,1607.32,75151.78
2019-04-15,2019-04-15,Service payment - Solis and Sons,REF17810101,0.0,222.94,75374.72
2019-04-15,2019-04-15,"Invoice payment - Brown, Smith and Sanchez",REF51092075,0.0,1292.12,76666.84
2019-04-15,2019-04-15,Invoice payment - Moreno PLC,REF77011086,0.0,1464.83,78131.67
2019-04-17,2019-04-17,Equipment Rental expense,REF55443311,544.15,0.0,77587.52
2019-04-22,2019-04-22,Business materials,REF85483302,1017.58,0.0,76569.94
2019-04-24,2019-04-24,Fuel purchase,REF19960158,444.53,0.0,76125.41
2019-04-25,2019-04-25,Business materials,REF13968723,714.99,0.0,75410.42
2019-04-27,2019-04-27,Business materials,REF47951381,1224.75,0.0,74185.67
2019-04-27,2019-04-27,Fuel purchase,REF78119573,76.3,0.0,74109.37
2019-04-29,2019-04-29,Safety Equipment expense,REF20772283,127.9,0.0,73981.47
2019-04-30,2019-04-30,"Project payment - Brown, Smith and Sanchez",REF58445549,0.0,1376.76,75358.23
2019-04-30,2019-04-30,Project payment - Moreno PLC,REF74114587,0.0,1591.01,76949.24
2019-04-30,2019-04-30,Invoice payment - Hoover-Camacho,REF40590606,0.0,2227.31,79176.55
2019-04-30,2019-04-30,Tools expense,REF50241622,206.87,0.0,78969.68
2019-04-30,2019-04-30,Payment from Solis and Sons,REF24409940,0.0,249.78,79219.46
2019-05-11,2019-05-11,Business materials,REF44502768,1349.35,0.0,77870.11
2019-05-11,2019-05-11,Permits Licenses expense,REF54450095,119.98,0.0,77750.13
2019-05-15,2019-05-15,Business insurance premium,REF72464806,258.83,0.0,77491.3
2019-05-15,2019-05-15,Invoice payment - Hoover-Camacho,REF65666211,0.0,1264.78,78756.08
2019-05-15,2019-05-15,Project payment - Solis and Sons,REF12527809,0.0,264.15,79020.23
2019-05-15,2019-05-15,"Payment from Brown, Smith and Sanchez",REF49130284,0.0,1746.63,80766.86
2019-05-15,2019-05-15,Invoice payment - Moreno PLC,REF47779038,0.0,1642.61,82409.47
2019-05-20,2019-05-20,Business materials,REF10990851,1494.53,0.0,80914.94
2019-05-21,2019-05-21,Business materials,REF82745909,1244.84,0.0,79670.1
2019-05-22,2019-05-22,Business materials,REF86455373,743.54,0.0,78926.56
2019-05-23,2019-05-23,Business materials,REF79604133,954.24,0.0,77972.32
2019-05-27,2019-05-27,Tools expense,REF45257719,77.56,0.0,77894.76
2019-05-30,2019-05-30,Service payment - Solis and Sons,REF66865738,0.0,264.4,78159.16
2019-05-30,2019-05-30,Invoice payment - Hoover-Camacho,REF74896065,0.0,1592.3,79751.46
2019-05-30,2019-05-30,Service payment - Moreno PLC,REF94896002,0.0,1629.87,81381.33
2019-05-30,2019-05-30,Safety Equipment expense,REF71225756,105.36,0.0,81275.97
2019-05-30,2019-05-30,Business materials,REF60526542,1104.6,0.0,80171.37
2019-05-30,2019-05-30,Payment from Smith-Rowe,REF74329430,0.0,1185.06,81356.43
2019-06-05,2019-06-05,Business materials,REF97835810,1188.93,0.0,80167.5
2019-06-06,2019-06-06,Business materials,REF98772834,904.04,0.0,79263.46
2019-06-13,2019-06-13,Business materials,REF47716133,766.57,0.0,78496.89
2019-06-15,2019-06-15,Fuel purchase,REF39113541,145.35,0.0,78351.54
2019-06-15,2019-06-15,Project payment - Smith-Rowe,REF26744011,0.0,1226.51,79578.05
2019-06-15,2019-06-15,Payment from Hoover-Camacho,REF14451552,0.0,2506.97,82085.02
2019-06-15,2019-06-15,Invoice payment - Solis and Sons,REF75192169,0.0,355.69,82440.71
2019-06-15,2019-06-15,Business insurance premium,REF13555555,285.13,0.0,82155.58
2019-06-15,2019-06-15,"Project payment - Brown, Smith and Sanchez",REF80739818,0.0,1481.79,83637.37
2019-06-15,2019-06-15,Service payment - Moreno PLC,REF72959053,0.0,1551.88,85189.25
2019-06-19,2019-06-19,Business materials,REF40349041,1472.53,0.0,83716.72
2019-06-19,2019-06-19,Fuel purchase,REF28623898,269.55,0.0,83447.17
2019-06-23,2019-06-23,Fuel purchase,REF95247344,430.78,0.0,83016.39
2019-06-30,2019-06-30,Invoice payment - Hoover-Camacho,REF19088513,0.0,2105.31,85121.7
2019-06-30,2019-06-30,Payment from Smith-Rowe,REF58211651,0.0,1170.33,86292.03
2019-06-30,2019-06-30,Payment from Solis and Sons,REF85970224,0.0,261.0,86553.03
2019-07-01,2019-07-01,Vehicle Maintenance expense,REF90744042,149.14,0.0,86403.89
2019-07-01,2019-07-01,Safety Equipment expense,REF32812628,109.65,0.0,86294.24
2019-07-03,2019-07-03,Fuel purchase,REF81705649,402.59,0.0,85891.65
2019-07-12,2019-07-12,Business materials,REF99408416,996.76,0.0,84894.89
2019-07-13,2019-07-13,Permits Licenses expense,REF17051021,89.04,0.0,84805.85
2019-07-13,2019-07-13,Business materials,REF77662848,1451.19,0.0,83354.66
2019-07-15,2019-07-15,Business insurance premium,REF21352147,248.88,0.0,83105.78
2019-07-15,2019-07-15,Service payment - Solis and Sons,REF74559468,0.0,239.45,83345.23
2019-07-15,2019-07-15,Invoice payment - Smith-Rowe,REF69130070,0.0,1130.9,84476.13
2019-07-15,2019-07-15,Invoice payment - Hoover-Camacho,REF67671289,0.0,1405.71,85881.84
2019-07-15,2019-07-15,Service payment - Moreno PLC,REF46056746,0.0,1702.49,87584.33
2019-07-15,2019-07-15,"Invoice payment - Brown, Smith and Sanchez",REF50471719,0.0,1581.46,89165.79
2019-07-30,2019-07-30,Project payment - Hoover-Camacho,REF62932562,0.0,1753.08,90918.87
2019-07-30,2019-07-30,Payment from Solis and Sons,REF59308170,0.0,252.79,91171.66
2019-07-30,2019-07-30,"Service payment - Brown, Smith and Sanchez",REF76133367,0.0,1903.35,93075.01
2019-07-30,2019-07-30,Project payment - Smith-Rowe,REF94758495,0.0,1014.82,94089.83
2019-08-01,2019-08-01,Equipment Rental expense,REF21022550,737.21,0.0,93352.62
2019-08-04,2019-08-04,Business materials,REF23709179,1148.89,0.0,92203.73
2019-08-13,2019-08-13,Permits Licenses expense,REF22231362,116.24,0.0,92087.49
2019-08-14,2019-08-14,Equipment Rental expense,REF30151973,507.85,0.0,91579.64
2019-08-15,2019-08-15,"Payment from Brown, Smith and Sanchez",REF15531087,0.0,1745.8,93325.44
2019-08-15,2019-08-15,Service payment - Hoover-Camacho,REF51848167,0.0,2108.83,95434.27
2019-08-15,2019-08-15,Project payment - Smith-Rowe,REF11479337,0.0,1160.57,96594.84
2019-08-15,2019-08-15,Service payment - Moreno PLC,REF97542160,0.0,1883.58,98478.42
2019-08-15,2019-08-15,Business materials,REF60193289,895.21,0.0,97583.21
2019-08-15,2019-08-15,Business insurance premium,REF69062997,241.37,0.0,97341.84
2019-08-16,2019-08-16,Fuel purchase,REF73398703,274.69,0.0,97067.15
2019-08-19,2019-08-19,Permits Licenses expense,REF28588160,64.56,0.0,97002.59
2019-08-21,2019-08-21,Safety Equipment expense,REF99767598,94.76,0.0,96907.83
2019-08-22,2019-08-22,Subcontractors expense,REF68558781,1329.95,0.0,95577.88
2019-08-25,2019-08-25,Fuel purchase,REF93094491,285.89,0.0,95291.99
2019-08-27,2019-08-27,Fuel purchase,REF93662838,387.16,0.0,94904.83
2019-08-28,2019-08-28,Subcontractors expense,REF60323682,1502.83,0.0,93402.0
2019-08-28,2019-08-28,Equipment Rental expense,REF37031867,359.18,0.0,93042.82
2019-08-30,2019-08-30,Fuel purchase,REF31189297,323.79,0.0,92719.03
2019-08-30,2019-08-30,Service payment - Moreno PLC,REF29264808,0.0,1590.01,94309.04
2019-08-30,2019-08-30,"Service payment - Brown, Smith and Sanchez",REF34269393,0.0,1473.16,95782.2
2019-08-30,2019-08-30,Project payment - Smith-Rowe,REF97099424,0.0,1154.67,96936.87
2019-08-30,2019-08-30,Project payment - Solis and Sons,REF77330018,0.0,271.54,97208.41
2019-08-31,2019-08-31,Vehicle Maintenance expense,REF48220796,215.33,0.0,96993.08
2019-09-06,2019-09-06,Vehicle Maintenance expense,REF75106006,242.15,0.0,96750.93
2019-09-09,2019-09-09,Business materials,REF20666495,448.83,0.0,96302.1
2019-09-14,2019-09-14,Subcontractors expense,REF67551382,967.45,0.0,95334.65
2019-09-15,2019-09-15,Project payment - Smith-Rowe,REF34123479,0.0,1053.52,96388.17
2019-09-15,2019-09-15,Invoice payment - Solis and Sons,REF65734066,0.0,263.83,96652.0
2019-09-15,2019-09-15,Invoice payment - Moreno PLC,REF71664530,0.0,1051.41,97703.41
2019-09-15,2019-09-15,Business insurance premium,REF12383803,232.14,0.0,97471.27
2019-09-15,2019-09-15,"Project payment - Brown, Smith and Sanchez",REF96015525,0.0,1592.46,99063.73
2019-09-22,2019-09-22,Business materials,REF43750414,799.62,0.0,98264.11
2019-09-27,2019-09-27,Fuel purchase,REF44413399,307.09,0.0,97957.02
2019-09-30,2019-09-30,Tools expense,REF25446956,105.67,0.0,97851.35
2019-09-30,2019-09-30,Safety Equipment expense,REF79335617,103.86,0.0,97747.49
2019-09-30,2019-09-30,Business materials,REF46988469,1168.86,0.0,96578.63
2019-09-30,2019-09-30,Invoice payment - Hoover-Camacho,REF10625204,0.0,1347.8,97926.43
2019-09-30,2019-09-30,Payment from Smith-Rowe,REF41027757,0.0,1409.1,99335.53
2019-09-30,2019-09-30,"Invoice payment - Brown, Smith and Sanchez",REF46614733,0.0,1357.93,100693.46
2019-09-30,2019-09-30,Invoice payment - Solis and Sons,REF82623285,0.0,288.35,100981.81
2019-09-30,2019-09-30,Project payment - Moreno PLC,REF97267649,0.0,1624.21,102606.02
2019-10-01,2019-10-01,Business materials,REF15706083,999.24,0.0,101606.78
2019-10-02,2019-10-02,Tools expense,REF14091917,70.23,0.0,101536.55
2019-10-03,2019-10-03,Permits Licenses expense,REF60064726,89.17,0.0,101447.38
2019-10-04,2019-10-04,Business materials,REF93859838,968.81,0.0,100478.57
2019-10-13,2019-10-13,Business materials,REF52769583,1194.05,0.0,99284.52
2019-10-15,2019-10-15,"Payment from Brown, Smith and Sanchez",REF71608585,0.0,1299.53,100584.05
2019-10-15,2019-10-15,Service payment - Smith-Rowe,REF13540686,0.0,737.33,101321.38
2019-10-15,2019-10-15,Payment from Hoover-Camacho,REF41802218,0.0,1115.9,102437.28
2019-10-15,2019-10-15,Invoice payment - Solis and Sons,REF71239888,0.0,247.67,102684.95
2019-10-15,2019-10-15,Business insurance premium,REF29221826,176.43,0.0,102508.52
2019-10-16,2019-10-16,Fuel purchase,REF26378291,362.63,0.0,102145.89
2019-10-19,2019-10-19,Business materials,REF27139514,777.0,0.0,101368.89
2019-10-20,2019-10-20,Subcontractors expense,REF91623326,1030.12,0.0,100338.77
2019-10-22,2019-10-22,Business materials,REF98170686,761.85,0.0,99576.92
2019-10-23,2019-10-23,Business materials,REF30298739,930.3,0.0,98646.62
2019-10-29,2019-10-29,Fuel purchase,REF84266890,335.88,0.0,98310.74
2019-10-30,2019-10-30,Project payment - Moreno PLC,REF75775682,0.0,1143.76,99454.5
2019-10-30,2019-10-30,Service payment - Smith-Rowe,REF27501396,0.0,1132.96,100587.46
2019-10-30,2019-10-30,Invoice payment - Hoover-Camacho,REF77362510,0.0,1620.37,102207.83
2019-10-30,2019-10-30,"Invoice payment - Brown, Smith and Sanchez",REF60997143,0.0,985.87,103193.7
2019-11-01,2019-11-01,Safety Equipment expense,REF68251297,26.27,0.0,103167.43
2019-11-05,2019-11-05,Subcontractors expense,REF75895259,794.08,0.0,102373.35
2019-11-05,2019-11-05,Fuel purchase,REF79612569,295.75,0.0,102077.6
2019-11-06,2019-11-06,Fuel purchase,REF16442649,257.01,0.0,101820.59
2019-11-08,2019-11-08,Business materials,REF16130919,872.32,0.0,100948.27
2019-11-09,2019-11-09,Permits Licenses expense,REF21755299,34.98,0.0,100913.29
2019-11-10,2019-11-10,Vehicle Maintenance expense,REF17735813,106.86,0.0,100806.43
2019-11-13,2019-11-13,Equipment Rental expense,REF20758229,289.31,0.0,100517.12
2019-11-13,2019-11-13,Permits Licenses expense,REF79575772,58.74,0.0,100458.38
2019-11-15,2019-11-15,Project payment - Smith-Rowe,REF10781469,0.0,825.79,101284.17
2019-11-15,2019-11-15,Business insurance premium,REF22181522,176.46,0.0,101107.71
2019-11-15,2019-11-15,Invoice payment - Solis and Sons,REF57507280,0.0,150.65,101258.36
2019-11-15,2019-11-15,Project payment - Hoover-Camacho,REF70473671,0.0,987.77,102246.13
2019-11-15,2019-11-15,"Payment from Brown, Smith and Sanchez",REF57291706,0.0,1012.41,103258.54
2019-11-15,2019-11-15,Project payment - Moreno PLC,REF46366397,0.0,880.85,104139.39
2019-11-16,2019-11-16,Equipment Rental expense,REF78388829,259.24,0.0,103880.15
2019-11-23,2019-11-23,Fuel purchase,REF85489110,327.86,0.0,103552.29
2019-11-24,2019-11-24,Safety Equipment expense,REF56295134,62.48,0.0,103489.81
2019-11-24,2019-11-24,Vehicle Maintenance expense,REF84379154,149.27,0.0,103340.54
2019-11-25,2019-11-25,Fuel purchase,REF45423882,202.08,0.0,103138.46
2019-11-27,2019-11-27,Safety Equipment expense,REF68020527,66.33,0.0,103072.13
2019-11-30,2019-11-30,"Payment from Brown, Smith and Sanchez",REF51935859,0.0,1131.4,104203.53
2019-11-30,2019-11-30,Invoice payment - Hoover-Camacho,REF48040504,0.0,1358.35,105561.88
2019-11-30,2019-11-30,Payment from Moreno PLC,REF24498845,0.0,1062.34,106624.22
2019-11-30,2019-11-30,Invoice payment - Smith-Rowe,REF78208748,0.0,642.23,107266.45
2019-11-30,2019-11-30,Payment from Solis and Sons,REF26086804,0.0,180.55,107447.0
2019-12-01,2019-12-01,Subcontractors expense,REF78727458,451.35,0.0,106995.65
2019-12-02,2019-12-02,Fuel purchase,REF30305728,204.91,0.0,106790.74
2019-12-07,2019-12-07,Tools expense,REF39886715,75.99,0.0,106714.75
2019-12-08,2019-12-08,Safety Equipment expense,REF68858305,59.97,0.0,106654.78
2019-12-15,2019-12-15,Business insurance premium,REF84667546,118.73,0.0,106536.05
2019-12-15,2019-12-15,Project payment - Smith-Rowe,REF17938995,0.0,546.86,107082.91
2019-12-15,2019-12-15,Fuel purchase,REF88129226,126.94,0.0,106955.97
2019-12-15,2019-12-15,Project payment - Solis and Sons,REF12326072,0.0,151.89,107107.86
2019-12-15,2019-12-15,"Project payment - Brown, Smith and Sanchez",REF44887065,0.0,857.06,107964.92
2019-12-15,2019-12-15,Service payment - Moreno PLC,REF97348282,0.0,766.44,108731.36
2019-12-17,2019-12-17,Fuel purchase,REF74503460,196.7,0.0,108534.66
2019-12-21,2019-12-21,Safety Equipment expense,REF76782082,50.11,0.0,108484.55
2019-12-22,2019-12-22,Business materials,REF93118257,678.73,0.0,107805.82
2019-12-26,2019-12-26,Business materials,REF16852822,542.79,0.0,107263.03
2019-12-26,2019-12-26,Permits Licenses expense,REF86392787,74.64,0.0,107188.39
2019-12-27,2019-12-27,Equipment Rental expense,REF26887188,80.1,0.0,107108.29
2019-12-28,2019-12-28,Safety Equipment expense,REF79487431,47.7,0.0,107060.59
2019-12-29,2019-12-29,Tools expense,REF65969786,71.12,0.0,106989.47
2019-12-30,2019-12-30,Fuel purchase,REF70548226,290.13,0.0,106699.34
2019-12-30,2019-12-30,"Invoice payment - Brown, Smith and Sanchez",REF13791033,0.0,847.07,107546.41
2019-12-30,2019-12-30,Payment from Hoover-Camacho,REF50149891,0.0,946.53,108492.94
2019-12-30,2019-12-30,Payment from Smith-Rowe,REF92513007,0.0,507.66,109000.6
2019-12-30,2019-12-30,Invoice payment - Moreno PLC,REF62696220,0.0,804.05,109804.65
2019-12-30,2019-12-30,Payment from Solis and Sons,REF26014539,0.0,89.37,109894.02
2019-12-31,2019-12-31,Business materials,REF55883894,564.02,0.0,109330.0
2020-01-02,2020-01-02,Safety Equipment expense,REF28130330,70.06,0.0,109259.94
2020-01-06,2020-01-06,Vehicle Maintenance expense,REF52834345,106.1,0.0,109153.84
2020-01-07,2020-01-07,Subcontractors expense,REF69748447,425.23,0.0,108728.61
2020-01-08,2020-01-08,Equipment Rental expense,REF97002030,340.32,0.0,108388.29
2020-01-13,2020-01-13,Fuel purchase,REF76025564,215.55,0.0,108172.74
2020-01-15,2020-01-15,"Project payment - Brown, Smith and Sanchez",REF22625811,0.0,1002.38,109175.12
2020-01-15,2020-01-15,Service payment - Solis and Sons,REF71632581,0.0,169.31,109344.43
2020-01-15,2020-01-15,Business insurance premium,REF83551531,141.76,0.0,109202.67
2020-01-15,2020-01-15,Invoice payment - Smith-Rowe,REF74408583,0.0,621.18,109823.85
2020-01-15,2020-01-15,Project payment - Hoover-Camacho,REF81855476,0.0,1076.94,110900.79
2020-01-15,2020-01-15,Payment from Moreno PLC,REF41057244,0.0,752.0,111652.79
2020-01-19,2020-01-19,Equipment Rental expense,REF57870559,302.76,0.0,111350.03
2020-01-22,2020-01-22,Safety Equipment expense,REF13246601,73.36,0.0,111276.67
2020-01-24,2020-01-24,Tools expense,REF38654841,87.53,0.0,111189.14
2020-01-25,2020-01-25,Vehicle Maintenance expense,REF40475685,117.26,0.0,111071.88
2020-01-26,2020-01-26,Permits Licenses expense,REF65051976,44.34,0.0,111027.54
2020-01-28,2020-01-28,Subcontractors expense,REF60435978,467.66,0.0,110559.88
2020-01-30,2020-01-30,Payment from Solis and Sons,REF60772985,0.0,131.89,110691.77
2020-01-30,2020-01-30,Invoice payment - Smith-Rowe,REF52268043,0.0,651.7,111343.47
2020-01-30,2020-01-30,Invoice payment - Moreno PLC,REF76801947,0.0,1051.57,112395.04
2020-01-30,2020-01-30,Invoice payment - Hoover-Camacho,REF60417072,0.0,1007.74,113402.78
2020-01-30,2020-01-30,"Invoice payment - Brown, Smith and Sanchez",REF80941343,0.0,1040.84,114443.62
2020-02-01,2020-02-01,Vehicle Maintenance expense,REF24905222,143.85,0.0,114299.77
2020-02-01,2020-02-01,Business materials,REF13958537,807.1,0.0,113492.67
2020-02-01,2020-02-01,Fuel purchase,REF24225314,225.6,0.0,113267.07
2020-02-02,2020-02-02,Vehicle Maintenance expense,REF71774218,89.71,0.0,113177.36
2020-02-04,2020-02-04,Permits Licenses expense,REF27696679,63.93,0.0,113113.43
2020-02-07,2020-02-07,Subcontractors expense,REF28170427,588.21,0.0,112525.22
2020-02-10,2020-02-10,Vehicle Maintenance expense,REF89503027,120.01,0.0,112405.21
2020-02-15,2020-02-15,Permits Licenses expense,REF96173683,35.78,0.0,112369.43
2020-02-15,2020-02-15,Payment from Solis and Sons,REF97721339,0.0,141.49,112510.92
2020-02-15,2020-02-15,Payment from Smith-Rowe,REF34597638,0.0,688.32,113199.24
2020-02-15,2020-02-15,"Invoice payment - Brown, Smith and Sanchez",REF23398622,0.0,969.92,114169.16
2020-02-15,2020-02-15,Business insurance premium,REF70869116,151.14,0.0,114018.02
2020-02-20,2020-02-20,Business materials,REF68794952,474.68,0.0,113543.34
2020-02-20,2020-02-20,Safety Equipment expense,REF62151506,62.44,0.0,113480.9
2020-02-21,2020-02-21,Business materials,REF56602496,369.95,0.0,113110.95
2020-02-23,2020-02-23,Vehicle Maintenance expense,REF24728085,144.35,0.0,112966.6
2020-02-28,2020-02-28,Business materials,REF26202892,684.61,0.0,112281.99
2020-02-28,2020-02-28,Service payment - Solis and Sons,REF69823856,0.0,156.65,112438.64
2020-02-28,2020-02-28,Subcontractors expense,REF84737703,725.42,0.0,111713.22
2020-02-28,2020-02-28,Service payment - Smith-Rowe,REF92687672,0.0,808.54,112521.76
2020-02-28,2020-02-28,Payment from Hoover-Camacho,REF55217431,0.0,1044.43,113566.19
2020-02-28,2020-02-28,"Service payment - Brown, Smith and Sanchez",REF25949956,0.0,936.47,114502.66
2020-03-03,2020-03-03,Fuel purchase,REF34982128,328.39,0.0,114174.27
2020-03-04,2020-03-04,Fuel purchase,REF85119686,249.48,0.0,113924.79
2020-03-04,2020-03-04,Permits Licenses expense,REF21098359,109.14,0.0,113815.65
2020-03-06,2020-03-06,Business materials,REF71503195,643.6,0.0,113172.05
2020-03-11,2020-03-11,Business materials,REF57615447,621.03,0.0,112551.02
2020-03-15,2020-03-15,Vehicle Maintenance expense,REF87125261,219.76,0.0,112331.26
2020-03-15,2020-03-15,Business insurance premium,REF72914487,209.81,0.0,112121.45
2020-03-15,2020-03-15,"Project payment - Brown, Smith and Sanchez",REF71222213,0.0,1355.19,113476.64
2020-03-15,2020-03-15,Business materials,REF84145241,479.76,0.0,112996.88
2020-03-15,2020-03-15,Payment from Smith-Rowe,REF56050976,0.0,734.3,113731.18
2020-03-15,2020-03-15,Service payment - Moreno PLC,REF62890698,0.0,1055.73,114786.91
2020-03-15,2020-03-15,Invoice payment - Hoover-Camacho,REF87425560,0.0,1432.04,116218.95
2020-03-18,2020-03-18,Permits Licenses expense,REF15180563,77.66,0.0,116141.29
2020-03-24,2020-03-24,Business materials,REF97286657,810.63,0.0,115330.66
2020-03-25,2020-03-25,Business materials,REF20633867,1013.23,0.0,114317.43
2020-03-30,2020-03-30,Payment from Solis and Sons,REF57116706,0.0,257.1,114574.53
2020-03-30,2020-03-30,Project payment - Hoover-Camacho,REF59166500,0.0,1734.23,116308.76
2020-03-30,2020-03-30,Project payment - Smith-Rowe,REF20636869,0.0,1268.4,117577.16
2020-03-30,2020-03-30,Payment from Moreno PLC,REF32916731,0.0,1256.54,118833.7
2020-03-30,2020-03-30,"Payment from Brown, Smith and Sanchez",REF29796537,0.0,1565.18,120398.88
2020-03-31,2020-03-31,Business materials,REF77531928,1080.88,0.0,119318.0
2020-03-31,2020-03-31,Fuel purchase,REF82683095,359.06,0.0,118958.94
2020-04-02,2020-04-02,Subcontractors expense,REF33228480,664.19,0.0,118294.75
2020-04-02,2020-04-02,Fuel purchase,REF62558134,345.76,0.0,117948.99
2020-04-06,2020-04-06,Fuel purchase,REF73745389,187.72,0.0,117761.27
2020-04-06,2020-04-06,Business materials,REF88847528,1407.48,0.0,116353.79
2020-04-07,2020-04-07,Safety Equipment expense,REF13719466,75.95,0.0,116277.84
2020-04-07,2020-04-07,Tools expense,REF37484850,98.39,0.0,116179.45
2020-04-15,2020-04-15,Business insurance premium,REF38578972,244.38,0.0,115935.07
2020-04-15,2020-04-15,Fuel purchase,REF18578459,370.3,0.0,115564.77
2020-04-15,2020-04-15,Payment from Hoover-Camacho,REF28528255,0.0,1495.02,117059.79
2020-04-15,2020-04-15,"Project payment - Brown, Smith and Sanchez",REF74934149,0.0,1203.59,118263.38
2020-04-15,2020-04-15,Service payment - Smith-Rowe,REF40118069,0.0,1029.76,119293.14
2020-04-15,2020-04-15,Invoice payment - Solis and Sons,REF30727915,0.0,269.17,119562.31
2020-04-16,2020-04-16,Tools expense,REF87446357,99.52,0.0,119462.79
2020-04-16,2020-04-16,Subcontractors expense,REF64640000,1616.69,0.0,117846.1
2020-04-18,2020-04-18,Safety Equipment expense,REF50212494,76.11,0.0,117769.99
2020-04-20,2020-04-20,Business materials,REF93921131,1059.0,0.0,116710.99
2020-04-23,2020-04-23,Equipment Rental expense,REF84579946,490.77,0.0,116220.22
2020-04-26,2020-04-26,Business materials,REF43428070,777.67,0.0,115442.55
2020-04-30,2020-04-30,Payment from Smith-Rowe,REF61726523,0.0,1097.66,116540.21
2020-04-30,2020-04-30,Service payment - Solis and Sons,REF35358260,0.0,176.81,116717.02
2020-04-30,2020-04-30,Project payment - Moreno PLC,REF58673556,0.0,1607.9,118324.92
2020-04-30,2020-04-30,Payment from Hoover-Camacho,REF39289897,0.0,1473.97,119798.89
2020-05-01,2020-05-01,Equipment Rental expense,REF78072830,382.13,0.0,119416.76
2020-05-10,2020-05-10,Equipment Rental expense,REF18179689,346.75,0.0,119070.01
2020-05-15,2020-05-15,Business materials,REF34801307,1228.64,0.0,117841.37
2020-05-15,2020-05-15,Invoice payment - Moreno PLC,REF76108872,0.0,1339.62,119180.99
2020-05-15,2020-05-15,Invoice payment - Solis and Sons,REF21767501,0.0,267.21,119448.2
2020-05-15,2020-05-15,Service payment - Hoover-Camacho,REF47684981,0.0,1974.14,121422.34
2020-05-15,2020-05-15,Payment from Smith-Rowe,REF20734047,0.0,1257.01,122679.35
2020-05-15,2020-05-15,"Payment from Brown, Smith and Sanchez",REF81427282,0.0,1739.37,124418.72
2020-05-15,2020-05-15,Business insurance premium,REF35465906,254.64,0.0,124164.08
2020-05-16,2020-05-16,Safety Equipment expense,REF56625026,78.59,0.0,124085.49
2020-05-16,2020-05-16,Subcontractors expense,REF29544489,1560.99,0.0,122524.5
2020-05-20,2020-05-20,Fuel purchase,REF38874739,547.21,0.0,121977.29
2020-05-20,2020-05-20,Vehicle Maintenance expense,REF25086250,278.73,0.0,121698.56
2020-05-23,2020-05-23,Fuel purchase,REF97164709,337.43,0.0,121361.13
2020-05-29,2020-05-29,Fuel purchase,REF82939678,5.0,0.0,121356.13
2020-05-30,2020-05-30,Invoice payment - Moreno PLC,REF34063232,0.0,1755.93,123112.06
2020-05-30,2020-05-30,Service payment - Hoover-Camacho,REF45282734,0.0,1621.9,124733.96
2020-05-30,2020-05-30,Payment from Smith-Rowe,REF89562075,0.0,933.43,125667.39
2020-05-30,2020-05-30,"Service payment - Brown, Smith and Sanchez",REF47340261,0.0,1253.39,126920.78
2020-05-30,2020-05-30,Service payment - Solis and Sons,REF34289227,0.0,317.66,127238.44
2020-05-30,2020-05-30,Business materials,REF15869767,674.17,0.0,126564.27
2020-05-31,2020-05-31,Fuel purchase,REF46621583,290.04,0.0,126274.23
2020-06-03,2020-06-03,Business materials,REF98662597,1157.96,0.0,125116.27
2020-06-08,2020-06-08,Fuel purchase,REF17191486,470.95,0.0,124645.32
2020-06-10,2020-06-10,Subcontractors expense,REF82174115,1180.66,0.0,123464.66
2020-06-14,2020-06-14,Tools expense,REF70991036,123.57,0.0,123341.09
2020-06-15,2020-06-15,Business insurance premium,REF57375261,238.44,0.0,123102.65
2020-06-15,2020-06-15,Project payment - Solis and Sons,REF60794122,0.0,242.24,123344.89
2020-06-15,2020-06-15,Service payment - Hoover-Camacho,REF96628723,0.0,1918.32,125263.21
2020-06-15,2020-06-15,Service payment - Moreno PLC,REF35505666,0.0,1418.1,126681.31
2020-06-15,2020-06-15,"Invoice payment - Brown, Smith and Sanchez",REF79914895,0.0,1513.99,128195.3
2020-06-15,2020-06-15,Payment from Smith-Rowe,REF34920574,0.0,1553.85,129749.15
2020-06-20,2020-06-20,Subcontractors expense,REF63972879,1674.25,0.0,128074.9
2020-06-21,2020-06-21,Equipment Rental expense,REF20619929,670.58,0.0,127404.32
2020-06-23,2020-06-23,Fuel purchase,REF11396646,382.63,0.0,127021.69
2020-06-25,2020-06-25,Safety Equipment expense,REF82090416,78.24,0.0,126943.45
2020-06-30,2020-06-30,Invoice payment - Moreno PLC,REF83638966,0.0,1359.72,128303.17
2020-06-30,2020-06-30,Project payment - Smith-Rowe,REF41064113,0.0,1182.75,129485.92
2020-06-30,2020-06-30,Service payment - Hoover-Camacho,REF79007476,0.0,1852.15,131338.07
2020-06-30,2020-06-30,"Payment from Brown, Smith and Sanchez",REF96503622,0.0,1414.25,132752.32
2020-06-30,2020-06-30,Invoice payment - Solis and Sons,REF18896950,0.0,249.82,133002.14
2020-07-05,2020-07-05,Safety Equipment expense,REF11071626,55.8,0.0,132946.34
2020-07-05,2020-07-05,Business materials,REF67167573,961.71,0.0,131984.63
2020-07-12,2020-07-12,Vehicle Maintenance expense,REF47181610,205.38,0.0,131779.25
2020-07-15,2020-07-15,Business insurance premium,REF12964783,215.8,0.0,131563.45
2020-07-15,2020-07-15,Invoice payment - Smith-Rowe,REF43483820,0.0,974.3,132537.75
2020-07-15,2020-07-15,Invoice payment - Solis and Sons,REF18071921,0.0,273.14,132810.89
2020-07-15,2020-07-15,Payment from Moreno PLC,REF43445753,0.0,1320.96,134131.85
2020-07-15,2020-07-15,Invoice payment - Hoover-Camacho,REF24778378,0.0,1338.49,135470.34
2020-07-16,2020-07-16,Business materials,REF14087950,1285.83,0.0,134184.51
2020-07-16,2020-07-16,Safety Equipment expense,REF96958595,115.64,0.0,134068.87
2020-07-17,2020-07-17,Business materials,REF79917464,916.26,0.0,133152.61
2020-07-17,2020-07-17,Vehicle Maintenance expense,REF88003139,294.69,0.0,132857.92
2020-07-19,2020-07-19,Safety Equipment expense,REF88185514,76.72,0.0,132781.2
2020-07-20,2020-07-20,Safety Equipment expense,REF25121342,101.3,0.0,132679.9
2020-07-23,2020-07-23,Fuel purchase,REF98904607,504.0,0.0,132175.9
2020-07-25,2020-07-25,Vehicle Maintenance expense,REF83447007,132.66,0.0,132043.24
2020-07-30,2020-07-30,Payment from Hoover-Camacho,REF14025722,0.0,1717.69,133760.93
2020-07-30,2020-07-30,Project payment - Moreno PLC,REF70672017,0.0,1358.17,135119.1
2020-07-30,2020-07-30,Subcontractors expense,REF19428592,1335.27,0.0,133783.83
2020-07-30,2020-07-30,Payment from Solis and Sons,REF67011206,0.0,286.19,134070.02
2020-07-30,2020-07-30,"Payment from Brown, Smith and Sanchez",REF53706949,0.0,1259.58,135329.6
2020-07-30,2020-07-30,Service payment - Smith-Rowe,REF70236953,0.0,1015.51,136345.11
2020-08-02,2020-08-02,Vehicle Maintenance expense,REF77636075,170.28,0.0,136174.83
2020-08-13,2020-08-13,Fuel purchase,REF24882288,366.3,0.0,135808.53
2020-08-15,2020-08-15,Project payment - Hoover-Camacho,REF88288788,0.0,1649.42,137457.95
2020-08-15,2020-08-15,Service payment - Solis and Sons,REF66655264,0.0,286.19,137744.14
2020-08-15,2020-08-15,Business insurance premium,REF39728295,230.15,0.0,137513.99
2020-08-15,2020-08-15,"Invoice payment - Brown, Smith and Sanchez",REF72810743,0.0,1382.74,138896.73
2020-08-15,2020-08-15,Safety Equipment expense,REF88429189,102.53,0.0,138794.2
2020-08-15,2020-08-15,Service payment - Moreno PLC,REF26617333,0.0,1404.93,140199.13
2020-08-16,2020-08-16,Business materials,REF58107932,872.25,0.0,139326.88
2020-08-16,2020-08-16,Fuel purchase,REF52586710,348.0,0.0,138978.88
2020-08-17,2020-08-17,Fuel purchase,REF63301331,526.81,0.0,138452.07
2020-08-19,2020-08-19,Permits Licenses expense,REF69031002,81.54,0.0,138370.53
2020-08-19,2020-08-19,Fuel purchase,REF24090533,409.51,0.0,137961.02
2020-08-20,2020-08-20,Subcontractors expense,REF77683456,1307.0,0.0,136654.02
2020-08-24,2020-08-24,Equipment Rental expense,REF56231957,426.41,0.0,136227.61
2020-08-27,2020-08-27,Safety Equipment expense,REF82206429,65.04,0.0,136162.57
2020-08-30,2020-08-30,Invoice payment - Solis and Sons,REF52679501,0.0,301.67,136464.24
2020-08-30,2020-08-30,Payment from Moreno PLC,REF70545723,0.0,1439.54,137903.78
2020-08-30,2020-08-30,Invoice payment - Smith-Rowe,REF24985493,0.0,1127.59,139031.37
2020-08-30,2020-08-30,"Service payment - Brown, Smith and Sanchez",REF41018434,0.0,1494.31,140525.68
2020-08-31,2020-08-31,Fuel purchase,REF43112447,360.65,0.0,140165.03
2020-09-08,2020-09-08,Business materials,REF74821447,1008.7,0.0,139156.33
2020-09-15,2020-09-15,Invoice payment - Smith-Rowe,REF58399317,0.0,999.22,140155.55
2020-09-15,2020-09-15,Business insurance premium,REF15224340,225.76,0.0,139929.79
2020-09-15,2020-09-15,Invoice payment - Hoover-Camacho,REF26169949,0.0,1592.7,141522.49
2020-09-15,2020-09-15,Payment from Moreno PLC,REF69412114,0.0,1217.08,142739.57
2020-09-15,2020-09-15,Payment from Solis and Sons,REF93439851,0.0,285.81,143025.38
2020-09-15,2020-09-15,"Invoice payment - Brown, Smith and Sanchez",REF31700929,0.0,1324.3,144349.68
2020-09-16,2020-09-16,Fuel purchase,REF36456013,260.86,0.0,144088.82
2020-09-19,2020-09-19,Permits Licenses expense,REF84011265,67.29,0.0,144021.53
2020-09-20,2020-09-20,Fuel purchase,REF28536855,194.39,0.0,143827.14
2020-09-30,2020-09-30,Project payment - Moreno PLC,REF83764294,0.0,1688.29,145515.43
2020-09-30,2020-09-30,Service payment - Solis and Sons,REF87210032,0.0,245.35,145760.78
2020-09-30,2020-09-30,Payment from Smith-Rowe,REF67647490,0.0,932.51,146693.29
2020-09-30,2020-09-30,Service payment - Hoover-Camacho,REF89249559,0.0,1488.0,148181.29
2020-09-30,2020-09-30,"Service payment - Brown, Smith and Sanchez",REF69576456,0.0,1745.41,149926.7
2020-10-04,2020-10-04,Fuel purchase,REF77745985,348.18,0.0,149578.52
2020-10-04,2020-10-04,Business materials,REF59574820,736.21,0.0,148842.31
2020-10-05,2020-10-05,Fuel purchase,REF52527620,451.97,0.0,148390.34
2020-10-07,2020-10-07,Fuel purchase,REF25265452,274.72,0.0,148115.62
2020-10-09,2020-10-09,Permits Licenses expense,REF68037811,68.38,0.0,148047.24
2020-10-15,2020-10-15,Business insurance premium,REF13720065,208.85,0.0,147838.39
2020-10-15,2020-10-15,"Project payment - Brown, Smith and Sanchez",REF52278532,0.0,1383.15,149221.54
2020-10-15,2020-10-15,Invoice payment - Solis and Sons,REF43547820,0.0,211.76,149433.3
2020-10-15,2020-10-15,Invoice payment - Smith-Rowe,REF69744620,0.0,932.19,150365.49
2020-10-15,2020-10-15,Payment from Moreno PLC,REF52700542,0.0,1065.02,151430.51
2020-10-18,2020-10-18,Fuel purchase,REF94035215,277.66,0.0,151152.85
2020-10-19,2020-10-19,Subcontractors expense,REF73607828,1496.14,0.0,149656.71
2020-10-21,2020-10-21,Fuel purchase,REF37040325,299.37,0.0,149357.34
2020-10-25,2020-10-25,Fuel purchase,REF95024308,286.82,0.0,149070.52
2020-10-25,2020-10-25,Vehicle Maintenance expense,REF52811275,218.0,0.0,148852.52
2020-10-26,2020-10-26,Equipment Rental expense,REF13724830,460.69,0.0,148391.83
2020-10-28,2020-10-28,Fuel purchase,REF22960638,363.75,0.0,148028.08
2020-10-30,2020-10-30,"Payment from Brown, Smith and Sanchez",REF77908098,0.0,1407.16,149435.24
2020-10-30,2020-10-30,Payment from Solis and Sons,REF52190729,0.0,231.68,149666.92
2020-10-30,2020-10-30,Project payment - Smith-Rowe,REF97552766,0.0,904.24,150571.16
2020-10-30,2020-10-30,Payment from Hoover-Camacho,REF89203968,0.0,1529.97,152101.13
2020-10-30,2020-10-30,Project payment - Moreno PLC,REF33293816,0.0,1054.01,153155.14
2020-11-04,2020-11-04,Fuel purchase,REF17793664,231.6,0.0,152923.54
2020-11-11,2020-11-11,Permits Licenses expense,REF51260746,38.44,0.0,152885.1
2020-11-12,2020-11-12,Fuel purchase,REF65084591,297.69,0.0,152587.41
2020-11-15,2020-11-15,Business insurance premium,REF57496391,142.63,0.0,152444.78
2020-11-15,2020-11-15,Invoice payment - Moreno PLC,REF92481668,0.0,1328.86,153773.64
2020-11-15,2020-11-15,Payment from Smith-Rowe,REF90376198,0.0,806.77,154580.41
2020-11-15,2020-11-15,"Project payment - Brown, Smith and Sanchez",REF42085153,0.0,1012.02,155592.43
2020-11-15,2020-11-15,Service payment - Hoover-Camacho,REF52580858,0.0,1349.89,156942.32
2020-11-15,2020-11-15,Service payment - Solis and Sons,REF13946770,0.0,187.09,157129.41
2020-11-17,2020-11-17,Safety Equipment expense,REF13139317,68.27,0.0,157061.14
2020-11-20,2020-11-20,Equipment Rental expense,REF63428293,335.32,0.0,156725.82
2020-11-26,2020-11-26,Business materials,REF12399059,620.05,0.0,156105.77
2020-11-27,2020-11-27,Business materials,REF91262331,827.41,0.0,155278.36
2020-11-28,2020-11-28,Fuel purchase,REF46835903,223.07,0.0,155055.29
2020-11-29,2020-11-29,Fuel purchase,REF56381089,298.73,0.0,154756.56
2020-11-30,2020-11-30,"Project payment - Brown, Smith and Sanchez",REF60161953,0.0,1098.13,155854.69
2020-11-30,2020-11-30,Project payment - Moreno PLC,REF86719824,0.0,867.31,156722.0
2020-11-30,2020-11-30,Payment from Smith-Rowe,REF24651153,0.0,688.98,157410.98
2020-11-30,2020-11-30,Payment from Hoover-Camacho,REF90854922,0.0,1132.49,158543.47
2020-11-30,2020-11-30,Project payment - Solis and Sons,REF50887765,0.0,207.03,158750.5
2020-12-02,2020-12-02,Business materials,REF16561774,511.64,0.0,158238.86
2020-12-02,2020-12-02,Safety Equipment expense,REF74733181,50.17,0.0,158188.69
2020-12-07,2020-12-07,Safety Equipment expense,REF26251436,39.92,0.0,158148.77
2020-12-10,2020-12-10,Vehicle Maintenance expense,REF72446508,50.26,0.0,158098.51
2020-12-12,2020-12-12,Business materials,REF72393892,576.76,0.0,157521.75
2020-12-15,2020-12-15,Fuel purchase,REF22467192,199.58,0.0,157322.17
2020-12-15,2020-12-15,Invoice payment - Hoover-Camacho,REF69146931,0.0,815.16,158137.33
2020-12-15,2020-12-15,"Service payment - Brown, Smith and Sanchez",REF73230150,0.0,921.1,159058.43
2020-12-15,2020-12-15,Project payment - Solis and Sons,REF78879471,0.0,124.25,159182.68
2020-12-15,2020-12-15,Service payment - Moreno PLC,REF76541349,0.0,717.37,159900.05
2020-12-15,2020-12-15,Invoice payment - Smith-Rowe,REF40670229,0.0,598.67,160498.72
2020-12-15,2020-12-15,Business insurance premium,REF35520593,116.65,0.0,160382.07
2020-12-16,2020-12-16,Safety Equipment expense,REF58302442,55.25,0.0,160326.82
2020-12-16,2020-12-16,Permits Licenses expense,REF60164213,44.35,0.0,160282.47
2020-12-19,2020-12-19,Equipment Rental expense,REF12910195,155.77,0.0,160126.7
2020-12-19,2020-12-19,Subcontractors expense,REF70149318,452.69,0.0,159674.01
2020-12-19,2020-12-19,Business materials,REF20337609,443.29,0.0,159230.72
2020-12-20,2020-12-20,Business materials,REF47577744,349.89,0.0,158880.83
2020-12-30,2020-12-30,Payment from Solis and Sons,REF94036715,0.0,139.51,159020.34
2020-12-30,2020-12-30,Invoice payment - Moreno PLC,REF91706950,0.0,820.15,159840.49
2020-12-30,2020-12-30,"Invoice payment - Brown, Smith and Sanchez",REF25166992,0.0,908.55,160749.04
2020-12-30,2020-12-30,Payment from Smith-Rowe,REF12933538,0.0,599.81,161348.85
2020-12-30,2020-12-30,Service payment - Hoover-Camacho,REF95645230,0.0,887.01,162235.86
2021-01-06,2021-01-06,Permits Licenses expense,REF68858927,55.41,0.0,162180.45
2021-01-09,2021-01-09,Business materials,REF81601367,378.72,0.0,161801.73
2021-01-12,2021-01-12,Business materials,REF28439972,697.02,0.0,161104.71
2021-01-12,2021-01-12,Vehicle Maintenance expense,REF90174370,62.59,0.0,161042.12
2021-01-15,2021-01-15,Payment from Moreno PLC,REF58910638,0.0,976.7,162018.82
2021-01-15,2021-01-15,Payment from Smith-Rowe,REF59850290,0.0,746.3,162765.12
2021-01-15,2021-01-15,"Payment from Brown, Smith and Sanchez",REF47192793,0.0,1131.29,163896.41
2021-01-15,2021-01-15,Invoice payment - Hoover-Camacho,REF71789227,0.0,1043.05,164939.46
2021-01-15,2021-01-15,Payment from Solis and Sons,REF16014215,0.0,185.73,165125.19
2021-01-15,2021-01-15,Business insurance premium,REF51491210,134.15,0.0,164991.04
2021-01-17,2021-01-17,Business materials,REF95715819,656.85,0.0,164334.19
2021-01-17,2021-01-17,Permits Licenses expense,REF41500781,29.64,0.0,164304.55
2021-01-21,2021-01-21,Safety Equipment expense,REF33030868,33.66,0.0,164270.89
2021-01-21,2021-01-21,Tools expense,REF90540257,42.46,0.0,164228.43
2021-01-25,2021-01-25,Tools expense,REF39784499,74.12,0.0,164154.31
2021-01-28,2021-01-28,Subcontractors expense,REF30857184,758.78,0.0,163395.53
2021-01-29,2021-01-29,Tools expense,REF20854330,106.39,0.0,163289.14
2021-01-30,2021-01-30,Service payment - Solis and Sons,REF21759749,0.0,169.59,163458.73
2021-01-30,2021-01-30,Invoice payment - Hoover-Camacho,REF97589752,0.0,866.55,164325.28
2021-01-30,2021-01-30,"Invoice payment - Brown, Smith and Sanchez",REF18262467,0.0,753.39,165078.67
2021-01-30,2021-01-30,Project payment - Smith-Rowe,REF53519060,0.0,636.61,165715.28
2021-02-01,2021-02-01,Permits Licenses expense,REF56505428,80.47,0.0,165634.81
2021-02-04,2021-02-04,Business materials,REF13685750,657.76,0.0,164977.05
2021-02-08,2021-02-08,Subcontractors expense,REF29405988,546.3,0.0,164430.75
2021-02-09,2021-02-09,Business materials,REF75312519,574.31,0.0,163856.44
2021-02-12,2021-02-12,Vehicle Maintenance expense,REF66342982,123.04,0.0,163733.4
2021-02-15,2021-02-15,Service payment - Moreno PLC,REF83149736,0.0,1135.59,164868.99
2021-02-15,2021-02-15,"Payment from Brown, Smith and Sanchez",REF94107105,0.0,888.82,165757.81
2021-02-15,2021-02-15,Payment from Hoover-Camacho,REF38117887,0.0,1359.15,167116.96
2021-02-15,2021-02-15,Service payment - Smith-Rowe,REF64390616,0.0,755.62,167872.58
2021-02-15,2021-02-15,Business insurance premium,REF31177394,166.41,0.0,167706.17
2021-02-16,2021-02-16,Fuel purchase,REF16702939,222.64,0.0,167483.53
2021-02-16,2021-02-16,Business materials,REF96778645,680.93,0.0,166802.6
2021-02-27,2021-02-27,Fuel purchase,REF46584369,354.25,0.0,166448.35
2021-02-28,2021-02-28,Payment from Hoover-Camacho,REF54977970,0.0,960.91,167409.26
2021-02-28,2021-02-28,Project payment - Solis and Sons,REF84738587,0.0,170.01,167579.27
2021-02-28,2021-02-28,"Payment from Brown, Smith and Sanchez",REF60569367,0.0,1091.45,168670.72
2021-02-28,2021-02-28,Project payment - Smith-Rowe,REF97595492,0.0,548.03,169218.75
2021-02-28,2021-02-28,Payment from Moreno PLC,REF62990385,0.0,857.45,170076.2
2021-03-02,2021-03-02,Tools expense,REF97991982,133.72,0.0,169942.48
2021-03-02,2021-03-02,Vehicle Maintenance expense,REF36015254,193.86,0.0,169748.62
2021-03-02,2021-03-02,Business materials,REF87603428,881.13,0.0,168867.49
2021-03-03,2021-03-03,Business materials,REF83697765,645.5,0.0,168221.99
2021-03-05,2021-03-05,Vehicle Maintenance expense,REF62732441,105.71,0.0,168116.28
2021-03-06,2021-03-06,Permits Licenses expense,REF65851667,56.91,0.0,168059.37
2021-03-06,2021-03-06,Fuel purchase,REF98563866,331.8,0.0,167727.57
2021-03-06,2021-03-06,Equipment Rental expense,REF97598192,476.96,0.0,167250.61
2021-03-08,2021-03-08,Fuel purchase,REF99978062,220.54,0.0,167030.07
2021-03-09,2021-03-09,Fuel purchase,REF99232091,375.8,0.0,166654.27
2021-03-10,2021-03-10,Tools expense,REF45447807,134.65,0.0,166519.62
2021-03-11,2021-03-11,Vehicle Maintenance expense,REF22333958,170.73,0.0,166348.89
2021-03-13,2021-03-13,Business materials,REF41498521,819.41,0.0,165529.48
2021-03-15,2021-03-15,Project payment - Hoover-Camacho,REF22110956,0.0,1497.43,167026.91
2021-03-15,2021-03-15,Invoice payment - Moreno PLC,REF26733656,0.0,1490.52,168517.43
2021-03-15,2021-03-15,"Service payment - Brown, Smith and Sanchez",REF43214614,0.0,1244.53,169761.96
2021-03-15,2021-03-15,Invoice payment - Solis and Sons,REF32252505,0.0,223.55,169985.51
2021-03-15,2021-03-15,Business insurance premium,REF16996429,205.16,0.0,169780.35
2021-03-15,2021-03-15,Payment from Smith-Rowe,REF66723285,0.0,989.12,170769.47
2021-03-19,2021-03-19,Fuel purchase,REF27940992,287.77,0.0,170481.7
2021-03-22,2021-03-22,Tools expense,REF18690950,123.53,0.0,170358.17
2021-03-23,2021-03-23,Tools expense,REF11836322,120.24,0.0,170237.93
2021-03-23,2021-03-23,Permits Licenses expense,REF20890602,115.72,0.0,170122.21
2021-03-27,2021-03-27,Business materials,REF81465746,1373.58,0.0,168748.63
2021-03-29,2021-03-29,Safety Equipment expense,REF75365790,89.89,0.0,168658.74
2021-03-30,2021-03-30,Invoice payment - Solis and Sons,REF93694872,0.0,308.22,168966.96
2021-03-30,2021-03-30,Service payment - Hoover-Camacho,REF42461122,0.0,1254.46,170221.42
2021-03-30,2021-03-30,Business materials,REF68254354,700.66,0.0,169520.76
2021-03-30,2021-03-30,Fuel purchase,REF66815314,390.76,0.0,169130.0
2021-03-30,2021-03-30,Project payment - Moreno PLC,REF61311721,0.0,1211.29,170341.29
2021-03-30,2021-03-30,Invoice payment - Smith-Rowe,REF34062104,0.0,838.07,171179.36
2021-03-30,2021-03-30,"Invoice payment - Brown, Smith and Sanchez",REF83128235,0.0,1090.67,172270.03
2021-04-02,2021-04-02,Equipment Rental expense,REF35401011,325.33,0.0,171944.7
2021-04-03,2021-04-03,Business materials,REF96522386,957.83,0.0,170986.87
2021-04-07,2021-04-07,Permits Licenses expense,REF52578727,70.78,0.0,170916.09
2021-04-10,2021-04-10,Equipment Rental expense,REF72893981,379.6,0.0,170536.49
2021-04-13,2021-04-13,Fuel purchase,REF95107656,412.0,0.0,170124.49
2021-04-13,2021-04-13,Vehicle Maintenance expense,REF72804205,271.43,0.0,169853.06
2021-04-15,2021-04-15,Service payment - Moreno PLC,REF77997676,0.0,1483.28,171336.34
2021-04-15,2021-04-15,Service payment - Solis and Sons,REF49479961,0.0,246.61,171582.95
2021-04-15,2021-04-15,"Project payment - Brown, Smith and Sanchez",REF77600691,0.0,1236.3,172819.25
2021-04-15,2021-04-15,Invoice payment - Hoover-Camacho,REF64536523,0.0,1882.14,174701.39
2021-04-15,2021-04-15,Payment from Smith-Rowe,REF17049865,0.0,1378.83,176080.22
2021-04-15,2021-04-15,Business insurance premium,REF72444687,231.45,0.0,175848.77
2021-04-21,2021-04-21,Fuel purchase,REF48475388,356.62,0.0,175492.15
2021-04-21,2021-04-21,Tools expense,REF85545057,197.89,0.0,175294.26
2021-04-22,2021-04-22,Fuel purchase,REF70298959,321.75,0.0,174972.51
2021-04-23,2021-04-23,Vehicle Maintenance expense,REF13739341,182.04,0.0,174790.47
2021-04-28,2021-04-28,Safety Equipment expense,REF46360838,104.65,0.0,174685.82
2021-04-29,2021-04-29,Fuel purchase,REF75281908,418.56,0.0,174267.26
2021-04-30,2021-04-30,Subcontractors expense,REF34027657,1774.31,0.0,172492.95
2021-04-30,2021-04-30,Payment from Moreno PLC,REF27796083,0.0,1531.87,174024.82
2021-04-30,2021-04-30,Service payment - Solis and Sons,REF64985643,0.0,274.24,174299.06
2021-04-30,2021-04-30,Project payment - Smith-Rowe,REF98459339,0.0,1176.01,175475.07
2021-04-30,2021-04-30,"Payment from Brown, Smith and Sanchez",REF77653938,0.0,1551.27,177026.34
2021-04-30,2021-04-30,Service payment - Hoover-Camacho,REF48733334,0.0,1564.7,178591.04
2021-05-09,2021-05-09,Permits Licenses expense,REF68200689,136.92,0.0,178454.12
2021-05-14,2021-05-14,Vehicle Maintenance expense,REF32138450,213.33,0.0,178240.79
2021-05-15,2021-05-15,Business materials,REF79867888,897.36,0.0,177343.43
2021-05-15,2021-05-15,Payment from Smith-Rowe,REF44132183,0.0,1203.13,178546.56
2021-05-15,2021-05-15,Business insurance premium,REF70292815,262.94,0.0,178283.62
2021-05-15,2021-05-15,Invoice payment - Hoover-Camacho,REF76089667,0.0,1868.25,180151.87
2021-05-15,2021-05-15,Service payment - Solis and Sons,REF22869936,0.0,291.85,180443.72
2021-05-15,2021-05-15,"Payment from Brown, Smith and Sanchez",REF51850141,0.0,1998.35,182442.07
2021-05-18,2021-05-18,Business materials,REF68417109,610.85,0.0,181831.22
2021-05-21,2021-05-21,Subcontractors expense,REF73502128,522.27,0.0,181308.95
2021-05-24,2021-05-24,Business materials,REF52540783,838.99,0.0,180469.96
2021-05-27,2021-05-27,Fuel purchase,REF80301525,422.44,0.0,180047.52
2021-05-29,2021-05-29,Business materials,REF32466394,1403.28,0.0,178644.24
2021-05-30,2021-05-30,Payment from Moreno PLC,REF63342185,0.0,1469.78,180114.02
2021-05-30,2021-05-30,Safety Equipment expense,REF90062991,67.42,0.0,180046.6
2021-05-30,2021-05-30,"Service payment - Brown, Smith and Sanchez",REF66239461,0.0,1891.25,181937.85
2021-05-30,2021-05-30,Service payment - Hoover-Camacho,REF51334994,0.0,1800.35,183738.2
2021-05-30,2021-05-30,Payment from Solis and Sons,REF86118917,0.0,300.86,184039.06
2021-05-30,2021-05-30,Invoice payment - Smith-Rowe,REF72853099,0.0,1552.51,185591.57
2021-05-31,2021-05-31,Business materials,REF11532898,827.97,0.0,184763.6
2021-05-31,2021-05-31,Equipment Rental expense,REF51678953,342.16,0.0,184421.44
2021-06-05,2021-06-05,Business materials,REF20426539,1812.14,0.0,182609.3
2021-06-14,2021-06-14,Fuel purchase,REF38673660,597.55,0.0,182011.75
2021-06-15,2021-06-15,Business insurance premium,REF91125086,282.13,0.0,181729.62
2021-06-15,2021-06-15,Invoice payment - Solis and Sons,REF42634601,0.0,343.5,182073.12
2021-06-15,2021-06-15,Invoice payment - Hoover-Camacho,REF98243029,0.0,1676.19,183749.31
2021-06-15,2021-06-15,"Project payment - Brown, Smith and Sanchez",REF84214249,0.0,1847.61,185596.92
2021-06-15,2021-06-15,Project payment - Smith-Rowe,REF89171312,0.0,1066.85,186663.77
2021-06-15,2021-06-15,Invoice payment - Moreno PLC,REF41761568,0.0,1716.53,188380.3
2021-06-18,2021-06-18,Fuel purchase,REF60480423,357.52,0.0,188022.78
2021-06-22,2021-06-22,Vehicle Maintenance expense,REF26538362,200.82,0.0,187821.96
2021-06-26,2021-06-26,Fuel purchase,REF97988638,431.33,0.0,187390.63
2021-06-30,2021-06-30,Project payment - Moreno PLC,REF94505064,0.0,2212.71,189603.34
2021-06-30,2021-06-30,Invoice payment - Smith-Rowe,REF20739231,0.0,1591.78,191195.12
2021-06-30,2021-06-30,Service payment - Solis and Sons,REF66484219,0.0,273.52,191468.64
2021-06-30,2021-06-30,"Payment from Brown, Smith and Sanchez",REF77465301,0.0,2012.34,193480.98
2021-06-30,2021-06-30,Project payment - Hoover-Camacho,REF41729315,0.0,1709.11,195190.09
2021-07-03,2021-07-03,Fuel purchase,REF78454087,156.66,0.0,195033.43
2021-07-09,2021-07-09,Business materials,REF35212794,964.81,0.0,194068.62
2021-07-10,2021-07-10,Fuel purchase,REF85866415,406.36,0.0,193662.26
2021-07-11,2021-07-11,Tools expense,REF24173486,70.47,0.0,193591.79
2021-07-12,2021-07-12,Fuel purchase,REF56604405,320.78,0.0,193271.01
2021-07-13,2021-07-13,Safety Equipment expense,REF83459516,64.11,0.0,193206.9
2021-07-15,2021-07-15,Equipment Rental expense,REF56774011,475.36,0.0,192731.54
2021-07-15,2021-07-15,Project payment - Smith-Rowe,REF76991244,0.0,1255.56,193987.1
2021-07-15,2021-07-15,Project payment - Hoover-Camacho,REF63936519,0.0,1780.25,195767.35
2021-07-15,2021-07-15,Payment from Moreno PLC,REF58236573,0.0,1614.77,197382.12
2021-07-15,2021-07-15,Business materials,REF33318474,581.07,0.0,196801.05
2021-07-15,2021-07-15,Business insurance premium,REF91140335,246.24,0.0,196554.81
2021-07-16,2021-07-16,Vehicle Maintenance expense,REF40125004,195.68,0.0,196359.13
2021-07-17,2021-07-17,Business materials,REF58042748,884.65,0.0,195474.48
2021-07-18,2021-07-18,Business materials,REF51770044,926.78,0.0,194547.7
2021-07-21,2021-07-21,Safety Equipment expense,REF75580848,79.12,0.0,194468.58
2021-07-22,2021-07-22,Equipment Rental expense,REF58095508,262.44,0.0,194206.14
2021-07-23,2021-07-23,Fuel purchase,REF16109862,362.2,0.0,193843.94
2021-07-23,2021-07-23,Business materials,REF16739564,822.95,0.0,193020.99
2021-07-24,2021-07-24,Business materials,REF97020203,1352.82,0.0,191668.17
2021-07-26,2021-07-26,Business materials,REF94374019,605.8,0.0,191062.37
2021-07-27,2021-07-27,Subcontractors expense,REF45128731,1196.64,0.0,189865.73
2021-07-28,2021-07-28,Subcontractors expense,REF40159832,709.28,0.0,189156.45
2021-07-30,2021-07-30,Invoice payment - Hoover-Camacho,REF39304759,0.0,2137.15,191293.6
2021-07-30,2021-07-30,"Invoice payment - Brown, Smith and Sanchez",REF32475136,0.0,1053.28,192346.88
2021-07-30,2021-07-30,Payment from Smith-Rowe,REF35499460,0.0,909.49,193256.37
2021-07-30,2021-07-30,Project payment - Moreno PLC,REF10468830,0.0,1739.8,194996.17
2021-08-01,2021-08-01,Equipment Rental expense,REF92285622,351.84,0.0,194644.33
2021-08-02,2021-08-02,Vehicle Maintenance expense,REF65036894,200.72,0.0,194443.61
2021-08-03,2021-08-03,Business materials,REF91107048,1491.22,0.0,192952.39
2021-08-05,2021-08-05,Subcontractors expense,REF91497029,1780.69,0.0,191171.7
2021-08-09,2021-08-09,Safety Equipment expense,REF55360766,102.3,0.0,191069.4
2021-08-10,2021-08-10,Fuel purchase,REF66427657,464.78,0.0,190604.62
2021-08-14,2021-08-14,Equipment Rental expense,REF97724672,752.84,0.0,189851.78
2021-08-14,2021-08-14,Business materials,REF53756376,873.79,0.0,188977.99
2021-08-15,2021-08-15,Payment from Hoover-Camacho,REF81924687,0.0,2064.72,191042.71
2021-08-15,2021-08-15,"Invoice payment - Brown, Smith and Sanchez",REF31839654,0.0,2223.86,193266.57
2021-08-15,2021-08-15,Business insurance premium,REF37724565,237.69,0.0,193028.88
2021-08-15,2021-08-15,Payment from Solis and Sons,REF91652008,0.0,229.64,193258.52
2021-08-15,2021-08-15,Payment from Moreno PLC,REF99344476,0.0,1659.01,194917.53
2021-08-18,2021-08-18,Business materials,REF43995876,1258.56,0.0,193658.97
2021-08-25,2021-08-25,Tools expense,REF11983712,111.74,0.0,193547.23
2021-08-26,2021-08-26,Business materials,REF48771326,905.57,0.0,192641.66
2021-08-30,2021-08-30,Business materials,REF13802047,1479.26,0.0,191162.4
2021-08-30,2021-08-30,Invoice payment - Solis and Sons,REF94174478,0.0,249.44,191411.84
2021-08-30,2021-08-30,Service payment - Moreno PLC,REF84352477,0.0,1676.61,193088.45
2021-08-30,2021-08-30,"Project payment - Brown, Smith and Sanchez",REF62719893,0.0,1477.61,194566.06
2021-08-30,2021-08-30,Payment from Hoover-Camacho,REF70127840,0.0,1916.1,196482.16
2021-09-03,2021-09-03,Permits Licenses expense,REF71059287,66.01,0.0,196416.15
2021-09-03,2021-09-03,Tools expense,REF34490796,147.55,0.0,196268.6
2021-09-05,2021-09-05,Subcontractors expense,REF63837698,963.65,0.0,195304.95
2021-09-10,2021-09-10,Equipment Rental expense,REF69886703,295.01,0.0,195009.94
2021-09-10,2021-09-10,Tools expense,REF61068482,114.23,0.0,194895.71
2021-09-15,2021-09-15,Service payment - Hoover-Camacho,REF49908228,0.0,1874.01,196769.72
2021-09-15,2021-09-15,Service payment - Solis and Sons,REF99400323,0.0,208.97,196978.69
2021-09-15,2021-09-15,"Invoice payment - Brown, Smith and Sanchez",REF99214227,0.0,1184.73,198163.42
2021-09-15,2021-09-15,Invoice payment - Smith-Rowe,REF78076166,0.0,1157.76,199321.18
2021-09-15,2021-09-15,Project payment - Moreno PLC,REF77787632,0.0,1327.52,200648.7
2021-09-15,2021-09-15,Business insurance premium,REF91435482,195.14,0.0,200453.56
2021-09-17,2021-09-17,Subcontractors expense,REF88879967,892.48,0.0,199561.08
2021-09-17,2021-09-17,Fuel purchase,REF65210253,478.65,0.0,199082.43
2021-09-19,2021-09-19,Business materials,REF89741276,1050.59,0.0,198031.84
2021-09-21,2021-09-21,Subcontractors expense,REF89689769,508.09,0.0,197523.75
2021-09-24,2021-09-24,Vehicle Maintenance expense,REF45685685,175.07,0.0,197348.68
2021-09-27,2021-09-27,Vehicle Maintenance expense,REF83833397,150.38,0.0,197198.3
2021-09-28,2021-09-28,Business materials,REF22302019,757.42,0.0,196440.88
2021-09-30,2021-09-30,Invoice payment - Hoover-Camacho,REF30057994,0.0,1687.59,198128.47
2021-09-30,2021-09-30,"Invoice payment - Brown, Smith and Sanchez",REF86079272,0.0,1427.04,199555.51
2021-09-30,2021-09-30,Project payment - Smith-Rowe,REF56434328,0.0,902.77,200458.28
2021-09-30,2021-09-30,Service payment - Solis and Sons,REF38833947,0.0,266.74,200725.02
2021-10-01,2021-10-01,Vehicle Maintenance expense,REF19834517,164.58,0.0,200560.44
2021-10-03,2021-10-03,Business materials,REF64996554,1238.81,0.0,199321.63
2021-10-07,2021-10-07,Permits Licenses expense,REF83478180,76.91,0.0,199244.72
2021-10-08,2021-10-08,Fuel purchase,REF48432802,298.21,0.0,198946.51
2021-10-08,2021-10-08,Equipment Rental expense,REF81669111,217.78,0.0,198728.73
2021-10-11,2021-10-11,Fuel purchase,REF18959696,195.2,0.0,198533.53
2021-10-15,2021-10-15,Business insurance premium,REF78229469,204.47,0.0,198329.06
2021-10-15,2021-10-15,Fuel purchase,REF62673376,360.26,0.0,197968.8
2021-10-15,2021-10-15,Payment from Moreno PLC,REF51609263,0.0,1357.76,199326.56
2021-10-15,2021-10-15,Service payment - Solis and Sons,REF12970071,0.0,228.48,199555.04
2021-10-15,2021-10-15,Project payment - Smith-Rowe,REF20478575,0.0,1053.9,200608.94
2021-10-15,2021-10-15,"Project payment - Brown, Smith and Sanchez",REF47387654,0.0,1115.61,201724.55
2021-10-15,2021-10-15,Service payment - Hoover-Camacho,REF92084241,0.0,1340.31,203064.86
2021-10-15,2021-10-15,Safety Equipment expense,REF17102274,41.43,0.0,203023.43
2021-10-16,2021-10-16,Fuel purchase,REF54278983,476.4,0.0,202547.03
2021-10-17,2021-10-17,Permits Licenses expense,REF14571424,65.19,0.0,202481.84
2021-10-19,2021-10-19,Tools expense,REF28954239,79.57,0.0,202402.27
2021-10-22,2021-10-22,Tools expense,REF89436204,146.87,0.0,202255.4
2021-10-24,2021-10-24,Permits Licenses expense,REF52470371,110.6,0.0,202144.8
2021-10-29,2021-10-29,Fuel purchase,REF93827095,367.64,0.0,201777.16
2021-10-30,2021-10-30,"Payment from Brown, Smith and Sanchez",REF49693479,0.0,1371.83,203148.99
2021-10-30,2021-10-30,Invoice payment - Moreno PLC,REF64919946,0.0,1392.12,204541.11
2021-10-30,2021-10-30,Invoice payment - Solis and Sons,REF40555912,0.0,270.77,204811.88
2021-10-30,2021-10-30,Payment from Hoover-Camacho,REF51792632,0.0,1147.57,205959.45
2021-10-30,2021-10-30,Invoice payment - Smith-Rowe,REF90365524,0.0,876.51,206835.96
2021-11-01,2021-11-01,Fuel purchase,REF75254426,167.47,0.0,206668.49
2021-11-04,2021-11-04,Vehicle Maintenance expense,REF17879307,188.62,0.0,206479.87
2021-11-10,2021-11-10,Subcontractors expense,REF13693657,348.84,0.0,206131.03
2021-11-13,2021-11-13,Business materials,REF53312108,574.82,0.0,205556.21
2021-11-13,2021-11-13,Fuel purchase,REF26916022,256.15,0.0,205300.06
2021-11-14,2021-11-14,Equipment Rental expense,REF50491693,205.32,0.0,205094.74
2021-11-15,2021-11-15,Business insurance premium,REF23544955,154.84,0.0,204939.9
2021-11-15,2021-11-15,Payment from Moreno PLC,REF98981054,0.0,1066.48,206006.38
2021-11-15,2021-11-15,Service payment - Smith-Rowe,REF99083496,0.0,782.59,206788.97
2021-11-15,2021-11-15,Fuel purchase,REF25026891,227.42,0.0,206561.55
2021-11-15,2021-11-15,Project payment - Solis and Sons,REF24303449,0.0,136.02,206697.57
2021-11-15,2021-11-15,"Project payment - Brown, Smith and Sanchez",REF16536317,0.0,1007.49,207705.06
2021-11-15,2021-11-15,Project payment - Hoover-Camacho,REF59664658,0.0,988.32,208693.38
2021-11-15,2021-11-15,Equipment Rental expense,REF41598668,418.5,0.0,208274.88
2021-11-18,2021-11-18,Fuel purchase,REF44880972,155.75,0.0,208119.13
2021-11-21,2021-11-21,Business materials,REF56635147,738.4,0.0,207380.73
2021-11-22,2021-11-22,Subcontractors expense,REF80932345,783.84,0.0,206596.89
2021-11-23,2021-11-23,Business materials,REF81303147,457.01,0.0,206139.88
2021-11-24,2021-11-24,Business materials,REF66085729,496.56,0.0,205643.32
2021-11-25,2021-11-25,Business materials,REF34748337,615.2,0.0,205028.12
2021-11-30,2021-11-30,Invoice payment - Hoover-Camacho,REF65374149,0.0,1401.93,206430.05
2021-11-30,2021-11-30,Invoice payment - Moreno PLC,REF21689211,0.0,876.61,207306.66
2021-11-30,2021-11-30,Project payment - Solis and Sons,REF54436954,0.0,176.28,207482.94
2021-11-30,2021-11-30,Invoice payment - Smith-Rowe,REF38527470,0.0,815.0,208297.94
2021-11-30,2021-11-30,Fuel purchase,REF51464243,176.27,0.0,208121.67
2021-11-30,2021-11-30,"Service payment - Brown, Smith and Sanchez",REF86458484,0.0,1232.31,209353.98
2021-12-01,2021-12-01,Equipment Rental expense,REF94823101,278.31,0.0,209075.67
2021-12-06,2021-12-06,Vehicle Maintenance expense,REF22516568,118.94,0.0,208956.73
2021-12-08,2021-12-08,Business materials,REF93657096,339.48,0.0,208617.25
2021-12-12,2021-12-12,Fuel purchase,REF42162353,182.83,0.0,208434.42
2021-12-14,2021-12-14,Fuel purchase,REF98289680,192.01,0.0,208242.41
2021-12-15,2021-12-15,Service payment - Moreno PLC,REF97421961,0.0,655.04,208897.45
2021-12-15,2021-12-15,Payment from Smith-Rowe,REF95694298,0.0,429.79,209327.24
2021-12-15,2021-12-15,Business insurance premium,REF38005490,114.24,0.0,209213.0
2021-12-15,2021-12-15,Project payment - Solis and Sons,REF35772253,0.0,155.05,209368.05
2021-12-15,2021-12-15,"Service payment - Brown, Smith and Sanchez",REF53598412,0.0,643.52,210011.57
2021-12-16,2021-12-16,Safety Equipment expense,REF89881577,62.13,0.0,209949.44
2021-12-18,2021-12-18,Fuel purchase,REF30835683,230.14,0.0,209719.3
2021-12-19,2021-12-19,Business materials,REF64197975,244.49,0.0,209474.81
2021-12-20,2021-12-20,Permits Licenses expense,REF60619877,50.97,0.0,209423.84
2021-12-20,2021-12-20,Subcontractors expense,REF98159752,495.03,0.0,208928.81
2021-12-24,2021-12-24,Tools expense,REF23752874,74.94,0.0,208853.87
2021-12-26,2021-12-26,Equipment Rental expense,REF51936317,267.38,0.0,208586.49
2021-12-28,2021-12-28,Permits Licenses expense,REF43434826,46.53,0.0,208539.96
2021-12-30,2021-12-30,Service payment - Hoover-Camacho,REF69688894,0.0,789.62,209329.58
2021-12-30,2021-12-30,Invoice payment - Solis and Sons,REF78492244,0.0,144.2,209473.78
2021-12-30,2021-12-30,Invoice payment - Smith-Rowe,REF45408707,0.0,504.61,209978.39
2021-12-30,2021-12-30,"Service payment - Brown, Smith and Sanchez",REF72945022,0.0,558.62,210537.01
2021-12-30,2021-12-30,Project payment - Moreno PLC,REF45397464,0.0,579.81,211116.82
2022-01-04,2022-01-04,Tools expense,REF43438362,63.28,0.0,211053.54
2022-01-06,2022-01-06,Fuel purchase,REF77894752,201.45,0.0,210852.09
2022-01-07,2022-01-07,Equipment Rental expense,REF75442284,381.56,0.0,210470.53
2022-01-08,2022-01-08,Safety Equipment expense,REF81730558,83.79,0.0,210386.74
2022-01-14,2022-01-14,Fuel purchase,REF18977030,174.87,0.0,210211.87
2022-01-15,2022-01-15,Business insurance premium,REF75295943,144.46,0.0,210067.41
2022-01-15,2022-01-15,Service payment - Smith-Rowe,REF16474733,0.0,678.39,210745.8
2022-01-15,2022-01-15,Project payment - Solis and Sons,REF91561677,0.0,181.18,210926.98
2022-01-15,2022-01-15,"Project payment - Brown, Smith and Sanchez",REF49640819,0.0,717.63,211644.61
2022-01-15,2022-01-15,Invoice payment - Moreno PLC,REF95464753,0.0,969.58,212614.19
2022-01-16,2022-01-16,Equipment Rental expense,REF82977992,303.11,0.0,212311.08
2022-01-17,2022-01-17,Safety Equipment expense,REF70194982,53.85,0.0,212257.23
2022-01-24,2022-01-24,Permits Licenses expense,REF39375041,43.46,0.0,212213.77
2022-01-25,2022-01-25,Vehicle Maintenance expense,REF85301997,111.58,0.0,212102.19
2022-01-25,2022-01-25,Fuel purchase,REF12250163,166.82,0.0,211935.37
2022-01-26,2022-01-26,Fuel purchase,REF72221523,256.02,0.0,211679.35
2022-01-26,2022-01-26,Business materials,REF43317708,688.82,0.0,210990.53
2022-01-29,2022-01-29,Business materials,REF71923198,706.55,0.0,210283.98
2022-01-30,2022-01-30,"Payment from Brown, Smith and Sanchez",REF99769301,0.0,842.27,211126.25
2022-01-30,2022-01-30,Payment from Moreno PLC,REF24035825,0.0,702.73,211828.98
2022-01-30,2022-01-30,Invoice payment - Hoover-Camacho,REF96677772,0.0,889.78,212718.76
2022-01-30,2022-01-30,Payment from Smith-Rowe,REF77321654,0.0,678.6,213397.36
2022-01-31,2022-01-31,Safety Equipment expense,REF22009104,25.09,0.0,213372.27
2022-02-12,2022-02-12,Subcontractors expense,REF72002824,418.8,0.0,212953.47
2022-02-15,2022-02-15,Business insurance premium,REF77553432,165.25,0.0,212788.22
2022-02-15,2022-02-15,Project payment - Solis and Sons,REF40904967,0.0,160.05,212948.27
2022-02-15,2022-02-15,Project payment - Hoover-Camacho,REF59290775,0.0,1071.42,214019.69
2022-02-15,2022-02-15,Service payment - Smith-Rowe,REF86985150,0.0,582.1,214601.79
2022-02-15,2022-02-15,"Invoice payment - Brown, Smith and Sanchez",REF59860919,0.0,1226.83,215828.62
2022-02-16,2022-02-16,Business materials,REF96567711,380.84,0.0,215447.78
2022-02-23,2022-02-23,Business materials,REF41012338,736.23,0.0,214711.55
2022-02-24,2022-02-24,Vehicle Maintenance expense,REF80462833,102.44,0.0,214609.11
2022-02-27,2022-02-27,Safety Equipment expense,REF68874737,81.72,0.0,214527.39
2022-02-28,2022-02-28,Vehicle Maintenance expense,REF21554306,133.34,0.0,214394.05
2022-02-28,2022-02-28,Invoice payment - Solis and Sons,REF39059448,0.0,170.2,214564.25
2022-02-28,2022-02-28,Invoice payment - Hoover-Camacho,REF84318093,0.0,1056.64,215620.89
2022-02-28,2022-02-28,"Project payment - Brown, Smith and Sanchez",REF43535756,0.0,1015.04,216635.93
2022-02-28,2022-02-28,Invoice payment - Moreno PLC,REF33980328,0.0,880.25,217516.18
2022-02-28,2022-02-28,Project payment - Smith-Rowe,REF83429749,0.0,582.07,218098.25
2022-03-01,2022-03-01,Vehicle Maintenance expense,REF99582024,161.46,0.0,217936.79
2022-03-01,2022-03-01,Fuel purchase,REF38997255,266.28,0.0,217670.51
2022-03-03,2022-03-03,Fuel purchase,REF55313191,216.95,0.0,217453.56
2022-03-04,2022-03-04,Safety Equipment expense,REF54056664,68.41,0.0,217385.15
2022-03-10,2022-03-10,Business materials,REF22224827,690.49,0.0,216694.66
2022-03-12,2022-03-12,Equipment Rental expense,REF15470756,385.8,0.0,216308.86
2022-03-13,2022-03-13,Tools expense,REF22990910,77.33,0.0,216231.53
2022-03-14,2022-03-14,Subcontractors expense,REF24657326,1028.44,0.0,215203.09
2022-03-15,2022-03-15,Service payment - Hoover-Camacho,REF83444383,0.0,1664.34,216867.43
2022-03-15,2022-03-15,Invoice payment - Smith-Rowe,REF41936576,0.0,904.66,217772.09
2022-03-15,2022-03-15,"Service payment - Brown, Smith and Sanchez",REF84251341,0.0,1079.18,218851.27
2022-03-15,2022-03-15,Business insurance premium,REF98477500,217.84,0.0,218633.43
2022-03-15,2022-03-15,Payment from Solis and Sons,REF23024122,0.0,221.02,218854.45
2022-03-17,2022-03-17,Business materials,REF52751556,527.66,0.0,218326.79
2022-03-19,2022-03-19,Fuel purchase,REF21011082,437.82,0.0,217888.97
2022-03-20,2022-03-20,Permits Licenses expense,REF73767977,88.09,0.0,217800.88
2022-03-21,2022-03-21,Business materials,REF25064806,992.5,0.0,216808.38
2022-03-22,2022-03-22,Fuel purchase,REF67499517,299.9,0.0,216508.48
2022-03-24,2022-03-24,Fuel purchase,REF80839059,268.76,0.0,216239.72
2022-03-24,2022-03-24,Subcontractors expense,REF64580832,1129.49,0.0,215110.23
2022-03-30,2022-03-30,Service payment - Moreno PLC,REF88120717,0.0,1296.98,216407.21
2022-03-30,2022-03-30,Service payment - Solis and Sons,REF67211400,0.0,253.17,216660.38
2022-03-30,2022-03-30,Invoice payment - Hoover-Camacho,REF13368305,0.0,1334.88,217995.26
2022-03-30,2022-03-30,"Service payment - Brown, Smith and Sanchez",REF35425948,0.0,1113.48,219108.74
2022-04-01,2022-04-01,Permits Licenses expense,REF96453044,116.2,0.0,218992.54
2022-04-01,2022-04-01,Fuel purchase,REF55322522,418.88,0.0,218573.66
2022-04-04,2022-04-04,Subcontractors expense,REF31209255,768.18,0.0,217805.48
2022-04-06,2022-04-06,Fuel purchase,REF71172379,262.61,0.0,217542.87
2022-04-06,2022-04-06,Business materials,REF51755431,1377.47,0.0,216165.4
2022-04-07,2022-04-07,Safety Equipment expense,REF79280124,140.18,0.0,216025.22
2022-04-11,2022-04-11,Business materials,REF71500343,785.34,0.0,215239.88
2022-04-11,2022-04-11,Fuel purchase,REF23441685,317.16,0.0,214922.72
2022-04-15,2022-04-15,Business insurance premium,REF86859805,244.72,0.0,214678.0
2022-04-15,2022-04-15,Payment from Smith-Rowe,REF58441923,0.0,1122.99,215800.99
2022-04-15,2022-04-15,"Service payment - Brown, Smith and Sanchez",REF15988814,0.0,1766.64,217567.63
2022-04-15,2022-04-15,Payment from Solis and Sons,REF48648761,0.0,283.71,217851.34
2022-04-15,2022-04-15,Project payment - Moreno PLC,REF73467453,0.0,1751.05,219602.39
2022-04-15,2022-04-15,Service payment - Hoover-Camacho,REF30104034,0.0,1727.79,221330.18
2022-04-22,2022-04-22,Tools expense,REF89560469,126.93,0.0,221203.25
2022-04-23,2022-04-23,Business materials,REF73992797,1002.08,0.0,220201.17
2022-04-25,2022-04-25,Business materials,REF33649726,1350.66,0.0,218850.51
2022-04-26,2022-04-26,Safety Equipment expense,REF87206741,77.93,0.0,218772.58
2022-04-30,2022-04-30,Service payment - Solis and Sons,REF56702371,0.0,276.19,219048.77
2022-04-30,2022-04-30,Project payment - Smith-Rowe,REF24101296,0.0,705.38,219754.15
2022-04-30,2022-04-30,Payment from Hoover-Camacho,REF26668003,0.0,2033.53,221787.68
2022-04-30,2022-04-30,Service payment - Moreno PLC,REF64214022,0.0,1332.29,223119.97
2022-04-30,2022-04-30,"Project payment - Brown, Smith and Sanchez",REF85325180,0.0,1378.0,224497.97
2022-05-01,2022-05-01,Business materials,REF76513257,1318.88,0.0,223179.09
2022-05-02,2022-05-02,Equipment Rental expense,REF99474256,588.85,0.0,222590.24
2022-05-02,2022-05-02,Business materials,REF35107376,685.75,0.0,221904.49
2022-05-04,2022-05-04,Business materials,REF42249702,1353.5,0.0,220550.99
2022-05-05,2022-05-05,Business materials,REF40090134,1315.25,0.0,219235.74
2022-05-08,2022-05-08,Safety Equipment expense,REF24395740,113.16,0.0,219122.58
2022-05-08,2022-05-08,Vehicle Maintenance expense,REF47703639,195.89,0.0,218926.69
2022-05-10,2022-05-10,Subcontractors expense,REF16716176,953.36,0.0,217973.33
2022-05-11,2022-05-11,Subcontractors expense,REF71195049,881.9,0.0,217091.43
2022-05-11,2022-05-11,Fuel purchase,REF19187853,230.45,0.0,216860.98
2022-05-12,2022-05-12,Fuel purchase,REF62301445,380.56,0.0,216480.42
2022-05-13,2022-05-13,Vehicle Maintenance expense,REF78727013,204.16,0.0,216276.26
2022-05-15,2022-05-15,Invoice payment - Moreno PLC,REF51578659,0.0,1671.49,217947.75
2022-05-15,2022-05-15,"Payment from Brown, Smith and Sanchez",REF94983707,0.0,1719.34,219667.09
2022-05-15,2022-05-15,Project payment - Hoover-Camacho,REF34072965,0.0,1578.17,221245.26
2022-05-15,2022-05-15,Payment from Smith-Rowe,REF57982927,0.0,1359.58,222604.84
2022-05-15,2022-05-15,Invoice payment - Solis and Sons,REF41852363,0.0,299.29,222904.13
2022-05-15,2022-05-15,Business insurance premium,REF65723112,251.12,0.0,222653.01
2022-05-16,2022-05-16,Business materials,REF38499380,708.94,0.0,221944.07
2022-05-17,2022-05-17,Fuel purchase,REF78179696,430.37,0.0,221513.7
2022-05-17,2022-05-17,Safety Equipment expense,REF31233677,68.87,0.0,221444.83
2022-05-18,2022-05-18,Fuel purchase,REF13245559,678.59,0.0,220766.24
2022-05-19,2022-05-19,Tools expense,REF22684671,186.91,0.0,220579.33
2022-05-21,2022-05-21,Safety Equipment expense,REF94644308,107.39,0.0,220471.94
2022-05-25,2022-05-25,Business materials,REF67909959,835.41,0.0,219636.53
2022-05-26,2022-05-26,Equipment Rental expense,REF60376614,735.71,0.0,218900.82
2022-05-27,2022-05-27,Business materials,REF69574564,850.12,0.0,218050.7
2022-05-29,2022-05-29,Fuel purchase,REF28658089,256.95,0.0,217793.75
2022-05-30,2022-05-30,Invoice payment - Hoover-Camacho,REF11745184,0.0,2063.68,219857.43
2022-05-30,2022-05-30,"Project payment - Brown, Smith and Sanchez",REF28763951,0.0,1251.27,221108.7
2022-05-30,2022-05-30,Payment from Solis and Sons,REF23983334,0.0,321.81,221430.51
2022-05-30,2022-05-30,Equipment Rental expense,REF23115398,599.59,0.0,220830.92
2022-05-30,2022-05-30,Invoice payment - Smith-Rowe,REF53097900,0.0,1044.15,221875.07
2022-05-30,2022-05-30,Payment from Moreno PLC,REF72029677,0.0,1549.35,223424.42
2022-06-01,2022-06-01,Fuel purchase,REF55834629,258.93,0.0,223165.49
2022-06-01,2022-06-01,Subcontractors expense,REF16830687,1034.35,0.0,222131.14
2022-06-02,2022-06-02,Safety Equipment expense,REF13146178,105.03,0.0,222026.11
2022-06-05,2022-06-05,Tools expense,REF28914329,140.8,0.0,221885.31
2022-06-08,2022-06-08,Fuel purchase,REF94790115,561.62,0.0,221323.69
2022-06-13,2022-06-13,Permits Licenses expense,REF30759725,126.03,0.0,221197.66
2022-06-15,2022-06-15,Business insurance premium,REF52477107,257.65,0.0,220940.01
2022-06-15,2022-06-15,Invoice payment - Moreno PLC,REF38575665,0.0,1322.36,222262.37
2022-06-15,2022-06-15,"Invoice payment - Brown, Smith and Sanchez",REF87901964,0.0,1711.39,223973.76
2022-06-15,2022-06-15,Invoice payment - Smith-Rowe,REF12572157,0.0,1229.49,225203.25
2022-06-15,2022-06-15,Project payment - Solis and Sons,REF32842099,0.0,190.8,225394.05
2022-06-15,2022-06-15,Vehicle Maintenance expense,REF23689012,194.18,0.0,225199.87
2022-06-16,2022-06-16,Business materials,REF27999589,1227.33,0.0,223972.54
2022-06-20,2022-06-20,Fuel purchase,REF97728820,391.8,0.0,223580.74
2022-06-20,2022-06-20,Tools expense,REF28090065,145.63,0.0,223435.11
2022-06-20,2022-06-20,Safety Equipment expense,REF12069269,79.84,0.0,223355.27
2022-06-25,2022-06-25,Business materials,REF46820878,1048.2,0.0,222307.07
2022-06-28,2022-06-28,Subcontractors expense,REF62328866,1575.91,0.0,220731.16
2022-06-28,2022-06-28,Fuel purchase,REF25347803,463.92,0.0,220267.24
2022-06-29,2022-06-29,Permits Licenses expense,REF20870696,62.83,0.0,220204.41
2022-06-29,2022-06-29,Business materials,REF78246523,516.25,0.0,219688.16
2022-06-30,2022-06-30,Invoice payment - Solis and Sons,REF20957705,0.0,308.45,219996.61
2022-06-30,2022-06-30,Fuel purchase,REF70490565,364.01,0.0,219632.6
2022-06-30,2022-06-30,Tools expense,REF15748085,165.17,0.0,219467.43
2022-06-30,2022-06-30,Invoice payment - Smith-Rowe,REF26404714,0.0,1221.58,220689.01
2022-06-30,2022-06-30,"Payment from Brown, Smith and Sanchez",REF75256652,0.0,1747.24,222436.25
2022-06-30,2022-06-30,Service payment - Moreno PLC,REF83596230,0.0,1533.02,223969.27
2022-07-01,2022-07-01,Permits Licenses expense,REF92989960,64.1,0.0,223905.17
2022-07-03,2022-07-03,Subcontractors expense,REF93289993,2038.56,0.0,221866.61
2022-07-03,2022-07-03,Vehicle Maintenance expense,REF89563207,86.41,0.0,221780.2
2022-07-05,2022-07-05,Vehicle Maintenance expense,REF12466397,218.3,0.0,221561.9
2022-07-09,2022-07-09,Fuel purchase,REF17123441,483.79,0.0,221078.11
2022-07-13,2022-07-13,Safety Equipment expense,REF47275552,80.36,0.0,220997.75
2022-07-15,2022-07-15,"Payment from Brown, Smith and Sanchez",REF59488965,0.0,1433.69,222431.44
2022-07-15,2022-07-15,Service payment - Smith-Rowe,REF82054416,0.0,1200.82,223632.26
2022-07-15,2022-07-15,Payment from Hoover-Camacho,REF85708911,0.0,1527.52,225159.78
2022-07-15,2022-07-15,Project payment - Solis and Sons,REF78468221,0.0,251.09,225410.87
2022-07-15,2022-07-15,Invoice payment - Moreno PLC,REF59409427,0.0,1697.13,227108.0
2022-07-15,2022-07-15,Business insurance premium,REF52316588,248.96,0.0,226859.04
2022-07-19,2022-07-19,Fuel purchase,REF29997669,477.24,0.0,226381.8
2022-07-23,2022-07-23,Fuel purchase,REF93977923,247.14,0.0,226134.66
2022-07-25,2022-07-25,Fuel purchase,REF52573160,248.82,0.0,225885.84
2022-07-26,2022-07-26,Business materials,REF66735475,1091.17,0.0,224794.67
2022-07-27,2022-07-27,Permits Licenses expense,REF87989201,110.13,0.0,224684.54
2022-07-30,2022-07-30,Payment from Smith-Rowe,REF97453730,0.0,1355.93,226040.47
2022-07-30,2022-07-30,"Invoice payment - Brown, Smith and Sanchez",REF73015906,0.0,1256.79,227297.26
2022-07-30,2022-07-30,Project payment - Hoover-Camacho,REF30536699,0.0,1440.08,228737.34
2022-07-30,2022-07-30,Project payment - Solis and Sons,REF44237811,0.0,326.25,229063.59
2022-07-30,2022-07-30,Invoice payment - Moreno PLC,REF43547141,0.0,1336.77,230400.36
2022-08-02,2022-08-02,Equipment Rental expense,REF21477601,683.07,0.0,229717.29
2022-08-04,2022-08-04,Business materials,REF72045712,1529.47,0.0,228187.82
2022-08-05,2022-08-05,Vehicle Maintenance expense,REF60474360,147.53,0.0,228040.29
2022-08-06,2022-08-06,Tools expense,REF84501791,111.09,0.0,227929.2
2022-08-13,2022-08-13,Safety Equipment expense,REF38900756,140.14,0.0,227789.06
2022-08-14,2022-08-14,Permits Licenses expense,REF57542225,100.36,0.0,227688.7
2022-08-15,2022-08-15,Payment from Solis and Sons,REF30694919,0.0,325.89,228014.59
2022-08-15,2022-08-15,Project payment - Hoover-Camacho,REF18863641,0.0,1674.55,229689.14
2022-08-15,2022-08-15,Business insurance premium,REF36628224,243.97,0.0,229445.17
2022-08-15,2022-08-15,"Payment from Brown, Smith and Sanchez",REF21377228,0.0,1841.63,231286.8
2022-08-15,2022-08-15,Payment from Smith-Rowe,REF72307968,0.0,1203.07,232489.87
2022-08-16,2022-08-16,Safety Equipment expense,REF45607193,63.36,0.0,232426.51
2022-08-17,2022-08-17,Business materials,REF96823859,519.49,0.0,231907.02
2022-08-19,2022-08-19,Fuel purchase,REF49594153,455.01,0.0,231452.01
2022-08-21,2022-08-21,Fuel purchase,REF67957172,267.86,0.0,231184.15
2022-08-23,2022-08-23,Business materials,REF13552366,610.25,0.0,230573.9
2022-08-28,2022-08-28,Business materials,REF26408017,1008.66,0.0,229565.24
2022-08-30,2022-08-30,Invoice payment - Hoover-Camacho,REF10512482,0.0,1661.63,231226.87
2022-08-30,2022-08-30,"Invoice payment - Brown, Smith and Sanchez",REF69860400,0.0,1325.37,232552.24
2022-08-30,2022-08-30,Project payment - Smith-Rowe,REF33918773,0.0,1213.17,233765.41
2022-08-30,2022-08-30,Payment from Moreno PLC,REF89214851,0.0,1428.36,235193.77
2022-08-30,2022-08-30,Invoice payment - Solis and Sons,REF10073337,0.0,312.93,235506.7
2022-09-10,2022-09-10,Subcontractors expense,REF42101607,1325.17,0.0,234181.53
2022-09-11,2022-09-11,Fuel purchase,REF99372727,312.66,0.0,233868.87
2022-09-15,2022-09-15,Project payment - Solis and Sons,REF83571214,0.0,221.45,234090.32
2022-09-15,2022-09-15,Business insurance premium,REF71668962,228.86,0.0,233861.46
2022-09-15,2022-09-15,Project payment - Smith-Rowe,REF58884815,0.0,1287.18,235148.64
2022-09-15,2022-09-15,Invoice payment - Hoover-Camacho,REF24777556,0.0,1843.67,236992.31
2022-09-15,2022-09-15,"Payment from Brown, Smith and Sanchez",REF92379881,0.0,1296.42,238288.73
2022-09-15,2022-09-15,Service payment - Moreno PLC,REF10149591,0.0,1558.16,239846.89
2022-09-22,2022-09-22,Equipment Rental expense,REF16202335,442.33,0.0,239404.56
2022-09-26,2022-09-26,Vehicle Maintenance expense,REF22439999,159.62,0.0,239244.94
2022-09-26,2022-09-26,Subcontractors expense,REF14282487,1159.69,0.0,238085.25
2022-09-26,2022-09-26,Fuel purchase,REF29124175,280.45,0.0,237804.8
2022-09-29,2022-09-29,Equipment Rental expense,REF97590411,401.63,0.0,237403.17
2022-09-30,2022-09-30,Payment from Moreno PLC,REF93659316,0.0,1211.35,238614.52
2022-09-30,2022-09-30,Service payment - Hoover-Camacho,REF32584125,0.0,1562.63,240177.15
2022-09-30,2022-09-30,Service payment - Solis and Sons,REF38403525,0.0,251.94,240429.09
2022-09-30,2022-09-30,"Project payment - Brown, Smith and Sanchez",REF13118936,0.0,1039.14,241468.23
2022-10-06,2022-10-06,Equipment Rental expense,REF55248124,386.35,0.0,241081.88
2022-10-06,2022-10-06,Vehicle Maintenance expense,REF82039369,150.22,0.0,240931.66
2022-10-08,2022-10-08,Equipment Rental expense,REF84496461,309.23,0.0,240622.43
2022-10-08,2022-10-08,Safety Equipment expense,REF32826561,69.88,0.0,240552.55
2022-10-12,2022-10-12,Fuel purchase,REF13099107,253.88,0.0,240298.67
2022-10-14,2022-10-14,Safety Equipment expense,REF44443379,38.04,0.0,240260.63
2022-10-15,2022-10-15,Payment from Moreno PLC,REF85732776,0.0,1203.28,241463.91
2022-10-15,2022-10-15,Project payment - Smith-Rowe,REF63823381,0.0,991.66,242455.57
2022-10-15,2022-10-15,Invoice payment - Hoover-Camacho,REF33271641,0.0,1452.87,243908.44
2022-10-15,2022-10-15,Business insurance premium,REF70246627,202.63,0.0,243705.81
2022-10-15,2022-10-15,Payment from Solis and Sons,REF45056057,0.0,175.81,243881.62
2022-10-16,2022-10-16,Vehicle Maintenance expense,REF26188090,151.18,0.0,243730.44
2022-10-20,2022-10-20,Business materials,REF37462586,864.36,0.0,242866.08
2022-10-27,2022-10-27,Equipment Rental expense,REF98807254,540.49,0.0,242325.59
2022-10-29,2022-10-29,Vehicle Maintenance expense,REF69470858,142.58,0.0,242183.01
2022-10-29,2022-10-29,Equipment Rental expense,REF86671899,55.94,0.0,242127.07
2022-10-30,2022-10-30,Invoice payment - Hoover-Camacho,REF97911451,0.0,1523.54,243650.61
2022-10-30,2022-10-30,Invoice payment - Moreno PLC,REF37724057,0.0,1413.11,245063.72
2022-10-30,2022-10-30,Invoice payment - Smith-Rowe,REF55792806,0.0,1085.96,246149.68
2022-10-30,2022-10-30,"Payment from Brown, Smith and Sanchez",REF43820864,0.0,1103.01,247252.69
2022-11-02,2022-11-02,Fuel purchase,REF84818668,296.39,0.0,246956.3
2022-11-02,2022-11-02,Permits Licenses expense,REF14756654,63.61,0.0,246892.69
2022-11-03,2022-11-03,Business materials,REF14013673,808.51,0.0,246084.18
2022-11-08,2022-11-08,Business materials,REF16440844,588.81,0.0,245495.37
2022-11-10,2022-11-10,Business materials,REF97392123,721.07,0.0,244774.3
2022-11-11,2022-11-11,Fuel purchase,REF59547593,306.51,0.0,244467.79
2022-11-12,2022-11-12,Tools expense,REF58770390,89.7,0.0,244378.09
2022-11-15,2022-11-15,Invoice payment - Solis and Sons,REF29328191,0.0,149.33,244527.42
2022-11-15,2022-11-15,Project payment - Hoover-Camacho,REF79076061,0.0,1036.31,245563.73
2022-11-15,2022-11-15,"Project payment - Brown, Smith and Sanchez",REF62055305,0.0,869.39,246433.12
2022-11-15,2022-11-15,Business insurance premium,REF14183883,165.62,0.0,246267.5
2022-11-15,2022-11-15,Service payment - Moreno PLC,REF88842328,0.0,1172.84,247440.34
2022-11-15,2022-11-15,Project payment - Smith-Rowe,REF65013628,0.0,743.38,248183.72
2022-11-17,2022-11-17,Business materials,REF32979184,279.14,0.0,247904.58
2022-11-18,2022-11-18,Subcontractors expense,REF64980489,1072.49,0.0,246832.09
2022-11-18,2022-11-18,Vehicle Maintenance expense,REF85221666,117.27,0.0,246714.82
2022-11-21,2022-11-21,Vehicle Maintenance expense,REF38614923,148.63,0.0,246566.19
2022-11-28,2022-11-28,Equipment Rental expense,REF78401201,293.04,0.0,246273.15
2022-11-30,2022-11-30,Payment from Smith-Rowe,REF36173037,0.0,554.45,246827.6
2022-11-30,2022-11-30,Service payment - Moreno PLC,REF42137238,0.0,1142.02,247969.62
2022-11-30,2022-11-30,"Payment from Brown, Smith and Sanchez",REF69238674,0.0,876.63,248846.25
2022-11-30,2022-11-30,Project payment - Solis and Sons,REF41963664,0.0,220.97,249067.22
2022-11-30,2022-11-30,Service payment - Hoover-Camacho,REF40559888,0.0,857.9,249925.12
2022-12-04,2022-12-04,Equipment Rental expense,REF47264413,169.1,0.0,249756.02
2022-12-04,2022-12-04,Vehicle Maintenance expense,REF81192682,61.9,0.0,249694.12
2022-12-05,2022-12-05,Safety Equipment expense,REF81500396,38.27,0.0,249655.85
2022-12-09,2022-12-09,Fuel purchase,REF14163781,130.58,0.0,249525.27
2022-12-11,2022-12-11,Fuel purchase,REF94257040,89.32,0.0,249435.95
2022-12-13,2022-12-13,Business materials,REF71753394,397.85,0.0,249038.1
2022-12-15,2022-12-15,Equipment Rental expense,REF47569540,326.6,0.0,248711.5
2022-12-15,2022-12-15,Invoice payment - Smith-Rowe,REF27211408,0.0,473.66,249185.16
2022-12-15,2022-12-15,"Payment from Brown, Smith and Sanchez",REF84352706,0.0,785.45,249970.61
2022-12-15,2022-12-15,Business insurance premium,REF48224746,126.56,0.0,249844.05
2022-12-15,2022-12-15,Service payment - Hoover-Camacho,REF44084366,0.0,928.67,250772.72
2022-12-15,2022-12-15,Invoice payment - Moreno PLC,REF91553720,0.0,823.64,251596.36
2022-12-15,2022-12-15,Invoice payment - Solis and Sons,REF80953516,0.0,140.16,251736.52
2022-12-17,2022-12-17,Business materials,REF37662868,447.59,0.0,251288.93
2022-12-25,2022-12-25,Business materials,REF70278520,348.24,0.0,250940.69
2022-12-27,2022-12-27,Fuel purchase,REF91241291,159.43,0.0,250781.26
2022-12-28,2022-12-28,Business materials,REF26401848,573.26,0.0,250208.0
2022-12-29,2022-12-29,Business materials,REF37268421,240.93,0.0,249967.07
2022-12-30,2022-12-30,"Service payment - Brown, Smith and Sanchez",REF46141103,0.0,683.45,250650.52
2022-12-30,2022-12-30,Vehicle Maintenance expense,REF95632951,102.92,0.0,250547.6
2022-12-30,2022-12-30,Project payment - Solis and Sons,REF95325333,0.0,155.66,250703.26
2022-12-30,2022-12-30,Service payment - Hoover-Camacho,REF51731412,0.0,984.2,251687.46
2022-12-30,2022-12-30,Payment from Smith-Rowe,REF59585225,0.0,509.83,252197.29
2022-12-31,2022-12-31,Tools expense,REF70376344,41.5,0.0,252155.79
2023-01-04,2023-01-04,Vehicle Maintenance expense,REF66168194,102.25,0.0,252053.54
2023-01-10,2023-01-10,Permits Licenses expense,REF51633820,41.05,0.0,252012.49
2023-01-13,2023-01-13,Permits Licenses expense,REF12331375,43.42,0.0,251969.07
2023-01-15,2023-01-15,Tools expense,REF66508037,107.43,0.0,251861.64
2023-01-15,2023-01-15,Service payment - Smith-Rowe,REF43571360,0.0,478.25,252339.89
2023-01-15,2023-01-15,Fuel purchase,REF65481483,212.9,0.0,252126.99
2023-01-15,2023-01-15,Business insurance premium,REF96623914,145.61,0.0,251981.38
2023-01-15,2023-01-15,"Project payment - Brown, Smith and Sanchez",REF92632975,0.0,922.23,252903.61
2023-01-15,2023-01-15,Payment from Hoover-Camacho,REF78466289,0.0,1217.63,254121.24
2023-01-15,2023-01-15,Project payment - Solis and Sons,REF47150586,0.0,184.96,254306.2
2023-01-15,2023-01-15,Payment from Moreno PLC,REF45334840,0.0,761.08,255067.28
2023-01-18,2023-01-18,Business materials,REF78938462,625.74,0.0,254441.54
2023-01-21,2023-01-21,Business materials,REF38974571,288.28,0.0,254153.26
2023-01-27,2023-01-27,Permits Licenses expense,REF44390498,62.97,0.0,254090.29
2023-01-27,2023-01-27,Fuel purchase,REF79542003,192.6,0.0,253897.69
2023-01-30,2023-01-30,Project payment - Moreno PLC,REF78629225,0.0,941.68,254839.37
2023-01-30,2023-01-30,Subcontractors expense,REF25755488,650.62,0.0,254188.75
2023-01-30,2023-01-30,Business materials,REF77256135,581.28,0.0,253607.47
2023-01-30,2023-01-30,Invoice payment - Solis and Sons,REF65249789,0.0,175.29,253782.76
2023-01-30,2023-01-30,"Project payment - Brown, Smith and Sanchez",REF10585937,0.0,1024.6,254807.36
2023-01-31,2023-01-31,Business materials,REF12818133,479.29,0.0,254328.07
2023-01-31,2023-01-31,Equipment Rental expense,REF27428329,469.69,0.0,253858.38
2023-02-02,2023-02-02,Business materials,REF47984130,709.28,0.0,253149.1
2023-02-03,2023-02-03,Fuel purchase,REF59877551,329.02,0.0,252820.08
2023-02-04,2023-02-04,Fuel purchase,REF22703679,312.59,0.0,252507.49
2023-02-09,2023-02-09,Fuel purchase,REF96496929,273.46,0.0,252234.03
2023-02-10,2023-02-10,Vehicle Maintenance expense,REF97114624,93.99,0.0,252140.04
2023-02-10,2023-02-10,Business materials,REF26863976,472.39,0.0,251667.65
2023-02-10,2023-02-10,Permits Licenses expense,REF17931865,65.69,0.0,251601.96
2023-02-11,2023-02-11,Business materials,REF43799281,692.99,0.0,250908.97
2023-02-12,2023-02-12,Equipment Rental expense,REF19477952,546.39,0.0,250362.58
2023-02-13,2023-02-13,Business materials,REF53908532,585.11,0.0,249777.47
2023-02-15,2023-02-15,Project payment - Hoover-Camacho,REF62922449,0.0,1160.7,250938.17
2023-02-15,2023-02-15,Business insurance premium,REF86658145,165.93,0.0,250772.24
2023-02-15,2023-02-15,Service payment - Smith-Rowe,REF16133175,0.0,809.97,251582.21
2023-02-15,2023-02-15,Service payment - Solis and Sons,REF78813882,0.0,198.23,251780.44
2023-02-15,2023-02-15,"Project payment - Brown, Smith and Sanchez",REF43287671,0.0,988.45,252768.89
2023-02-17,2023-02-17,Business materials,REF89796198,387.21,0.0,252381.68
2023-02-17,2023-02-17,Safety Equipment expense,REF40858289,67.5,0.0,252314.18
2023-02-17,2023-02-17,Vehicle Maintenance expense,REF12719701,162.98,0.0,252151.2
2023-02-21,2023-02-21,Equipment Rental expense,REF20141948,246.03,0.0,251905.17
2023-02-23,2023-02-23,Safety Equipment expense,REF64956320,31.12,0.0,251874.05
2023-02-23,2023-02-23,Tools expense,REF94960763,100.56,0.0,251773.49
2023-02-24,2023-02-24,Fuel purchase,REF48771494,209.79,0.0,251563.7
2023-02-28,2023-02-28,Project payment - Hoover-Camacho,REF93338388,0.0,906.48,252470.18
2023-02-28,2023-02-28,Payment from Smith-Rowe,REF90135327,0.0,820.27,253290.45
2023-02-28,2023-02-28,Payment from Moreno PLC,REF49407738,0.0,736.63,254027.08
2023-02-28,2023-02-28,Service payment - Solis and Sons,REF31040256,0.0,156.86,254183.94
2023-02-28,2023-02-28,"Service payment - Brown, Smith and Sanchez",REF52932270,0.0,1165.1,255349.04
2023-03-02,2023-03-02,Equipment Rental expense,REF51240664,261.78,0.0,255087.26
2023-03-04,2023-03-04,Permits Licenses expense,REF79179134,76.09,0.0,255011.17
2023-03-07,2023-03-07,Business materials,REF83835810,894.68,0.0,254116.49
2023-03-09,2023-03-09,Subcontractors expense,REF18875584,655.61,0.0,253460.88
2023-03-10,2023-03-10,Safety Equipment expense,REF78395827,103.29,0.0,253357.59
2023-03-11,2023-03-11,Business materials,REF53330617,912.89,0.0,252444.7
2023-03-15,2023-03-15,Business insurance premium,REF68138961,200.46,0.0,252244.24
2023-03-15,2023-03-15,Service payment - Hoover-Camacho,REF52918380,0.0,1776.97,254021.21
2023-03-15,2023-03-15,Payment from Solis and Sons,REF21984679,0.0,266.8,254288.01
2023-03-15,2023-03-15,"Invoice payment - Brown, Smith and Sanchez",REF65473144,0.0,1763.47,256051.48
2023-03-15,2023-03-15,Service payment - Moreno PLC,REF31199342,0.0,1182.61,257234.09
2023-03-15,2023-03-15,Payment from Smith-Rowe,REF94737299,0.0,986.19,258220.28
2023-03-20,2023-03-20,Permits Licenses expense,REF70797024,77.22,0.0,258143.06
2023-03-21,2023-03-21,Fuel purchase,REF84474126,304.74,0.0,257838.32
2023-03-22,2023-03-22,Subcontractors expense,REF49746049,1161.66,0.0,256676.66
2023-03-23,2023-03-23,Permits Licenses expense,REF29154093,69.92,0.0,256606.74
2023-03-25,2023-03-25,Permits Licenses expense,REF31674417,93.75,0.0,256512.99
2023-03-26,2023-03-26,Business materials,REF76926426,597.34,0.0,255915.65
2023-03-30,2023-03-30,Project payment - Hoover-Camacho,REF31612099,0.0,1514.49,257430.14
2023-03-30,2023-03-30,Service payment - Moreno PLC,REF37742725,0.0,1383.33,258813.47
2023-03-30,2023-03-30,Project payment - Solis and Sons,REF27375710,0.0,255.86,259069.33
2023-03-30,2023-03-30,Service payment - Smith-Rowe,REF42336816,0.0,964.16,260033.49
2023-03-31,2023-03-31,Business materials,REF54363477,690.02,0.0,259343.47
2023-03-31,2023-03-31,Tools expense,REF23760387,76.25,0.0,259267.22
2023-04-02,2023-04-02,Business materials,REF68235927,605.71,0.0,258661.51
2023-04-05,2023-04-05,Fuel purchase,REF72649037,269.1,0.0,258392.41
2023-04-08,2023-04-08,Tools expense,REF12742835,69.65,0.0,258322.76
2023-04-08,2023-04-08,Fuel purchase,REF76041995,248.08,0.0,258074.68
2023-04-13,2023-04-13,Equipment Rental expense,REF60397123,331.0,0.0,257743.68
2023-04-14,2023-04-14,Equipment Rental expense,REF40204530,434.78,0.0,257308.9
2023-04-15,2023-04-15,Project payment - Moreno PLC,REF28098757,0.0,1276.72,258585.62
2023-04-15,2023-04-15,Business insurance premium,REF23989458,231.82,0.0,258353.8
2023-04-15,2023-04-15,Permits Licenses expense,REF69225268,150.95,0.0,258202.85
2023-04-15,2023-04-15,Payment from Hoover-Camacho,REF77893346,0.0,1799.23,260002.08
2023-04-15,2023-04-15,Business materials,REF95661306,918.57,0.0,259083.51
2023-04-19,2023-04-19,Permits Licenses expense,REF52041221,76.31,0.0,259007.2
2023-04-22,2023-04-22,Equipment Rental expense,REF51393895,569.4,0.0,258437.8
2023-04-23,2023-04-23,Business materials,REF43569231,1367.62,0.0,257070.18
2023-04-25,2023-04-25,Subcontractors expense,REF57836730,1417.63,0.0,255652.55
2023-04-25,2023-04-25,Tools expense,REF34800257,95.26,0.0,255557.29
2023-04-30,2023-04-30,"Invoice payment - Brown, Smith and Sanchez",REF69385476,0.0,1585.78,257143.07
2023-04-30,2023-04-30,Project payment - Smith-Rowe,REF87356323,0.0,1120.6,258263.67
2023-04-30,2023-04-30,Project payment - Hoover-Camacho,REF16462991,0.0,1953.48,260217.15
2023-04-30,2023-04-30,Payment from Solis and Sons,REF57454069,0.0,315.35,260532.5
2023-04-30,2023-04-30,Service payment - Moreno PLC,REF41111556,0.0,1677.88,262210.38
2023-05-02,2023-05-02,Vehicle Maintenance expense,REF90732105,216.02,0.0,261994.36
2023-05-03,2023-05-03,Subcontractors expense,REF96594427,521.13,0.0,261473.23
2023-05-03,2023-05-03,Tools expense,REF26507910,186.12,0.0,261287.11
2023-05-04,2023-05-04,Equipment Rental expense,REF40460904,547.91,0.0,260739.2
2023-05-05,2023-05-05,Permits Licenses expense,REF41089058,137.74,0.0,260601.46
2023-05-08,2023-05-08,Fuel purchase,REF47086665,370.88,0.0,260230.58
2023-05-12,2023-05-12,Permits Licenses expense,REF15151989,119.21,0.0,260111.37
2023-05-15,2023-05-15,Business insurance premium,REF16289768,281.35,0.0,259830.02
2023-05-15,2023-05-15,Payment from Solis and Sons,REF41558810,0.0,300.19,260130.21
2023-05-15,2023-05-15,Project payment - Smith-Rowe,REF86273403,0.0,953.96,261084.17
2023-05-15,2023-05-15,Fuel purchase,REF15027814,261.54,0.0,260822.63
2023-05-15,2023-05-15,"Invoice payment - Brown, Smith and Sanchez",REF60091916,0.0,1730.4,262553.03
2023-05-15,2023-05-15,Payment from Hoover-Camacho,REF46385718,0.0,2073.3,264626.33
2023-05-15,2023-05-15,Invoice payment - Moreno PLC,REF51001629,0.0,1246.85,265873.18
2023-05-16,2023-05-16,Safety Equipment expense,REF91750605,57.17,0.0,265816.01
2023-05-25,2023-05-25,Fuel purchase,REF40277482,363.42,0.0,265452.59
2023-05-26,2023-05-26,Fuel purchase,REF77487941,498.75,0.0,264953.84
2023-05-26,2023-05-26,Business materials,REF34457628,1635.44,0.0,263318.4
2023-05-27,2023-05-27,Permits Licenses expense,REF70860930,99.79,0.0,263218.61
2023-05-27,2023-05-27,Fuel purchase,REF92149667,306.79,0.0,262911.82
2023-05-27,2023-05-27,Safety Equipment expense,REF39779090,111.62,0.0,262800.2
2023-05-30,2023-05-30,Payment from Solis and Sons,REF51620014,0.0,252.71,263052.91
2023-05-30,2023-05-30,Payment from Smith-Rowe,REF65178438,0.0,1430.71,264483.62
2023-05-30,2023-05-30,Payment from Hoover-Camacho,REF78956282,0.0,1019.56,265503.18
2023-05-30,2023-05-30,"Service payment - Brown, Smith and Sanchez",REF56519201,0.0,1915.37,267418.55
2023-05-31,2023-05-31,Subcontractors expense,REF35016242,1553.85,0.0,265864.7
2023-06-01,2023-06-01,Business materials,REF62799232,1186.74,0.0,264677.96
2023-06-01,2023-06-01,Fuel purchase,REF63597795,159.18,0.0,264518.78
2023-06-06,2023-06-06,Equipment Rental expense,REF56369576,759.89,0.0,263758.89
2023-06-08,2023-06-08,Fuel purchase,REF44216142,426.87,0.0,263332.02
2023-06-13,2023-06-13,Business materials,REF17400203,1032.72,0.0,262299.3
2023-06-15,2023-06-15,Service payment - Hoover-Camacho,REF94810330,0.0,1260.78,263560.08
2023-06-15,2023-06-15,Service payment - Solis and Sons,REF29685070,0.0,253.12,263813.2
2023-06-15,2023-06-15,Business insurance premium,REF69084478,272.87,0.0,263540.33
2023-06-15,2023-06-15,Payment from Moreno PLC,REF86129140,0.0,1421.76,264962.09
2023-06-15,2023-06-15,Service payment - Smith-Rowe,REF32776554,0.0,990.98,265953.07
2023-06-15,2023-06-15,"Project payment - Brown, Smith and Sanchez",REF77886489,0.0,1148.08,267101.15
2023-06-15,2023-06-15,Business materials,REF36786709,1011.26,0.0,266089.89
2023-06-18,2023-06-18,Equipment Rental expense,REF64984061,435.24,0.0,265654.65
2023-06-21,2023-06-21,Fuel purchase,REF65977535,363.79,0.0,265290.86
2023-06-27,2023-06-27,Business materials,REF67470334,372.46,0.0,264918.4
2023-06-30,2023-06-30,"Service payment - Brown, Smith and Sanchez",REF55548857,0.0,1496.46,266414.86
2023-06-30,2023-06-30,Service payment - Moreno PLC,REF34679365,0.0,1823.26,268238.12
2023-06-30,2023-06-30,Payment from Solis and Sons,REF86512464,0.0,339.44,268577.56
2023-06-30,2023-06-30,Payment from Smith-Rowe,REF35547818,0.0,1189.88,269767.44
2023-06-30,2023-06-30,Project payment - Hoover-Camacho,REF27629830,0.0,1931.18,271698.62
2023-07-01,2023-07-01,Subcontractors expense,REF25236917,980.15,0.0,270718.47
2023-07-02,2023-07-02,Business materials,REF80254711,1129.2,0.0,269589.27
2023-07-03,2023-07-03,Equipment Rental expense,REF79074974,610.92,0.0,268978.35
2023-07-07,2023-07-07,Safety Equipment expense,REF84714814,49.51,0.0,268928.84
2023-07-11,2023-07-11,Safety Equipment expense,REF23762658,158.7,0.0,268770.14
2023-07-12,2023-07-12,Vehicle Maintenance expense,REF59267935,127.17,0.0,268642.97
2023-07-12,2023-07-12,Business materials,REF31288322,662.37,0.0,267980.6
2023-07-12,2023-07-12,Fuel purchase,REF97895923,417.73,0.0,267562.87
2023-07-15,2023-07-15,Business insurance premium,REF69746391,250.98,0.0,267311.89
2023-07-15,2023-07-15,Project payment - Solis and Sons,REF55511109,0.0,243.51,267555.4
2023-07-15,2023-07-15,Project payment - Moreno PLC,REF29590379,0.0,1654.55,269209.95
2023-07-15,2023-07-15,Service payment - Smith-Rowe,REF69758622,0.0,1174.52,270384.47
2023-07-15,2023-07-15,"Service payment - Brown, Smith and Sanchez",REF52126602,0.0,1465.47,271849.94
2023-07-15,2023-07-15,Payment from Hoover-Camacho,REF31203450,0.0,1541.39,273391.33
2023-07-19,2023-07-19,Business materials,REF38247472,1369.03,0.0,272022.3
2023-07-20,2023-07-20,Equipment Rental expense,REF46148056,607.51,0.0,271414.79
2023-07-23,2023-07-23,Fuel purchase,REF87406946,379.97,0.0,271034.82
2023-07-27,2023-07-27,Business materials,REF60534385,1068.72,0.0,269966.1
2023-07-30,2023-07-30,Project payment - Moreno PLC,REF84865465,0.0,1627.68,271593.78
2023-07-30,2023-07-30,"Project payment - Brown, Smith and Sanchez",REF94963796,0.0,1461.25,273055.03
2023-07-30,2023-07-30,Payment from Solis and Sons,REF79264749,0.0,322.39,273377.42
2023-07-30,2023-07-30,Project payment - Smith-Rowe,REF34622352,0.0,1011.19,274388.61
2023-07-30,2023-07-30,Payment from Hoover-Camacho,REF91903238,0.0,1639.98,276028.59
2023-07-31,2023-07-31,Vehicle Maintenance expense,REF91683605,128.12,0.0,275900.47
2023-08-01,2023-08-01,Business materials,REF93215611,590.84,0.0,275309.63
2023-08-02,2023-08-02,Safety Equipment expense,REF68892915,138.07,0.0,275171.56
2023-08-02,2023-08-02,Fuel purchase,REF89006691,463.05,0.0,274708.51
2023-08-03,2023-08-03,Fuel purchase,REF78763723,279.49,0.0,274429.02
2023-08-08,2023-08-08,Equipment Rental expense,REF68083249,795.28,0.0,273633.74
2023-08-09,2023-08-09,Vehicle Maintenance expense,REF98988612,212.17,0.0,273421.57
2023-08-09,2023-08-09,Equipment Rental expense,REF99041761,350.15,0.0,273071.42
2023-08-11,2023-08-11,Fuel purchase,REF16220779,532.09,0.0,272539.33
2023-08-12,2023-08-12,Fuel purchase,REF98330793,150.36,0.0,272388.97
2023-08-15,2023-08-15,Service payment - Solis and Sons,REF70911408,0.0,255.15,272644.12
2023-08-15,2023-08-15,"Invoice payment - Brown, Smith and Sanchez",REF45244997,0.0,1485.61,274129.73
2023-08-15,2023-08-15,Project payment - Smith-Rowe,REF87720544,0.0,884.98,275014.71
2023-08-15,2023-08-15,Business materials,REF30227097,867.56,0.0,274147.15
2023-08-15,2023-08-15,Project payment - Moreno PLC,REF27778711,0.0,1375.47,275522.62
2023-08-15,2023-08-15,Project payment - Hoover-Camacho,REF19469306,0.0,1322.71,276845.33
2023-08-15,2023-08-15,Business insurance premium,REF61007517,246.12,0.0,276599.21
2023-08-18,2023-08-18,Fuel purchase,REF82227437,427.71,0.0,276171.5
2023-08-18,2023-08-18,Tools expense,REF73054223,121.04,0.0,276050.46
2023-08-19,2023-08-19,Fuel purchase,REF87653358,246.42,0.0,275804.04
2023-08-25,2023-08-25,Safety Equipment expense,REF67634734,109.9,0.0,275694.14
2023-08-27,2023-08-27,Safety Equipment expense,REF50524589,73.37,0.0,275620.77
2023-08-27,2023-08-27,Equipment Rental expense,REF31521198,597.83,0.0,275022.94
2023-08-29,2023-08-29,Business materials,REF24487524,1065.84,0.0,273957.1
2023-08-30,2023-08-30,Payment from Smith-Rowe,REF18139087,0.0,975.68,274932.78
2023-08-30,2023-08-30,Tools expense,REF78545782,195.07,0.0,274737.71
2023-08-30,2023-08-30,Payment from Solis and Sons,REF49389270,0.0,276.72,275014.43
2023-08-30,2023-08-30,Payment from Hoover-Camacho,REF25418566,0.0,1330.59,276345.02
2023-08-30,2023-08-30,Payment from Moreno PLC,REF79315805,0.0,1448.17,277793.19
2023-08-31,2023-08-31,Fuel purchase,REF97870555,257.46,0.0,277535.73
2023-09-01,2023-09-01,Business materials,REF23230341,409.91,0.0,277125.82
2023-09-02,2023-09-02,Safety Equipment expense,REF33610837,74.96,0.0,277050.86
