transaction_date,value_date,description,reference,debit,credit,balance
2010-08-21,2010-08-21,Marketing expenses,REF13544123,135.83,0.0,4489.46
2010-08-26,2010-08-26,Internet and phone service,REF22599609,64.6,0.0,4424.86
2010-08-27,2010-08-27,Office supplies,REF28154078,33.36,0.0,4391.5
2010-08-28,2010-08-28,Office supplies,REF97752928,40.1,0.0,4351.4
2010-08-30,2010-08-30,Professional services,REF74990179,185.3,0.0,4166.1
2010-09-01,2010-09-01,Office supplies,REF55886218,38.79,0.0,4127.31
2010-09-02,2010-09-02,Internet and phone service,REF53350787,67.2,0.0,4060.11
2010-09-06,2010-09-06,Professional services,REF86317100,340.28,0.0,3719.83
2010-09-06,2010-09-06,Internet and phone service,REF46098890,85.58,0.0,3634.25
2010-09-07,2010-09-07,Marketing expenses,REF90236239,158.32,0.0,3475.93
2010-09-09,2010-09-09,Software subscription,REF13357901,136.65,0.0,3339.28
2010-09-12,2010-09-12,Office supplies,REF78083181,55.37,0.0,3283.91
2010-09-14,2010-09-14,Office supplies,REF72648845,51.4,0.0,3232.51
2010-09-15,2010-09-15,Service payment - Jackson-Wilcox,REF23267818,0.0,1370.48,4602.99
2010-09-15,2010-09-15,Project payment - Abbott-Harrison,REF26393805,0.0,1297.36,5900.35
2010-09-15,2010-09-15,Service payment - Gordon PLC,REF60474974,0.0,1269.1,7169.45
2010-09-15,2010-09-15,Business insurance premium,REF31322688,142.22,0.0,7027.23
2010-09-17,2010-09-17,Office supplies,REF33250426,89.71,0.0,6937.52
2010-09-23,2010-09-23,Training/conference,REF12704777,135.1,0.0,6802.42
2010-09-27,2010-09-27,Equipment purchase,REF77541705,80.84,0.0,6721.58
2010-10-01,2010-10-01,Internet and phone service,REF37725824,55.76,0.0,6665.82
2010-10-03,2010-10-03,Office supplies,REF26850210,90.73,0.0,6575.09
2010-10-06,2010-10-06,Training/conference,REF37979355,190.73,0.0,6384.36
2010-10-09,2010-10-09,Business travel,REF58196358,202.51,0.0,6181.85
2010-10-09,2010-10-09,Software subscription,REF94578395,172.34,0.0,6009.51
2010-10-10,2010-10-10,Marketing expenses,REF90658853,177.7,0.0,5831.81
2010-10-12,2010-10-12,Professional services,REF34042312,268.82,0.0,5562.99
2010-10-14,2010-10-14,Training/conference,REF19174331,130.77,0.0,5432.22
2010-10-15,2010-10-15,Business insurance premium,REF27173086,143.62,0.0,5288.6
2010-10-15,2010-10-15,Project payment - Gordon PLC,REF75720311,0.0,1287.38,6575.98
2010-10-15,2010-10-15,Service payment - Jackson-Wilcox,REF39542041,0.0,1634.72,8210.7
2010-10-15,2010-10-15,Invoice payment - Abbott-Harrison,REF40107988,0.0,1264.13,9474.83
2010-10-19,2010-10-19,Marketing expenses,REF64132217,333.35,0.0,9141.48
2010-10-26,2010-10-26,Office supplies,REF13105547,71.21,0.0,9070.27
2010-11-03,2010-11-03,Professional services,REF31528632,318.52,0.0,8751.75
2010-11-03,2010-11-03,Office supplies,REF72126145,81.71,0.0,8670.04
2010-11-03,2010-11-03,Marketing expenses,REF98230331,264.64,0.0,8405.4
2010-11-09,2010-11-09,Software subscription,REF44148245,169.41,0.0,8235.99
2010-11-10,2010-11-10,Business travel,REF83510613,148.85,0.0,8087.14
2010-11-10,2010-11-10,Marketing expenses,REF44855583,236.06,0.0,7851.08
2010-11-10,2010-11-10,Equipment purchase,REF30504184,78.33,0.0,7772.75
2010-11-13,2010-11-13,Office supplies,REF41755854,54.16,0.0,7718.59
2010-11-15,2010-11-15,Service payment - Jackson-Wilcox,REF53342438,0.0,1436.61,9155.2
2010-11-15,2010-11-15,Project payment - Gordon PLC,REF56654274,0.0,1541.01,10696.21
2010-11-15,2010-11-15,Payment from Abbott-Harrison,REF50525346,0.0,1277.47,11973.68
2010-11-15,2010-11-15,Business insurance premium,REF92876214,135.66,0.0,11838.02
2010-11-19,2010-11-19,Office supplies,REF72103799,67.6,0.0,11770.42
2010-11-21,2010-11-21,Equipment purchase,REF15863446,100.06,0.0,11670.36
2010-11-23,2010-11-23,Training/conference,REF69530021,81.31,0.0,11589.05
2010-11-24,2010-11-24,Training/conference,REF52067347,104.51,0.0,11484.54
2010-12-01,2010-12-01,Office supplies,REF94218924,52.99,0.0,11431.55
2010-12-05,2010-12-05,Office supplies,REF70191726,43.07,0.0,11388.48
2010-12-08,2010-12-08,Office supplies,REF56825763,23.33,0.0,11365.15
2010-12-09,2010-12-09,Software subscription,REF31164799,160.53,0.0,11204.62
2010-12-09,2010-12-09,Marketing expenses,REF82291735,131.3,0.0,11073.32
2010-12-09,2010-12-09,Internet and phone service,REF17487013,64.76,0.0,11008.56
2010-12-13,2010-12-13,Business travel,REF37623830,190.51,0.0,10818.05
2010-12-15,2010-12-15,Service payment - Jackson-Wilcox,REF49380774,0.0,1277.13,12095.18
2010-12-15,2010-12-15,Professional services,REF37236370,112.19,0.0,11982.99
2010-12-15,2010-12-15,Project payment - Gordon PLC,REF46042542,0.0,988.94,12971.93
2010-12-15,2010-12-15,Business insurance premium,REF22288222,104.35,0.0,12867.58
2010-12-18,2010-12-18,Office supplies,REF13151421,50.07,0.0,12817.51
2010-12-19,2010-12-19,Training/conference,REF92832128,97.65,0.0,12719.86
2010-12-25,2010-12-25,Office supplies,REF40805518,26.22,0.0,12693.64
2010-12-30,2010-12-30,Internet and phone service,REF30498382,53.07,0.0,12640.57
2011-01-01,2011-01-01,Office supplies,REF63967534,22.25,0.0,12618.32
2011-01-02,2011-01-02,Business travel,REF62896486,119.04,0.0,12499.28
2011-01-05,2011-01-05,Professional services,REF45682624,252.27,0.0,12247.01
2011-01-07,2011-01-07,Business travel,REF68871416,109.94,0.0,12137.07
2011-01-09,2011-01-09,Software subscription,REF52800817,116.98,0.0,12020.09
2011-01-10,2011-01-10,Office supplies,REF45897195,43.82,0.0,11976.27
2011-01-12,2011-01-12,Professional services,REF97589410,323.71,0.0,11652.56
2011-01-15,2011-01-15,Payment from Gordon PLC,REF16842326,0.0,1056.56,12709.12
2011-01-15,2011-01-15,Service payment - Abbott-Harrison,REF86750779,0.0,879.52,13588.64
2011-01-15,2011-01-15,Payment from Jackson-Wilcox,REF24663082,0.0,1086.01,14674.65
2011-01-15,2011-01-15,Business insurance premium,REF98725453,94.53,0.0,14580.12
2011-01-17,2011-01-17,Marketing expenses,REF59801090,205.89,0.0,14374.23
2011-01-20,2011-01-20,Internet and phone service,REF80879518,85.99,0.0,14288.24
2011-01-26,2011-01-26,Professional services,REF89871908,206.9,0.0,14081.34
2011-01-30,2011-01-30,Office supplies,REF16288905,44.16,0.0,14037.18
2011-02-05,2011-02-05,Business travel,REF82780755,107.99,0.0,13929.19
2011-02-07,2011-02-07,Professional services,REF46421355,245.83,0.0,13683.36
2011-02-09,2011-02-09,Software subscription,REF56871986,152.91,0.0,13530.45
2011-02-10,2011-02-10,Business travel,REF85978628,129.4,0.0,13401.05
2011-02-12,2011-02-12,Professional services,REF95051140,230.93,0.0,13170.12
2011-02-15,2011-02-15,Business insurance premium,REF78079604,102.44,0.0,13067.68
2011-02-15,2011-02-15,Payment from Abbott-Harrison,REF61659160,0.0,1071.62,14139.3
2011-02-15,2011-02-15,Service payment - Gordon PLC,REF18622780,0.0,931.39,15070.69
2011-02-15,2011-02-15,Project payment - Jackson-Wilcox,REF94644712,0.0,1127.61,16198.3
2011-02-16,2011-02-16,Internet and phone service,REF40406073,75.5,0.0,16122.8
2011-02-17,2011-02-17,Internet and phone service,REF91762907,86.85,0.0,16035.95
2011-02-19,2011-02-19,Training/conference,REF32304243,89.31,0.0,15946.64
2011-02-24,2011-02-24,Business travel,REF96107852,68.55,0.0,15878.09
2011-02-24,2011-02-24,Marketing expenses,REF72725833,186.97,0.0,15691.12
2011-02-28,2011-02-28,Office supplies,REF55891342,46.81,0.0,15644.31
2011-03-03,2011-03-03,Training/conference,REF25948618,130.37,0.0,15513.94
2011-03-06,2011-03-06,Office supplies,REF78412133,58.44,0.0,15455.5
2011-03-09,2011-03-09,Software subscription,REF93199668,176.71,0.0,15278.79
2011-03-15,2011-03-15,Business insurance premium,REF80349736,120.13,0.0,15158.66
2011-03-15,2011-03-15,Service payment - Abbott-Harrison,REF63954744,0.0,1267.65,16426.31
2011-03-15,2011-03-15,Invoice payment - Jackson-Wilcox,REF48823815,0.0,1598.74,18025.05
2011-03-30,2011-03-30,Office supplies,REF90874058,61.57,0.0,17963.48
2011-03-31,2011-03-31,Business travel,REF79007557,206.44,0.0,17757.04
2011-03-31,2011-03-31,Marketing expenses,REF78265041,262.41,0.0,17494.63
2011-04-02,2011-04-02,Business travel,REF95293769,165.94,0.0,17328.69
2011-04-04,2011-04-04,Office supplies,REF57148865,61.75,0.0,17266.94
2011-04-05,2011-04-05,Office supplies,REF97847759,57.68,0.0,17209.26
2011-04-09,2011-04-09,Software subscription,REF43124057,145.79,0.0,17063.47
2011-04-10,2011-04-10,Professional services,REF73264117,305.92,0.0,16757.55
2011-04-14,2011-04-14,Business travel,REF59302124,211.51,0.0,16546.04
2011-04-15,2011-04-15,Business insurance premium,REF81482455,125.93,0.0,16420.11
2011-04-15,2011-04-15,Project payment - Gordon PLC,REF59649682,0.0,1150.94,17571.05
2011-04-15,2011-04-15,Project payment - Jackson-Wilcox,REF82264794,0.0,1543.42,19114.47
2011-04-15,2011-04-15,Invoice payment - Abbott-Harrison,REF43252372,0.0,973.33,20087.8
2011-04-15,2011-04-15,Office supplies,REF71958332,67.01,0.0,20020.79
2011-04-17,2011-04-17,Internet and phone service,REF44994429,58.38,0.0,19962.41
2011-04-28,2011-04-28,Office supplies,REF90229448,50.93,0.0,19911.48
2011-04-30,2011-04-30,Professional services,REF89095200,259.62,0.0,19651.86
2011-05-03,2011-05-03,Office supplies,REF30389356,78.81,0.0,19573.05
2011-05-03,2011-05-03,Professional services,REF29066253,299.05,0.0,19274.0
2011-05-04,2011-05-04,Professional services,REF74207028,317.29,0.0,18956.71
2011-05-07,2011-05-07,Equipment purchase,REF37326137,110.93,0.0,18845.78
2011-05-09,2011-05-09,Software subscription,REF21662148,141.71,0.0,18704.07
2011-05-09,2011-05-09,Equipment purchase,REF69554735,106.95,0.0,18597.12
2011-05-13,2011-05-13,Marketing expenses,REF72102304,214.7,0.0,18382.42
2011-05-15,2011-05-15,Professional services,REF48299334,178.2,0.0,18204.22
2011-05-15,2011-05-15,Service payment - Jackson-Wilcox,REF93961519,0.0,1274.05,19478.27
2011-05-15,2011-05-15,Business insurance premium,REF73676009,118.02,0.0,19360.25
2011-05-15,2011-05-15,Project payment - Gordon PLC,REF25701798,0.0,1214.98,20575.23
2011-05-15,2011-05-15,Service payment - Abbott-Harrison,REF74175909,0.0,1150.43,21725.66
2011-05-21,2011-05-21,Business travel,REF33263692,216.71,0.0,21508.95
2011-05-28,2011-05-28,Training/conference,REF50127991,82.46,0.0,21426.49
2011-05-31,2011-05-31,Equipment purchase,REF31742378,109.16,0.0,21317.33
2011-06-05,2011-06-05,Office supplies,REF81879616,64.39,0.0,21252.94
2011-06-06,2011-06-06,Office supplies,REF99859242,68.6,0.0,21184.34
2011-06-09,2011-06-09,Software subscription,REF24903211,135.39,0.0,21048.95
2011-06-10,2011-06-10,Professional services,REF46736897,262.02,0.0,20786.93
2011-06-11,2011-06-11,Professional services,REF22992035,152.86,0.0,20634.07
2011-06-11,2011-06-11,Marketing expenses,REF50373157,161.93,0.0,20472.14
2011-06-15,2011-06-15,Business insurance premium,REF20687586,112.98,0.0,20359.16
2011-06-15,2011-06-15,Project payment - Gordon PLC,REF63789779,0.0,924.07,21283.23
2011-06-15,2011-06-15,Invoice payment - Jackson-Wilcox,REF49499021,0.0,1395.14,22678.37
2011-06-16,2011-06-16,Marketing expenses,REF55399862,146.33,0.0,22532.04
2011-06-19,2011-06-19,Equipment purchase,REF83313121,94.33,0.0,22437.71
2011-06-20,2011-06-20,Office supplies,REF26169072,65.88,0.0,22371.83
2011-06-20,2011-06-20,Internet and phone service,REF53321650,57.29,0.0,22314.54
2011-06-23,2011-06-23,Training/conference,REF45365511,91.01,0.0,22223.53
2011-06-23,2011-06-23,Office supplies,REF14667953,33.15,0.0,22190.38
2011-06-27,2011-06-27,Training/conference,REF78614062,85.37,0.0,22105.01
2011-07-01,2011-07-01,Equipment purchase,REF37930744,60.3,0.0,22044.71
2011-07-04,2011-07-04,Business travel,REF38036234,225.92,0.0,21818.79
2011-07-05,2011-07-05,Business travel,REF83677512,146.24,0.0,21672.55
2011-07-08,2011-07-08,Marketing expenses,REF43034658,159.57,0.0,21512.98
2011-07-09,2011-07-09,Software subscription,REF76670417,107.1,0.0,21405.88
2011-07-10,2011-07-10,Office supplies,REF65686910,50.71,0.0,21355.17
2011-07-12,2011-07-12,Equipment purchase,REF52538035,93.01,0.0,21262.16
2011-07-15,2011-07-15,Service payment - Abbott-Harrison,REF45637993,0.0,1100.49,22362.65
2011-07-15,2011-07-15,Business insurance premium,REF28338186,91.67,0.0,22270.98
2011-07-15,2011-07-15,Payment from Gordon PLC,REF68561457,0.0,1186.92,23457.9
2011-07-18,2011-07-18,Business travel,REF25579206,173.19,0.0,23284.71
2011-07-27,2011-07-27,Marketing expenses,REF43034198,178.98,0.0,23105.73
2011-08-04,2011-08-04,Business travel,REF86391614,73.93,0.0,23031.8
2011-08-05,2011-08-05,Professional services,REF74550551,182.37,0.0,22849.43
2011-08-09,2011-08-09,Software subscription,REF31963138,122.33,0.0,22727.1
2011-08-10,2011-08-10,Training/conference,REF66074986,44.1,0.0,22683.0
2011-08-11,2011-08-11,Office supplies,REF18555135,38.11,0.0,22644.89
2011-08-11,2011-08-11,Training/conference,REF24392248,69.38,0.0,22575.51
2011-08-12,2011-08-12,Training/conference,REF46571716,68.31,0.0,22507.2
2011-08-12,2011-08-12,Business travel,REF46818308,123.15,0.0,22384.05
2011-08-14,2011-08-14,Internet and phone service,REF80192701,78.96,0.0,22305.09
2011-08-15,2011-08-15,Office supplies,REF68635750,51.05,0.0,22254.04
2011-08-15,2011-08-15,Invoice payment - Gordon PLC,REF54657481,0.0,999.88,23253.92
2011-08-15,2011-08-15,Payment from Abbott-Harrison,REF36877479,0.0,685.97,23939.89
2011-08-15,2011-08-15,Business insurance premium,REF21279464,79.31,0.0,23860.58
2011-08-15,2011-08-15,Service payment - Jackson-Wilcox,REF69995698,0.0,681.69,24542.27
2011-08-15,2011-08-15,Internet and phone service,REF32013775,65.99,0.0,24476.28
2011-08-16,2011-08-16,Office supplies,REF93408335,29.95,0.0,24446.33
2011-08-18,2011-08-18,Equipment purchase,REF95703132,66.45,0.0,24379.88
2011-08-23,2011-08-23,Business travel,REF56623558,69.03,0.0,24310.85
2011-08-24,2011-08-24,Office supplies,REF44020190,39.19,0.0,24271.66
2011-08-24,2011-08-24,Marketing expenses,REF14557119,171.92,0.0,24099.74
2011-09-03,2011-09-03,Business travel,REF85659213,100.91,0.0,23998.83
2011-09-03,2011-09-03,Equipment purchase,REF72473771,96.91,0.0,23901.92
2011-09-08,2011-09-08,Professional services,REF26044309,251.35,0.0,23650.57
2011-09-09,2011-09-09,Software subscription,REF15352520,144.0,0.0,23506.57
2011-09-10,2011-09-10,Business travel,REF33328842,158.07,0.0,23348.5
2011-09-11,2011-09-11,Equipment purchase,REF63835587,94.1,0.0,23254.4
2011-09-14,2011-09-14,Office supplies,REF64694294,80.36,0.0,23174.04
2011-09-15,2011-09-15,Business insurance premium,REF51438032,127.82,0.0,23046.22
2011-09-15,2011-09-15,Service payment - Jackson-Wilcox,REF11014161,0.0,955.95,24002.17
2011-09-15,2011-09-15,Project payment - Gordon PLC,REF44739210,0.0,1455.25,25457.42
2011-09-19,2011-09-19,Marketing expenses,REF78524165,252.27,0.0,25205.15
2011-09-29,2011-09-29,Professional services,REF27923919,254.14,0.0,24951.01
2011-10-02,2011-10-02,Office supplies,REF46465812,90.54,0.0,24860.47
2011-10-03,2011-10-03,Office supplies,REF32967036,44.59,0.0,24815.88
2011-10-03,2011-10-03,Equipment purchase,REF14000954,99.71,0.0,24716.17
2011-10-09,2011-10-09,Software subscription,REF93267197,188.62,0.0,24527.55
2011-10-15,2011-10-15,Project payment - Abbott-Harrison,REF59203147,0.0,1500.13,26027.68
2011-10-15,2011-10-15,Service payment - Jackson-Wilcox,REF97444811,0.0,1364.95,27392.63
2011-10-15,2011-10-15,Project payment - Gordon PLC,REF81496183,0.0,1585.49,28978.12
2011-10-15,2011-10-15,Business insurance premium,REF83818035,138.2,0.0,28839.92
2011-10-22,2011-10-22,Marketing expenses,REF84190361,239.75,0.0,28600.17
2011-10-28,2011-10-28,Office supplies,REF16450179,96.95,0.0,28503.22
2011-11-05,2011-11-05,Marketing expenses,REF46038199,167.79,0.0,28335.43
2011-11-07,2011-11-07,Business travel,REF57567952,154.67,0.0,28180.76
2011-11-09,2011-11-09,Software subscription,REF73879691,158.48,0.0,28022.28
2011-11-10,2011-11-10,Training/conference,REF19878319,94.55,0.0,27927.73
2011-11-11,2011-11-11,Equipment purchase,REF39257881,86.67,0.0,27841.06
2011-11-13,2011-11-13,Office supplies,REF32341122,74.77,0.0,27766.29
2011-11-14,2011-11-14,Training/conference,REF80366754,98.91,0.0,27667.38
2011-11-15,2011-11-15,Project payment - Gordon PLC,REF64440651,0.0,1424.95,29092.33
2011-11-15,2011-11-15,Invoice payment - Abbott-Harrison,REF93743488,0.0,905.11,29997.44
2011-11-15,2011-11-15,Business insurance premium,REF97037074,128.24,0.0,29869.2
2011-11-15,2011-11-15,Service payment - Jackson-Wilcox,REF40264712,0.0,1082.9,30952.1
2011-11-16,2011-11-16,Equipment purchase,REF84759864,117.77,0.0,30834.33
2011-12-02,2011-12-02,Internet and phone service,REF38607510,65.1,0.0,30769.23
2011-12-04,2011-12-04,Equipment purchase,REF81566978,71.56,0.0,30697.67
2011-12-06,2011-12-06,Professional services,REF68085014,344.46,0.0,30353.21
2011-12-09,2011-12-09,Software subscription,REF24719306,144.23,0.0,30208.98
2011-12-12,2011-12-12,Internet and phone service,REF92223994,79.79,0.0,30129.19
2011-12-15,2011-12-15,Business insurance premium,REF32512986,119.01,0.0,30010.18
2011-12-15,2011-12-15,Invoice payment - Gordon PLC,REF27712932,0.0,900.72,30910.9
2011-12-15,2011-12-15,Invoice payment - Jackson-Wilcox,REF40422033,0.0,881.21,31792.11
2011-12-15,2011-12-15,Invoice payment - Abbott-Harrison,REF36341935,0.0,763.8,32555.91
2011-12-17,2011-12-17,Office supplies,REF35331190,43.24,0.0,32512.67
2011-12-24,2011-12-24,Training/conference,REF74202900,93.46,0.0,32419.21
2011-12-29,2011-12-29,Training/conference,REF74031592,121.65,0.0,32297.56
2012-01-07,2012-01-07,Training/conference,REF68889158,43.36,0.0,32254.2
2012-01-08,2012-01-08,Internet and phone service,REF57013648,70.22,0.0,32183.98
2012-01-09,2012-01-09,Software subscription,REF10366741,119.0,0.0,32064.98
2012-01-10,2012-01-10,Business travel,REF94507286,98.04,0.0,31966.94
2012-01-12,2012-01-12,Office supplies,REF74397638,25.63,0.0,31941.31
2012-01-13,2012-01-13,Office supplies,REF65250568,43.42,0.0,31897.89
2012-01-14,2012-01-14,Professional services,REF32276545,210.98,0.0,31686.91
2012-01-14,2012-01-14,Office supplies,REF33195944,38.79,0.0,31648.12
2012-01-15,2012-01-15,Service payment - Abbott-Harrison,REF41163332,0.0,1001.7,32649.82
2012-01-15,2012-01-15,Business insurance premium,REF79552225,87.66,0.0,32562.16
2012-01-15,2012-01-15,Service payment - Gordon PLC,REF79706032,0.0,1078.26,33640.42
2012-01-15,2012-01-15,Office supplies,REF99981279,44.16,0.0,33596.26
2012-01-15,2012-01-15,Project payment - Jackson-Wilcox,REF63513793,0.0,1049.47,34645.73
2012-01-16,2012-01-16,Business travel,REF16860541,98.44,0.0,34547.29
2012-01-17,2012-01-17,Office supplies,REF92757882,47.93,0.0,34499.36
2012-01-19,2012-01-19,Training/conference,REF59371706,96.22,0.0,34403.14
2012-01-22,2012-01-22,Office supplies,REF16361907,42.98,0.0,34360.16
2012-01-26,2012-01-26,Office supplies,REF73386772,47.99,0.0,34312.17
2012-01-29,2012-01-29,Professional services,REF82711735,107.29,0.0,34204.88
2012-02-02,2012-02-02,Internet and phone service,REF90701714,78.63,0.0,34126.25
2012-02-03,2012-02-03,Marketing expenses,REF49603344,156.08,0.0,33970.17
2012-02-08,2012-02-08,Business travel,REF34509344,75.51,0.0,33894.66
2012-02-09,2012-02-09,Software subscription,REF95831873,121.15,0.0,33773.51
2012-02-13,2012-02-13,Office supplies,REF78685272,35.22,0.0,33738.29
2012-02-15,2012-02-15,Project payment - Gordon PLC,REF20387826,0.0,944.73,34683.02
2012-02-15,2012-02-15,Business insurance premium,REF75673829,105.36,0.0,34577.66
2012-02-15,2012-02-15,Project payment - Jackson-Wilcox,REF63300416,0.0,835.37,35413.03
2012-02-17,2012-02-17,Equipment purchase,REF69767795,44.07,0.0,35368.96
2012-02-21,2012-02-21,Professional services,REF66568007,346.8,0.0,35022.16
2012-03-01,2012-03-01,Training/conference,REF35521195,65.03,0.0,34957.13
2012-03-02,2012-03-02,Business travel,REF91014975,141.7,0.0,34815.43
2012-03-04,2012-03-04,Office supplies,REF74073204,30.55,0.0,34784.88
2012-03-09,2012-03-09,Software subscription,REF17064382,158.25,0.0,34626.63
2012-03-13,2012-03-13,Training/conference,REF33142390,122.17,0.0,34504.46
2012-03-15,2012-03-15,Business insurance premium,REF82693159,146.01,0.0,34358.45
2012-03-15,2012-03-15,Payment from Jackson-Wilcox,REF41361103,0.0,1548.24,35906.69
2012-03-15,2012-03-15,Invoice payment - Gordon PLC,REF92207225,0.0,1368.09,37274.78
2012-03-15,2012-03-15,Service payment - Abbott-Harrison,REF40542314,0.0,1517.19,38791.97
2012-03-24,2012-03-24,Marketing expenses,REF58255024,210.66,0.0,38581.31
2012-03-25,2012-03-25,Equipment purchase,REF93422692,90.55,0.0,38490.76
2012-03-25,2012-03-25,Training/conference,REF16750339,138.03,0.0,38352.73
2012-03-26,2012-03-26,Office supplies,REF88376066,60.12,0.0,38292.61
2012-03-27,2012-03-27,Office supplies,REF82862968,50.73,0.0,38241.88
2012-03-27,2012-03-27,Training/conference,REF98190301,118.54,0.0,38123.34
2012-03-31,2012-03-31,Office supplies,REF47820421,39.63,0.0,38083.71
2012-04-05,2012-04-05,Business travel,REF51235571,117.12,0.0,37966.59
2012-04-06,2012-04-06,Equipment purchase,REF85021222,146.7,0.0,37819.89
2012-04-07,2012-04-07,Equipment purchase,REF56290406,126.99,0.0,37692.9
2012-04-09,2012-04-09,Software subscription,REF27781574,129.41,0.0,37563.49
2012-04-15,2012-04-15,Business insurance premium,REF29173889,130.78,0.0,37432.71
2012-04-15,2012-04-15,Service payment - Jackson-Wilcox,REF23886348,0.0,1306.2,38738.91
2012-04-15,2012-04-15,Professional services,REF90826456,381.36,0.0,38357.55
2012-04-15,2012-04-15,Project payment - Gordon PLC,REF58576845,0.0,1411.35,39768.9
2012-04-15,2012-04-15,Invoice payment - Abbott-Harrison,REF13567773,0.0,1016.67,40785.57
2012-04-23,2012-04-23,Office supplies,REF46693337,35.91,0.0,40749.66
2012-04-26,2012-04-26,Office supplies,REF58555984,54.68,0.0,40694.98
2012-05-01,2012-05-01,Equipment purchase,REF37674824,71.87,0.0,40623.11
2012-05-02,2012-05-02,Office supplies,REF46123665,39.42,0.0,40583.69
2012-05-02,2012-05-02,Equipment purchase,REF48582295,79.39,0.0,40504.3
2012-05-08,2012-05-08,Internet and phone service,REF20795278,85.02,0.0,40419.28
2012-05-09,2012-05-09,Software subscription,REF76064398,157.25,0.0,40262.03
2012-05-10,2012-05-10,Professional services,REF67394852,227.21,0.0,40034.82
2012-05-13,2012-05-13,Training/conference,REF62548787,63.25,0.0,39971.57
2012-05-15,2012-05-15,Invoice payment - Abbott-Harrison,REF21222542,0.0,993.68,40965.25
2012-05-15,2012-05-15,Business insurance premium,REF16365545,114.28,0.0,40850.97
2012-05-15,2012-05-15,Equipment purchase,REF87004815,103.4,0.0,40747.57
2012-05-15,2012-05-15,Service payment - Jackson-Wilcox,REF70687809,0.0,1232.95,41980.52
2012-05-17,2012-05-17,Business travel,REF67896007,188.1,0.0,41792.42
2012-05-18,2012-05-18,Internet and phone service,REF13526150,40.68,0.0,41751.74
2012-05-20,2012-05-20,Professional services,REF25282434,251.2,0.0,41500.54
2012-05-26,2012-05-26,Office supplies,REF59296017,52.72,0.0,41447.82
2012-05-27,2012-05-27,Marketing expenses,REF95219997,155.38,0.0,41292.44
2012-05-28,2012-05-28,Equipment purchase,REF85166930,105.92,0.0,41186.52
2012-05-29,2012-05-29,Business travel,REF86845270,135.3,0.0,41051.22
2012-05-30,2012-05-30,Business travel,REF29355744,158.27,0.0,40892.95
2012-05-31,2012-05-31,Office supplies,REF87198361,41.37,0.0,40851.58
2012-06-01,2012-06-01,Professional services,REF34812930,184.78,0.0,40666.8
2012-06-09,2012-06-09,Software subscription,REF98597630,138.35,0.0,40528.45
2012-06-09,2012-06-09,Office supplies,REF11527324,35.15,0.0,40493.3
2012-06-15,2012-06-15,Marketing expenses,REF60041656,213.68,0.0,40279.62
2012-06-15,2012-06-15,Business insurance premium,REF55217684,109.25,0.0,40170.37
2012-06-15,2012-06-15,Project payment - Gordon PLC,REF89081857,0.0,1304.13,41474.5
2012-06-15,2012-06-15,Invoice payment - Abbott-Harrison,REF88560063,0.0,1189.3,42663.8
2012-06-15,2012-06-15,Business travel,REF26649661,101.0,0.0,42562.8
2012-06-19,2012-06-19,Office supplies,REF19309267,60.06,0.0,42502.74
2012-06-19,2012-06-19,Internet and phone service,REF98908695,59.73,0.0,42443.01
2012-06-21,2012-06-21,Office supplies,REF55068513,50.8,0.0,42392.21
2012-06-28,2012-06-28,Marketing expenses,REF60248830,249.6,0.0,42142.61
2012-06-28,2012-06-28,Office supplies,REF54963882,38.67,0.0,42103.94
2012-07-02,2012-07-02,Training/conference,REF98378497,57.16,0.0,42046.78
2012-07-05,2012-07-05,Business travel,REF56717396,122.28,0.0,41924.5
2012-07-08,2012-07-08,Internet and phone service,REF11382210,83.21,0.0,41841.29
2012-07-09,2012-07-09,Software subscription,REF82453991,115.96,0.0,41725.33
2012-07-10,2012-07-10,Business travel,REF43501501,71.37,0.0,41653.96
2012-07-11,2012-07-11,Professional services,REF75305329,170.66,0.0,41483.3
2012-07-15,2012-07-15,Payment from Gordon PLC,REF98064008,0.0,1159.99,42643.29
2012-07-15,2012-07-15,Invoice payment - Abbott-Harrison,REF91035307,0.0,1144.89,43788.18
2012-07-15,2012-07-15,Service payment - Jackson-Wilcox,REF65690104,0.0,803.01,44591.19
2012-07-15,2012-07-15,Business insurance premium,REF29246224,89.96,0.0,44501.23
2012-07-17,2012-07-17,Equipment purchase,REF41675289,73.19,0.0,44428.04
2012-07-19,2012-07-19,Training/conference,REF16849830,64.16,0.0,44363.88
2012-07-21,2012-07-21,Training/conference,REF74787922,39.55,0.0,44324.33
2012-07-21,2012-07-21,Office supplies,REF80346220,50.27,0.0,44274.06
2012-07-22,2012-07-22,Marketing expenses,REF90823978,114.61,0.0,44159.45
2012-07-28,2012-07-28,Office supplies,REF41629888,57.67,0.0,44101.78
2012-07-30,2012-07-30,Office supplies,REF84228189,24.08,0.0,44077.7
2012-08-04,2012-08-04,Equipment purchase,REF51409734,57.66,0.0,44020.04
2012-08-07,2012-08-07,Marketing expenses,REF37714584,110.52,0.0,43909.52
2012-08-08,2012-08-08,Office supplies,REF41162505,53.25,0.0,43856.27
2012-08-09,2012-08-09,Equipment purchase,REF81131149,56.66,0.0,43799.61
2012-08-09,2012-08-09,Software subscription,REF73723470,91.96,0.0,43707.65
2012-08-13,2012-08-13,Marketing expenses,REF33074141,178.14,0.0,43529.51
2012-08-14,2012-08-14,Professional services,REF79293124,54.3,0.0,43475.21
2012-08-15,2012-08-15,Business insurance premium,REF12183898,76.09,0.0,43399.12
2012-08-15,2012-08-15,Service payment - Abbott-Harrison,REF16550117,0.0,755.72,44154.84
2012-08-15,2012-08-15,Payment from Gordon PLC,REF94548947,0.0,887.9,45042.74
2012-08-15,2012-08-15,Marketing expenses,REF24748330,105.44,0.0,44937.3
2012-08-15,2012-08-15,Payment from Jackson-Wilcox,REF36482191,0.0,867.43,45804.73
2012-08-21,2012-08-21,Business travel,REF47115212,49.46,0.0,45755.27
2012-08-22,2012-08-22,Office supplies,REF82224900,45.25,0.0,45710.02
2012-08-25,2012-08-25,Office supplies,REF43516609,43.7,0.0,45666.32
2012-08-30,2012-08-30,Equipment purchase,REF40919147,63.09,0.0,45603.23
2012-09-03,2012-09-03,Business travel,REF78434122,119.48,0.0,45483.75
2012-09-04,2012-09-04,Internet and phone service,REF74511875,37.68,0.0,45446.07
2012-09-09,2012-09-09,Equipment purchase,REF35816518,71.97,0.0,45374.1
2012-09-09,2012-09-09,Software subscription,REF89321324,166.88,0.0,45207.22
2012-09-12,2012-09-12,Business travel,REF37277978,198.24,0.0,45008.98
2012-09-14,2012-09-14,Internet and phone service,REF94692065,54.49,0.0,44954.49
2012-09-15,2012-09-15,Invoice payment - Jackson-Wilcox,REF72923559,0.0,1349.51,46304.0
2012-09-15,2012-09-15,Invoice payment - Abbott-Harrison,REF90278576,0.0,860.55,47164.55
2012-09-15,2012-09-15,Project payment - Gordon PLC,REF31542249,0.0,1847.68,49012.23
2012-09-15,2012-09-15,Business insurance premium,REF54110658,125.99,0.0,48886.24
2012-09-20,2012-09-20,Internet and phone service,REF81901494,97.42,0.0,48788.82
2012-09-21,2012-09-21,Internet and phone service,REF53318606,125.04,0.0,48663.78
2012-09-24,2012-09-24,Equipment purchase,REF80864239,135.69,0.0,48528.09
2012-09-28,2012-09-28,Training/conference,REF10124216,126.22,0.0,48401.87
2012-09-30,2012-09-30,Internet and phone service,REF29663318,43.66,0.0,48358.21
2012-10-03,2012-10-03,Business travel,REF24819528,213.62,0.0,48144.59
2012-10-09,2012-10-09,Software subscription,REF35681234,181.32,0.0,47963.27
2012-10-11,2012-10-11,Equipment purchase,REF45034608,124.41,0.0,47838.86
2012-10-11,2012-10-11,Professional services,REF80707356,374.94,0.0,47463.92
2012-10-15,2012-10-15,Invoice payment - Jackson-Wilcox,REF21700218,0.0,1395.65,48859.57
2012-10-15,2012-10-15,Payment from Abbott-Harrison,REF92458881,0.0,1272.39,50131.96
2012-10-15,2012-10-15,Business insurance premium,REF92206768,142.22,0.0,49989.74
2012-10-15,2012-10-15,Invoice payment - Gordon PLC,REF65856004,0.0,1268.09,51257.83
2012-10-16,2012-10-16,Professional services,REF11683860,252.39,0.0,51005.44
2012-10-20,2012-10-20,Equipment purchase,REF90884569,148.77,0.0,50856.67
2012-10-28,2012-10-28,Internet and phone service,REF89770523,119.62,0.0,50737.05
2012-11-02,2012-11-02,Office supplies,REF86405601,30.39,0.0,50706.66
2012-11-03,2012-11-03,Equipment purchase,REF71997318,130.02,0.0,50576.64
2012-11-05,2012-11-05,Office supplies,REF66347733,62.99,0.0,50513.65
2012-11-08,2012-11-08,Office supplies,REF20306912,63.93,0.0,50449.72
2012-11-09,2012-11-09,Software subscription,REF13725024,163.61,0.0,50286.11
2012-11-12,2012-11-12,Office supplies,REF19397060,39.21,0.0,50246.9
2012-11-15,2012-11-15,Project payment - Abbott-Harrison,REF69180505,0.0,1516.12,51763.02
2012-11-15,2012-11-15,Business insurance premium,REF41755909,122.66,0.0,51640.36
2012-11-15,2012-11-15,Project payment - Jackson-Wilcox,REF52300270,0.0,1265.67,52906.03
2012-11-15,2012-11-15,Payment from Gordon PLC,REF94033022,0.0,1381.79,54287.82
2012-11-16,2012-11-16,Professional services,REF39276553,279.38,0.0,54008.44
2012-11-18,2012-11-18,Equipment purchase,REF65526225,160.71,0.0,53847.73
2012-11-19,2012-11-19,Business travel,REF39602391,85.37,0.0,53762.36
2012-11-19,2012-11-19,Training/conference,REF12585456,117.96,0.0,53644.4
2012-11-19,2012-11-19,Internet and phone service,REF49120698,71.29,0.0,53573.11
2012-11-20,2012-11-20,Marketing expenses,REF71402002,343.74,0.0,53229.37
2012-11-23,2012-11-23,Office supplies,REF24386891,70.6,0.0,53158.77
2012-11-24,2012-11-24,Business travel,REF88643934,146.79,0.0,53011.98
2012-11-25,2012-11-25,Office supplies,REF48888882,85.85,0.0,52926.13
2012-12-03,2012-12-03,Office supplies,REF88466867,65.89,0.0,52860.24
2012-12-06,2012-12-06,Office supplies,REF53500595,39.7,0.0,52820.54
2012-12-07,2012-12-07,Business travel,REF55859380,135.29,0.0,52685.25
2012-12-07,2012-12-07,Internet and phone service,REF25529469,79.08,0.0,52606.17
2012-12-09,2012-12-09,Software subscription,REF30370197,120.99,0.0,52485.18
2012-12-12,2012-12-12,Business travel,REF79970609,118.55,0.0,52366.63
2012-12-13,2012-12-13,Equipment purchase,REF11783951,51.52,0.0,52315.11
2012-12-14,2012-12-14,Equipment purchase,REF54301114,111.89,0.0,52203.22
2012-12-15,2012-12-15,Payment from Jackson-Wilcox,REF21722873,0.0,955.26,53158.48
2012-12-15,2012-12-15,Service payment - Abbott-Harrison,REF29430842,0.0,912.29,54070.77
2012-12-15,2012-12-15,Project payment - Gordon PLC,REF73937452,0.0,619.11,54689.88
2012-12-15,2012-12-15,Business insurance premium,REF90239414,106.01,0.0,54583.87
2012-12-18,2012-12-18,Professional services,REF87921727,284.31,0.0,54299.56
2012-12-28,2012-12-28,Office supplies,REF11057466,32.03,0.0,54267.53
2012-12-29,2012-12-29,Marketing expenses,REF67405255,128.1,0.0,54139.43
2013-01-06,2013-01-06,Internet and phone service,REF25430606,70.06,0.0,54069.37
2013-01-07,2013-01-07,Internet and phone service,REF91945887,61.97,0.0,54007.4
2013-01-09,2013-01-09,Equipment purchase,REF45647453,99.51,0.0,53907.89
2013-01-09,2013-01-09,Training/conference,REF21824178,95.49,0.0,53812.4
2013-01-09,2013-01-09,Software subscription,REF61364960,96.48,0.0,53715.92
2013-01-14,2013-01-14,Professional services,REF64678497,244.31,0.0,53471.61
2013-01-15,2013-01-15,Business insurance premium,REF39584225,90.96,0.0,53380.65
2013-01-15,2013-01-15,Invoice payment - Abbott-Harrison,REF83519067,0.0,933.13,54313.78
2013-01-15,2013-01-15,Project payment - Gordon PLC,REF84904786,0.0,899.32,55213.1
2013-01-15,2013-01-15,Project payment - Jackson-Wilcox,REF13979622,0.0,1165.28,56378.38
2013-01-18,2013-01-18,Office supplies,REF44453816,17.04,0.0,56361.34
2013-01-19,2013-01-19,Professional services,REF58621933,298.69,0.0,56062.65
2013-01-22,2013-01-22,Business travel,REF42258075,102.78,0.0,55959.87
2013-01-28,2013-01-28,Marketing expenses,REF34432347,241.41,0.0,55718.46
2013-01-29,2013-01-29,Professional services,REF27060657,167.47,0.0,55550.99
2013-02-02,2013-02-02,Marketing expenses,REF30595420,209.72,0.0,55341.27
2013-02-04,2013-02-04,Internet and phone service,REF57211065,57.6,0.0,55283.67
2013-02-05,2013-02-05,Professional services,REF72668894,279.64,0.0,55004.03
2013-02-05,2013-02-05,Training/conference,REF33508477,78.43,0.0,54925.6
2013-02-09,2013-02-09,Marketing expenses,REF76486706,113.12,0.0,54812.48
2013-02-09,2013-02-09,Software subscription,REF64448007,127.24,0.0,54685.24
2013-02-11,2013-02-11,Training/conference,REF74857842,74.71,0.0,54610.53
2013-02-12,2013-02-12,Office supplies,REF16533877,39.57,0.0,54570.96
2013-02-13,2013-02-13,Training/conference,REF71182256,97.55,0.0,54473.41
2013-02-15,2013-02-15,Payment from Gordon PLC,REF74721497,0.0,1124.97,55598.38
2013-02-15,2013-02-15,Internet and phone service,REF53696490,97.05,0.0,55501.33
2013-02-15,2013-02-15,Payment from Abbott-Harrison,REF64963067,0.0,1021.44,56522.77
2013-02-15,2013-02-15,Project payment - Jackson-Wilcox,REF15680500,0.0,1046.85,57569.62
2013-02-15,2013-02-15,Business insurance premium,REF94797108,103.96,0.0,57465.66
2013-02-17,2013-02-17,Training/conference,REF22468437,28.75,0.0,57436.91
2013-02-19,2013-02-19,Training/conference,REF33567161,66.94,0.0,57369.97
2013-02-20,2013-02-20,Training/conference,REF99346121,68.06,0.0,57301.91
2013-02-21,2013-02-21,Business travel,REF62328116,214.21,0.0,57087.7
2013-02-22,2013-02-22,Training/conference,REF13501015,102.72,0.0,56984.98
2013-02-23,2013-02-23,Internet and phone service,REF28883176,109.19,0.0,56875.79
2013-03-02,2013-03-02,Office supplies,REF52542671,58.11,0.0,56817.68
2013-03-09,2013-03-09,Software subscription,REF11461481,145.64,0.0,56672.04
2013-03-15,2013-03-15,Invoice payment - Jackson-Wilcox,REF36685289,0.0,1683.52,58355.56
2013-03-15,2013-03-15,Service payment - Gordon PLC,REF70685202,0.0,1172.97,59528.53
2013-03-15,2013-03-15,Invoice payment - Abbott-Harrison,REF27286882,0.0,1534.32,61062.85
2013-03-15,2013-03-15,Business insurance premium,REF19486144,125.73,0.0,60937.12
2013-03-18,2013-03-18,Office supplies,REF16788747,58.46,0.0,60878.66
2013-03-21,2013-03-21,Professional services,REF78510884,134.14,0.0,60744.52
2013-03-27,2013-03-27,Internet and phone service,REF10040548,66.83,0.0,60677.69
2013-03-31,2013-03-31,Office supplies,REF94395318,83.1,0.0,60594.59
2013-04-03,2013-04-03,Training/conference,REF37290740,96.96,0.0,60497.63
2013-04-04,2013-04-04,Professional services,REF57331315,209.37,0.0,60288.26
2013-04-06,2013-04-06,Business travel,REF27108528,146.17,0.0,60142.09
2013-04-09,2013-04-09,Software subscription,REF78989898,156.47,0.0,59985.62
2013-04-15,2013-04-15,Payment from Jackson-Wilcox,REF24654039,0.0,941.97,60927.59
2013-04-15,2013-04-15,Service payment - Abbott-Harrison,REF69582870,0.0,1198.12,62125.71
2013-04-15,2013-04-15,Service payment - Gordon PLC,REF35348484,0.0,1237.9,63363.61
2013-04-15,2013-04-15,Business insurance premium,REF81451891,128.56,0.0,63235.05
2013-04-17,2013-04-17,Office supplies,REF45313141,36.11,0.0,63198.94
2013-04-18,2013-04-18,Internet and phone service,REF24213824,98.83,0.0,63100.11
2013-04-29,2013-04-29,Office supplies,REF79393417,46.86,0.0,63053.25
2013-04-30,2013-04-30,Professional services,REF51276492,235.78,0.0,62817.47
2013-05-02,2013-05-02,Office supplies,REF78145120,50.23,0.0,62767.24
2013-05-07,2013-05-07,Marketing expenses,REF40818379,171.53,0.0,62595.71
2013-05-09,2013-05-09,Software subscription,REF33121316,162.65,0.0,62433.06
2013-05-09,2013-05-09,Professional services,REF95263965,322.02,0.0,62111.04
2013-05-15,2013-05-15,Business insurance premium,REF11577276,115.29,0.0,61995.75
2013-05-15,2013-05-15,Service payment - Abbott-Harrison,REF91669079,0.0,1164.18,63159.93
2013-05-15,2013-05-15,Payment from Gordon PLC,REF74645689,0.0,1841.15,65001.08
2013-05-15,2013-05-15,Payment from Jackson-Wilcox,REF98883456,0.0,1270.58,66271.66
2013-05-20,2013-05-20,Equipment purchase,REF16935173,53.81,0.0,66217.85
2013-05-20,2013-05-20,Internet and phone service,REF77684843,56.73,0.0,66161.12
2013-05-20,2013-05-20,Business travel,REF53202193,212.85,0.0,65948.27
2013-05-26,2013-05-26,Professional services,REF99175094,275.87,0.0,65672.4
2013-05-28,2013-05-28,Training/conference,REF95457052,139.93,0.0,65532.47
2013-05-29,2013-05-29,Training/conference,REF14697898,91.57,0.0,65440.9
2013-05-30,2013-05-30,Internet and phone service,REF35766993,56.79,0.0,65384.11
2013-05-31,2013-05-31,Business travel,REF69907845,105.2,0.0,65278.91
2013-05-31,2013-05-31,Marketing expenses,REF55746077,178.28,0.0,65100.63
2013-06-01,2013-06-01,Office supplies,REF32386292,38.85,0.0,65061.78
2013-06-04,2013-06-04,Office supplies,REF58696124,45.24,0.0,65016.54
2013-06-05,2013-06-05,Office supplies,REF46670785,37.78,0.0,64978.76
2013-06-08,2013-06-08,Office supplies,REF75531887,43.72,0.0,64935.04
2013-06-09,2013-06-09,Software subscription,REF17879705,147.7,0.0,64787.34
2013-06-10,2013-06-10,Professional services,REF25049872,220.28,0.0,64567.06
2013-06-12,2013-06-12,Office supplies,REF91183373,45.36,0.0,64521.7
2013-06-13,2013-06-13,Business travel,REF83269937,85.79,0.0,64435.91
2013-06-15,2013-06-15,Invoice payment - Gordon PLC,REF38924878,0.0,1116.76,65552.67
2013-06-15,2013-06-15,Payment from Abbott-Harrison,REF98592480,0.0,776.47,66329.14
2013-06-15,2013-06-15,Service payment - Jackson-Wilcox,REF22553156,0.0,1016.21,67345.35
2013-06-15,2013-06-15,Business insurance premium,REF18757950,110.83,0.0,67234.52
2013-06-22,2013-06-22,Marketing expenses,REF63217916,240.4,0.0,66994.12
2013-06-24,2013-06-24,Professional services,REF87177643,174.48,0.0,66819.64
2013-06-25,2013-06-25,Professional services,REF43380192,303.81,0.0,66515.83
2013-06-28,2013-06-28,Business travel,REF74582197,139.35,0.0,66376.48
2013-07-02,2013-07-02,Internet and phone service,REF40744161,64.7,0.0,66311.78
2013-07-09,2013-07-09,Business travel,REF15117335,96.29,0.0,66215.49
2013-07-09,2013-07-09,Software subscription,REF73968281,96.35,0.0,66119.14
2013-07-15,2013-07-15,Business insurance premium,REF88620346,95.65,0.0,66023.49
2013-07-15,2013-07-15,Payment from Jackson-Wilcox,REF50622834,0.0,1144.65,67168.14
2013-07-15,2013-07-15,Service payment - Gordon PLC,REF76798925,0.0,1145.41,68313.55
2013-07-15,2013-07-15,Project payment - Abbott-Harrison,REF39333667,0.0,807.62,69121.17
2013-07-16,2013-07-16,Office supplies,REF37818448,42.91,0.0,69078.26
2013-07-21,2013-07-21,Professional services,REF21696118,121.84,0.0,68956.42
2013-07-23,2013-07-23,Internet and phone service,REF39821403,95.01,0.0,68861.41
2013-07-24,2013-07-24,Equipment purchase,REF99149769,57.02,0.0,68804.39
2013-08-01,2013-08-01,Business travel,REF72890591,89.93,0.0,68714.46
2013-08-03,2013-08-03,Training/conference,REF82485365,44.56,0.0,68669.9
2013-08-05,2013-08-05,Equipment purchase,REF17260785,118.79,0.0,68551.11
2013-08-07,2013-08-07,Professional services,REF85684825,149.24,0.0,68401.87
2013-08-07,2013-08-07,Office supplies,REF48633222,40.85,0.0,68361.02
2013-08-07,2013-08-07,Internet and phone service,REF92324990,55.23,0.0,68305.79
2013-08-09,2013-08-09,Software subscription,REF31094200,106.45,0.0,68199.34
2013-08-09,2013-08-09,Internet and phone service,REF19202949,79.02,0.0,68120.32
2013-08-10,2013-08-10,Office supplies,REF84528830,46.03,0.0,68074.29
2013-08-15,2013-08-15,Payment from Gordon PLC,REF16926336,0.0,738.75,68813.04
2013-08-15,2013-08-15,Service payment - Abbott-Harrison,REF16625871,0.0,901.0,69714.04
2013-08-15,2013-08-15,Business insurance premium,REF11636634,86.65,0.0,69627.39
2013-08-21,2013-08-21,Business travel,REF57957856,75.24,0.0,69552.15
2013-08-24,2013-08-24,Internet and phone service,REF12079802,71.82,0.0,69480.33
2013-08-25,2013-08-25,Office supplies,REF61972228,38.13,0.0,69442.2
2013-08-31,2013-08-31,Business travel,REF18029246,119.18,0.0,69323.02
2013-09-03,2013-09-03,Equipment purchase,REF43846032,130.55,0.0,69192.47
2013-09-04,2013-09-04,Training/conference,REF19252882,154.55,0.0,69037.92
2013-09-09,2013-09-09,Software subscription,REF33174189,155.82,0.0,68882.1
2013-09-10,2013-09-10,Office supplies,REF18653640,37.44,0.0,68844.66
2013-09-10,2013-09-10,Business travel,REF97470808,132.24,0.0,68712.42
2013-09-11,2013-09-11,Office supplies,REF96084934,65.25,0.0,68647.17
2013-09-13,2013-09-13,Equipment purchase,REF65818590,88.63,0.0,68558.54
2013-09-15,2013-09-15,Project payment - Gordon PLC,REF68374535,0.0,1535.9,70094.44
2013-09-15,2013-09-15,Business insurance premium,REF31388744,132.99,0.0,69961.45
2013-09-17,2013-09-17,Business travel,REF72573556,94.61,0.0,69866.84
2013-09-18,2013-09-18,Office supplies,REF48186804,66.46,0.0,69800.38
2013-09-24,2013-09-24,Professional services,REF76704348,174.61,0.0,69625.77
2013-09-25,2013-09-25,Marketing expenses,REF20595242,99.37,0.0,69526.4
2013-10-02,2013-10-02,Office supplies,REF88161608,82.37,0.0,69444.03
2013-10-08,2013-10-08,Business travel,REF52519351,120.82,0.0,69323.21
2013-10-09,2013-10-09,Software subscription,REF13662268,168.87,0.0,69154.34
2013-10-11,2013-10-11,Business travel,REF67630593,133.56,0.0,69020.78
2013-10-13,2013-10-13,Professional services,REF64597810,130.99,0.0,68889.79
2013-10-15,2013-10-15,Payment from Jackson-Wilcox,REF77212361,0.0,1716.7,70606.49
2013-10-15,2013-10-15,Project payment - Gordon PLC,REF26532429,0.0,962.26,71568.75
2013-10-15,2013-10-15,Business insurance premium,REF35190158,149.38,0.0,71419.37
2013-10-15,2013-10-15,Service payment - Abbott-Harrison,REF91928171,0.0,1450.42,72869.79
2013-10-16,2013-10-16,Office supplies,REF47962723,82.58,0.0,72787.21
2013-10-17,2013-10-17,Internet and phone service,REF75041440,84.82,0.0,72702.39
2013-10-18,2013-10-18,Internet and phone service,REF98866645,71.88,0.0,72630.51
2013-10-25,2013-10-25,Marketing expenses,REF18291043,264.89,0.0,72365.62
2013-10-31,2013-10-31,Internet and phone service,REF95630375,71.35,0.0,72294.27
2013-11-01,2013-11-01,Internet and phone service,REF79373549,107.92,0.0,72186.35
2013-11-03,2013-11-03,Marketing expenses,REF96774218,187.16,0.0,71999.19
2013-11-09,2013-11-09,Software subscription,REF38672709,158.65,0.0,71840.54
2013-11-09,2013-11-09,Equipment purchase,REF94843766,106.64,0.0,71733.9
2013-11-11,2013-11-11,Office supplies,REF33706275,82.63,0.0,71651.27
2013-11-12,2013-11-12,Equipment purchase,REF95072460,135.8,0.0,71515.47
2013-11-13,2013-11-13,Office supplies,REF16347819,51.03,0.0,71464.44
2013-11-14,2013-11-14,Training/conference,REF19138314,138.96,0.0,71325.48
2013-11-15,2013-11-15,Business insurance premium,REF35755042,135.09,0.0,71190.39
2013-11-15,2013-11-15,Payment from Gordon PLC,REF49426341,0.0,1636.11,72826.5
2013-11-16,2013-11-16,Office supplies,REF44092620,57.51,0.0,72768.99
2013-11-21,2013-11-21,Office supplies,REF99369532,46.59,0.0,72722.4
2013-11-23,2013-11-23,Office supplies,REF80072438,77.69,0.0,72644.71
2013-11-29,2013-11-29,Office supplies,REF37554317,41.14,0.0,72603.57
2013-12-03,2013-12-03,Equipment purchase,REF85567879,91.39,0.0,72512.18
2013-12-09,2013-12-09,Software subscription,REF80734802,120.86,0.0,72391.32
2013-12-13,2013-12-13,Internet and phone service,REF33139468,124.73,0.0,72266.59
2013-12-14,2013-12-14,Training/conference,REF29346938,152.02,0.0,72114.57
2013-12-15,2013-12-15,Invoice payment - Gordon PLC,REF64728680,0.0,1247.89,73362.46
2013-12-15,2013-12-15,Payment from Jackson-Wilcox,REF76573441,0.0,948.44,74310.9
2013-12-15,2013-12-15,Business insurance premium,REF93868604,109.67,0.0,74201.23
2013-12-20,2013-12-20,Professional services,REF17436756,310.66,0.0,73890.57
2013-12-22,2013-12-22,Marketing expenses,REF85204717,171.77,0.0,73718.8
2013-12-27,2013-12-27,Internet and phone service,REF74004426,73.92,0.0,73644.88
2013-12-30,2013-12-30,Training/conference,REF99195853,121.6,0.0,73523.28
2013-12-31,2013-12-31,Professional services,REF18463473,151.35,0.0,73371.93
2014-01-01,2014-01-01,Office supplies,REF55058529,40.79,0.0,73331.14
2014-01-02,2014-01-02,Office supplies,REF56709238,53.8,0.0,73277.34
2014-01-06,2014-01-06,Office supplies,REF17039031,46.72,0.0,73230.62
2014-01-09,2014-01-09,Software subscription,REF95636707,137.89,0.0,73092.73
2014-01-15,2014-01-15,Professional services,REF56030550,108.14,0.0,72984.59
2014-01-15,2014-01-15,Service payment - Gordon PLC,REF61654891,0.0,1129.22,74113.81
2014-01-15,2014-01-15,Project payment - Jackson-Wilcox,REF81170799,0.0,905.85,75019.66
2014-01-15,2014-01-15,Business insurance premium,REF99528715,94.62,0.0,74925.04
2014-01-15,2014-01-15,Payment from Abbott-Harrison,REF47152078,0.0,978.44,75903.48
2014-01-16,2014-01-16,Training/conference,REF40700576,109.8,0.0,75793.68
2014-01-22,2014-01-22,Office supplies,REF84688088,38.19,0.0,75755.49
2014-01-28,2014-01-28,Office supplies,REF74158685,28.14,0.0,75727.35
2014-01-29,2014-01-29,Training/conference,REF66664997,48.21,0.0,75679.14
2014-01-29,2014-01-29,Office supplies,REF30909440,43.16,0.0,75635.98
2014-02-04,2014-02-04,Internet and phone service,REF10214192,70.91,0.0,75565.07
2014-02-09,2014-02-09,Software subscription,REF21315237,122.96,0.0,75442.11
2014-02-12,2014-02-12,Professional services,REF57527892,159.63,0.0,75282.48
2014-02-14,2014-02-14,Equipment purchase,REF90749172,46.69,0.0,75235.79
2014-02-15,2014-02-15,Project payment - Jackson-Wilcox,REF21768294,0.0,1103.5,76339.29
2014-02-15,2014-02-15,Business insurance premium,REF94936353,100.91,0.0,76238.38
2014-02-15,2014-02-15,Service payment - Gordon PLC,REF94064810,0.0,1041.6,77279.98
2014-02-15,2014-02-15,Service payment - Abbott-Harrison,REF78983997,0.0,1038.97,78318.95
2014-02-17,2014-02-17,Professional services,REF71931320,280.96,0.0,78037.99
2014-02-20,2014-02-20,Internet and phone service,REF17192866,74.55,0.0,77963.44
2014-03-02,2014-03-02,Office supplies,REF28435494,54.16,0.0,77909.28
2014-03-06,2014-03-06,Marketing expenses,REF97194678,258.12,0.0,77651.16
2014-03-07,2014-03-07,Internet and phone service,REF97760437,107.2,0.0,77543.96
2014-03-09,2014-03-09,Software subscription,REF26134009,153.65,0.0,77390.31
2014-03-10,2014-03-10,Office supplies,REF54013918,58.64,0.0,77331.67
2014-03-11,2014-03-11,Professional services,REF31680409,321.47,0.0,77010.2
2014-03-13,2014-03-13,Internet and phone service,REF82260800,68.86,0.0,76941.34
2014-03-15,2014-03-15,Business insurance premium,REF66006379,124.72,0.0,76816.62
2014-03-15,2014-03-15,Payment from Jackson-Wilcox,REF99776343,0.0,1114.82,77931.44
2014-03-15,2014-03-15,Invoice payment - Gordon PLC,REF53986160,0.0,1356.06,79287.5
2014-03-15,2014-03-15,Service payment - Abbott-Harrison,REF17764242,0.0,977.25,80264.75
2014-03-18,2014-03-18,Office supplies,REF90484152,44.46,0.0,80220.29
2014-03-20,2014-03-20,Internet and phone service,REF48793821,105.98,0.0,80114.31
2014-03-22,2014-03-22,Business travel,REF85877311,209.94,0.0,79904.37
2014-03-24,2014-03-24,Equipment purchase,REF27891199,189.41,0.0,79714.96
2014-03-27,2014-03-27,Training/conference,REF45733054,91.99,0.0,79622.97
2014-03-30,2014-03-30,Equipment purchase,REF47158713,61.72,0.0,79561.25
2014-04-04,2014-04-04,Office supplies,REF85813480,69.04,0.0,79492.21
2014-04-06,2014-04-06,Professional services,REF25263320,172.08,0.0,79320.13
2014-04-06,2014-04-06,Internet and phone service,REF89390618,84.97,0.0,79235.16
2014-04-08,2014-04-08,Internet and phone service,REF11092137,45.57,0.0,79189.59
2014-04-09,2014-04-09,Software subscription,REF43006299,166.22,0.0,79023.37
2014-04-10,2014-04-10,Business travel,REF17067423,110.81,0.0,78912.56
2014-04-11,2014-04-11,Equipment purchase,REF38103009,77.57,0.0,78834.99
2014-04-11,2014-04-11,Marketing expenses,REF23127023,163.95,0.0,78671.04
2014-04-13,2014-04-13,Training/conference,REF47381005,143.58,0.0,78527.46
2014-04-14,2014-04-14,Professional services,REF14122035,127.71,0.0,78399.75
2014-04-14,2014-04-14,Equipment purchase,REF46129019,80.36,0.0,78319.39
2014-04-15,2014-04-15,Business insurance premium,REF37351865,122.25,0.0,78197.14
2014-04-15,2014-04-15,Service payment - Abbott-Harrison,REF34575478,0.0,1095.41,79292.55
2014-04-15,2014-04-15,Payment from Gordon PLC,REF44835539,0.0,1131.66,80424.21
2014-04-15,2014-04-15,Service payment - Jackson-Wilcox,REF62838729,0.0,1265.5,81689.71
2014-04-15,2014-04-15,Office supplies,REF19339943,28.36,0.0,81661.35
2014-04-15,2014-04-15,Internet and phone service,REF77063857,103.96,0.0,81557.39
2014-04-17,2014-04-17,Equipment purchase,REF38161068,138.04,0.0,81419.35
2014-04-18,2014-04-18,Marketing expenses,REF34359667,148.69,0.0,81270.66
2014-04-21,2014-04-21,Training/conference,REF81266546,63.31,0.0,81207.35
2014-04-24,2014-04-24,Professional services,REF60110498,268.15,0.0,80939.2
2014-04-27,2014-04-27,Professional services,REF26639599,179.36,0.0,80759.84
2014-04-27,2014-04-27,Marketing expenses,REF51702694,124.96,0.0,80634.88
2014-05-07,2014-05-07,Equipment purchase,REF52237244,15.57,0.0,80619.31
2014-05-08,2014-05-08,Office supplies,REF20988209,33.41,0.0,80585.9
2014-05-08,2014-05-08,Marketing expenses,REF97812999,215.26,0.0,80370.64
2014-05-09,2014-05-09,Software subscription,REF83517133,140.83,0.0,80229.81
2014-05-09,2014-05-09,Internet and phone service,REF31662716,45.42,0.0,80184.39
2014-05-10,2014-05-10,Marketing expenses,REF49044867,198.0,0.0,79986.39
2014-05-11,2014-05-11,Internet and phone service,REF54889311,103.86,0.0,79882.53
2014-05-14,2014-05-14,Office supplies,REF32768258,49.76,0.0,79832.77
2014-05-15,2014-05-15,Service payment - Gordon PLC,REF23293415,0.0,1294.9,81127.67
2014-05-15,2014-05-15,Business insurance premium,REF37370135,118.52,0.0,81009.15
2014-05-16,2014-05-16,Training/conference,REF85034540,75.74,0.0,80933.41
2014-05-17,2014-05-17,Training/conference,REF71164361,113.84,0.0,80819.57
2014-05-18,2014-05-18,Marketing expenses,REF85511340,149.16,0.0,80670.41
2014-05-19,2014-05-19,Equipment purchase,REF26584303,113.88,0.0,80556.53
2014-05-23,2014-05-23,Office supplies,REF47298008,63.54,0.0,80492.99
2014-05-28,2014-05-28,Internet and phone service,REF79003741,93.08,0.0,80399.91
2014-05-29,2014-05-29,Professional services,REF47794193,294.22,0.0,80105.69
2014-06-02,2014-06-02,Office supplies,REF56184206,41.16,0.0,80064.53
2014-06-03,2014-06-03,Business travel,REF56232621,109.63,0.0,79954.9
2014-06-08,2014-06-08,Internet and phone service,REF37938039,97.08,0.0,79857.82
2014-06-09,2014-06-09,Software subscription,REF84387937,148.76,0.0,79709.06
2014-06-10,2014-06-10,Internet and phone service,REF95421514,51.42,0.0,79657.64
2014-06-11,2014-06-11,Office supplies,REF13765246,23.51,0.0,79634.13
2014-06-15,2014-06-15,Project payment - Jackson-Wilcox,REF75877609,0.0,1017.04,80651.17
2014-06-15,2014-06-15,Marketing expenses,REF75658706,177.87,0.0,80473.3
2014-06-15,2014-06-15,Business insurance premium,REF70055506,96.29,0.0,80377.01
2014-06-15,2014-06-15,Service payment - Gordon PLC,REF75247956,0.0,1404.84,81781.85
2014-06-23,2014-06-23,Marketing expenses,REF73579415,119.58,0.0,81662.27
2014-06-25,2014-06-25,Marketing expenses,REF44910050,86.45,0.0,81575.82
2014-06-27,2014-06-27,Business travel,REF16063993,170.43,0.0,81405.39
2014-07-01,2014-07-01,Marketing expenses,REF55984458,170.55,0.0,81234.84
2014-07-04,2014-07-04,Business travel,REF45475371,193.56,0.0,81041.28
2014-07-04,2014-07-04,Internet and phone service,REF63422527,42.0,0.0,80999.28
2014-07-07,2014-07-07,Business travel,REF73571850,115.02,0.0,80884.26
2014-07-08,2014-07-08,Office supplies,REF14756629,41.3,0.0,80842.96
2014-07-09,2014-07-09,Software subscription,REF12082909,106.81,0.0,80736.15
2014-07-15,2014-07-15,Professional services,REF45151267,227.48,0.0,80508.67
2014-07-15,2014-07-15,Business insurance premium,REF28367930,100.04,0.0,80408.63
2014-07-15,2014-07-15,Payment from Abbott-Harrison,REF19974432,0.0,1003.78,81412.41
2014-07-15,2014-07-15,Project payment - Jackson-Wilcox,REF79121278,0.0,1066.13,82478.54
2014-07-15,2014-07-15,Invoice payment - Gordon PLC,REF41597725,0.0,1116.83,83595.37
2014-07-17,2014-07-17,Professional services,REF97771132,197.3,0.0,83398.07
2014-07-20,2014-07-20,Marketing expenses,REF46364378,105.26,0.0,83292.81
2014-07-21,2014-07-21,Office supplies,REF52651554,42.15,0.0,83250.66
2014-07-23,2014-07-23,Marketing expenses,REF48907268,124.39,0.0,83126.27
2014-07-24,2014-07-24,Internet and phone service,REF94306113,43.92,0.0,83082.35
2014-07-29,2014-07-29,Business travel,REF14955143,117.63,0.0,82964.72
2014-08-02,2014-08-02,Professional services,REF25973458,158.44,0.0,82806.28
2014-08-09,2014-08-09,Software subscription,REF10449524,117.07,0.0,82689.21
2014-08-15,2014-08-15,Business insurance premium,REF98689575,88.34,0.0,82600.87
2014-08-15,2014-08-15,Service payment - Jackson-Wilcox,REF91767445,0.0,876.56,83477.43
2014-08-15,2014-08-15,Project payment - Gordon PLC,REF65615669,0.0,1015.47,84492.9
2014-08-19,2014-08-19,Office supplies,REF40141971,25.11,0.0,84467.79
2014-08-30,2014-08-30,Office supplies,REF69816120,35.27,0.0,84432.52
2014-09-01,2014-09-01,Office supplies,REF47790628,62.4,0.0,84370.12
2014-09-03,2014-09-03,Internet and phone service,REF28608169,110.88,0.0,84259.24
2014-09-06,2014-09-06,Marketing expenses,REF77111402,143.47,0.0,84115.77
2014-09-09,2014-09-09,Office supplies,REF53012007,54.43,0.0,84061.34
2014-09-09,2014-09-09,Software subscription,REF40406829,144.67,0.0,83916.67
2014-09-15,2014-09-15,Professional services,REF52712730,244.07,0.0,83672.6
2014-09-15,2014-09-15,Service payment - Abbott-Harrison,REF28781010,0.0,1656.15,85328.75
2014-09-15,2014-09-15,Business insurance premium,REF15575512,136.22,0.0,85192.53
2014-09-15,2014-09-15,Service payment - Gordon PLC,REF53057317,0.0,1394.19,86586.72
2014-09-15,2014-09-15,Service payment - Jackson-Wilcox,REF13612889,0.0,1198.39,87785.11
2014-09-21,2014-09-21,Marketing expenses,REF11978519,205.88,0.0,87579.23
2014-09-22,2014-09-22,Office supplies,REF94155268,53.55,0.0,87525.68
2014-09-27,2014-09-27,Office supplies,REF80659450,79.52,0.0,87446.16
2014-10-02,2014-10-02,Equipment purchase,REF48497836,186.21,0.0,87259.95
2014-10-06,2014-10-06,Marketing expenses,REF35902256,265.62,0.0,86994.33
2014-10-09,2014-10-09,Software subscription,REF16929471,177.93,0.0,86816.4
2014-10-11,2014-10-11,Marketing expenses,REF63426986,78.21,0.0,86738.19
2014-10-15,2014-10-15,Service payment - Gordon PLC,REF38179684,0.0,1594.76,88332.95
2014-10-15,2014-10-15,Service payment - Jackson-Wilcox,REF32725875,0.0,1593.43,89926.38
2014-10-15,2014-10-15,Invoice payment - Abbott-Harrison,REF94954702,0.0,1699.24,91625.62
2014-10-15,2014-10-15,Business insurance premium,REF72152544,156.66,0.0,91468.96
2014-10-18,2014-10-18,Business travel,REF60772940,281.39,0.0,91187.57
2014-10-18,2014-10-18,Office supplies,REF43185019,70.78,0.0,91116.79
2014-10-20,2014-10-20,Marketing expenses,REF46394778,176.9,0.0,90939.89
2014-10-23,2014-10-23,Business travel,REF41688754,173.01,0.0,90766.88
2014-10-23,2014-10-23,Office supplies,REF41518008,42.83,0.0,90724.05
2014-10-26,2014-10-26,Professional services,REF93559520,228.8,0.0,90495.25
2014-10-26,2014-10-26,Office supplies,REF81111443,48.56,0.0,90446.69
2014-10-28,2014-10-28,Internet and phone service,REF15235908,104.79,0.0,90341.9
2014-10-28,2014-10-28,Office supplies,REF16022158,64.83,0.0,90277.07
2014-10-28,2014-10-28,Marketing expenses,REF28817199,115.94,0.0,90161.13
2014-10-29,2014-10-29,Business travel,REF96497544,229.13,0.0,89932.0
2014-10-30,2014-10-30,Equipment purchase,REF52966112,72.71,0.0,89859.29
2014-10-31,2014-10-31,Professional services,REF77400919,134.86,0.0,89724.43
2014-11-01,2014-11-01,Office supplies,REF28778936,23.01,0.0,89701.42
2014-11-02,2014-11-02,Professional services,REF14410591,371.7,0.0,89329.72
2014-11-09,2014-11-09,Software subscription,REF42451528,141.19,0.0,89188.53
2014-11-10,2014-11-10,Professional services,REF40190831,377.88,0.0,88810.65
2014-11-12,2014-11-12,Marketing expenses,REF36504453,158.32,0.0,88652.33
2014-11-15,2014-11-15,Payment from Abbott-Harrison,REF14089481,0.0,1033.65,89685.98
2014-11-15,2014-11-15,Payment from Gordon PLC,REF22797509,0.0,1532.98,91218.96
2014-11-15,2014-11-15,Project payment - Jackson-Wilcox,REF53900695,0.0,1411.0,92629.96
2014-11-15,2014-11-15,Business insurance premium,REF64548119,133.38,0.0,92496.58
2014-11-17,2014-11-17,Business travel,REF62954338,146.09,0.0,92350.49
2014-11-29,2014-11-29,Office supplies,REF72173822,57.39,0.0,92293.1
2014-11-30,2014-11-30,Professional services,REF89213883,290.07,0.0,92003.03
2014-12-02,2014-12-02,Marketing expenses,REF85974233,198.87,0.0,91804.16
2014-12-05,2014-12-05,Equipment purchase,REF30276212,114.84,0.0,91689.32
2014-12-09,2014-12-09,Software subscription,REF52511287,139.97,0.0,91549.35
2014-12-10,2014-12-10,Training/conference,REF12484077,73.05,0.0,91476.3
2014-12-10,2014-12-10,Office supplies,REF35819270,41.72,0.0,91434.58
2014-12-12,2014-12-12,Business travel,REF65306579,128.88,0.0,91305.7
2014-12-13,2014-12-13,Business travel,REF24408259,110.37,0.0,91195.33
2014-12-14,2014-12-14,Professional services,REF37617419,127.75,0.0,91067.58
2014-12-15,2014-12-15,Service payment - Abbott-Harrison,REF11024853,0.0,1175.36,92242.94
2014-12-15,2014-12-15,Business insurance premium,REF32910724,114.72,0.0,92128.22
2014-12-15,2014-12-15,Service payment - Jackson-Wilcox,REF52971146,0.0,1252.35,93380.57
2014-12-16,2014-12-16,Professional services,REF23822181,362.64,0.0,93017.93
2014-12-16,2014-12-16,Marketing expenses,REF83063989,216.67,0.0,92801.26
2014-12-18,2014-12-18,Office supplies,REF98598736,58.55,0.0,92742.71
2014-12-22,2014-12-22,Training/conference,REF43465656,33.88,0.0,92708.83
2014-12-29,2014-12-29,Training/conference,REF81784710,112.41,0.0,92596.42
2014-12-31,2014-12-31,Business travel,REF63738906,144.44,0.0,92451.98
2015-01-09,2015-01-09,Software subscription,REF75310114,137.46,0.0,92314.52
2015-01-11,2015-01-11,Office supplies,REF88301450,31.49,0.0,92283.03
2015-01-12,2015-01-12,Business travel,REF55569219,89.66,0.0,92193.37
2015-01-14,2015-01-14,Business travel,REF13861306,152.84,0.0,92040.53
2015-01-15,2015-01-15,Office supplies,REF16068735,33.98,0.0,92006.55
2015-01-15,2015-01-15,Payment from Jackson-Wilcox,REF21125695,0.0,1096.76,93103.31
2015-01-15,2015-01-15,Business insurance premium,REF26294229,97.77,0.0,93005.54
2015-01-15,2015-01-15,Payment from Abbott-Harrison,REF56991837,0.0,943.89,93949.43
2015-01-16,2015-01-16,Equipment purchase,REF77595750,59.32,0.0,93890.11
2015-01-18,2015-01-18,Office supplies,REF72874144,46.35,0.0,93843.76
2015-01-22,2015-01-22,Training/conference,REF14583412,87.82,0.0,93755.94
2015-01-24,2015-01-24,Office supplies,REF20915300,47.44,0.0,93708.5
2015-01-26,2015-01-26,Professional services,REF72122674,172.63,0.0,93535.87
2015-01-26,2015-01-26,Office supplies,REF33193033,18.19,0.0,93517.68
2015-01-27,2015-01-27,Equipment purchase,REF18422114,77.58,0.0,93440.1
2015-01-29,2015-01-29,Office supplies,REF67131554,21.37,0.0,93418.73
2015-01-30,2015-01-30,Marketing expenses,REF74121993,182.95,0.0,93235.78
2015-02-01,2015-02-01,Marketing expenses,REF72013091,152.9,0.0,93082.88
2015-02-06,2015-02-06,Office supplies,REF39463372,46.92,0.0,93035.96
2015-02-09,2015-02-09,Software subscription,REF76876988,127.15,0.0,92908.81
2015-02-11,2015-02-11,Business travel,REF77031279,89.15,0.0,92819.66
2015-02-11,2015-02-11,Office supplies,REF49015159,36.23,0.0,92783.43
2015-02-13,2015-02-13,Office supplies,REF95052318,41.52,0.0,92741.91
2015-02-15,2015-02-15,Business insurance premium,REF37955133,103.38,0.0,92638.53
2015-02-15,2015-02-15,Service payment - Jackson-Wilcox,REF38811346,0.0,1154.0,93792.53
2015-02-15,2015-02-15,Payment from Gordon PLC,REF19872655,0.0,840.18,94632.71
2015-02-15,2015-02-15,Project payment - Abbott-Harrison,REF50604344,0.0,1315.48,95948.19
2015-02-18,2015-02-18,Equipment purchase,REF13757635,75.13,0.0,95873.06
2015-02-20,2015-02-20,Office supplies,REF66691745,39.24,0.0,95833.82
2015-02-23,2015-02-23,Office supplies,REF26931992,42.29,0.0,95791.53
2015-02-23,2015-02-23,Training/conference,REF38228759,121.98,0.0,95669.55
2015-03-01,2015-03-01,Business travel,REF59035080,204.9,0.0,95464.65
2015-03-09,2015-03-09,Software subscription,REF48133373,195.82,0.0,95268.83
2015-03-09,2015-03-09,Professional services,REF88334740,231.41,0.0,95037.42
2015-03-11,2015-03-11,Training/conference,REF62881331,128.67,0.0,94908.75
2015-03-12,2015-03-12,Office supplies,REF19748517,55.03,0.0,94853.72
2015-03-13,2015-03-13,Internet and phone service,REF50049687,92.97,0.0,94760.75
2015-03-15,2015-03-15,Business insurance premium,REF72394806,130.67,0.0,94630.08
2015-03-15,2015-03-15,Project payment - Gordon PLC,REF39121667,0.0,1257.99,95888.07
2015-03-15,2015-03-15,Invoice payment - Abbott-Harrison,REF15270000,0.0,1278.06,97166.13
2015-04-02,2015-04-02,Office supplies,REF88171806,50.16,0.0,97115.97
2015-04-07,2015-04-07,Office supplies,REF85136772,19.37,0.0,97096.6
2015-04-09,2015-04-09,Software subscription,REF32829991,141.3,0.0,96955.3
2015-04-10,2015-04-10,Marketing expenses,REF25643892,306.96,0.0,96648.34
2015-04-12,2015-04-12,Marketing expenses,REF85913841,190.91,0.0,96457.43
2015-04-13,2015-04-13,Office supplies,REF72248658,35.48,0.0,96421.95
2015-04-15,2015-04-15,Project payment - Jackson-Wilcox,REF83987403,0.0,1431.72,97853.67
2015-04-15,2015-04-15,Service payment - Gordon PLC,REF10454840,0.0,1218.59,99072.26
2015-04-15,2015-04-15,Invoice payment - Abbott-Harrison,REF99181301,0.0,1329.74,100402.0
2015-04-15,2015-04-15,Business insurance premium,REF20430704,124.46,0.0,100277.54
2015-04-23,2015-04-23,Internet and phone service,REF72719498,137.27,0.0,100140.27
2015-04-26,2015-04-26,Business travel,REF89940555,77.92,0.0,100062.35
2015-04-27,2015-04-27,Office supplies,REF81258364,44.18,0.0,100018.17
2015-05-05,2015-05-05,Professional services,REF84439720,233.03,0.0,99785.14
2015-05-06,2015-05-06,Office supplies,REF42413077,70.12,0.0,99715.02
2015-05-09,2015-05-09,Software subscription,REF53548878,137.64,0.0,99577.38
2015-05-15,2015-05-15,Business insurance premium,REF60851986,124.42,0.0,99452.96
2015-05-15,2015-05-15,Service payment - Abbott-Harrison,REF68970723,0.0,969.34,100422.3
2015-05-15,2015-05-15,Service payment - Gordon PLC,REF75075323,0.0,1414.09,101836.39
2015-05-15,2015-05-15,Project payment - Jackson-Wilcox,REF44109984,0.0,1164.47,103000.86
2015-05-24,2015-05-24,Business travel,REF43808749,154.78,0.0,102846.08
2015-05-25,2015-05-25,Business travel,REF36320531,60.67,0.0,102785.41
2015-06-07,2015-06-07,Office supplies,REF11022443,57.51,0.0,102727.9
2015-06-09,2015-06-09,Software subscription,REF63258507,149.64,0.0,102578.26
2015-06-14,2015-06-14,Equipment purchase,REF55462287,88.06,0.0,102490.2
2015-06-15,2015-06-15,Service payment - Gordon PLC,REF45805105,0.0,1103.61,103593.81
2015-06-15,2015-06-15,Project payment - Jackson-Wilcox,REF64041089,0.0,902.32,104496.13
2015-06-15,2015-06-15,Invoice payment - Abbott-Harrison,REF40814011,0.0,725.41,105221.54
2015-06-15,2015-06-15,Business insurance premium,REF92946312,105.97,0.0,105115.57
2015-06-22,2015-06-22,Office supplies,REF93099610,42.37,0.0,105073.2
2015-06-25,2015-06-25,Office supplies,REF96290812,29.92,0.0,105043.28
2015-06-26,2015-06-26,Office supplies,REF96625301,28.79,0.0,105014.49
2015-06-27,2015-06-27,Office supplies,REF99546849,46.92,0.0,104967.57
2015-07-01,2015-07-01,Office supplies,REF32578359,47.62,0.0,104919.95
2015-07-05,2015-07-05,Professional services,REF13686763,255.64,0.0,104664.31
2015-07-07,2015-07-07,Equipment purchase,REF68985530,86.05,0.0,104578.26
2015-07-09,2015-07-09,Software subscription,REF50410797,129.6,0.0,104448.66
2015-07-13,2015-07-13,Internet and phone service,REF81753093,58.63,0.0,104390.03
2015-07-15,2015-07-15,Marketing expenses,REF81585422,140.51,0.0,104249.52
2015-07-15,2015-07-15,Service payment - Abbott-Harrison,REF11775376,0.0,959.87,105209.39
2015-07-15,2015-07-15,Invoice payment - Gordon PLC,REF55433288,0.0,1131.35,106340.74
2015-07-15,2015-07-15,Office supplies,REF43821358,60.09,0.0,106280.65
2015-07-15,2015-07-15,Service payment - Jackson-Wilcox,REF27071552,0.0,998.65,107279.3
2015-07-15,2015-07-15,Internet and phone service,REF32230511,34.55,0.0,107244.75
2015-07-15,2015-07-15,Business insurance premium,REF57794230,98.08,0.0,107146.67
2015-08-01,2015-08-01,Business travel,REF10269485,151.63,0.0,106995.04
2015-08-04,2015-08-04,Internet and phone service,REF22711232,47.86,0.0,106947.18
2015-08-05,2015-08-05,Office supplies,REF85402415,35.67,0.0,106911.51
2015-08-05,2015-08-05,Equipment purchase,REF32256207,102.42,0.0,106809.09
2015-08-09,2015-08-09,Software subscription,REF34048477,118.75,0.0,106690.34
2015-08-14,2015-08-14,Equipment purchase,REF95320110,66.35,0.0,106623.99
2015-08-15,2015-08-15,Invoice payment - Gordon PLC,REF88148007,0.0,985.35,107609.34
2015-08-15,2015-08-15,Business insurance premium,REF49304250,79.45,0.0,107529.89
2015-08-15,2015-08-15,Service payment - Abbott-Harrison,REF29532237,0.0,876.0,108405.89
2015-08-15,2015-08-15,Service payment - Jackson-Wilcox,REF27321591,0.0,864.36,109270.25
2015-08-17,2015-08-17,Internet and phone service,REF43603249,59.36,0.0,109210.89
2015-08-18,2015-08-18,Business travel,REF47435677,62.21,0.0,109148.68
2015-08-21,2015-08-21,Office supplies,REF54713710,40.0,0.0,109108.68
2015-08-23,2015-08-23,Training/conference,REF46719509,77.66,0.0,109031.02
2015-08-29,2015-08-29,Office supplies,REF69048937,12.02,0.0,109019.0
2015-09-01,2015-09-01,Office supplies,REF14832679,74.94,0.0,108944.06
2015-09-02,2015-09-02,Professional services,REF55263835,233.81,0.0,108710.25
2015-09-03,2015-09-03,Office supplies,REF33544857,90.12,0.0,108620.13
2015-09-03,2015-09-03,Marketing expenses,REF31305940,133.31,0.0,108486.82
2015-09-05,2015-09-05,Equipment purchase,REF85023491,86.04,0.0,108400.78
2015-09-07,2015-09-07,Marketing expenses,REF43337142,220.43,0.0,108180.35
2015-09-09,2015-09-09,Software subscription,REF87047262,153.96,0.0,108026.39
2015-09-09,2015-09-09,Equipment purchase,REF29731947,89.09,0.0,107937.3
2015-09-13,2015-09-13,Professional services,REF59826903,262.67,0.0,107674.63
2015-09-15,2015-09-15,Business insurance premium,REF85133485,132.87,0.0,107541.76
2015-09-15,2015-09-15,Payment from Jackson-Wilcox,REF40868427,0.0,1341.65,108883.41
2015-09-15,2015-09-15,Project payment - Abbott-Harrison,REF12735479,0.0,1171.39,110054.8
2015-10-01,2015-10-01,Business travel,REF92619553,157.19,0.0,109897.61
2015-10-06,2015-10-06,Training/conference,REF60745926,109.99,0.0,109787.62
2015-10-06,2015-10-06,Professional services,REF24326141,457.36,0.0,109330.26
2015-10-07,2015-10-07,Professional services,REF21376745,340.5,0.0,108989.76
2015-10-09,2015-10-09,Software subscription,REF96242854,207.41,0.0,108782.35
2015-10-12,2015-10-12,Internet and phone service,REF90083175,83.88,0.0,108698.47
2015-10-15,2015-10-15,Business insurance premium,REF38913212,143.96,0.0,108554.51
2015-10-15,2015-10-15,Service payment - Jackson-Wilcox,REF50791391,0.0,1522.44,110076.95
2015-10-15,2015-10-15,Payment from Gordon PLC,REF78243149,0.0,1376.32,111453.27
2015-10-15,2015-10-15,Invoice payment - Abbott-Harrison,REF27657769,0.0,1327.44,112780.71
2015-10-16,2015-10-16,Professional services,REF50327393,227.36,0.0,112553.35
2015-10-16,2015-10-16,Equipment purchase,REF31748020,112.99,0.0,112440.36
2015-10-18,2015-10-18,Equipment purchase,REF26842906,114.12,0.0,112326.24
2015-10-22,2015-10-22,Office supplies,REF38525815,55.75,0.0,112270.49
2015-10-27,2015-10-27,Business travel,REF98300415,182.58,0.0,112087.91
2015-11-03,2015-11-03,Equipment purchase,REF46959769,114.76,0.0,111973.15
2015-11-09,2015-11-09,Software subscription,REF94015013,141.03,0.0,111832.12
2015-11-12,2015-11-12,Office supplies,REF33097231,51.54,0.0,111780.58
2015-11-14,2015-11-14,Marketing expenses,REF83745207,329.37,0.0,111451.21
2015-11-15,2015-11-15,Business insurance premium,REF37394671,139.23,0.0,111311.98
2015-11-15,2015-11-15,Payment from Abbott-Harrison,REF78215101,0.0,1444.69,112756.67
2015-11-15,2015-11-15,Project payment - Jackson-Wilcox,REF68461110,0.0,1262.71,114019.38
2015-11-15,2015-11-15,Service payment - Gordon PLC,REF84421944,0.0,1229.69,115249.07
2015-11-16,2015-11-16,Equipment purchase,REF58810988,41.69,0.0,115207.38
2015-11-18,2015-11-18,Equipment purchase,REF68810820,93.45,0.0,115113.93
2015-11-20,2015-11-20,Office supplies,REF25762609,55.96,0.0,115057.97
2015-11-21,2015-11-21,Professional services,REF37868154,398.33,0.0,114659.64
2015-11-23,2015-11-23,Office supplies,REF78005339,55.65,0.0,114603.99
2015-11-24,2015-11-24,Training/conference,REF63314745,147.06,0.0,114456.93
2015-11-25,2015-11-25,Marketing expenses,REF58461466,348.01,0.0,114108.92
2015-11-27,2015-11-27,Office supplies,REF64044320,46.28,0.0,114062.64
2015-11-27,2015-11-27,Internet and phone service,REF74501116,48.81,0.0,114013.83
2015-11-28,2015-11-28,Internet and phone service,REF20324002,71.26,0.0,113942.57
2015-11-29,2015-11-29,Office supplies,REF68428619,43.75,0.0,113898.82
2015-11-30,2015-11-30,Office supplies,REF16848362,49.95,0.0,113848.87
2015-12-07,2015-12-07,Office supplies,REF46782738,47.42,0.0,113801.45
2015-12-08,2015-12-08,Office supplies,REF53536624,45.22,0.0,113756.23
2015-12-09,2015-12-09,Software subscription,REF43485975,160.71,0.0,113595.52
2015-12-11,2015-12-11,Business travel,REF86061628,120.22,0.0,113475.3
2015-12-11,2015-12-11,Office supplies,REF77570482,63.66,0.0,113411.64
2015-12-12,2015-12-12,Business travel,REF90120672,145.18,0.0,113266.46
2015-12-14,2015-12-14,Training/conference,REF62931018,43.48,0.0,113222.98
2015-12-14,2015-12-14,Equipment purchase,REF69908571,50.34,0.0,113172.64
2015-12-15,2015-12-15,Business insurance premium,REF96013465,108.72,0.0,113063.92
2015-12-15,2015-12-15,Project payment - Gordon PLC,REF71708502,0.0,1185.16,114249.08
2015-12-15,2015-12-15,Project payment - Abbott-Harrison,REF58964381,0.0,977.89,115226.97
2015-12-15,2015-12-15,Payment from Jackson-Wilcox,REF71356362,0.0,1008.22,116235.19
2015-12-20,2015-12-20,Business travel,REF44715764,173.45,0.0,116061.74
2015-12-20,2015-12-20,Marketing expenses,REF27699748,201.7,0.0,115860.04
2015-12-24,2015-12-24,Marketing expenses,REF33911144,97.81,0.0,115762.23
2015-12-25,2015-12-25,Internet and phone service,REF11097462,70.31,0.0,115691.92
2015-12-31,2015-12-31,Training/conference,REF92065978,126.9,0.0,115565.02
2016-01-07,2016-01-07,Office supplies,REF25945525,33.61,0.0,115531.41
2016-01-09,2016-01-09,Software subscription,REF30130034,115.99,0.0,115415.42
2016-01-15,2016-01-15,Business insurance premium,REF80575740,91.93,0.0,115323.49
2016-01-15,2016-01-15,Invoice payment - Jackson-Wilcox,REF39037996,0.0,1234.41,116557.9
2016-01-15,2016-01-15,Invoice payment - Abbott-Harrison,REF67711602,0.0,1105.83,117663.73
2016-01-21,2016-01-21,Business travel,REF45316128,45.04,0.0,117618.69
2016-01-29,2016-01-29,Professional services,REF98099716,69.61,0.0,117549.08
2016-01-31,2016-01-31,Training/conference,REF15726711,38.73,0.0,117510.35
2016-02-02,2016-02-02,Office supplies,REF54968098,53.21,0.0,117457.14
2016-02-03,2016-02-03,Training/conference,REF64270263,95.01,0.0,117362.13
2016-02-04,2016-02-04,Equipment purchase,REF82508756,93.98,0.0,117268.15
2016-02-06,2016-02-06,Office supplies,REF54505710,28.43,0.0,117239.72
2016-02-09,2016-02-09,Software subscription,REF16132503,160.16,0.0,117079.56
2016-02-11,2016-02-11,Business travel,REF47072400,160.12,0.0,116919.44
2016-02-14,2016-02-14,Professional services,REF88818230,321.37,0.0,116598.07
2016-02-15,2016-02-15,Project payment - Abbott-Harrison,REF52651281,0.0,1056.93,117655.0
2016-02-15,2016-02-15,Payment from Jackson-Wilcox,REF87122283,0.0,927.65,118582.65
2016-02-15,2016-02-15,Payment from Gordon PLC,REF60418151,0.0,1361.08,119943.73
2016-02-15,2016-02-15,Business insurance premium,REF63158026,98.93,0.0,119844.8
2016-02-16,2016-02-16,Office supplies,REF16836026,64.27,0.0,119780.53
2016-02-18,2016-02-18,Office supplies,REF79317525,33.25,0.0,119747.28
2016-02-18,2016-02-18,Training/conference,REF65233072,61.3,0.0,119685.98
2016-02-20,2016-02-20,Equipment purchase,REF84222474,88.69,0.0,119597.29
2016-02-27,2016-02-27,Internet and phone service,REF80372180,78.05,0.0,119519.24
2016-02-28,2016-02-28,Equipment purchase,REF22122013,93.83,0.0,119425.41
2016-03-07,2016-03-07,Office supplies,REF65559548,41.51,0.0,119383.9
2016-03-09,2016-03-09,Internet and phone service,REF38022500,69.32,0.0,119314.58
2016-03-09,2016-03-09,Professional services,REF31123679,221.06,0.0,119093.52
2016-03-09,2016-03-09,Software subscription,REF94490331,171.8,0.0,118921.72
2016-03-15,2016-03-15,Payment from Jackson-Wilcox,REF90184004,0.0,986.57,119908.29
2016-03-15,2016-03-15,Project payment - Gordon PLC,REF91364765,0.0,1387.74,121296.03
2016-03-15,2016-03-15,Business insurance premium,REF38382082,136.91,0.0,121159.12
2016-03-15,2016-03-15,Project payment - Abbott-Harrison,REF77607780,0.0,1568.67,122727.79
2016-03-20,2016-03-20,Office supplies,REF88135986,27.27,0.0,122700.52
2016-03-22,2016-03-22,Office supplies,REF68189859,73.5,0.0,122627.02
2016-03-23,2016-03-23,Office supplies,REF85296691,48.24,0.0,122578.78
2016-03-23,2016-03-23,Professional services,REF21299965,165.78,0.0,122413.0
2016-03-24,2016-03-24,Training/conference,REF35306033,117.63,0.0,122295.37
2016-03-25,2016-03-25,Equipment purchase,REF47523156,184.9,0.0,122110.47
2016-03-28,2016-03-28,Business travel,REF84437226,133.34,0.0,121977.13
2016-03-28,2016-03-28,Marketing expenses,REF46003125,187.57,0.0,121789.56
2016-03-29,2016-03-29,Internet and phone service,REF45682507,84.57,0.0,121704.99
2016-03-30,2016-03-30,Office supplies,REF69913499,53.37,0.0,121651.62
2016-04-04,2016-04-04,Office supplies,REF28560442,32.41,0.0,121619.21
2016-04-05,2016-04-05,Internet and phone service,REF34555772,108.24,0.0,121510.97
2016-04-08,2016-04-08,Office supplies,REF43880668,44.92,0.0,121466.05
2016-04-09,2016-04-09,Software subscription,REF55033929,136.69,0.0,121329.36
2016-04-15,2016-04-15,Service payment - Abbott-Harrison,REF86220395,0.0,1211.01,122540.37
2016-04-15,2016-04-15,Project payment - Jackson-Wilcox,REF90282662,0.0,1198.63,123739.0
2016-04-15,2016-04-15,Business insurance premium,REF56508054,130.22,0.0,123608.78
2016-04-15,2016-04-15,Payment from Gordon PLC,REF34772560,0.0,1497.9,125106.68
2016-04-16,2016-04-16,Office supplies,REF75156442,45.93,0.0,125060.75
2016-04-17,2016-04-17,Business travel,REF51897441,219.22,0.0,124841.53
2016-04-20,2016-04-20,Office supplies,REF29561429,88.33,0.0,124753.2
2016-04-22,2016-04-22,Equipment purchase,REF53461925,131.68,0.0,124621.52
2016-04-26,2016-04-26,Equipment purchase,REF88230312,88.72,0.0,124532.8
2016-04-27,2016-04-27,Equipment purchase,REF18469607,69.21,0.0,124463.59
2016-04-29,2016-04-29,Professional services,REF44146550,168.0,0.0,124295.59
2016-04-29,2016-04-29,Marketing expenses,REF15320243,106.21,0.0,124189.38
2016-05-01,2016-05-01,Office supplies,REF69160291,61.65,0.0,124127.73
2016-05-07,2016-05-07,Training/conference,REF13365547,71.62,0.0,124056.11
2016-05-09,2016-05-09,Software subscription,REF17869295,145.59,0.0,123910.52
2016-05-14,2016-05-14,Training/conference,REF63524275,83.16,0.0,123827.36
2016-05-15,2016-05-15,Payment from Jackson-Wilcox,REF89070672,0.0,1319.36,125146.72
2016-05-15,2016-05-15,Invoice payment - Gordon PLC,REF47169853,0.0,1289.42,126436.14
2016-05-15,2016-05-15,Project payment - Abbott-Harrison,REF87176017,0.0,982.9,127419.04
2016-05-15,2016-05-15,Business insurance premium,REF19591409,118.11,0.0,127300.93
2016-05-19,2016-05-19,Equipment purchase,REF97436171,86.86,0.0,127214.07
2016-05-21,2016-05-21,Professional services,REF57388372,185.99,0.0,127028.08
2016-05-27,2016-05-27,Marketing expenses,REF28849566,181.54,0.0,126846.54
2016-05-28,2016-05-28,Office supplies,REF43313324,68.84,0.0,126777.7
2016-05-31,2016-05-31,Office supplies,REF22587603,52.68,0.0,126725.02
2016-06-06,2016-06-06,Business travel,REF61247542,66.36,0.0,126658.66
2016-06-09,2016-06-09,Office supplies,REF92923911,32.14,0.0,126626.52
2016-06-09,2016-06-09,Software subscription,REF17377600,131.81,0.0,126494.71
2016-06-10,2016-06-10,Training/conference,REF25128355,34.5,0.0,126460.21
2016-06-15,2016-06-15,Project payment - Jackson-Wilcox,REF44435937,0.0,1009.14,127469.35
2016-06-15,2016-06-15,Invoice payment - Abbott-Harrison,REF57809709,0.0,984.29,128453.64
2016-06-15,2016-06-15,Business insurance premium,REF17348727,100.69,0.0,128352.95
2016-06-23,2016-06-23,Professional services,REF69564947,174.86,0.0,128178.09
2016-06-24,2016-06-24,Office supplies,REF33991871,42.27,0.0,128135.82
2016-06-28,2016-06-28,Office supplies,REF56942003,30.22,0.0,128105.6
2016-07-03,2016-07-03,Office supplies,REF30316952,30.0,0.0,128075.6
2016-07-09,2016-07-09,Software subscription,REF39526423,113.21,0.0,127962.39
2016-07-15,2016-07-15,Business insurance premium,REF91413176,97.57,0.0,127864.82
2016-07-15,2016-07-15,Marketing expenses,REF91304291,105.49,0.0,127759.33
2016-07-15,2016-07-15,Service payment - Gordon PLC,REF95415431,0.0,1046.97,128806.3
2016-07-15,2016-07-15,Invoice payment - Abbott-Harrison,REF75224268,0.0,1007.4,129813.7
2016-07-16,2016-07-16,Equipment purchase,REF61886297,62.5,0.0,129751.2
2016-07-17,2016-07-17,Office supplies,REF22387071,38.36,0.0,129712.84
2016-07-20,2016-07-20,Training/conference,REF29191108,101.7,0.0,129611.14
2016-07-24,2016-07-24,Office supplies,REF33164958,50.56,0.0,129560.58
2016-07-25,2016-07-25,Internet and phone service,REF76084664,62.66,0.0,129497.92
2016-07-26,2016-07-26,Office supplies,REF62911022,69.23,0.0,129428.69
2016-08-01,2016-08-01,Business travel,REF19313235,123.76,0.0,129304.93
2016-08-03,2016-08-03,Internet and phone service,REF16337252,61.62,0.0,129243.31
2016-08-04,2016-08-04,Professional services,REF49860319,202.7,0.0,129040.61
2016-08-04,2016-08-04,Training/conference,REF67880265,66.3,0.0,128974.31
2016-08-05,2016-08-05,Office supplies,REF53180821,36.08,0.0,128938.23
2016-08-07,2016-08-07,Office supplies,REF72284956,35.19,0.0,128903.04
2016-08-08,2016-08-08,Equipment purchase,REF13397641,32.05,0.0,128870.99
2016-08-09,2016-08-09,Software subscription,REF88847749,116.55,0.0,128754.44
2016-08-11,2016-08-11,Office supplies,REF59243130,28.39,0.0,128726.05
2016-08-15,2016-08-15,Project payment - Abbott-Harrison,REF82021732,0.0,1050.29,129776.34
2016-08-15,2016-08-15,Business insurance premium,REF54575606,81.28,0.0,129695.06
2016-08-15,2016-08-15,Payment from Jackson-Wilcox,REF31615570,0.0,852.1,130547.16
2016-08-15,2016-08-15,Office supplies,REF36509560,38.85,0.0,130508.31
2016-08-20,2016-08-20,Office supplies,REF40103614,54.86,0.0,130453.45
2016-08-20,2016-08-20,Internet and phone service,REF93478202,54.17,0.0,130399.28
2016-08-26,2016-08-26,Business travel,REF91771220,57.88,0.0,130341.4
2016-08-28,2016-08-28,Business travel,REF70150407,97.44,0.0,130243.96
2016-08-28,2016-08-28,Training/conference,REF27234338,94.74,0.0,130149.22
2016-08-28,2016-08-28,Marketing expenses,REF43997209,138.18,0.0,130011.04
2016-08-31,2016-08-31,Professional services,REF54051131,72.74,0.0,129938.3
2016-09-03,2016-09-03,Office supplies,REF54186212,56.4,0.0,129881.9
2016-09-05,2016-09-05,Training/conference,REF42029306,82.31,0.0,129799.59
2016-09-08,2016-09-08,Office supplies,REF50950416,58.23,0.0,129741.36
2016-09-09,2016-09-09,Office supplies,REF51710530,64.03,0.0,129677.33
2016-09-09,2016-09-09,Software subscription,REF31174842,153.19,0.0,129524.14
2016-09-15,2016-09-15,Office supplies,REF54734526,43.01,0.0,129481.13
2016-09-15,2016-09-15,Business insurance premium,REF78865327,133.65,0.0,129347.48
2016-09-15,2016-09-15,Service payment - Jackson-Wilcox,REF16977594,0.0,1575.63,130923.11
2016-09-15,2016-09-15,Project payment - Gordon PLC,REF19852774,0.0,1156.44,132079.55
2016-09-15,2016-09-15,Business travel,REF57362715,119.98,0.0,131959.57
2016-09-15,2016-09-15,Payment from Abbott-Harrison,REF11379783,0.0,1184.9,133144.47
2016-09-17,2016-09-17,Professional services,REF22729710,286.37,0.0,132858.1
2016-09-19,2016-09-19,Internet and phone service,REF61956714,86.3,0.0,132771.8
2016-09-23,2016-09-23,Professional services,REF46427912,458.35,0.0,132313.45
2016-09-26,2016-09-26,Marketing expenses,REF60738090,200.57,0.0,132112.88
2016-09-27,2016-09-27,Internet and phone service,REF82586249,133.24,0.0,131979.64
2016-09-29,2016-09-29,Internet and phone service,REF60018738,106.0,0.0,131873.64
2016-10-05,2016-10-05,Marketing expenses,REF92819959,160.58,0.0,131713.06
2016-10-08,2016-10-08,Professional services,REF99537513,292.15,0.0,131420.91
2016-10-09,2016-10-09,Software subscription,REF64363897,148.98,0.0,131271.93
2016-10-11,2016-10-11,Office supplies,REF45029741,58.61,0.0,131213.32
2016-10-15,2016-10-15,Project payment - Jackson-Wilcox,REF54114133,0.0,1439.61,132652.93
2016-10-15,2016-10-15,Project payment - Abbott-Harrison,REF96739191,0.0,1560.98,134213.91
2016-10-15,2016-10-15,Business insurance premium,REF75272393,133.45,0.0,134080.46
2016-10-15,2016-10-15,Project payment - Gordon PLC,REF61353581,0.0,2036.07,136116.53
2016-10-16,2016-10-16,Internet and phone service,REF63997895,75.33,0.0,136041.2
2016-10-18,2016-10-18,Equipment purchase,REF70532992,173.6,0.0,135867.6
2016-10-20,2016-10-20,Training/conference,REF59908454,136.64,0.0,135730.96
2016-10-21,2016-10-21,Office supplies,REF99851367,88.44,0.0,135642.52
2016-10-30,2016-10-30,Office supplies,REF31747183,53.41,0.0,135589.11
2016-11-02,2016-11-02,Business travel,REF49308049,143.31,0.0,135445.8
2016-11-04,2016-11-04,Business travel,REF51118042,122.68,0.0,135323.12
2016-11-07,2016-11-07,Office supplies,REF10898698,81.17,0.0,135241.95
2016-11-08,2016-11-08,Marketing expenses,REF94515187,206.42,0.0,135035.53
2016-11-08,2016-11-08,Office supplies,REF64471722,66.49,0.0,134969.04
2016-11-09,2016-11-09,Software subscription,REF12967042,169.28,0.0,134799.76
2016-11-09,2016-11-09,Office supplies,REF74439223,59.29,0.0,134740.47
2016-11-15,2016-11-15,Business insurance premium,REF24143333,128.65,0.0,134611.82
2016-11-15,2016-11-15,Project payment - Abbott-Harrison,REF60385407,0.0,1510.31,136122.13
2016-11-15,2016-11-15,Office supplies,REF30552348,40.43,0.0,136081.7
2016-11-15,2016-11-15,Payment from Jackson-Wilcox,REF28837815,0.0,1170.53,137252.23
2016-11-15,2016-11-15,Invoice payment - Gordon PLC,REF35290531,0.0,1218.43,138470.66
2016-11-18,2016-11-18,Internet and phone service,REF61540692,35.19,0.0,138435.47
2016-11-21,2016-11-21,Training/conference,REF43267503,159.53,0.0,138275.94
2016-11-30,2016-11-30,Equipment purchase,REF21629456,122.06,0.0,138153.88
2016-12-09,2016-12-09,Training/conference,REF67743040,75.26,0.0,138078.62
2016-12-09,2016-12-09,Software subscription,REF31633599,141.1,0.0,137937.52
2016-12-12,2016-12-12,Office supplies,REF85245556,55.96,0.0,137881.56
2016-12-15,2016-12-15,Business insurance premium,REF82956536,97.28,0.0,137784.28
2016-12-15,2016-12-15,Payment from Gordon PLC,REF38405173,0.0,1224.52,139008.8
2016-12-15,2016-12-15,Invoice payment - Abbott-Harrison,REF58148195,0.0,840.09,139848.89
2016-12-15,2016-12-15,Payment from Jackson-Wilcox,REF96044248,0.0,1416.78,141265.67
2016-12-16,2016-12-16,Equipment purchase,REF71429478,75.35,0.0,141190.32
2016-12-31,2016-12-31,Office supplies,REF97155636,50.26,0.0,141140.06
2017-01-01,2017-01-01,Training/conference,REF14703017,97.66,0.0,141042.4
2017-01-06,2017-01-06,Office supplies,REF91304146,27.51,0.0,141014.89
2017-01-06,2017-01-06,Training/conference,REF46117244,88.51,0.0,140926.38
2017-01-09,2017-01-09,Software subscription,REF88889459,116.8,0.0,140809.58
2017-01-14,2017-01-14,Training/conference,REF13540489,42.59,0.0,140766.99
2017-01-15,2017-01-15,Business insurance premium,REF48833357,89.33,0.0,140677.66
2017-01-15,2017-01-15,Business travel,REF13352446,118.21,0.0,140559.45
2017-01-15,2017-01-15,Payment from Abbott-Harrison,REF94916089,0.0,875.12,141434.57
2017-01-15,2017-01-15,Invoice payment - Jackson-Wilcox,REF58374785,0.0,977.81,142412.38
2017-01-17,2017-01-17,Office supplies,REF77713422,25.11,0.0,142387.27
2017-01-19,2017-01-19,Office supplies,REF12488770,36.05,0.0,142351.22
2017-01-20,2017-01-20,Office supplies,REF90415449,40.06,0.0,142311.16
2017-02-02,2017-02-02,Office supplies,REF81415468,35.2,0.0,142275.96
2017-02-03,2017-02-03,Marketing expenses,REF78184161,163.42,0.0,142112.54
2017-02-04,2017-02-04,Office supplies,REF73636207,39.03,0.0,142073.51
2017-02-05,2017-02-05,Internet and phone service,REF41676193,59.06,0.0,142014.45
2017-02-06,2017-02-06,Internet and phone service,REF93925032,81.82,0.0,141932.63
2017-02-06,2017-02-06,Business travel,REF20447468,158.62,0.0,141774.01
2017-02-08,2017-02-08,Business travel,REF82953257,113.77,0.0,141660.24
2017-02-09,2017-02-09,Training/conference,REF65836017,79.82,0.0,141580.42
2017-02-09,2017-02-09,Software subscription,REF89387263,117.54,0.0,141462.88
2017-02-09,2017-02-09,Marketing expenses,REF12947599,209.0,0.0,141253.88
2017-02-15,2017-02-15,Business insurance premium,REF71117516,112.63,0.0,141141.25
2017-02-15,2017-02-15,Invoice payment - Abbott-Harrison,REF33496929,0.0,1315.76,142457.01
2017-02-15,2017-02-15,Payment from Jackson-Wilcox,REF96581557,0.0,1190.15,143647.16
2017-02-15,2017-02-15,Invoice payment - Gordon PLC,REF85613798,0.0,1183.08,144830.24
2017-02-19,2017-02-19,Equipment purchase,REF93961599,117.59,0.0,144712.65
2017-02-23,2017-02-23,Office supplies,REF97929922,38.88,0.0,144673.77
2017-02-23,2017-02-23,Business travel,REF73545785,152.28,0.0,144521.49
2017-02-24,2017-02-24,Equipment purchase,REF38329702,133.27,0.0,144388.22
2017-02-26,2017-02-26,Equipment purchase,REF77322771,30.79,0.0,144357.43
2017-02-26,2017-02-26,Office supplies,REF48340573,43.47,0.0,144313.96
2017-03-03,2017-03-03,Equipment purchase,REF66282045,125.63,0.0,144188.33
2017-03-09,2017-03-09,Software subscription,REF19767464,152.24,0.0,144036.09
2017-03-13,2017-03-13,Office supplies,REF13387597,61.55,0.0,143974.54
2017-03-14,2017-03-14,Training/conference,REF20073656,56.56,0.0,143917.98
2017-03-14,2017-03-14,Marketing expenses,REF10866911,218.21,0.0,143699.77
2017-03-15,2017-03-15,Payment from Gordon PLC,REF41736772,0.0,1472.48,145172.25
2017-03-15,2017-03-15,Training/conference,REF71925516,165.84,0.0,145006.41
2017-03-15,2017-03-15,Payment from Abbott-Harrison,REF50979717,0.0,1611.66,146618.07
2017-03-15,2017-03-15,Service payment - Jackson-Wilcox,REF85101536,0.0,1419.3,148037.37
2017-03-15,2017-03-15,Business insurance premium,REF99583379,144.35,0.0,147893.02
2017-03-19,2017-03-19,Equipment purchase,REF45286176,128.58,0.0,147764.44
2017-03-31,2017-03-31,Professional services,REF49894576,197.33,0.0,147567.11
2017-04-01,2017-04-01,Marketing expenses,REF40461622,182.76,0.0,147384.35
2017-04-01,2017-04-01,Office supplies,REF90353329,56.24,0.0,147328.11
2017-04-04,2017-04-04,Office supplies,REF76841076,42.01,0.0,147286.1
2017-04-07,2017-04-07,Office supplies,REF29334488,54.39,0.0,147231.71
2017-04-09,2017-04-09,Software subscription,REF55135502,133.37,0.0,147098.34
2017-04-15,2017-04-15,Business insurance premium,REF68290270,117.09,0.0,146981.25
2017-04-15,2017-04-15,Service payment - Jackson-Wilcox,REF88140628,0.0,1256.07,148237.32
2017-04-15,2017-04-15,Invoice payment - Abbott-Harrison,REF63432561,0.0,1285.28,149522.6
2017-04-15,2017-04-15,Service payment - Gordon PLC,REF87753533,0.0,1568.75,151091.35
2017-04-15,2017-04-15,Training/conference,REF35150969,113.28,0.0,150978.07
2017-04-21,2017-04-21,Training/conference,REF13548961,142.08,0.0,150835.99
2017-05-03,2017-05-03,Training/conference,REF77244566,105.8,0.0,150730.19
2017-05-05,2017-05-05,Office supplies,REF54051609,50.38,0.0,150679.81
2017-05-06,2017-05-06,Marketing expenses,REF18318292,159.01,0.0,150520.8
2017-05-07,2017-05-07,Office supplies,REF78932190,40.96,0.0,150479.84
2017-05-08,2017-05-08,Office supplies,REF17620060,68.33,0.0,150411.51
2017-05-09,2017-05-09,Software subscription,REF41358103,159.69,0.0,150251.82
2017-05-14,2017-05-14,Professional services,REF79364997,194.8,0.0,150057.02
2017-05-15,2017-05-15,Business insurance premium,REF55916055,119.99,0.0,149937.03
2017-05-15,2017-05-15,Project payment - Jackson-Wilcox,REF40848796,0.0,1373.99,151311.02
2017-05-15,2017-05-15,Invoice payment - Gordon PLC,REF25037768,0.0,1401.73,152712.75
2017-05-15,2017-05-15,Invoice payment - Abbott-Harrison,REF99659032,0.0,1379.09,154091.84
2017-05-16,2017-05-16,Business travel,REF22324063,136.39,0.0,153955.45
2017-05-18,2017-05-18,Office supplies,REF24153708,35.6,0.0,153919.85
2017-05-20,2017-05-20,Office supplies,REF89702865,42.77,0.0,153877.08
2017-05-22,2017-05-22,Professional services,REF81909221,288.51,0.0,153588.57
2017-06-02,2017-06-02,Business travel,REF92721847,93.63,0.0,153494.94
2017-06-06,2017-06-06,Internet and phone service,REF95036697,99.24,0.0,153395.7
2017-06-07,2017-06-07,Professional services,REF49181018,386.05,0.0,153009.65
2017-06-08,2017-06-08,Office supplies,REF44125324,46.3,0.0,152963.35
2017-06-09,2017-06-09,Software subscription,REF81645272,159.17,0.0,152804.18
2017-06-12,2017-06-12,Office supplies,REF40959213,55.39,0.0,152748.79
2017-06-12,2017-06-12,Equipment purchase,REF27044041,95.77,0.0,152653.02
2017-06-13,2017-06-13,Business travel,REF37723777,148.1,0.0,152504.92
2017-06-15,2017-06-15,Service payment - Gordon PLC,REF56054567,0.0,1565.4,154070.32
2017-06-15,2017-06-15,Internet and phone service,REF25692036,45.84,0.0,154024.48
2017-06-15,2017-06-15,Payment from Abbott-Harrison,REF27565242,0.0,681.88,154706.36
2017-06-15,2017-06-15,Business insurance premium,REF40807791,111.09,0.0,154595.27
2017-06-16,2017-06-16,Office supplies,REF79229502,50.42,0.0,154544.85
2017-06-18,2017-06-18,Equipment purchase,REF44104046,84.58,0.0,154460.27
2017-06-19,2017-06-19,Office supplies,REF35086669,45.94,0.0,154414.33
2017-06-20,2017-06-20,Internet and phone service,REF40229862,57.74,0.0,154356.59
2017-06-26,2017-06-26,Internet and phone service,REF98859398,79.75,0.0,154276.84
2017-06-29,2017-06-29,Office supplies,REF96755878,16.62,0.0,154260.22
2017-07-09,2017-07-09,Software subscription,REF58923315,137.99,0.0,154122.23
2017-07-11,2017-07-11,Training/conference,REF45359027,100.2,0.0,154022.03
2017-07-15,2017-07-15,Payment from Gordon PLC,REF91961295,0.0,1114.9,155136.93
2017-07-15,2017-07-15,Invoice payment - Abbott-Harrison,REF20516786,0.0,1040.03,156176.96
2017-07-15,2017-07-15,Business insurance premium,REF39439682,93.82,0.0,156083.14
2017-07-16,2017-07-16,Professional services,REF87227098,205.35,0.0,155877.79
2017-07-20,2017-07-20,Office supplies,REF55549909,26.08,0.0,155851.71
2017-07-24,2017-07-24,Internet and phone service,REF47781049,68.4,0.0,155783.31
2017-07-27,2017-07-27,Equipment purchase,REF30077303,91.69,0.0,155691.62
2017-08-01,2017-08-01,Professional services,REF49617813,269.84,0.0,155421.78
2017-08-02,2017-08-02,Equipment purchase,REF25587771,78.07,0.0,155343.71
2017-08-05,2017-08-05,Training/conference,REF87959920,98.4,0.0,155245.31
2017-08-08,2017-08-08,Marketing expenses,REF65776933,121.19,0.0,155124.12
2017-08-09,2017-08-09,Software subscription,REF65568387,94.27,0.0,155029.85
2017-08-10,2017-08-10,Internet and phone service,REF14010354,63.85,0.0,154966.0
2017-08-13,2017-08-13,Marketing expenses,REF51309273,198.48,0.0,154767.52
2017-08-15,2017-08-15,Project payment - Gordon PLC,REF80548525,0.0,940.6,155708.12
2017-08-15,2017-08-15,Business insurance premium,REF81573963,81.47,0.0,155626.65
2017-08-15,2017-08-15,Invoice payment - Abbott-Harrison,REF35336833,0.0,881.41,156508.06
2017-08-21,2017-08-21,Training/conference,REF26707032,37.82,0.0,156470.24
2017-08-24,2017-08-24,Training/conference,REF70958521,46.74,0.0,156423.5
2017-08-24,2017-08-24,Marketing expenses,REF78267646,143.05,0.0,156280.45
2017-08-26,2017-08-26,Office supplies,REF28070425,38.29,0.0,156242.16
2017-09-01,2017-09-01,Professional services,REF91287782,239.28,0.0,156002.88
2017-09-02,2017-09-02,Equipment purchase,REF57283573,105.04,0.0,155897.84
2017-09-05,2017-09-05,Equipment purchase,REF93523280,69.08,0.0,155828.76
2017-09-09,2017-09-09,Software subscription,REF84782570,188.85,0.0,155639.91
2017-09-15,2017-09-15,Payment from Gordon PLC,REF15651666,0.0,1454.21,157094.12
2017-09-15,2017-09-15,Payment from Abbott-Harrison,REF60301936,0.0,628.26,157722.38
2017-09-15,2017-09-15,Business insurance premium,REF82105688,138.45,0.0,157583.93
2017-09-16,2017-09-16,Business travel,REF65640189,184.88,0.0,157399.05
2017-09-18,2017-09-18,Equipment purchase,REF91231173,101.22,0.0,157297.83
2017-09-20,2017-09-20,Business travel,REF18282046,244.21,0.0,157053.62
2017-09-21,2017-09-21,Professional services,REF64121356,128.8,0.0,156924.82
2017-09-24,2017-09-24,Marketing expenses,REF67256406,128.61,0.0,156796.21
2017-09-25,2017-09-25,Office supplies,REF44897621,40.49,0.0,156755.72
2017-10-02,2017-10-02,Office supplies,REF23013762,31.84,0.0,156723.88
2017-10-08,2017-10-08,Marketing expenses,REF46483179,128.42,0.0,156595.46
2017-10-09,2017-10-09,Business travel,REF13931485,147.95,0.0,156447.51
2017-10-09,2017-10-09,Office supplies,REF73828725,70.98,0.0,156376.53
2017-10-09,2017-10-09,Marketing expenses,REF54123438,109.48,0.0,156267.05
2017-10-09,2017-10-09,Software subscription,REF81097921,180.93,0.0,156086.12
2017-10-11,2017-10-11,Training/conference,REF46122361,101.42,0.0,155984.7
2017-10-15,2017-10-15,Invoice payment - Jackson-Wilcox,REF39840564,0.0,1828.14,157812.84
2017-10-15,2017-10-15,Invoice payment - Gordon PLC,REF99991417,0.0,1945.07,159757.91
2017-10-15,2017-10-15,Invoice payment - Abbott-Harrison,REF59124753,0.0,1497.76,161255.67
2017-10-15,2017-10-15,Business insurance premium,REF37337861,147.49,0.0,161108.18
2017-10-31,2017-10-31,Marketing expenses,REF16801831,254.29,0.0,160853.89
2017-10-31,2017-10-31,Business travel,REF16865662,185.29,0.0,160668.6
2017-10-31,2017-10-31,Office supplies,REF33504470,69.3,0.0,160599.3
2017-11-02,2017-11-02,Office supplies,REF73606841,41.55,0.0,160557.75
2017-11-04,2017-11-04,Equipment purchase,REF79362142,35.56,0.0,160522.19
2017-11-09,2017-11-09,Software subscription,REF38987185,171.15,0.0,160351.04
2017-11-09,2017-11-09,Office supplies,REF27299201,76.11,0.0,160274.93
2017-11-13,2017-11-13,Business travel,REF34089138,188.23,0.0,160086.7
2017-11-15,2017-11-15,Business insurance premium,REF84881643,139.28,0.0,159947.42
2017-11-15,2017-11-15,Marketing expenses,REF72157462,200.17,0.0,159747.25
2017-11-15,2017-11-15,Payment from Abbott-Harrison,REF29582408,0.0,1147.73,160894.98
2017-11-15,2017-11-15,Invoice payment - Jackson-Wilcox,REF13916832,0.0,1393.5,162288.48
2017-11-15,2017-11-15,Invoice payment - Gordon PLC,REF50766129,0.0,1482.74,163771.22
2017-11-18,2017-11-18,Business travel,REF48629562,99.79,0.0,163671.43
2017-11-21,2017-11-21,Business travel,REF41658916,160.72,0.0,163510.71
2017-11-24,2017-11-24,Professional services,REF27361001,315.65,0.0,163195.06
2017-11-26,2017-11-26,Training/conference,REF68718704,63.5,0.0,163131.56
2017-12-02,2017-12-02,Business travel,REF52109827,162.83,0.0,162968.73
2017-12-04,2017-12-04,Office supplies,REF53307775,14.29,0.0,162954.44
2017-12-04,2017-12-04,Business travel,REF11928062,69.34,0.0,162885.1
2017-12-05,2017-12-05,Professional services,REF15473228,227.02,0.0,162658.08
2017-12-06,2017-12-06,Office supplies,REF69234531,46.33,0.0,162611.75
2017-12-09,2017-12-09,Software subscription,REF16592344,119.04,0.0,162492.71
2017-12-15,2017-12-15,Project payment - Abbott-Harrison,REF42201623,0.0,921.0,163413.71
2017-12-15,2017-12-15,Payment from Jackson-Wilcox,REF93598991,0.0,1216.66,164630.37
2017-12-15,2017-12-15,Office supplies,REF21731145,50.35,0.0,164580.02
2017-12-15,2017-12-15,Project payment - Gordon PLC,REF79583722,0.0,1249.86,165829.88
2017-12-15,2017-12-15,Business insurance premium,REF13823688,108.14,0.0,165721.74
2017-12-18,2017-12-18,Marketing expenses,REF27953678,205.5,0.0,165516.24
2017-12-20,2017-12-20,Equipment purchase,REF60602229,101.97,0.0,165414.27
2017-12-21,2017-12-21,Office supplies,REF42055876,73.78,0.0,165340.49
2017-12-25,2017-12-25,Equipment purchase,REF57402883,55.03,0.0,165285.46
2017-12-26,2017-12-26,Marketing expenses,REF54364009,196.37,0.0,165089.09
2017-12-27,2017-12-27,Professional services,REF11058172,156.94,0.0,164932.15
2017-12-28,2017-12-28,Professional services,REF46476484,108.89,0.0,164823.26
2017-12-29,2017-12-29,Marketing expenses,REF82106623,167.54,0.0,164655.72
2018-01-05,2018-01-05,Internet and phone service,REF66859964,22.06,0.0,164633.66
2018-01-08,2018-01-08,Office supplies,REF27808624,31.69,0.0,164601.97
2018-01-09,2018-01-09,Business travel,REF45537161,73.35,0.0,164528.62
2018-01-09,2018-01-09,Software subscription,REF38251291,116.4,0.0,164412.22
2018-01-10,2018-01-10,Equipment purchase,REF15054686,33.21,0.0,164379.01
2018-01-11,2018-01-11,Office supplies,REF86102624,14.72,0.0,164364.29
2018-01-15,2018-01-15,Payment from Abbott-Harrison,REF97711095,0.0,790.41,165154.7
2018-01-15,2018-01-15,Office supplies,REF36290209,29.99,0.0,165124.71
2018-01-15,2018-01-15,Business insurance premium,REF54574902,90.47,0.0,165034.24
2018-01-15,2018-01-15,Invoice payment - Gordon PLC,REF75537558,0.0,1046.31,166080.55
2018-01-15,2018-01-15,Project payment - Jackson-Wilcox,REF19902946,0.0,891.19,166971.74
2018-01-18,2018-01-18,Professional services,REF52865049,165.67,0.0,166806.07
2018-01-19,2018-01-19,Marketing expenses,REF56549738,130.47,0.0,166675.6
2018-01-28,2018-01-28,Business travel,REF55532268,38.73,0.0,166636.87
2018-01-28,2018-01-28,Office supplies,REF68290076,47.42,0.0,166589.45
2018-02-03,2018-02-03,Internet and phone service,REF35512169,38.1,0.0,166551.35
2018-02-04,2018-02-04,Office supplies,REF62309414,34.31,0.0,166517.04
2018-02-04,2018-02-04,Training/conference,REF71965342,88.94,0.0,166428.1
2018-02-09,2018-02-09,Software subscription,REF32424458,111.34,0.0,166316.76
2018-02-09,2018-02-09,Equipment purchase,REF69402148,153.42,0.0,166163.34
2018-02-14,2018-02-14,Marketing expenses,REF23225073,186.14,0.0,165977.2
2018-02-15,2018-02-15,Professional services,REF17906205,177.0,0.0,165800.2
2018-02-15,2018-02-15,Invoice payment - Jackson-Wilcox,REF41206053,0.0,1198.45,166998.65
2018-02-15,2018-02-15,Business insurance premium,REF13765684,109.69,0.0,166888.96
2018-02-15,2018-02-15,Payment from Gordon PLC,REF95290353,0.0,1085.08,167974.04
2018-02-15,2018-02-15,Project payment - Abbott-Harrison,REF48839997,0.0,1419.1,169393.14
2018-02-16,2018-02-16,Training/conference,REF78047413,101.92,0.0,169291.22
2018-02-16,2018-02-16,Business travel,REF17128189,47.83,0.0,169243.39
2018-02-16,2018-02-16,Office supplies,REF70762124,47.45,0.0,169195.94
2018-02-18,2018-02-18,Equipment purchase,REF50382751,97.5,0.0,169098.44
2018-02-19,2018-02-19,Marketing expenses,REF46334398,260.09,0.0,168838.35
2018-03-03,2018-03-03,Marketing expenses,REF91562249,231.43,0.0,168606.92
2018-03-07,2018-03-07,Office supplies,REF68074923,61.83,0.0,168545.09
2018-03-09,2018-03-09,Software subscription,REF61895781,152.78,0.0,168392.31
2018-03-12,2018-03-12,Professional services,REF94090525,290.86,0.0,168101.45
2018-03-13,2018-03-13,Business travel,REF46454651,148.46,0.0,167952.99
2018-03-15,2018-03-15,Business insurance premium,REF49547436,126.73,0.0,167826.26
2018-03-15,2018-03-15,Project payment - Jackson-Wilcox,REF54793571,0.0,1306.32,169132.58
2018-03-15,2018-03-15,Invoice payment - Gordon PLC,REF66613362,0.0,1339.98,170472.56
2018-03-15,2018-03-15,Payment from Abbott-Harrison,REF43421197,0.0,1010.78,171483.34
2018-03-16,2018-03-16,Marketing expenses,REF83170418,164.97,0.0,171318.37
2018-03-16,2018-03-16,Equipment purchase,REF66463153,113.5,0.0,171204.87
2018-03-17,2018-03-17,Internet and phone service,REF79878632,84.76,0.0,171120.11
2018-03-25,2018-03-25,Marketing expenses,REF82238713,206.11,0.0,170914.0
2018-03-25,2018-03-25,Equipment purchase,REF61518208,118.44,0.0,170795.56
2018-03-29,2018-03-29,Business travel,REF83990072,112.02,0.0,170683.54
2018-03-31,2018-03-31,Office supplies,REF87006305,41.09,0.0,170642.45
2018-04-01,2018-04-01,Office supplies,REF35042887,55.86,0.0,170586.59
2018-04-03,2018-04-03,Professional services,REF70506670,160.78,0.0,170425.81
2018-04-05,2018-04-05,Office supplies,REF14580514,65.09,0.0,170360.72
2018-04-06,2018-04-06,Training/conference,REF93182042,105.24,0.0,170255.48
2018-04-09,2018-04-09,Software subscription,REF41862255,160.77,0.0,170094.71
2018-04-15,2018-04-15,Invoice payment - Jackson-Wilcox,REF99882116,0.0,1069.91,171164.62
2018-04-15,2018-04-15,Marketing expenses,REF74159815,209.17,0.0,170955.45
2018-04-15,2018-04-15,Business insurance premium,REF19630918,116.95,0.0,170838.5
2018-04-15,2018-04-15,Project payment - Gordon PLC,REF59365515,0.0,1698.7,172537.2
2018-04-15,2018-04-15,Project payment - Abbott-Harrison,REF71972265,0.0,937.08,173474.28
2018-04-16,2018-04-16,Office supplies,REF72805985,32.71,0.0,173441.57
2018-04-16,2018-04-16,Equipment purchase,REF56097484,90.64,0.0,173350.93
2018-04-17,2018-04-17,Office supplies,REF83600684,39.81,0.0,173311.12
2018-04-19,2018-04-19,Marketing expenses,REF14349749,247.84,0.0,173063.28
2018-04-20,2018-04-20,Marketing expenses,REF28350568,298.71,0.0,172764.57
2018-04-26,2018-04-26,Equipment purchase,REF12467042,58.45,0.0,172706.12
2018-04-26,2018-04-26,Internet and phone service,REF59063276,73.22,0.0,172632.9
2018-05-02,2018-05-02,Office supplies,REF37633813,54.94,0.0,172577.96
2018-05-03,2018-05-03,Office supplies,REF42801339,41.79,0.0,172536.17
2018-05-04,2018-05-04,Marketing expenses,REF73194434,166.71,0.0,172369.46
2018-05-09,2018-05-09,Software subscription,REF50905024,174.41,0.0,172195.05
2018-05-10,2018-05-10,Marketing expenses,REF16549903,347.73,0.0,171847.32
2018-05-10,2018-05-10,Business travel,REF82496226,117.15,0.0,171730.17
2018-05-15,2018-05-15,Service payment - Abbott-Harrison,REF32619389,0.0,852.24,172582.41
2018-05-15,2018-05-15,Project payment - Gordon PLC,REF16548628,0.0,1423.05,174005.46
2018-05-15,2018-05-15,Invoice payment - Jackson-Wilcox,REF94025941,0.0,1327.62,175333.08
2018-05-15,2018-05-15,Business insurance premium,REF30105049,128.4,0.0,175204.68
2018-05-24,2018-05-24,Office supplies,REF55063653,46.29,0.0,175158.39
2018-05-26,2018-05-26,Marketing expenses,REF57806535,266.27,0.0,174892.12
2018-05-27,2018-05-27,Business travel,REF39705079,119.34,0.0,174772.78
2018-05-28,2018-05-28,Office supplies,REF19484714,69.94,0.0,174702.84
2018-06-03,2018-06-03,Business travel,REF54685380,123.33,0.0,174579.51
2018-06-08,2018-06-08,Training/conference,REF49275686,110.17,0.0,174469.34
2018-06-09,2018-06-09,Software subscription,REF77049977,134.61,0.0,174334.73
2018-06-10,2018-06-10,Equipment purchase,REF73260197,97.62,0.0,174237.11
2018-06-11,2018-06-11,Professional services,REF83364150,269.83,0.0,173967.28
2018-06-14,2018-06-14,Marketing expenses,REF92843233,267.14,0.0,173700.14
2018-06-15,2018-06-15,Business insurance premium,REF35031531,117.21,0.0,173582.93
2018-06-15,2018-06-15,Service payment - Jackson-Wilcox,REF27586343,0.0,1331.62,174914.55
2018-06-15,2018-06-15,Service payment - Gordon PLC,REF87437467,0.0,1370.37,176284.92
2018-06-15,2018-06-15,Service payment - Abbott-Harrison,REF48280414,0.0,1103.25,177388.17
2018-06-17,2018-06-17,Office supplies,REF16810184,15.3,0.0,177372.87
2018-06-17,2018-06-17,Training/conference,REF42922307,100.34,0.0,177272.53
2018-06-27,2018-06-27,Marketing expenses,REF36524400,171.01,0.0,177101.52
2018-06-28,2018-06-28,Business travel,REF21632604,188.01,0.0,176913.51
2018-07-06,2018-07-06,Professional services,REF10743145,227.02,0.0,176686.49
2018-07-06,2018-07-06,Office supplies,REF14175931,45.8,0.0,176640.69
2018-07-09,2018-07-09,Software subscription,REF43474342,115.43,0.0,176525.26
2018-07-10,2018-07-10,Marketing expenses,REF26253830,72.62,0.0,176452.64
2018-07-11,2018-07-11,Professional services,REF86608661,160.5,0.0,176292.14
2018-07-13,2018-07-13,Office supplies,REF47049836,25.39,0.0,176266.75
2018-07-15,2018-07-15,Business insurance premium,REF60728132,98.08,0.0,176168.67
2018-07-15,2018-07-15,Payment from Abbott-Harrison,REF40579860,0.0,886.94,177055.61
2018-07-15,2018-07-15,Project payment - Jackson-Wilcox,REF37866263,0.0,746.57,177802.18
2018-07-18,2018-07-18,Equipment purchase,REF36222228,99.61,0.0,177702.57
2018-07-19,2018-07-19,Internet and phone service,REF46138656,106.83,0.0,177595.74
2018-07-20,2018-07-20,Internet and phone service,REF55460168,40.75,0.0,177554.99
2018-07-24,2018-07-24,Business travel,REF28252250,48.67,0.0,177506.32
2018-07-28,2018-07-28,Internet and phone service,REF52289177,63.91,0.0,177442.41
2018-08-03,2018-08-03,Internet and phone service,REF60966172,58.88,0.0,177383.53
2018-08-04,2018-08-04,Office supplies,REF79020341,41.95,0.0,177341.58
2018-08-08,2018-08-08,Internet and phone service,REF87902657,78.82,0.0,177262.76
2018-08-08,2018-08-08,Marketing expenses,REF28974655,257.85,0.0,177004.91
2018-08-09,2018-08-09,Software subscription,REF55464926,108.37,0.0,176896.54
2018-08-15,2018-08-15,Business insurance premium,REF35465491,81.07,0.0,176815.47
2018-08-15,2018-08-15,Payment from Abbott-Harrison,REF55918083,0.0,936.71,177752.18
2018-08-15,2018-08-15,Service payment - Jackson-Wilcox,REF92156499,0.0,905.52,178657.7
2018-08-15,2018-08-15,Service payment - Gordon PLC,REF78755691,0.0,744.35,179402.05
2018-08-20,2018-08-20,Internet and phone service,REF87537069,78.21,0.0,179323.84
2018-08-20,2018-08-20,Marketing expenses,REF20598182,129.18,0.0,179194.66
2018-08-21,2018-08-21,Office supplies,REF11090262,40.02,0.0,179154.64
2018-08-25,2018-08-25,Training/conference,REF17144540,61.17,0.0,179093.47
2018-08-27,2018-08-27,Internet and phone service,REF63866066,39.67,0.0,179053.8
2018-08-29,2018-08-29,Professional services,REF73704605,203.9,0.0,178849.9
2018-08-30,2018-08-30,Equipment purchase,REF14210980,73.55,0.0,178776.35
2018-08-30,2018-08-30,Office supplies,REF43401475,25.2,0.0,178751.15
2018-08-31,2018-08-31,Training/conference,REF19598144,106.25,0.0,178644.9
2018-09-01,2018-09-01,Business travel,REF67627455,139.76,0.0,178505.14
2018-09-02,2018-09-02,Business travel,REF91480952,165.65,0.0,178339.49
2018-09-03,2018-09-03,Business travel,REF47079339,220.65,0.0,178118.84
2018-09-09,2018-09-09,Software subscription,REF41405791,175.95,0.0,177942.89
2018-09-11,2018-09-11,Equipment purchase,REF54465331,148.81,0.0,177794.08
2018-09-11,2018-09-11,Business travel,REF51149206,82.18,0.0,177711.9
2018-09-13,2018-09-13,Office supplies,REF58633191,40.0,0.0,177671.9
2018-09-14,2018-09-14,Office supplies,REF53242231,68.09,0.0,177603.81
2018-09-15,2018-09-15,Invoice payment - Abbott-Harrison,REF88880445,0.0,1418.25,179022.06
2018-09-15,2018-09-15,Business insurance premium,REF30112113,136.72,0.0,178885.34
2018-09-15,2018-09-15,Payment from Gordon PLC,REF71073426,0.0,1393.47,180278.81
2018-09-15,2018-09-15,Service payment - Jackson-Wilcox,REF13290234,0.0,1259.22,181538.03
2018-09-24,2018-09-24,Internet and phone service,REF55705707,47.94,0.0,181490.09
2018-09-25,2018-09-25,Equipment purchase,REF53819825,116.26,0.0,181373.83
2018-09-26,2018-09-26,Marketing expenses,REF26013906,283.8,0.0,181090.03
2018-09-28,2018-09-28,Professional services,REF59068126,250.43,0.0,180839.6
2018-10-02,2018-10-02,Office supplies,REF59042064,51.18,0.0,180788.42
2018-10-06,2018-10-06,Professional services,REF42214661,225.66,0.0,180562.76
2018-10-08,2018-10-08,Office supplies,REF86926666,27.52,0.0,180535.24
2018-10-09,2018-10-09,Office supplies,REF82892989,39.09,0.0,180496.15
2018-10-09,2018-10-09,Software subscription,REF75232331,152.39,0.0,180343.76
2018-10-12,2018-10-12,Equipment purchase,REF26612861,93.57,0.0,180250.19
2018-10-15,2018-10-15,Business insurance premium,REF56027382,140.73,0.0,180109.46
2018-10-15,2018-10-15,Equipment purchase,REF30128513,199.2,0.0,179910.26
2018-10-15,2018-10-15,Invoice payment - Jackson-Wilcox,REF99927541,0.0,1213.57,181123.83
2018-10-15,2018-10-15,Project payment - Abbott-Harrison,REF72073867,0.0,1386.13,182509.96
2018-10-15,2018-10-15,Office supplies,REF90973951,80.75,0.0,182429.21
2018-10-23,2018-10-23,Professional services,REF18828398,315.16,0.0,182114.05
2018-10-23,2018-10-23,Office supplies,REF56828906,74.65,0.0,182039.4
2018-10-26,2018-10-26,Business travel,REF59045446,221.15,0.0,181818.25
2018-10-29,2018-10-29,Professional services,REF41141210,316.86,0.0,181501.39
2018-10-29,2018-10-29,Internet and phone service,REF54832964,108.06,0.0,181393.33
2018-10-30,2018-10-30,Office supplies,REF44131617,60.02,0.0,181333.31
2018-11-02,2018-11-02,Internet and phone service,REF72976209,120.18,0.0,181213.13
2018-11-04,2018-11-04,Equipment purchase,REF68689603,55.63,0.0,181157.5
2018-11-05,2018-11-05,Professional services,REF54010841,278.06,0.0,180879.44
2018-11-07,2018-11-07,Professional services,REF57086635,368.71,0.0,180510.73
2018-11-08,2018-11-08,Marketing expenses,REF68786019,287.23,0.0,180223.5
2018-11-09,2018-11-09,Office supplies,REF72961492,61.3,0.0,180162.2
2018-11-09,2018-11-09,Software subscription,REF20856162,190.32,0.0,179971.88
2018-11-12,2018-11-12,Business travel,REF86516949,165.3,0.0,179806.58
2018-11-12,2018-11-12,Office supplies,REF29529494,57.91,0.0,179748.67
2018-11-14,2018-11-14,Equipment purchase,REF16822981,123.53,0.0,179625.14
2018-11-15,2018-11-15,Invoice payment - Gordon PLC,REF83079075,0.0,1661.08,181286.22
2018-11-15,2018-11-15,Business insurance premium,REF54965161,128.72,0.0,181157.5
2018-11-15,2018-11-15,Payment from Abbott-Harrison,REF40973294,0.0,1150.86,182308.36
2018-12-02,2018-12-02,Internet and phone service,REF91200590,63.04,0.0,182245.32
2018-12-02,2018-12-02,Office supplies,REF61010757,27.06,0.0,182218.26
2018-12-03,2018-12-03,Office supplies,REF39810589,33.12,0.0,182185.14
2018-12-08,2018-12-08,Marketing expenses,REF58898743,185.1,0.0,182000.04
2018-12-08,2018-12-08,Equipment purchase,REF44427676,73.18,0.0,181926.86
2018-12-08,2018-12-08,Business travel,REF54037250,134.88,0.0,181791.98
2018-12-09,2018-12-09,Software subscription,REF85126900,109.95,0.0,181682.03
2018-12-10,2018-12-10,Office supplies,REF40709912,53.14,0.0,181628.89
2018-12-14,2018-12-14,Professional services,REF96521337,305.17,0.0,181323.72
2018-12-15,2018-12-15,Invoice payment - Gordon PLC,REF59197780,0.0,1036.69,182360.41
2018-12-15,2018-12-15,Payment from Jackson-Wilcox,REF15568283,0.0,1351.67,183712.08
2018-12-15,2018-12-15,Payment from Abbott-Harrison,REF57114142,0.0,922.21,184634.29
2018-12-15,2018-12-15,Business insurance premium,REF72775674,109.41,0.0,184524.88
2018-12-23,2018-12-23,Office supplies,REF15890100,35.11,0.0,184489.77
2018-12-28,2018-12-28,Office supplies,REF27714393,38.64,0.0,184451.13
2018-12-30,2018-12-30,Office supplies,REF64870861,75.69,0.0,184375.44
2019-01-09,2019-01-09,Software subscription,REF11610490,114.62,0.0,184260.82
2019-01-09,2019-01-09,Equipment purchase,REF73174601,111.48,0.0,184149.34
2019-01-10,2019-01-10,Marketing expenses,REF56400844,182.62,0.0,183966.72
2019-01-11,2019-01-11,Marketing expenses,REF75042701,124.09,0.0,183842.63
2019-01-11,2019-01-11,Equipment purchase,REF64317491,90.71,0.0,183751.92
2019-01-13,2019-01-13,Internet and phone service,REF55942163,84.64,0.0,183667.28
2019-01-14,2019-01-14,Internet and phone service,REF79280012,56.98,0.0,183610.3
2019-01-15,2019-01-15,Invoice payment - Jackson-Wilcox,REF40520615,0.0,1097.81,184708.11
2019-01-15,2019-01-15,Service payment - Gordon PLC,REF60256960,0.0,1351.81,186059.92
2019-01-15,2019-01-15,Payment from Abbott-Harrison,REF94506447,0.0,1172.66,187232.58
2019-01-15,2019-01-15,Business insurance premium,REF90699786,94.78,0.0,187137.8
2019-01-16,2019-01-16,Office supplies,REF93289506,42.14,0.0,187095.66
2019-01-20,2019-01-20,Business travel,REF15865205,120.61,0.0,186975.05
2019-01-24,2019-01-24,Office supplies,REF60151217,42.94,0.0,186932.11
2019-01-28,2019-01-28,Professional services,REF73401989,205.54,0.0,186726.57
2019-02-01,2019-02-01,Training/conference,REF20709658,80.55,0.0,186646.02
2019-02-01,2019-02-01,Equipment purchase,REF22438303,92.88,0.0,186553.14
2019-02-08,2019-02-08,Training/conference,REF70029468,60.59,0.0,186492.55
2019-02-09,2019-02-09,Software subscription,REF32082395,127.71,0.0,186364.84
2019-02-10,2019-02-10,Equipment purchase,REF98233742,107.16,0.0,186257.68
2019-02-13,2019-02-13,Professional services,REF66920041,283.49,0.0,185974.19
2019-02-15,2019-02-15,Business insurance premium,REF68375510,110.15,0.0,185864.04
2019-02-15,2019-02-15,Project payment - Abbott-Harrison,REF74993446,0.0,908.35,186772.39
2019-02-15,2019-02-15,Service payment - Jackson-Wilcox,REF65880948,0.0,1482.14,188254.53
2019-02-15,2019-02-15,Invoice payment - Gordon PLC,REF35078527,0.0,1076.37,189330.9
2019-02-23,2019-02-23,Office supplies,REF59087041,32.47,0.0,189298.43
2019-02-26,2019-02-26,Equipment purchase,REF43281302,73.78,0.0,189224.65
2019-03-06,2019-03-06,Training/conference,REF56080785,82.14,0.0,189142.51
2019-03-07,2019-03-07,Office supplies,REF83442858,56.66,0.0,189085.85
2019-03-09,2019-03-09,Software subscription,REF39956899,158.92,0.0,188926.93
2019-03-10,2019-03-10,Internet and phone service,REF13913442,79.32,0.0,188847.61
2019-03-11,2019-03-11,Marketing expenses,REF36576708,182.77,0.0,188664.84
2019-03-15,2019-03-15,Payment from Abbott-Harrison,REF58159206,0.0,1391.56,190056.4
2019-03-15,2019-03-15,Service payment - Gordon PLC,REF62633242,0.0,1277.25,191333.65
2019-03-15,2019-03-15,Business insurance premium,REF46238859,137.55,0.0,191196.1
2019-03-15,2019-03-15,Service payment - Jackson-Wilcox,REF20150173,0.0,1518.57,192714.67
2019-03-29,2019-03-29,Office supplies,REF82257385,44.64,0.0,192670.03
2019-04-04,2019-04-04,Professional services,REF38749001,283.28,0.0,192386.75
2019-04-05,2019-04-05,Marketing expenses,REF89029927,233.83,0.0,192152.92
2019-04-07,2019-04-07,Marketing expenses,REF30412346,172.58,0.0,191980.34
2019-04-09,2019-04-09,Software subscription,REF26686958,142.4,0.0,191837.94
2019-04-11,2019-04-11,Professional services,REF45769530,282.22,0.0,191555.72
2019-04-15,2019-04-15,Service payment - Jackson-Wilcox,REF86347021,0.0,1037.96,192593.68
2019-04-15,2019-04-15,Payment from Gordon PLC,REF97757679,0.0,1051.63,193645.31
2019-04-15,2019-04-15,Payment from Abbott-Harrison,REF29984460,0.0,731.12,194376.43
2019-04-15,2019-04-15,Office supplies,REF84294572,72.25,0.0,194304.18
2019-04-15,2019-04-15,Business insurance premium,REF15138041,118.79,0.0,194185.39
2019-04-16,2019-04-16,Business travel,REF95673361,124.48,0.0,194060.91
2019-04-18,2019-04-18,Business travel,REF30304763,176.65,0.0,193884.26
2019-05-03,2019-05-03,Office supplies,REF48930976,89.97,0.0,193794.29
2019-05-09,2019-05-09,Software subscription,REF61052717,136.33,0.0,193657.96
2019-05-12,2019-05-12,Office supplies,REF19343304,22.6,0.0,193635.36
2019-05-14,2019-05-14,Marketing expenses,REF32904871,119.21,0.0,193516.15
2019-05-15,2019-05-15,Business insurance premium,REF46740203,126.86,0.0,193389.29
2019-05-15,2019-05-15,Service payment - Gordon PLC,REF31620973,0.0,1579.88,194969.17
2019-05-15,2019-05-15,Invoice payment - Abbott-Harrison,REF98518068,0.0,1268.29,196237.46
2019-05-15,2019-05-15,Payment from Jackson-Wilcox,REF63681876,0.0,1183.49,197420.95
2019-05-26,2019-05-26,Office supplies,REF91898012,38.48,0.0,197382.47
2019-05-31,2019-05-31,Internet and phone service,REF55128918,89.74,0.0,197292.73
2019-06-02,2019-06-02,Office supplies,REF59155751,35.19,0.0,197257.54
2019-06-05,2019-06-05,Office supplies,REF27837491,45.83,0.0,197211.71
2019-06-09,2019-06-09,Software subscription,REF11496958,134.77,0.0,197076.94
2019-06-11,2019-06-11,Business travel,REF20001818,163.01,0.0,196913.93
2019-06-15,2019-06-15,Invoice payment - Jackson-Wilcox,REF61798570,0.0,1066.81,197980.74
2019-06-15,2019-06-15,Business insurance premium,REF59228555,111.46,0.0,197869.28
2019-06-15,2019-06-15,Service payment - Abbott-Harrison,REF74141929,0.0,1075.88,198945.16
2019-06-15,2019-06-15,Invoice payment - Gordon PLC,REF34138317,0.0,1240.79,200185.95
2019-06-16,2019-06-16,Training/conference,REF44050975,51.98,0.0,200133.97
2019-06-17,2019-06-17,Internet and phone service,REF69315312,63.26,0.0,200070.71
2019-06-19,2019-06-19,Office supplies,REF25209617,42.6,0.0,200028.11
2019-06-23,2019-06-23,Training/conference,REF75197206,44.19,0.0,199983.92
2019-06-23,2019-06-23,Office supplies,REF70030827,48.25,0.0,199935.67
2019-06-27,2019-06-27,Training/conference,REF23307181,51.02,0.0,199884.65
2019-07-04,2019-07-04,Business travel,REF46307720,85.75,0.0,199798.9
2019-07-09,2019-07-09,Software subscription,REF47460567,100.56,0.0,199698.34
2019-07-09,2019-07-09,Training/conference,REF40362516,98.87,0.0,199599.47
2019-07-15,2019-07-15,Office supplies,REF40266291,67.94,0.0,199531.53
2019-07-15,2019-07-15,Service payment - Gordon PLC,REF77883574,0.0,1149.81,200681.34
2019-07-15,2019-07-15,Business insurance premium,REF93397245,94.08,0.0,200587.26
2019-07-15,2019-07-15,Project payment - Jackson-Wilcox,REF74269581,0.0,1213.15,201800.41
2019-07-15,2019-07-15,Service payment - Abbott-Harrison,REF95564113,0.0,1068.02,202868.43
2019-07-17,2019-07-17,Equipment purchase,REF96180049,111.48,0.0,202756.95
2019-07-25,2019-07-25,Professional services,REF11501278,179.68,0.0,202577.27
2019-07-28,2019-07-28,Training/conference,REF84197846,39.52,0.0,202537.75
2019-08-03,2019-08-03,Marketing expenses,REF80912880,139.38,0.0,202398.37
2019-08-05,2019-08-05,Marketing expenses,REF17637418,124.77,0.0,202273.6
2019-08-09,2019-08-09,Software subscription,REF95698374,117.4,0.0,202156.2
2019-08-10,2019-08-10,Training/conference,REF31127619,91.56,0.0,202064.64
2019-08-11,2019-08-11,Office supplies,REF96214041,22.47,0.0,202042.17
2019-08-13,2019-08-13,Office supplies,REF42158764,29.02,0.0,202013.15
2019-08-15,2019-08-15,Business insurance premium,REF44435844,77.33,0.0,201935.82
2019-08-15,2019-08-15,Payment from Abbott-Harrison,REF18157111,0.0,979.41,202915.23
2019-08-15,2019-08-15,Invoice payment - Gordon PLC,REF67377410,0.0,1177.61,204092.84
2019-08-28,2019-08-28,Marketing expenses,REF69147830,121.04,0.0,203971.8
2019-09-07,2019-09-07,Internet and phone service,REF11206899,35.65,0.0,203936.15
2019-09-08,2019-09-08,Office supplies,REF47659008,41.44,0.0,203894.71
2019-09-09,2019-09-09,Software subscription,REF42738184,188.85,0.0,203705.86
2019-09-15,2019-09-15,Business insurance premium,REF23246384,129.99,0.0,203575.87
2019-09-15,2019-09-15,Service payment - Jackson-Wilcox,REF65201327,0.0,1216.65,204792.52
2019-09-15,2019-09-15,Invoice payment - Abbott-Harrison,REF88433881,0.0,1215.38,206007.9
2019-09-15,2019-09-15,Project payment - Gordon PLC,REF37897737,0.0,1202.88,207210.78
2019-09-16,2019-09-16,Equipment purchase,REF59165789,178.18,0.0,207032.6
2019-09-17,2019-09-17,Equipment purchase,REF70227585,125.2,0.0,206907.4
2019-09-20,2019-09-20,Internet and phone service,REF16096648,101.52,0.0,206805.88
2019-09-21,2019-09-21,Marketing expenses,REF42037682,296.48,0.0,206509.4
2019-09-21,2019-09-21,Internet and phone service,REF32901021,96.44,0.0,206412.96
2019-09-25,2019-09-25,Equipment purchase,REF53243506,105.6,0.0,206307.36
2019-09-30,2019-09-30,Equipment purchase,REF64646778,57.51,0.0,206249.85
2019-09-30,2019-09-30,Internet and phone service,REF56984263,92.15,0.0,206157.7
2019-10-04,2019-10-04,Office supplies,REF16649713,63.07,0.0,206094.63
2019-10-08,2019-10-08,Business travel,REF44833791,228.19,0.0,205866.44
2019-10-08,2019-10-08,Office supplies,REF87889176,66.52,0.0,205799.92
2019-10-09,2019-10-09,Software subscription,REF56375916,196.65,0.0,205603.27
2019-10-09,2019-10-09,Training/conference,REF42152955,156.48,0.0,205446.79
2019-10-15,2019-10-15,Invoice payment - Jackson-Wilcox,REF79248485,0.0,1368.01,206814.8
2019-10-15,2019-10-15,Service payment - Gordon PLC,REF59293880,0.0,1546.79,208361.59
2019-10-15,2019-10-15,Service payment - Abbott-Harrison,REF96376675,0.0,1550.22,209911.81
2019-10-15,2019-10-15,Business insurance premium,REF19540130,145.9,0.0,209765.91
2019-10-18,2019-10-18,Office supplies,REF93806964,44.4,0.0,209721.51
2019-10-27,2019-10-27,Office supplies,REF13108607,80.72,0.0,209640.79
2019-10-31,2019-10-31,Business travel,REF51317233,262.22,0.0,209378.57
2019-11-01,2019-11-01,Training/conference,REF87095012,98.72,0.0,209279.85
2019-11-04,2019-11-04,Equipment purchase,REF25088195,116.12,0.0,209163.73
2019-11-05,2019-11-05,Marketing expenses,REF74994021,147.93,0.0,209015.8
2019-11-07,2019-11-07,Internet and phone service,REF63296606,109.59,0.0,208906.21
2019-11-09,2019-11-09,Software subscription,REF39018318,170.53,0.0,208735.68
2019-11-15,2019-11-15,Service payment - Jackson-Wilcox,REF75561094,0.0,987.81,209723.49
2019-11-15,2019-11-15,Project payment - Abbott-Harrison,REF44751550,0.0,1308.0,211031.49
2019-11-15,2019-11-15,Business insurance premium,REF44031956,120.8,0.0,210910.69
2019-11-15,2019-11-15,Project payment - Gordon PLC,REF32158241,0.0,1114.58,212025.27
2019-11-17,2019-11-17,Internet and phone service,REF19492336,85.01,0.0,211940.26
2019-11-17,2019-11-17,Marketing expenses,REF63466882,301.54,0.0,211638.72
2019-11-21,2019-11-21,Office supplies,REF46765906,12.87,0.0,211625.85
2019-11-24,2019-11-24,Internet and phone service,REF58427986,93.65,0.0,211532.2
2019-12-02,2019-12-02,Training/conference,REF38303109,90.0,0.0,211442.2
2019-12-05,2019-12-05,Business travel,REF26965003,81.56,0.0,211360.64
2019-12-05,2019-12-05,Office supplies,REF53446393,47.16,0.0,211313.48
2019-12-09,2019-12-09,Software subscription,REF65145319,135.23,0.0,211178.25
2019-12-13,2019-12-13,Marketing expenses,REF55025309,193.09,0.0,210985.16
2019-12-15,2019-12-15,Service payment - Abbott-Harrison,REF12966479,0.0,1259.58,212244.74
2019-12-15,2019-12-15,Service payment - Jackson-Wilcox,REF63433013,0.0,1004.17,213248.91
2019-12-15,2019-12-15,Project payment - Gordon PLC,REF32385843,0.0,1152.29,214401.2
2019-12-15,2019-12-15,Business insurance premium,REF67157296,100.4,0.0,214300.8
2019-12-17,2019-12-17,Training/conference,REF49125890,91.48,0.0,214209.32
2019-12-17,2019-12-17,Business travel,REF79689237,157.05,0.0,214052.27
2019-12-25,2019-12-25,Equipment purchase,REF57379387,130.06,0.0,213922.21
2020-01-01,2020-01-01,Equipment purchase,REF44964674,107.0,0.0,213815.21
2020-01-05,2020-01-05,Marketing expenses,REF79849073,170.4,0.0,213644.81
2020-01-08,2020-01-08,Equipment purchase,REF82088823,75.28,0.0,213569.53
2020-01-09,2020-01-09,Office supplies,REF69867513,29.95,0.0,213539.58
2020-01-09,2020-01-09,Software subscription,REF68122559,125.93,0.0,213413.65
2020-01-13,2020-01-13,Equipment purchase,REF74010623,74.32,0.0,213339.33
2020-01-15,2020-01-15,Business insurance premium,REF57814304,92.34,0.0,213246.99
2020-01-15,2020-01-15,Payment from Jackson-Wilcox,REF96955245,0.0,1164.14,214411.13
2020-01-15,2020-01-15,Invoice payment - Abbott-Harrison,REF98881830,0.0,907.61,215318.74
2020-01-18,2020-01-18,Office supplies,REF23625805,38.56,0.0,215280.18
2020-01-21,2020-01-21,Office supplies,REF86211995,47.48,0.0,215232.7
2020-01-21,2020-01-21,Internet and phone service,REF79073914,52.77,0.0,215179.93
2020-01-22,2020-01-22,Training/conference,REF32749774,34.15,0.0,215145.78
2020-01-24,2020-01-24,Training/conference,REF80898037,96.23,0.0,215049.55
2020-01-24,2020-01-24,Internet and phone service,REF50796446,84.05,0.0,214965.5
2020-02-05,2020-02-05,Business travel,REF94292964,162.31,0.0,214803.19
2020-02-09,2020-02-09,Software subscription,REF55480225,124.65,0.0,214678.54
2020-02-10,2020-02-10,Office supplies,REF22367376,43.71,0.0,214634.83
2020-02-11,2020-02-11,Professional services,REF98686091,206.34,0.0,214428.49
2020-02-15,2020-02-15,Business insurance premium,REF40261018,101.59,0.0,214326.9
2020-02-15,2020-02-15,Invoice payment - Gordon PLC,REF96273703,0.0,1007.72,215334.62
2020-02-15,2020-02-15,Service payment - Jackson-Wilcox,REF34328900,0.0,923.24,216257.86
2020-02-15,2020-02-15,Service payment - Abbott-Harrison,REF13660617,0.0,1023.06,217280.92
2020-02-19,2020-02-19,Business travel,REF57207644,109.12,0.0,217171.8
2020-02-22,2020-02-22,Equipment purchase,REF95968777,63.57,0.0,217108.23
2020-02-24,2020-02-24,Professional services,REF88786617,224.3,0.0,216883.93
2020-02-25,2020-02-25,Business travel,REF61584572,221.69,0.0,216662.24
2020-02-27,2020-02-27,Internet and phone service,REF12776212,76.58,0.0,216585.66
2020-02-27,2020-02-27,Training/conference,REF55604254,118.71,0.0,216466.95
2020-02-28,2020-02-28,Office supplies,REF25625986,45.15,0.0,216421.8
2020-02-29,2020-02-29,Professional services,REF37485837,267.27,0.0,216154.53
2020-03-01,2020-03-01,Office supplies,REF59497670,68.07,0.0,216086.46
2020-03-02,2020-03-02,Office supplies,REF92430305,58.86,0.0,216027.6
2020-03-04,2020-03-04,Business travel,REF88241333,18.3,0.0,216009.3
2020-03-09,2020-03-09,Professional services,REF96862528,249.96,0.0,215759.34
2020-03-09,2020-03-09,Software subscription,REF46497996,161.76,0.0,215597.58
2020-03-15,2020-03-15,Invoice payment - Jackson-Wilcox,REF68537843,0.0,1120.81,216718.39
2020-03-15,2020-03-15,Service payment - Gordon PLC,REF32377416,0.0,1291.75,218010.14
2020-03-15,2020-03-15,Invoice payment - Abbott-Harrison,REF90297673,0.0,1112.17,219122.31
2020-03-15,2020-03-15,Office supplies,REF54647845,56.18,0.0,219066.13
2020-03-15,2020-03-15,Business insurance premium,REF76981013,135.7,0.0,218930.43
2020-03-19,2020-03-19,Business travel,REF62714576,202.74,0.0,218727.69
2020-03-19,2020-03-19,Marketing expenses,REF97083570,330.38,0.0,218397.31
2020-03-23,2020-03-23,Equipment purchase,REF85853427,167.29,0.0,218230.02
2020-03-23,2020-03-23,Internet and phone service,REF53516290,81.04,0.0,218148.98
2020-03-25,2020-03-25,Office supplies,REF14074066,70.02,0.0,218078.96
2020-04-03,2020-04-03,Office supplies,REF38756781,54.73,0.0,218024.23
2020-04-04,2020-04-04,Office supplies,REF79269023,66.46,0.0,217957.77
2020-04-04,2020-04-04,Marketing expenses,REF37064263,137.68,0.0,217820.09
2020-04-06,2020-04-06,Internet and phone service,REF57581132,57.21,0.0,217762.88
2020-04-08,2020-04-08,Office supplies,REF67926994,28.83,0.0,217734.05
2020-04-09,2020-04-09,Software subscription,REF30527356,136.2,0.0,217597.85
2020-04-09,2020-04-09,Professional services,REF71930995,261.87,0.0,217335.98
2020-04-15,2020-04-15,Business insurance premium,REF95477877,120.29,0.0,217215.69
2020-04-15,2020-04-15,Payment from Jackson-Wilcox,REF92965645,0.0,1197.07,218412.76
2020-04-15,2020-04-15,Service payment - Abbott-Harrison,REF54192644,0.0,1059.8,219472.56
2020-04-15,2020-04-15,Invoice payment - Gordon PLC,REF36132570,0.0,1510.12,220982.68
2020-04-16,2020-04-16,Business travel,REF49515106,159.13,0.0,220823.55
2020-04-18,2020-04-18,Office supplies,REF24230870,55.43,0.0,220768.12
2020-04-20,2020-04-20,Business travel,REF98374711,92.91,0.0,220675.21
2020-04-20,2020-04-20,Internet and phone service,REF67673798,96.19,0.0,220579.02
2020-04-26,2020-04-26,Training/conference,REF54055676,84.09,0.0,220494.93
2020-04-29,2020-04-29,Business travel,REF21993119,145.81,0.0,220349.12
2020-04-29,2020-04-29,Training/conference,REF83820912,149.02,0.0,220200.1
2020-04-29,2020-04-29,Office supplies,REF46838667,50.91,0.0,220149.19
2020-05-02,2020-05-02,Marketing expenses,REF46736462,203.66,0.0,219945.53
2020-05-07,2020-05-07,Business travel,REF23450144,92.29,0.0,219853.24
2020-05-09,2020-05-09,Software subscription,REF86981124,125.15,0.0,219728.09
2020-05-10,2020-05-10,Business travel,REF91925968,85.92,0.0,219642.17
2020-05-11,2020-05-11,Professional services,REF87325278,295.63,0.0,219346.54
2020-05-14,2020-05-14,Office supplies,REF44878698,56.67,0.0,219289.87
2020-05-14,2020-05-14,Professional services,REF48119302,198.81,0.0,219091.06
2020-05-15,2020-05-15,Business insurance premium,REF53015888,111.76,0.0,218979.3
2020-05-15,2020-05-15,Invoice payment - Gordon PLC,REF31756847,0.0,1269.29,220248.59
2020-05-15,2020-05-15,Invoice payment - Abbott-Harrison,REF66227843,0.0,1274.12,221522.71
2020-05-15,2020-05-15,Invoice payment - Jackson-Wilcox,REF70450204,0.0,1195.68,222718.39
2020-05-17,2020-05-17,Office supplies,REF55162695,35.31,0.0,222683.08
2020-05-22,2020-05-22,Professional services,REF13697107,276.39,0.0,222406.69
2020-05-28,2020-05-28,Marketing expenses,REF96656665,212.22,0.0,222194.47
2020-05-29,2020-05-29,Office supplies,REF29049405,69.6,0.0,222124.87
2020-06-03,2020-06-03,Professional services,REF19241962,391.7,0.0,221733.17
2020-06-03,2020-06-03,Training/conference,REF49042885,88.78,0.0,221644.39
2020-06-06,2020-06-06,Office supplies,REF30701243,51.66,0.0,221592.73
2020-06-09,2020-06-09,Software subscription,REF35025860,138.36,0.0,221454.37
2020-06-11,2020-06-11,Business travel,REF93705323,164.2,0.0,221290.17
2020-06-12,2020-06-12,Equipment purchase,REF73356509,102.31,0.0,221187.86
2020-06-14,2020-06-14,Office supplies,REF66492872,43.53,0.0,221144.33
2020-06-15,2020-06-15,Payment from Abbott-Harrison,REF64315729,0.0,1083.92,222228.25
2020-06-15,2020-06-15,Business insurance premium,REF34384370,110.02,0.0,222118.23
2020-06-15,2020-06-15,Project payment - Gordon PLC,REF55704117,0.0,1470.86,223589.09
2020-06-18,2020-06-18,Office supplies,REF16525233,45.5,0.0,223543.59
2020-06-23,2020-06-23,Office supplies,REF12269478,52.28,0.0,223491.31
2020-06-24,2020-06-24,Internet and phone service,REF62695446,42.01,0.0,223449.3
2020-06-26,2020-06-26,Internet and phone service,REF32163629,47.88,0.0,223401.42
2020-07-02,2020-07-02,Office supplies,REF78229654,45.0,0.0,223356.42
2020-07-08,2020-07-08,Office supplies,REF34579854,29.9,0.0,223326.52
2020-07-09,2020-07-09,Software subscription,REF98155172,122.22,0.0,223204.3
2020-07-11,2020-07-11,Marketing expenses,REF85622168,219.41,0.0,222984.89
2020-07-13,2020-07-13,Training/conference,REF37794840,107.43,0.0,222877.46
2020-07-13,2020-07-13,Professional services,REF91091738,163.73,0.0,222713.73
2020-07-14,2020-07-14,Marketing expenses,REF60101611,229.58,0.0,222484.15
2020-07-15,2020-07-15,Office supplies,REF28227652,50.37,0.0,222433.78
2020-07-15,2020-07-15,Project payment - Jackson-Wilcox,REF58567085,0.0,1062.95,223496.73
2020-07-15,2020-07-15,Service payment - Abbott-Harrison,REF19308864,0.0,897.49,224394.22
2020-07-15,2020-07-15,Business insurance premium,REF70923085,92.24,0.0,224301.98
2020-07-17,2020-07-17,Marketing expenses,REF13971713,233.96,0.0,224068.02
2020-07-20,2020-07-20,Internet and phone service,REF14425934,75.8,0.0,223992.22
2020-07-21,2020-07-21,Office supplies,REF69041168,59.79,0.0,223932.43
2020-07-23,2020-07-23,Office supplies,REF55641483,43.87,0.0,223888.56
2020-07-26,2020-07-26,Office supplies,REF14620761,8.42,0.0,223880.14
2020-07-29,2020-07-29,Marketing expenses,REF31228955,184.6,0.0,223695.54
2020-08-02,2020-08-02,Training/conference,REF83114901,33.59,0.0,223661.95
2020-08-07,2020-08-07,Business travel,REF71499399,76.06,0.0,223585.89
2020-08-09,2020-08-09,Software subscription,REF67791414,100.76,0.0,223485.13
2020-08-11,2020-08-11,Marketing expenses,REF71183103,129.27,0.0,223355.86
2020-08-13,2020-08-13,Office supplies,REF14817182,19.28,0.0,223336.58
2020-08-13,2020-08-13,Equipment purchase,REF73872899,74.22,0.0,223262.36
2020-08-15,2020-08-15,Business insurance premium,REF97017164,80.51,0.0,223181.85
2020-08-15,2020-08-15,Project payment - Jackson-Wilcox,REF71392128,0.0,649.86,223831.71
2020-08-15,2020-08-15,Payment from Gordon PLC,REF85011100,0.0,948.12,224779.83
2020-08-15,2020-08-15,Service payment - Abbott-Harrison,REF29591366,0.0,832.74,225612.57
2020-08-17,2020-08-17,Office supplies,REF62122458,27.86,0.0,225584.71
2020-08-17,2020-08-17,Training/conference,REF16710134,83.81,0.0,225500.9
2020-08-22,2020-08-22,Office supplies,REF27294999,51.12,0.0,225449.78
2020-08-23,2020-08-23,Equipment purchase,REF60520420,64.43,0.0,225385.35
2020-08-26,2020-08-26,Training/conference,REF99633407,43.79,0.0,225341.56
2020-08-26,2020-08-26,Office supplies,REF88318758,40.42,0.0,225301.14
2020-09-01,2020-09-01,Business travel,REF28361438,85.86,0.0,225215.28
2020-09-04,2020-09-04,Office supplies,REF84675581,48.79,0.0,225166.49
2020-09-04,2020-09-04,Equipment purchase,REF83053298,90.54,0.0,225075.95
2020-09-09,2020-09-09,Software subscription,REF89480344,137.73,0.0,224938.22
2020-09-09,2020-09-09,Marketing expenses,REF52031153,213.76,0.0,224724.46
2020-09-10,2020-09-10,Business travel,REF85872897,127.14,0.0,224597.32
2020-09-15,2020-09-15,Project payment - Jackson-Wilcox,REF32584302,0.0,1593.83,226191.15
2020-09-15,2020-09-15,Business insurance premium,REF60985312,126.21,0.0,226064.94
2020-09-15,2020-09-15,Invoice payment - Gordon PLC,REF42560658,0.0,1381.99,227446.93
2020-09-16,2020-09-16,Training/conference,REF69262668,148.92,0.0,227298.01
2020-09-19,2020-09-19,Internet and phone service,REF22610096,57.71,0.0,227240.3
2020-09-27,2020-09-27,Office supplies,REF53049907,25.24,0.0,227215.06
2020-10-01,2020-10-01,Professional services,REF29577926,193.77,0.0,227021.29
2020-10-04,2020-10-04,Office supplies,REF66017793,91.03,0.0,226930.26
2020-10-06,2020-10-06,Equipment purchase,REF57203833,134.59,0.0,226795.67
2020-10-09,2020-10-09,Software subscription,REF82904822,150.01,0.0,226645.66
2020-10-14,2020-10-14,Equipment purchase,REF50113111,130.47,0.0,226515.19
2020-10-14,2020-10-14,Office supplies,REF43163763,39.62,0.0,226475.57
2020-10-15,2020-10-15,Project payment - Jackson-Wilcox,REF52664621,0.0,2034.86,228510.43
2020-10-15,2020-10-15,Business travel,REF34351812,148.35,0.0,228362.08
2020-10-15,2020-10-15,Business insurance premium,REF11477084,150.29,0.0,228211.79
2020-10-15,2020-10-15,Payment from Gordon PLC,REF47576900,0.0,1436.03,229647.82
2020-10-15,2020-10-15,Service payment - Abbott-Harrison,REF43098743,0.0,1253.83,230901.65
2020-10-16,2020-10-16,Office supplies,REF39856303,72.99,0.0,230828.66
2020-10-16,2020-10-16,Marketing expenses,REF46051366,290.67,0.0,230537.99
2020-10-19,2020-10-19,Internet and phone service,REF10852418,149.64,0.0,230388.35
2020-10-20,2020-10-20,Equipment purchase,REF31975366,186.57,0.0,230201.78
2020-10-23,2020-10-23,Office supplies,REF78130025,76.5,0.0,230125.28
2020-10-25,2020-10-25,Business travel,REF64960742,154.51,0.0,229970.77
2020-10-31,2020-10-31,Business travel,REF51099409,221.59,0.0,229749.18
2020-11-05,2020-11-05,Office supplies,REF16334795,23.85,0.0,229725.33
2020-11-08,2020-11-08,Equipment purchase,REF74935977,112.23,0.0,229613.1
2020-11-09,2020-11-09,Software subscription,REF69569495,140.18,0.0,229472.92
2020-11-09,2020-11-09,Professional services,REF19929779,388.45,0.0,229084.47
2020-11-09,2020-11-09,Equipment purchase,REF16010467,108.85,0.0,228975.62
2020-11-13,2020-11-13,Marketing expenses,REF82961733,232.4,0.0,228743.22
2020-11-15,2020-11-15,Business insurance premium,REF30432066,120.43,0.0,228622.79
2020-11-15,2020-11-15,Service payment - Jackson-Wilcox,REF75652257,0.0,1089.71,229712.5
2020-11-22,2020-11-22,Equipment purchase,REF73944876,172.6,0.0,229539.9
2020-11-24,2020-11-24,Marketing expenses,REF85757289,156.99,0.0,229382.91
2020-11-28,2020-11-28,Equipment purchase,REF39750800,121.67,0.0,229261.24
2020-12-03,2020-12-03,Office supplies,REF41383990,22.09,0.0,229239.15
2020-12-04,2020-12-04,Office supplies,REF66755171,45.96,0.0,229193.19
2020-12-07,2020-12-07,Business travel,REF91249549,163.59,0.0,229029.6
2020-12-09,2020-12-09,Software subscription,REF10803520,144.0,0.0,228885.6
2020-12-11,2020-12-11,Marketing expenses,REF99147693,210.37,0.0,228675.23
2020-12-12,2020-12-12,Marketing expenses,REF18986390,228.51,0.0,228446.72
2020-12-13,2020-12-13,Internet and phone service,REF75094298,57.06,0.0,228389.66
2020-12-14,2020-12-14,Equipment purchase,REF46217664,74.42,0.0,228315.24
2020-12-15,2020-12-15,Internet and phone service,REF61082087,106.71,0.0,228208.53
2020-12-15,2020-12-15,Service payment - Jackson-Wilcox,REF83212745,0.0,1305.11,229513.64
2020-12-15,2020-12-15,Business insurance premium,REF56260320,101.76,0.0,229411.88
2020-12-15,2020-12-15,Invoice payment - Abbott-Harrison,REF66864992,0.0,979.3,230391.18
2020-12-15,2020-12-15,Payment from Gordon PLC,REF46878792,0.0,993.72,231384.9
2020-12-17,2020-12-17,Office supplies,REF51200947,50.32,0.0,231334.58
2020-12-19,2020-12-19,Equipment purchase,REF47409665,95.83,0.0,231238.75
2020-12-24,2020-12-24,Training/conference,REF93956363,107.85,0.0,231130.9
2020-12-25,2020-12-25,Office supplies,REF24553857,43.21,0.0,231087.69
2020-12-26,2020-12-26,Office supplies,REF54434600,57.42,0.0,231030.27
2020-12-26,2020-12-26,Business travel,REF38896959,72.84,0.0,230957.43
2021-01-09,2021-01-09,Training/conference,REF97712302,73.88,0.0,230883.55
2021-01-09,2021-01-09,Software subscription,REF15220600,101.85,0.0,230781.7
2021-01-13,2021-01-13,Office supplies,REF50097498,36.85,0.0,230744.85
2021-01-15,2021-01-15,Business insurance premium,REF66118759,100.53,0.0,230644.32
2021-01-15,2021-01-15,Project payment - Gordon PLC,REF26806445,0.0,1300.57,231944.89
2021-01-15,2021-01-15,Invoice payment - Jackson-Wilcox,REF41907719,0.0,1180.55,233125.44
2021-01-15,2021-01-15,Project payment - Abbott-Harrison,REF26039547,0.0,1187.11,234312.55
2021-01-17,2021-01-17,Office supplies,REF81964704,45.27,0.0,234267.28
2021-02-04,2021-02-04,Internet and phone service,REF38687104,75.73,0.0,234191.55
2021-02-06,2021-02-06,Internet and phone service,REF40862610,74.25,0.0,234117.3
2021-02-07,2021-02-07,Office supplies,REF79269486,48.07,0.0,234069.23
2021-02-08,2021-02-08,Business travel,REF59868534,136.11,0.0,233933.12
2021-02-08,2021-02-08,Office supplies,REF27388733,44.24,0.0,233888.88
2021-02-09,2021-02-09,Software subscription,REF44146870,153.32,0.0,233735.56
2021-02-11,2021-02-11,Training/conference,REF56334687,120.63,0.0,233614.93
2021-02-14,2021-02-14,Marketing expenses,REF68300988,233.01,0.0,233381.92
2021-02-15,2021-02-15,Project payment - Gordon PLC,REF78966720,0.0,1145.06,234526.98
2021-02-15,2021-02-15,Business insurance premium,REF22647520,110.22,0.0,234416.76
2021-02-15,2021-02-15,Project payment - Jackson-Wilcox,REF77652115,0.0,1111.38,235528.14
2021-02-15,2021-02-15,Payment from Abbott-Harrison,REF70618204,0.0,1176.81,236704.95
2021-02-19,2021-02-19,Training/conference,REF51901640,114.05,0.0,236590.9
2021-02-19,2021-02-19,Internet and phone service,REF50830840,104.3,0.0,236486.6
2021-03-04,2021-03-04,Business travel,REF72079129,125.7,0.0,236360.9
2021-03-09,2021-03-09,Software subscription,REF48748705,186.49,0.0,236174.41
2021-03-09,2021-03-09,Office supplies,REF67210967,66.01,0.0,236108.4
2021-03-10,2021-03-10,Office supplies,REF62904409,28.93,0.0,236079.47
2021-03-12,2021-03-12,Office supplies,REF68559423,37.78,0.0,236041.69
2021-03-15,2021-03-15,Service payment - Abbott-Harrison,REF95017920,0.0,1257.22,237298.91
2021-03-15,2021-03-15,Business insurance premium,REF27338791,130.47,0.0,237168.44
2021-03-15,2021-03-15,Payment from Gordon PLC,REF14573574,0.0,1420.83,238589.27
2021-03-15,2021-03-15,Office supplies,REF29636188,46.03,0.0,238543.24
2021-03-16,2021-03-16,Marketing expenses,REF59322527,284.77,0.0,238258.47
2021-03-24,2021-03-24,Professional services,REF17398402,346.61,0.0,237911.86
2021-03-24,2021-03-24,Business travel,REF43764823,201.5,0.0,237710.36
2021-03-28,2021-03-28,Business travel,REF14967575,170.51,0.0,237539.85
2021-03-30,2021-03-30,Professional services,REF42501452,328.53,0.0,237211.32
2021-04-03,2021-04-03,Professional services,REF33794879,345.53,0.0,236865.79
2021-04-04,2021-04-04,Internet and phone service,REF48940971,61.52,0.0,236804.27
2021-04-06,2021-04-06,Marketing expenses,REF23323557,176.65,0.0,236627.62
2021-04-09,2021-04-09,Software subscription,REF41607325,162.42,0.0,236465.2
2021-04-15,2021-04-15,Invoice payment - Jackson-Wilcox,REF84502905,0.0,1265.97,237731.17
2021-04-15,2021-04-15,Service payment - Abbott-Harrison,REF84045194,0.0,1152.94,238884.11
2021-04-15,2021-04-15,Business insurance premium,REF60844293,118.53,0.0,238765.58
2021-04-17,2021-04-17,Business travel,REF69118138,155.94,0.0,238609.64
2021-04-18,2021-04-18,Marketing expenses,REF67020689,167.39,0.0,238442.25
2021-04-19,2021-04-19,Internet and phone service,REF75036475,86.4,0.0,238355.85
2021-04-23,2021-04-23,Office supplies,REF92165558,45.94,0.0,238309.91
2021-04-27,2021-04-27,Marketing expenses,REF19013893,234.9,0.0,238075.01
2021-04-29,2021-04-29,Office supplies,REF28890263,20.76,0.0,238054.25
2021-05-03,2021-05-03,Office supplies,REF12404263,52.2,0.0,238002.05
2021-05-05,2021-05-05,Business travel,REF20252190,189.28,0.0,237812.77
2021-05-05,2021-05-05,Professional services,REF62333283,359.77,0.0,237453.0
2021-05-05,2021-05-05,Equipment purchase,REF64906055,95.63,0.0,237357.37
2021-05-08,2021-05-08,Equipment purchase,REF27111071,128.06,0.0,237229.31
2021-05-09,2021-05-09,Software subscription,REF13365350,146.93,0.0,237082.38
2021-05-11,2021-05-11,Training/conference,REF39489129,130.75,0.0,236951.63
2021-05-11,2021-05-11,Office supplies,REF94138433,31.5,0.0,236920.13
2021-05-15,2021-05-15,Training/conference,REF72779333,137.68,0.0,236782.45
2021-05-15,2021-05-15,Service payment - Jackson-Wilcox,REF65527891,0.0,1269.6,238052.05
2021-05-15,2021-05-15,Payment from Abbott-Harrison,REF84288702,0.0,1029.4,239081.45
2021-05-15,2021-05-15,Service payment - Gordon PLC,REF95180212,0.0,1228.41,240309.86
2021-05-15,2021-05-15,Business insurance premium,REF52572446,114.1,0.0,240195.76
2021-05-23,2021-05-23,Office supplies,REF38308657,41.52,0.0,240154.24
2021-05-25,2021-05-25,Business travel,REF33538665,182.25,0.0,239971.99
2021-05-28,2021-05-28,Internet and phone service,REF99461548,62.26,0.0,239909.73
2021-05-30,2021-05-30,Office supplies,REF54636968,36.23,0.0,239873.5
2021-05-30,2021-05-30,Internet and phone service,REF45902763,114.63,0.0,239758.87
2021-06-02,2021-06-02,Business travel,REF97935223,140.38,0.0,239618.49
2021-06-04,2021-06-04,Office supplies,REF67830238,38.67,0.0,239579.82
2021-06-09,2021-06-09,Software subscription,REF42197116,136.78,0.0,239443.04
2021-06-15,2021-06-15,Office supplies,REF31809021,33.57,0.0,239409.47
2021-06-15,2021-06-15,Invoice payment - Jackson-Wilcox,REF88946377,0.0,1089.44,240498.91
2021-06-15,2021-06-15,Business insurance premium,REF30586159,110.16,0.0,240388.75
2021-06-15,2021-06-15,Payment from Gordon PLC,REF15686718,0.0,1205.97,241594.72
2021-06-19,2021-06-19,Training/conference,REF28363824,77.34,0.0,241517.38
2021-06-20,2021-06-20,Business travel,REF34523681,74.5,0.0,241442.88
2021-06-20,2021-06-20,Office supplies,REF80597872,35.8,0.0,241407.08
2021-06-25,2021-06-25,Office supplies,REF66092661,51.04,0.0,241356.04
2021-06-27,2021-06-27,Training/conference,REF51879971,60.85,0.0,241295.19
2021-06-30,2021-06-30,Internet and phone service,REF91145512,43.9,0.0,241251.29
2021-07-06,2021-07-06,Equipment purchase,REF22300242,78.28,0.0,241173.01
2021-07-06,2021-07-06,Professional services,REF65141881,202.3,0.0,240970.71
2021-07-07,2021-07-07,Business travel,REF10427521,93.86,0.0,240876.85
2021-07-09,2021-07-09,Software subscription,REF60466574,121.55,0.0,240755.3
2021-07-09,2021-07-09,Office supplies,REF37041416,41.68,0.0,240713.62
2021-07-12,2021-07-12,Equipment purchase,REF23781800,49.52,0.0,240664.1
2021-07-13,2021-07-13,Equipment purchase,REF59669119,119.85,0.0,240544.25
2021-07-15,2021-07-15,Project payment - Jackson-Wilcox,REF39289548,0.0,862.09,241406.34
2021-07-15,2021-07-15,Service payment - Gordon PLC,REF46760501,0.0,1273.31,242679.65
2021-07-15,2021-07-15,Business insurance premium,REF61033480,95.14,0.0,242584.51
2021-07-15,2021-07-15,Service payment - Abbott-Harrison,REF47491774,0.0,977.32,243561.83
2021-07-18,2021-07-18,Office supplies,REF11230470,46.75,0.0,243515.08
2021-07-19,2021-07-19,Office supplies,REF11349207,23.67,0.0,243491.41
2021-08-01,2021-08-01,Equipment purchase,REF47283482,35.31,0.0,243456.1
2021-08-03,2021-08-03,Equipment purchase,REF49059605,63.93,0.0,243392.17
2021-08-08,2021-08-08,Training/conference,REF39346539,109.48,0.0,243282.69
2021-08-09,2021-08-09,Software subscription,REF96924101,81.25,0.0,243201.44
2021-08-12,2021-08-12,Professional services,REF98112709,180.75,0.0,243020.69
2021-08-12,2021-08-12,Marketing expenses,REF14694959,159.8,0.0,242860.89
2021-08-15,2021-08-15,Service payment - Jackson-Wilcox,REF81683931,0.0,834.71,243695.6
2021-08-15,2021-08-15,Invoice payment - Abbott-Harrison,REF71701921,0.0,837.74,244533.34
2021-08-15,2021-08-15,Business insurance premium,REF13781596,84.03,0.0,244449.31
2021-08-15,2021-08-15,Invoice payment - Gordon PLC,REF59377440,0.0,765.34,245214.65
2021-08-16,2021-08-16,Business travel,REF59524173,86.86,0.0,245127.79
2021-08-19,2021-08-19,Office supplies,REF27769558,31.88,0.0,245095.91
2021-08-21,2021-08-21,Marketing expenses,REF95641398,149.77,0.0,244946.14
2021-08-24,2021-08-24,Business travel,REF27306273,143.35,0.0,244802.79
2021-08-28,2021-08-28,Marketing expenses,REF71803830,163.01,0.0,244639.78
2021-08-28,2021-08-28,Office supplies,REF41366501,39.23,0.0,244600.55
2021-08-30,2021-08-30,Marketing expenses,REF66086078,171.21,0.0,244429.34
2021-09-01,2021-09-01,Internet and phone service,REF58345646,56.31,0.0,244373.03
2021-09-08,2021-09-08,Equipment purchase,REF63713454,126.57,0.0,244246.46
2021-09-09,2021-09-09,Software subscription,REF66516335,128.51,0.0,244117.95
2021-09-12,2021-09-12,Marketing expenses,REF78282227,174.97,0.0,243942.98
2021-09-12,2021-09-12,Equipment purchase,REF96582051,199.0,0.0,243743.98
2021-09-15,2021-09-15,Business insurance premium,REF13311468,126.42,0.0,243617.56
2021-09-15,2021-09-15,Service payment - Gordon PLC,REF13444780,0.0,1192.97,244810.53
2021-09-15,2021-09-15,Project payment - Jackson-Wilcox,REF89691331,0.0,1190.57,246001.1
2021-09-19,2021-09-19,Internet and phone service,REF82652449,119.06,0.0,245882.04
2021-09-24,2021-09-24,Office supplies,REF63316665,60.97,0.0,245821.07
2021-09-26,2021-09-26,Marketing expenses,REF97604312,240.37,0.0,245580.7
2021-09-30,2021-09-30,Internet and phone service,REF87236600,100.77,0.0,245479.93
2021-10-02,2021-10-02,Office supplies,REF22903185,44.35,0.0,245435.58
2021-10-03,2021-10-03,Professional services,REF34715783,245.3,0.0,245190.28
2021-10-05,2021-10-05,Equipment purchase,REF54948415,96.18,0.0,245094.1
2021-10-09,2021-10-09,Software subscription,REF39699357,162.83,0.0,244931.27
2021-10-15,2021-10-15,Project payment - Gordon PLC,REF81029665,0.0,1928.46,246859.73
2021-10-15,2021-10-15,Payment from Jackson-Wilcox,REF45020736,0.0,1397.52,248257.25
2021-10-15,2021-10-15,Business insurance premium,REF67015845,137.93,0.0,248119.32
2021-10-16,2021-10-16,Office supplies,REF97992598,57.74,0.0,248061.58
2021-10-16,2021-10-16,Training/conference,REF94676880,119.45,0.0,247942.13
2021-10-18,2021-10-18,Office supplies,REF36892238,45.89,0.0,247896.24
2021-10-20,2021-10-20,Business travel,REF42452715,123.52,0.0,247772.72
2021-10-21,2021-10-21,Training/conference,REF92951141,112.42,0.0,247660.3
2021-10-30,2021-10-30,Business travel,REF49522993,196.23,0.0,247464.07
2021-11-03,2021-11-03,Office supplies,REF34945329,32.66,0.0,247431.41
2021-11-05,2021-11-05,Training/conference,REF32376492,92.84,0.0,247338.57
2021-11-08,2021-11-08,Business travel,REF14256211,187.57,0.0,247151.0
2021-11-09,2021-11-09,Software subscription,REF24896127,139.18,0.0,247011.82
2021-11-11,2021-11-11,Business travel,REF35437418,85.17,0.0,246926.65
2021-11-14,2021-11-14,Business travel,REF75088935,201.71,0.0,246724.94
2021-11-14,2021-11-14,Office supplies,REF50797011,36.35,0.0,246688.59
2021-11-15,2021-11-15,Project payment - Gordon PLC,REF77021307,0.0,1812.04,248500.63
2021-11-15,2021-11-15,Payment from Abbott-Harrison,REF20640138,0.0,1284.57,249785.2
2021-11-15,2021-11-15,Business insurance premium,REF98744362,138.68,0.0,249646.52
2021-11-18,2021-11-18,Marketing expenses,REF89138665,219.3,0.0,249427.22
2021-12-02,2021-12-02,Office supplies,REF56545268,23.65,0.0,249403.57
2021-12-06,2021-12-06,Equipment purchase,REF60695330,98.9,0.0,249304.67
2021-12-07,2021-12-07,Professional services,REF59917145,185.93,0.0,249118.74
2021-12-07,2021-12-07,Office supplies,REF65566160,29.61,0.0,249089.13
2021-12-08,2021-12-08,Office supplies,REF69998935,19.79,0.0,249069.34
2021-12-08,2021-12-08,Professional services,REF73067503,165.5,0.0,248903.84
2021-12-09,2021-12-09,Software subscription,REF86237639,156.53,0.0,248747.31
2021-12-09,2021-12-09,Office supplies,REF86722817,50.11,0.0,248697.2
2021-12-10,2021-12-10,Internet and phone service,REF13745986,81.72,0.0,248615.48
2021-12-11,2021-12-11,Business travel,REF13336585,124.57,0.0,248490.91
2021-12-12,2021-12-12,Equipment purchase,REF65016847,126.29,0.0,248364.62
2021-12-14,2021-12-14,Office supplies,REF94984121,48.55,0.0,248316.07
2021-12-15,2021-12-15,Invoice payment - Jackson-Wilcox,REF19240358,0.0,994.97,249311.04
2021-12-15,2021-12-15,Service payment - Abbott-Harrison,REF13380370,0.0,890.62,250201.66
2021-12-15,2021-12-15,Payment from Gordon PLC,REF28299733,0.0,1059.44,251261.1
2021-12-15,2021-12-15,Business insurance premium,REF56219996,106.32,0.0,251154.78
2021-12-16,2021-12-16,Equipment purchase,REF10952011,115.46,0.0,251039.32
2021-12-16,2021-12-16,Professional services,REF41146861,360.92,0.0,250678.4
2021-12-20,2021-12-20,Business travel,REF24134900,65.38,0.0,250613.02
2021-12-22,2021-12-22,Business travel,REF15650184,120.63,0.0,250492.39
2021-12-26,2021-12-26,Business travel,REF99793431,128.36,0.0,250364.03
2021-12-29,2021-12-29,Training/conference,REF34407780,98.75,0.0,250265.28
2021-12-30,2021-12-30,Training/conference,REF27469836,137.38,0.0,250127.9
2022-01-01,2022-01-01,Business travel,REF74010546,112.82,0.0,250015.08
2022-01-02,2022-01-02,Internet and phone service,REF39188487,62.99,0.0,249952.09
2022-01-02,2022-01-02,Office supplies,REF53821795,39.54,0.0,249912.55
2022-01-09,2022-01-09,Software subscription,REF42455393,109.21,0.0,249803.34
2022-01-10,2022-01-10,Equipment purchase,REF33775056,72.32,0.0,249731.02
2022-01-13,2022-01-13,Training/conference,REF25975966,110.79,0.0,249620.23
2022-01-14,2022-01-14,Training/conference,REF82579392,109.79,0.0,249510.44
2022-01-15,2022-01-15,Invoice payment - Abbott-Harrison,REF64361720,0.0,1123.07,250633.51
2022-01-15,2022-01-15,Business insurance premium,REF64471200,93.19,0.0,250540.32
2022-01-15,2022-01-15,Service payment - Jackson-Wilcox,REF84569243,0.0,1115.68,251656.0
2022-01-15,2022-01-15,Project payment - Gordon PLC,REF78192484,0.0,1076.93,252732.93
2022-01-16,2022-01-16,Training/conference,REF80393770,105.37,0.0,252627.56
2022-01-17,2022-01-17,Professional services,REF26959278,235.39,0.0,252392.17
2022-01-20,2022-01-20,Office supplies,REF13598838,39.36,0.0,252352.81
2022-01-26,2022-01-26,Professional services,REF28722691,176.33,0.0,252176.48
2022-02-08,2022-02-08,Business travel,REF59413955,72.7,0.0,252103.78
2022-02-09,2022-02-09,Office supplies,REF62023311,48.18,0.0,252055.6
2022-02-09,2022-02-09,Software subscription,REF17593427,130.92,0.0,251924.68
2022-02-10,2022-02-10,Internet and phone service,REF67224826,73.13,0.0,251851.55
2022-02-15,2022-02-15,Payment from Abbott-Harrison,REF76635069,0.0,1064.54,252916.09
2022-02-15,2022-02-15,Business insurance premium,REF89492973,114.67,0.0,252801.42
2022-02-15,2022-02-15,Project payment - Gordon PLC,REF43238205,0.0,1314.99,254116.41
2022-02-16,2022-02-16,Professional services,REF83173172,251.52,0.0,253864.89
2022-02-18,2022-02-18,Equipment purchase,REF75463111,44.45,0.0,253820.44
2022-02-19,2022-02-19,Business travel,REF47672506,116.34,0.0,253704.1
2022-02-20,2022-02-20,Training/conference,REF54143402,114.6,0.0,253589.5
2022-02-23,2022-02-23,Office supplies,REF81618638,21.1,0.0,253568.4
2022-02-26,2022-02-26,Business travel,REF90092295,117.89,0.0,253450.51
2022-02-27,2022-02-27,Business travel,REF12177981,155.11,0.0,253295.4
2022-03-06,2022-03-06,Equipment purchase,REF38918204,93.01,0.0,253202.39
2022-03-06,2022-03-06,Office supplies,REF91203238,54.34,0.0,253148.05
2022-03-09,2022-03-09,Internet and phone service,REF92790434,74.83,0.0,253073.22
2022-03-09,2022-03-09,Software subscription,REF42653868,157.78,0.0,252915.44
2022-03-13,2022-03-13,Internet and phone service,REF96852842,104.11,0.0,252811.33
2022-03-15,2022-03-15,Service payment - Abbott-Harrison,REF66520343,0.0,1401.88,254213.21
2022-03-15,2022-03-15,Invoice payment - Jackson-Wilcox,REF71150102,0.0,1438.81,255652.02
2022-03-15,2022-03-15,Professional services,REF23606098,228.63,0.0,255423.39
2022-03-15,2022-03-15,Business insurance premium,REF89385772,133.23,0.0,255290.16
2022-03-15,2022-03-15,Invoice payment - Gordon PLC,REF91329719,0.0,1698.66,256988.82
2022-03-23,2022-03-23,Training/conference,REF94465829,101.55,0.0,256887.27
2022-03-29,2022-03-29,Professional services,REF97452895,242.97,0.0,256644.3
2022-04-01,2022-04-01,Internet and phone service,REF85314634,99.46,0.0,256544.84
2022-04-02,2022-04-02,Internet and phone service,REF68451832,85.87,0.0,256458.97
2022-04-07,2022-04-07,Equipment purchase,REF24793542,78.05,0.0,256380.92
2022-04-08,2022-04-08,Equipment purchase,REF95540635,102.66,0.0,256278.26
2022-04-09,2022-04-09,Software subscription,REF88505501,135.57,0.0,256142.69
2022-04-13,2022-04-13,Training/conference,REF51457072,91.86,0.0,256050.83
2022-04-15,2022-04-15,Payment from Abbott-Harrison,REF62795653,0.0,1146.39,257197.22
2022-04-15,2022-04-15,Payment from Gordon PLC,REF81166053,0.0,1267.33,258464.55
2022-04-15,2022-04-15,Payment from Jackson-Wilcox,REF12582712,0.0,1014.39,259478.94
2022-04-15,2022-04-15,Business insurance premium,REF80641426,124.87,0.0,259354.07
2022-04-18,2022-04-18,Business travel,REF43753605,100.25,0.0,259253.82
2022-04-21,2022-04-21,Marketing expenses,REF24285754,270.54,0.0,258983.28
2022-04-21,2022-04-21,Equipment purchase,REF76315524,82.14,0.0,258901.14
2022-04-21,2022-04-21,Business travel,REF35327859,95.5,0.0,258805.64
2022-04-24,2022-04-24,Office supplies,REF10592585,37.75,0.0,258767.89
2022-04-26,2022-04-26,Professional services,REF88609827,371.43,0.0,258396.46
2022-05-01,2022-05-01,Marketing expenses,REF72671537,177.75,0.0,258218.71
2022-05-02,2022-05-02,Office supplies,REF24174146,47.85,0.0,258170.86
2022-05-05,2022-05-05,Office supplies,REF72921255,60.57,0.0,258110.29
2022-05-05,2022-05-05,Equipment purchase,REF37676511,73.79,0.0,258036.5
2022-05-09,2022-05-09,Software subscription,REF31389341,141.68,0.0,257894.82
2022-05-12,2022-05-12,Professional services,REF21620673,240.51,0.0,257654.31
2022-05-14,2022-05-14,Training/conference,REF71493944,129.45,0.0,257524.86
2022-05-14,2022-05-14,Professional services,REF62268611,198.17,0.0,257326.69
2022-05-15,2022-05-15,Invoice payment - Gordon PLC,REF24990885,0.0,981.5,258308.19
2022-05-15,2022-05-15,Service payment - Jackson-Wilcox,REF79350471,0.0,1346.33,259654.52
2022-05-15,2022-05-15,Business insurance premium,REF14611295,121.42,0.0,259533.1
2022-05-15,2022-05-15,Payment from Abbott-Harrison,REF40042944,0.0,978.63,260511.73
2022-05-16,2022-05-16,Business travel,REF48815238,164.93,0.0,260346.8
2022-05-18,2022-05-18,Business travel,REF99638557,154.11,0.0,260192.69
2022-05-18,2022-05-18,Office supplies,REF73172736,71.46,0.0,260121.23
2022-05-27,2022-05-27,Office supplies,REF36256878,67.75,0.0,260053.48
2022-05-30,2022-05-30,Professional services,REF59722037,250.93,0.0,259802.55
2022-06-09,2022-06-09,Software subscription,REF94381207,128.43,0.0,259674.12
2022-06-10,2022-06-10,Office supplies,REF43184130,10.42,0.0,259663.7
2022-06-12,2022-06-12,Office supplies,REF40122258,38.7,0.0,259625.0
2022-06-15,2022-06-15,Payment from Gordon PLC,REF18579104,0.0,520.51,260145.51
2022-06-15,2022-06-15,Business insurance premium,REF84736413,109.47,0.0,260036.04
2022-06-15,2022-06-15,Invoice payment - Jackson-Wilcox,REF32719515,0.0,1471.33,261507.37
2022-06-15,2022-06-15,Invoice payment - Abbott-Harrison,REF49729524,0.0,894.05,262401.42
2022-06-16,2022-06-16,Equipment purchase,REF80113785,102.68,0.0,262298.74
2022-06-19,2022-06-19,Business travel,REF71208252,118.4,0.0,262180.34
2022-06-24,2022-06-24,Business travel,REF84505437,61.81,0.0,262118.53
2022-06-26,2022-06-26,Office supplies,REF75298317,51.7,0.0,262066.83
2022-06-27,2022-06-27,Office supplies,REF86042572,44.31,0.0,262022.52
2022-06-30,2022-06-30,Business travel,REF94916979,88.59,0.0,261933.93
2022-07-02,2022-07-02,Training/conference,REF45993938,84.14,0.0,261849.79
2022-07-05,2022-07-05,Marketing expenses,REF34503349,104.28,0.0,261745.51
2022-07-08,2022-07-08,Marketing expenses,REF65688159,200.66,0.0,261544.85
2022-07-09,2022-07-09,Software subscription,REF50687973,125.46,0.0,261419.39
2022-07-10,2022-07-10,Business travel,REF27720555,89.56,0.0,261329.83
2022-07-11,2022-07-11,Marketing expenses,REF54802781,98.56,0.0,261231.27
2022-07-14,2022-07-14,Office supplies,REF39517778,41.07,0.0,261190.2
2022-07-15,2022-07-15,Business insurance premium,REF65862452,102.58,0.0,261087.62
2022-07-15,2022-07-15,Service payment - Abbott-Harrison,REF16359236,0.0,1001.17,262088.79
2022-07-15,2022-07-15,Project payment - Gordon PLC,REF35788751,0.0,1164.81,263253.6
2022-07-25,2022-07-25,Marketing expenses,REF53466714,98.14,0.0,263155.46
2022-07-28,2022-07-28,Marketing expenses,REF70596372,169.48,0.0,262985.98
2022-07-29,2022-07-29,Office supplies,REF15490928,39.37,0.0,262946.61
2022-07-30,2022-07-30,Internet and phone service,REF64875079,52.67,0.0,262893.94
2022-08-07,2022-08-07,Office supplies,REF95571293,34.82,0.0,262859.12
2022-08-09,2022-08-09,Software subscription,REF42911267,87.4,0.0,262771.72
2022-08-12,2022-08-12,Business travel,REF31181112,35.84,0.0,262735.88
2022-08-15,2022-08-15,Professional services,REF24048220,222.03,0.0,262513.85
2022-08-15,2022-08-15,Service payment - Abbott-Harrison,REF90139861,0.0,755.54,263269.39
2022-08-15,2022-08-15,Payment from Gordon PLC,REF71218802,0.0,960.89,264230.28
2022-08-15,2022-08-15,Business insurance premium,REF70638896,84.44,0.0,264145.84
2022-08-15,2022-08-15,Payment from Jackson-Wilcox,REF66033594,0.0,819.35,264965.19
2022-08-16,2022-08-16,Equipment purchase,REF75640870,94.81,0.0,264870.38
2022-08-25,2022-08-25,Office supplies,REF11214640,45.63,0.0,264824.75
2022-08-26,2022-08-26,Training/conference,REF12704730,62.04,0.0,264762.71
2022-08-26,2022-08-26,Office supplies,REF38823234,35.25,0.0,264727.46
2022-08-31,2022-08-31,Business travel,REF97665063,66.61,0.0,264660.85
2022-09-02,2022-09-02,Marketing expenses,REF42346829,255.32,0.0,264405.53
2022-09-08,2022-09-08,Office supplies,REF64337867,83.05,0.0,264322.48
2022-09-09,2022-09-09,Software subscription,REF24107357,149.05,0.0,264173.43
2022-09-15,2022-09-15,Business insurance premium,REF40008091,137.07,0.0,264036.36
2022-09-15,2022-09-15,Service payment - Gordon PLC,REF73231683,0.0,1685.61,265721.97
2022-09-15,2022-09-15,Payment from Jackson-Wilcox,REF21406578,0.0,1487.48,267209.45
2022-09-15,2022-09-15,Payment from Abbott-Harrison,REF57991851,0.0,1367.11,268576.56
2022-09-15,2022-09-15,Office supplies,REF62932938,36.63,0.0,268539.93
2022-09-17,2022-09-17,Office supplies,REF16528793,45.97,0.0,268493.96
2022-09-24,2022-09-24,Business travel,REF42193809,257.5,0.0,268236.46
2022-09-25,2022-09-25,Office supplies,REF22302735,63.76,0.0,268172.7
2022-10-03,2022-10-03,Office supplies,REF49583909,79.27,0.0,268093.43
2022-10-08,2022-10-08,Internet and phone service,REF79459818,84.06,0.0,268009.37
2022-10-09,2022-10-09,Marketing expenses,REF78812385,327.04,0.0,267682.33
2022-10-09,2022-10-09,Software subscription,REF42298342,200.68,0.0,267481.65
2022-10-10,2022-10-10,Business travel,REF50345452,181.82,0.0,267299.83
2022-10-12,2022-10-12,Equipment purchase,REF39321266,168.51,0.0,267131.32
2022-10-12,2022-10-12,Office supplies,REF92245483,58.41,0.0,267072.91
2022-10-12,2022-10-12,Internet and phone service,REF94662904,69.26,0.0,267003.65
2022-10-12,2022-10-12,Marketing expenses,REF29737937,253.39,0.0,266750.26
2022-10-14,2022-10-14,Office supplies,REF41447325,75.36,0.0,266674.9
2022-10-15,2022-10-15,Invoice payment - Gordon PLC,REF83926211,0.0,1396.71,268071.61
2022-10-15,2022-10-15,Project payment - Jackson-Wilcox,REF75102299,0.0,1873.99,269945.6
2022-10-15,2022-10-15,Invoice payment - Abbott-Harrison,REF49936061,0.0,1273.27,271218.87
2022-10-15,2022-10-15,Business insurance premium,REF17925566,141.56,0.0,271077.31
2022-10-18,2022-10-18,Office supplies,REF60610921,25.21,0.0,271052.1
2022-10-19,2022-10-19,Training/conference,REF52942643,138.81,0.0,270913.29
2022-10-20,2022-10-20,Business travel,REF49048027,92.01,0.0,270821.28
2022-10-23,2022-10-23,Marketing expenses,REF35633451,207.92,0.0,270613.36
2022-11-01,2022-11-01,Business travel,REF43612501,208.61,0.0,270404.75
2022-11-09,2022-11-09,Software subscription,REF62734683,181.21,0.0,270223.54
2022-11-09,2022-11-09,Marketing expenses,REF47072158,347.63,0.0,269875.91
2022-11-11,2022-11-11,Training/conference,REF87143713,5.0,0.0,269870.91
2022-11-12,2022-11-12,Office supplies,REF50149585,46.38,0.0,269824.53
2022-11-15,2022-11-15,Service payment - Abbott-Harrison,REF91760562,0.0,1341.14,271165.67
2022-11-15,2022-11-15,Project payment - Gordon PLC,REF70622148,0.0,1109.97,272275.64
2022-11-15,2022-11-15,Business insurance premium,REF95772440,137.93,0.0,272137.71
2022-11-15,2022-11-15,Internet and phone service,REF64183910,43.66,0.0,272094.05
2022-11-15,2022-11-15,Service payment - Jackson-Wilcox,REF81535243,0.0,1027.8,273121.85
2022-11-18,2022-11-18,Internet and phone service,REF46657221,97.61,0.0,273024.24
2022-11-30,2022-11-30,Office supplies,REF84300040,29.28,0.0,272994.96
2022-12-01,2022-12-01,Marketing expenses,REF89216257,101.46,0.0,272893.5
2022-12-02,2022-12-02,Professional services,REF25101988,203.41,0.0,272690.09
2022-12-03,2022-12-03,Office supplies,REF24764498,35.86,0.0,272654.23
2022-12-06,2022-12-06,Business travel,REF46177438,148.73,0.0,272505.5
2022-12-09,2022-12-09,Software subscription,REF25087553,118.5,0.0,272387.0
2022-12-14,2022-12-14,Training/conference,REF14027939,102.03,0.0,272284.97
2022-12-15,2022-12-15,Business insurance premium,REF81144986,104.73,0.0,272180.24
2022-12-15,2022-12-15,Invoice payment - Gordon PLC,REF66837346,0.0,930.24,273110.48
2022-12-15,2022-12-15,Project payment - Jackson-Wilcox,REF42562530,0.0,1015.0,274125.48
2022-12-15,2022-12-15,Payment from Abbott-Harrison,REF64077797,0.0,569.14,274694.62
2022-12-16,2022-12-16,Equipment purchase,REF85028566,72.82,0.0,274621.8
2022-12-17,2022-12-17,Office supplies,REF93701600,20.29,0.0,274601.51
2022-12-20,2022-12-20,Office supplies,REF65186749,42.81,0.0,274558.7
2022-12-29,2022-12-29,Training/conference,REF75654075,88.65,0.0,274470.05
2023-01-03,2023-01-03,Office supplies,REF74263179,40.35,0.0,274429.7
2023-01-07,2023-01-07,Professional services,REF61213309,170.63,0.0,274259.07
2023-01-08,2023-01-08,Internet and phone service,REF32633690,76.43,0.0,274182.64
2023-01-09,2023-01-09,Software subscription,REF40608180,117.05,0.0,274065.59
2023-01-10,2023-01-10,Equipment purchase,REF50647123,79.25,0.0,273986.34
2023-01-15,2023-01-15,Project payment - Jackson-Wilcox,REF72413783,0.0,854.84,274841.18
2023-01-15,2023-01-15,Business insurance premium,REF97313176,92.01,0.0,274749.17
2023-01-15,2023-01-15,Invoice payment - Gordon PLC,REF76740054,0.0,909.6,275658.77
2023-01-15,2023-01-15,Internet and phone service,REF35463620,67.42,0.0,275591.35
2023-01-19,2023-01-19,Marketing expenses,REF17457163,215.2,0.0,275376.15
2023-01-30,2023-01-30,Training/conference,REF95219008,58.81,0.0,275317.34
2023-02-07,2023-02-07,Marketing expenses,REF28018755,195.67,0.0,275121.67
2023-02-09,2023-02-09,Software subscription,REF83039411,119.83,0.0,275001.84
2023-02-09,2023-02-09,Office supplies,REF60569236,47.65,0.0,274954.19
2023-02-12,2023-02-12,Marketing expenses,REF40571689,235.04,0.0,274719.15
2023-02-15,2023-02-15,Payment from Gordon PLC,REF26687474,0.0,1050.51,275769.66
2023-02-15,2023-02-15,Business insurance premium,REF95654447,109.25,0.0,275660.41
2023-02-15,2023-02-15,Project payment - Jackson-Wilcox,REF42679244,0.0,1158.23,276818.64
2023-02-15,2023-02-15,Service payment - Abbott-Harrison,REF53910035,0.0,1075.85,277894.49
2023-02-16,2023-02-16,Office supplies,REF85621915,48.91,0.0,277845.58
2023-02-17,2023-02-17,Marketing expenses,REF93627804,219.01,0.0,277626.57
2023-02-19,2023-02-19,Marketing expenses,REF11064314,257.42,0.0,277369.15
2023-02-20,2023-02-20,Equipment purchase,REF36113325,103.47,0.0,277265.68
2023-03-05,2023-03-05,Office supplies,REF80424945,78.91,0.0,277186.77
2023-03-09,2023-03-09,Professional services,REF68473759,367.81,0.0,276818.96
2023-03-09,2023-03-09,Software subscription,REF96059318,179.77,0.0,276639.19
2023-03-15,2023-03-15,Invoice payment - Abbott-Harrison,REF42037323,0.0,1095.06,277734.25
2023-03-15,2023-03-15,Business insurance premium,REF29923326,131.21,0.0,277603.04
2023-03-15,2023-03-15,Invoice payment - Jackson-Wilcox,REF15496096,0.0,1170.53,278773.57
2023-03-15,2023-03-15,Project payment - Gordon PLC,REF21074664,0.0,1385.7,280159.27
2023-03-21,2023-03-21,Internet and phone service,REF27639340,123.53,0.0,280035.74
2023-03-26,2023-03-26,Equipment purchase,REF79310790,113.5,0.0,279922.24
2023-03-31,2023-03-31,Equipment purchase,REF78920212,81.95,0.0,279840.29
2023-04-01,2023-04-01,Office supplies,REF97398369,57.12,0.0,279783.17
2023-04-05,2023-04-05,Internet and phone service,REF37797960,107.71,0.0,279675.46
2023-04-09,2023-04-09,Internet and phone service,REF64579781,54.39,0.0,279621.07
2023-04-09,2023-04-09,Software subscription,REF61464641,149.06,0.0,279472.01
2023-04-14,2023-04-14,Training/conference,REF16050149,118.07,0.0,279353.94
2023-04-14,2023-04-14,Office supplies,REF46607200,51.16,0.0,279302.78
2023-04-15,2023-04-15,Invoice payment - Gordon PLC,REF68503855,0.0,881.76,280184.54
2023-04-15,2023-04-15,Project payment - Jackson-Wilcox,REF77018135,0.0,1338.39,281522.93
2023-04-15,2023-04-15,Business insurance premium,REF80055604,114.38,0.0,281408.55
2023-04-15,2023-04-15,Project payment - Abbott-Harrison,REF71913084,0.0,908.26,282316.81
2023-04-16,2023-04-16,Office supplies,REF84375631,51.86,0.0,282264.95
2023-04-21,2023-04-21,Business travel,REF51066753,166.33,0.0,282098.62
2023-04-24,2023-04-24,Training/conference,REF28355191,114.39,0.0,281984.23
2023-04-27,2023-04-27,Professional services,REF92117472,160.49,0.0,281823.74
2023-04-29,2023-04-29,Business travel,REF95824741,169.25,0.0,281654.49
2023-04-30,2023-04-30,Internet and phone service,REF39719900,67.56,0.0,281586.93
2023-05-02,2023-05-02,Training/conference,REF50606204,101.38,0.0,281485.55
2023-05-09,2023-05-09,Software subscription,REF14458251,175.14,0.0,281310.41
2023-05-13,2023-05-13,Office supplies,REF83785157,54.6,0.0,281255.81
2023-05-15,2023-05-15,Professional services,REF92985230,200.5,0.0,281055.31
2023-05-15,2023-05-15,Business insurance premium,REF54686554,128.56,0.0,280926.75
2023-05-15,2023-05-15,Invoice payment - Abbott-Harrison,REF34939685,0.0,1335.37,282262.12
2023-05-15,2023-05-15,Invoice payment - Jackson-Wilcox,REF43031019,0.0,1240.19,283502.31
2023-05-15,2023-05-15,Service payment - Gordon PLC,REF57594597,0.0,1172.26,284674.57
2023-05-20,2023-05-20,Marketing expenses,REF80997226,206.09,0.0,284468.48
2023-05-28,2023-05-28,Equipment purchase,REF76838055,108.07,0.0,284360.41
2023-05-28,2023-05-28,Internet and phone service,REF94080236,71.57,0.0,284288.84
2023-06-02,2023-06-02,Training/conference,REF34889896,112.81,0.0,284176.03
2023-06-06,2023-06-06,Training/conference,REF21050802,93.2,0.0,284082.83
2023-06-07,2023-06-07,Professional services,REF51151657,195.98,0.0,283886.85
2023-06-07,2023-06-07,Office supplies,REF34763810,41.76,0.0,283845.09
2023-06-08,2023-06-08,Marketing expenses,REF44531167,36.25,0.0,283808.84
2023-06-09,2023-06-09,Marketing expenses,REF80586655,68.5,0.0,283740.34
2023-06-09,2023-06-09,Software subscription,REF49208436,128.63,0.0,283611.71
2023-06-10,2023-06-10,Business travel,REF32700071,136.68,0.0,283475.03
2023-06-10,2023-06-10,Equipment purchase,REF28869329,101.97,0.0,283373.06
2023-06-11,2023-06-11,Business travel,REF71018357,108.11,0.0,283264.95
2023-06-14,2023-06-14,Equipment purchase,REF36633043,86.65,0.0,283178.3
2023-06-15,2023-06-15,Business insurance premium,REF40672562,105.81,0.0,283072.49
2023-06-15,2023-06-15,Project payment - Jackson-Wilcox,REF23362551,0.0,1033.96,284106.45
2023-06-15,2023-06-15,Payment from Gordon PLC,REF39401976,0.0,1166.46,285272.91
2023-06-15,2023-06-15,Service payment - Abbott-Harrison,REF57724519,0.0,641.86,285914.77
2023-06-19,2023-06-19,Internet and phone service,REF59219381,96.78,0.0,285817.99
2023-06-20,2023-06-20,Training/conference,REF77482805,129.43,0.0,285688.56
2023-06-23,2023-06-23,Professional services,REF83151686,258.93,0.0,285429.63
2023-06-26,2023-06-26,Internet and phone service,REF61027597,95.14,0.0,285334.49
2023-06-29,2023-06-29,Professional services,REF14720010,141.52,0.0,285192.97
2023-07-01,2023-07-01,Business travel,REF78072722,144.02,0.0,285048.95
2023-07-09,2023-07-09,Office supplies,REF98823680,37.94,0.0,285011.01
2023-07-09,2023-07-09,Software subscription,REF57827383,130.67,0.0,284880.34
2023-07-10,2023-07-10,Office supplies,REF83701850,30.82,0.0,284849.52
2023-07-12,2023-07-12,Professional services,REF59971554,189.09,0.0,284660.43
2023-07-13,2023-07-13,Marketing expenses,REF34704701,169.42,0.0,284491.01
2023-07-13,2023-07-13,Business travel,REF60599189,146.12,0.0,284344.89
2023-07-15,2023-07-15,Payment from Jackson-Wilcox,REF60163180,0.0,965.04,285309.93
2023-07-15,2023-07-15,Business insurance premium,REF43764485,96.55,0.0,285213.38
2023-07-15,2023-07-15,Payment from Gordon PLC,REF55193952,0.0,845.05,286058.43
2023-07-22,2023-07-22,Internet and phone service,REF13417428,60.53,0.0,285997.9
2023-07-28,2023-07-28,Marketing expenses,REF76729733,111.93,0.0,285885.97
2023-07-29,2023-07-29,Office supplies,REF74532065,33.9,0.0,285852.07
2023-07-31,2023-07-31,Training/conference,REF49682747,53.75,0.0,285798.32
2023-08-04,2023-08-04,Office supplies,REF89429695,29.07,0.0,285769.25
2023-08-05,2023-08-05,Business travel,REF36674082,136.99,0.0,285632.26
2023-08-06,2023-08-06,Professional services,REF47833372,178.83,0.0,285453.43
2023-08-06,2023-08-06,Office supplies,REF11472932,29.46,0.0,285423.97
2023-08-08,2023-08-08,Training/conference,REF73310745,74.01,0.0,285349.96
2023-08-09,2023-08-09,Software subscription,REF50711968,118.49,0.0,285231.47
2023-08-10,2023-08-10,Office supplies,REF27735920,28.27,0.0,285203.2
2023-08-11,2023-08-11,Equipment purchase,REF46066053,98.92,0.0,285104.28
2023-08-11,2023-08-11,Office supplies,REF12518298,59.89,0.0,285044.39
2023-08-15,2023-08-15,Service payment - Jackson-Wilcox,REF22311437,0.0,888.47,285932.86
2023-08-15,2023-08-15,Invoice payment - Abbott-Harrison,REF68436748,0.0,711.03,286643.89
2023-08-15,2023-08-15,Business insurance premium,REF17978447,80.01,0.0,286563.88
2023-08-18,2023-08-18,Business travel,REF90411892,103.92,0.0,286459.96
2023-08-18,2023-08-18,Internet and phone service,REF45519853,70.72,0.0,286389.24
2023-08-19,2023-08-19,Business travel,REF69815137,96.8,0.0,286292.44
2023-08-24,2023-08-24,Equipment purchase,REF54072258,66.71,0.0,286225.73
2023-08-29,2023-08-29,Business travel,REF37434010,87.74,0.0,286137.99
2023-08-30,2023-08-30,Equipment purchase,REF61565688,38.56,0.0,286099.43
2023-09-03,2023-09-03,Internet and phone service,REF31536996,63.02,0.0,286036.41
2023-09-09,2023-09-09,Software subscription,REF61878182,173.63,0.0,285862.78
2023-09-15,2023-09-15,Invoice payment - Gordon PLC,REF49660135,0.0,1395.89,287258.67
2023-09-15,2023-09-15,Service payment - Jackson-Wilcox,REF73489212,0.0,1329.09,288587.76
2023-09-15,2023-09-15,Invoice payment - Abbott-Harrison,REF70884096,0.0,1170.42,289758.18
2023-09-15,2023-09-15,Business insurance premium,REF35547025,131.22,0.0,289626.96
2023-09-16,2023-09-16,Professional services,REF77530216,208.53,0.0,289418.43
2023-09-21,2023-09-21,Training/conference,REF74822785,138.39,0.0,289280.04
2023-09-25,2023-09-25,Business travel,REF80369724,198.38,0.0,289081.66
2023-09-29,2023-09-29,Office supplies,REF45164857,17.58,0.0,289064.08
2023-10-02,2023-10-02,Internet and phone service,REF99538970,87.73,0.0,288976.35
2023-10-03,2023-10-03,Professional services,REF19383623,300.88,0.0,288675.47
2023-10-04,2023-10-04,Professional services,REF13509437,92.12,0.0,288583.35
2023-10-06,2023-10-06,Professional services,REF13128544,308.26,0.0,288275.09
2023-10-08,2023-10-08,Office supplies,REF94933590,43.63,0.0,288231.46
2023-10-09,2023-10-09,Software subscription,REF33051662,203.1,0.0,288028.36
2023-10-09,2023-10-09,Internet and phone service,REF99386276,107.3,0.0,287921.06
2023-10-10,2023-10-10,Office supplies,REF88450335,29.19,0.0,287891.87
2023-10-15,2023-10-15,Invoice payment - Abbott-Harrison,REF27277816,0.0,1356.31,289248.18
2023-10-15,2023-10-15,Service payment - Jackson-Wilcox,REF58324258,0.0,1718.5,290966.68
2023-10-15,2023-10-15,Service payment - Gordon PLC,REF80801204,0.0,1595.4,292562.08
2023-10-15,2023-10-15,Business insurance premium,REF73982837,126.77,0.0,292435.31
2023-10-23,2023-10-23,Training/conference,REF54096918,92.3,0.0,292343.01
2023-11-02,2023-11-02,Equipment purchase,REF48453463,140.4,0.0,292202.61
2023-11-02,2023-11-02,Training/conference,REF17668636,146.54,0.0,292056.07
2023-11-04,2023-11-04,Office supplies,REF32947589,71.17,0.0,291984.9
2023-11-06,2023-11-06,Office supplies,REF39597176,77.35,0.0,291907.55
2023-11-08,2023-11-08,Internet and phone service,REF67293974,78.11,0.0,291829.44
2023-11-09,2023-11-09,Software subscription,REF93870741,165.91,0.0,291663.53
2023-11-15,2023-11-15,Payment from Jackson-Wilcox,REF53523297,0.0,1265.22,292928.75
2023-11-15,2023-11-15,Invoice payment - Abbott-Harrison,REF25419369,0.0,1567.09,294495.84
2023-11-15,2023-11-15,Service payment - Gordon PLC,REF71527665,0.0,1372.81,295868.65
2023-11-15,2023-11-15,Business insurance premium,REF17624526,130.26,0.0,295738.39
2023-11-19,2023-11-19,Business travel,REF84113855,156.68,0.0,295581.71
2023-11-20,2023-11-20,Training/conference,REF23438406,79.01,0.0,295502.7
2023-11-22,2023-11-22,Marketing expenses,REF26920134,195.76,0.0,295306.94
2023-11-26,2023-11-26,Marketing expenses,REF69701051,300.15,0.0,295006.79
2023-11-27,2023-11-27,Training/conference,REF79349234,113.75,0.0,294893.04
2023-12-09,2023-12-09,Business travel,REF25202391,118.94,0.0,294774.1
2023-12-09,2023-12-09,Software subscription,REF32964722,140.71,0.0,294633.39
2023-12-12,2023-12-12,Business travel,REF42215351,111.72,0.0,294521.67
2023-12-15,2023-12-15,Project payment - Abbott-Harrison,REF28050488,0.0,1184.19,295705.86
2023-12-15,2023-12-15,Project payment - Gordon PLC,REF12947018,0.0,1290.47,296996.33
2023-12-15,2023-12-15,Business insurance premium,REF47845322,105.42,0.0,296890.91
2023-12-17,2023-12-17,Office supplies,REF48218195,28.98,0.0,296861.93
2023-12-23,2023-12-23,Marketing expenses,REF16327424,190.16,0.0,296671.77
2023-12-28,2023-12-28,Office supplies,REF21188626,59.45,0.0,296612.32
2023-12-29,2023-12-29,Office supplies,REF45222757,68.7,0.0,296543.62
2024-01-07,2024-01-07,Office supplies,REF53372405,56.58,0.0,296487.04
2024-01-07,2024-01-07,Professional services,REF69481512,363.08,0.0,296123.96
2024-01-09,2024-01-09,Software subscription,REF91344649,134.39,0.0,295989.57
2024-01-10,2024-01-10,Business travel,REF64047221,152.18,0.0,295837.39
2024-01-10,2024-01-10,Equipment purchase,REF25107303,100.37,0.0,295737.02
2024-01-12,2024-01-12,Business travel,REF52163861,139.98,0.0,295597.04
2024-01-15,2024-01-15,Business insurance premium,REF78272528,99.54,0.0,295497.5
2024-01-15,2024-01-15,Service payment - Jackson-Wilcox,REF68287950,0.0,926.86,296424.36
2024-01-15,2024-01-15,Payment from Abbott-Harrison,REF72427087,0.0,883.7,297308.06
2024-01-15,2024-01-15,Invoice payment - Gordon PLC,REF98973988,0.0,925.34,298233.4
2024-01-20,2024-01-20,Equipment purchase,REF83644623,50.02,0.0,298183.38
2024-01-23,2024-01-23,Internet and phone service,REF68780763,70.21,0.0,298113.17
2024-01-27,2024-01-27,Office supplies,REF34643230,27.46,0.0,298085.71
2024-01-28,2024-01-28,Business travel,REF26873585,97.96,0.0,297987.75
2024-01-30,2024-01-30,Equipment purchase,REF13069402,111.95,0.0,297875.8
2024-02-06,2024-02-06,Training/conference,REF18678775,93.12,0.0,297782.68
2024-02-06,2024-02-06,Business travel,REF57580699,140.38,0.0,297642.3
2024-02-09,2024-02-09,Software subscription,REF79600157,123.08,0.0,297519.22
2024-02-12,2024-02-12,Office supplies,REF36050709,53.83,0.0,297465.39
2024-02-15,2024-02-15,Payment from Abbott-Harrison,REF12442183,0.0,961.17,298426.56
2024-02-15,2024-02-15,Business insurance premium,REF63806681,117.33,0.0,298309.23
2024-02-15,2024-02-15,Payment from Jackson-Wilcox,REF48371322,0.0,1025.37,299334.6
2024-02-15,2024-02-15,Service payment - Gordon PLC,REF56281000,0.0,994.67,300329.27
2024-02-16,2024-02-16,Office supplies,REF99634536,44.53,0.0,300284.74
2024-02-18,2024-02-18,Equipment purchase,REF36360707,45.19,0.0,300239.55
2024-02-23,2024-02-23,Equipment purchase,REF10493973,68.9,0.0,300170.65
2024-02-28,2024-02-28,Professional services,REF75208431,202.07,0.0,299968.58
2024-03-02,2024-03-02,Training/conference,REF31294900,137.03,0.0,299831.55
2024-03-04,2024-03-04,Marketing expenses,REF43629753,358.48,0.0,299473.07
2024-03-09,2024-03-09,Software subscription,REF96342797,151.75,0.0,299321.32
2024-03-10,2024-03-10,Training/conference,REF73371694,116.31,0.0,299205.01
2024-03-11,2024-03-11,Marketing expenses,REF77914330,61.67,0.0,299143.34
2024-03-12,2024-03-12,Office supplies,REF46019019,72.8,0.0,299070.54
2024-03-15,2024-03-15,Project payment - Jackson-Wilcox,REF64163205,0.0,1142.04,300212.58
2024-03-15,2024-03-15,Project payment - Gordon PLC,REF65464055,0.0,1300.66,301513.24
2024-03-15,2024-03-15,Business insurance premium,REF41153993,143.32,0.0,301369.92
2024-03-19,2024-03-19,Professional services,REF52892982,204.49,0.0,301165.43
2024-03-21,2024-03-21,Office supplies,REF52323236,39.66,0.0,301125.77
2024-03-24,2024-03-24,Office supplies,REF38467020,27.14,0.0,301098.63
2024-03-25,2024-03-25,Office supplies,REF99308846,50.6,0.0,301048.03
2024-04-09,2024-04-09,Software subscription,REF81598049,136.94,0.0,300911.09
2024-04-12,2024-04-12,Office supplies,REF31195586,40.96,0.0,300870.13
2024-04-14,2024-04-14,Marketing expenses,REF72100664,145.14,0.0,300724.99
2024-04-15,2024-04-15,Business insurance premium,REF82432833,124.75,0.0,300600.24
2024-04-15,2024-04-15,Invoice payment - Abbott-Harrison,REF39101020,0.0,1173.6,301773.84
2024-04-15,2024-04-15,Payment from Jackson-Wilcox,REF54305251,0.0,1145.1,302918.94
2024-04-15,2024-04-15,Project payment - Gordon PLC,REF66958483,0.0,1558.61,304477.55
2024-04-17,2024-04-17,Office supplies,REF81282949,51.13,0.0,304426.42
2024-04-20,2024-04-20,Equipment purchase,REF88042782,103.94,0.0,304322.48
2024-04-26,2024-04-26,Equipment purchase,REF80339491,117.07,0.0,304205.41
2024-05-04,2024-05-04,Internet and phone service,REF15947204,91.32,0.0,304114.09
2024-05-09,2024-05-09,Software subscription,REF93920879,159.5,0.0,303954.59
2024-05-13,2024-05-13,Marketing expenses,REF17504405,70.28,0.0,303884.31
2024-05-14,2024-05-14,Office supplies,REF36648929,47.1,0.0,303837.21
2024-05-15,2024-05-15,Business insurance premium,REF21130656,111.31,0.0,303725.9
2024-05-15,2024-05-15,Service payment - Abbott-Harrison,REF92532992,0.0,1078.38,304804.28
2024-05-15,2024-05-15,Invoice payment - Gordon PLC,REF58951715,0.0,959.15,305763.43
2024-05-15,2024-05-15,Payment from Jackson-Wilcox,REF10746636,0.0,1163.65,306927.08
2024-05-15,2024-05-15,Training/conference,REF55433475,82.26,0.0,306844.82
2024-05-21,2024-05-21,Office supplies,REF31542772,65.92,0.0,306778.9
2024-05-23,2024-05-23,Professional services,REF48736550,171.29,0.0,306607.61
2024-05-24,2024-05-24,Professional services,REF26963586,350.35,0.0,306257.26
2024-05-24,2024-05-24,Marketing expenses,REF92214925,333.1,0.0,305924.16
2024-05-29,2024-05-29,Office supplies,REF96004787,45.08,0.0,305879.08
2024-06-09,2024-06-09,Software subscription,REF90382444,127.68,0.0,305751.4
2024-06-15,2024-06-15,Invoice payment - Jackson-Wilcox,REF29524189,0.0,1074.07,306825.47
2024-06-15,2024-06-15,Service payment - Abbott-Harrison,REF92700923,0.0,942.19,307767.66
2024-06-15,2024-06-15,Business insurance premium,REF16044365,104.46,0.0,307663.2
2024-06-15,2024-06-15,Project payment - Gordon PLC,REF58228357,0.0,888.68,308551.88
2024-06-15,2024-06-15,Office supplies,REF71995454,28.67,0.0,308523.21
2024-06-16,2024-06-16,Professional services,REF67319206,266.89,0.0,308256.32
2024-06-16,2024-06-16,Marketing expenses,REF11181272,170.24,0.0,308086.08
2024-06-19,2024-06-19,Office supplies,REF76305780,27.84,0.0,308058.24
2024-06-19,2024-06-19,Business travel,REF65592933,171.64,0.0,307886.6
2024-06-23,2024-06-23,Internet and phone service,REF90838009,81.26,0.0,307805.34
2024-06-24,2024-06-24,Professional services,REF14907563,228.53,0.0,307576.81
2024-06-24,2024-06-24,Office supplies,REF11315249,55.59,0.0,307521.22
2024-06-26,2024-06-26,Training/conference,REF95245236,159.18,0.0,307362.04
2024-06-27,2024-06-27,Internet and phone service,REF29877214,66.52,0.0,307295.52
2024-06-30,2024-06-30,Internet and phone service,REF58561445,50.12,0.0,307245.4
2024-07-01,2024-07-01,Office supplies,REF73098579,37.91,0.0,307207.49
2024-07-04,2024-07-04,Business travel,REF24919265,121.0,0.0,307086.49
2024-07-08,2024-07-08,Marketing expenses,REF72211627,226.37,0.0,306860.12
2024-07-09,2024-07-09,Software subscription,REF27676119,134.26,0.0,306725.86
2024-07-11,2024-07-11,Equipment purchase,REF87688078,71.54,0.0,306654.32
2024-07-15,2024-07-15,Business insurance premium,REF61696525,91.81,0.0,306562.51
2024-07-15,2024-07-15,Payment from Gordon PLC,REF98174389,0.0,1152.53,307715.04
2024-07-15,2024-07-15,Service payment - Abbott-Harrison,REF57306299,0.0,876.68,308591.72
2024-07-18,2024-07-18,Office supplies,REF56354319,38.83,0.0,308552.89
2024-07-20,2024-07-20,Professional services,REF23044973,208.4,0.0,308344.49
2024-07-21,2024-07-21,Training/conference,REF61995380,92.38,0.0,308252.11
2024-07-24,2024-07-24,Office supplies,REF76212777,37.04,0.0,308215.07
2024-08-09,2024-08-09,Training/conference,REF71220876,45.13,0.0,308169.94
2024-08-09,2024-08-09,Software subscription,REF72120044,115.82,0.0,308054.12
2024-08-13,2024-08-13,Office supplies,REF35825408,12.0,0.0,308042.12
2024-08-13,2024-08-13,Marketing expenses,REF94940346,155.44,0.0,307886.68
2024-08-14,2024-08-14,Professional services,REF11467431,165.13,0.0,307721.55
2024-08-15,2024-08-15,Business insurance premium,REF49154673,82.58,0.0,307638.97
2024-08-15,2024-08-15,Payment from Gordon PLC,REF55246323,0.0,899.69,308538.66
2024-08-15,2024-08-15,Project payment - Abbott-Harrison,REF80229052,0.0,859.97,309398.63
2024-08-15,2024-08-15,Project payment - Jackson-Wilcox,REF77209819,0.0,919.4,310318.03
2011-08-23,2011-08-23,Marketing expenses,REF53788984,111.5,0.0,4014.62
2011-08-24,2011-08-24,Office supplies,REF60285333,17.41,0.0,3997.21
2011-08-30,2011-08-30,Equipment purchase,REF31717540,65.25,0.0,3931.96
2011-09-02,2011-09-02,Office supplies,REF51206699,56.63,0.0,3875.33
2011-09-04,2011-09-04,Business travel,REF73550386,141.09,0.0,3734.24
2011-09-07,2011-09-07,Equipment purchase,REF85568111,98.73,0.0,3635.51
2011-09-09,2011-09-09,Software subscription,REF32029507,172.97,0.0,3462.54
2011-09-10,2011-09-10,Business travel,REF27116603,184.32,0.0,3278.22
2011-09-15,2011-09-15,Project payment - Allen PLC,REF94359614,0.0,1249.64,4527.86
2011-09-15,2011-09-15,Payment from Mendez-Tyler,REF75724715,0.0,2124.76,6652.62
2011-09-15,2011-09-15,Invoice payment - Lucas-Campos,REF61895565,0.0,1995.59,8648.21
2011-09-15,2011-09-15,Business insurance premium,REF12196424,124.24,0.0,8523.97
2011-09-26,2011-09-26,Business travel,REF94644877,172.42,0.0,8351.55
2011-09-28,2011-09-28,Professional services,REF34880453,223.02,0.0,8128.53
2011-10-04,2011-10-04,Equipment purchase,REF77692331,116.86,0.0,8011.67
2011-10-09,2011-10-09,Software subscription,REF43801658,158.35,0.0,7853.32
2011-10-11,2011-10-11,Business travel,REF18307912,126.32,0.0,7727.0
2011-10-15,2011-10-15,Service payment - Allen PLC,REF22170241,0.0,2268.66,9995.66
2011-10-15,2011-10-15,Invoice payment - Mendez-Tyler,REF38701360,0.0,2148.65,12144.31
2011-10-15,2011-10-15,Business insurance premium,REF78425194,141.41,0.0,12002.9
2011-10-17,2011-10-17,Professional services,REF40434689,319.35,0.0,11683.55
2011-10-18,2011-10-18,Office supplies,REF69742819,46.52,0.0,11637.03
2011-10-19,2011-10-19,Business travel,REF17805988,178.71,0.0,11458.32
2011-10-22,2011-10-22,Equipment purchase,REF88204259,130.4,0.0,11327.92
2011-10-31,2011-10-31,Marketing expenses,REF60406695,279.92,0.0,11048.0
2011-11-06,2011-11-06,Office supplies,REF95903242,62.89,0.0,10985.11
2011-11-08,2011-11-08,Office supplies,REF43751549,47.47,0.0,10937.64
2011-11-09,2011-11-09,Software subscription,REF61955933,134.71,0.0,10802.93
2011-11-10,2011-11-10,Office supplies,REF45909911,72.63,0.0,10730.3
2011-11-15,2011-11-15,Business insurance premium,REF43496321,138.72,0.0,10591.58
2011-11-15,2011-11-15,Payment from Allen PLC,REF17545145,0.0,1204.68,11796.26
2011-11-15,2011-11-15,Invoice payment - Lucas-Campos,REF64922213,0.0,2138.48,13934.74
2011-11-15,2011-11-15,Invoice payment - Mendez-Tyler,REF74263979,0.0,2237.9,16172.64
2011-11-29,2011-11-29,Office supplies,REF65687480,64.81,0.0,16107.83
2011-12-04,2011-12-04,Internet and phone service,REF16535601,112.47,0.0,15995.36
2011-12-04,2011-12-04,Training/conference,REF19955128,44.29,0.0,15951.07
2011-12-07,2011-12-07,Office supplies,REF13185335,54.01,0.0,15897.06
2011-12-08,2011-12-08,Office supplies,REF38415890,67.57,0.0,15829.49
2011-12-09,2011-12-09,Software subscription,REF39776648,118.74,0.0,15710.75
2011-12-10,2011-12-10,Office supplies,REF60005809,57.08,0.0,15653.67
2011-12-14,2011-12-14,Office supplies,REF99001395,60.88,0.0,15592.79
2011-12-15,2011-12-15,Service payment - Mendez-Tyler,REF54982684,0.0,1552.26,17145.05
2011-12-15,2011-12-15,Invoice payment - Lucas-Campos,REF49286368,0.0,1611.03,18756.08
2011-12-15,2011-12-15,Business insurance premium,REF78638475,108.34,0.0,18647.74
2011-12-15,2011-12-15,Payment from Allen PLC,REF82603492,0.0,1309.32,19957.06
2011-12-15,2011-12-15,Internet and phone service,REF83239739,79.94,0.0,19877.12
2011-12-16,2011-12-16,Office supplies,REF53765818,54.74,0.0,19822.38
2011-12-17,2011-12-17,Office supplies,REF37222337,62.6,0.0,19759.78
2011-12-19,2011-12-19,Office supplies,REF29754949,18.35,0.0,19741.43
2012-01-01,2012-01-01,Office supplies,REF74792179,34.1,0.0,19707.33
2012-01-04,2012-01-04,Business travel,REF35676476,155.69,0.0,19551.64
2012-01-04,2012-01-04,Office supplies,REF32186038,37.4,0.0,19514.24
2012-01-09,2012-01-09,Software subscription,REF16852729,113.76,0.0,19400.48
2012-01-12,2012-01-12,Office supplies,REF92800737,53.21,0.0,19347.27
2012-01-13,2012-01-13,Business travel,REF15140843,122.78,0.0,19224.49
2012-01-14,2012-01-14,Office supplies,REF45525017,21.17,0.0,19203.32
2012-01-15,2012-01-15,Service payment - Lucas-Campos,REF94324953,0.0,1665.61,20868.93
2012-01-15,2012-01-15,Project payment - Allen PLC,REF94377447,0.0,1056.09,21925.02
2012-01-15,2012-01-15,Business insurance premium,REF73705438,97.16,0.0,21827.86
2012-01-21,2012-01-21,Business travel,REF96549071,157.75,0.0,21670.11
2012-01-25,2012-01-25,Office supplies,REF31115127,36.8,0.0,21633.31
2012-01-26,2012-01-26,Internet and phone service,REF72503824,55.79,0.0,21577.52
2012-01-30,2012-01-30,Office supplies,REF88030052,51.68,0.0,21525.84
2012-01-31,2012-01-31,Professional services,REF66297705,382.06,0.0,21143.78
2012-02-08,2012-02-08,Marketing expenses,REF15251980,127.59,0.0,21016.19
2012-02-09,2012-02-09,Software subscription,REF22450977,135.6,0.0,20880.59
2012-02-12,2012-02-12,Training/conference,REF77282544,45.93,0.0,20834.66
2012-02-13,2012-02-13,Internet and phone service,REF49952175,56.16,0.0,20778.5
2012-02-15,2012-02-15,Business insurance premium,REF19344079,114.06,0.0,20664.44
2012-02-15,2012-02-15,Payment from Lucas-Campos,REF51011164,0.0,1889.3,22553.74
2012-02-15,2012-02-15,Payment from Allen PLC,REF29567305,0.0,1083.29,23637.03
2012-02-15,2012-02-15,Project payment - Mendez-Tyler,REF24325199,0.0,1728.55,25365.58
2012-02-19,2012-02-19,Training/conference,REF91830961,92.16,0.0,25273.42
2012-02-27,2012-02-27,Internet and phone service,REF28785460,72.9,0.0,25200.52
2012-03-06,2012-03-06,Equipment purchase,REF94176969,115.94,0.0,25084.58
2012-03-07,2012-03-07,Office supplies,REF65140130,97.93,0.0,24986.65
2012-03-08,2012-03-08,Office supplies,REF15262474,55.27,0.0,24931.38
2012-03-09,2012-03-09,Software subscription,REF43699802,120.08,0.0,24811.3
2012-03-09,2012-03-09,Internet and phone service,REF26153180,54.51,0.0,24756.79
2012-03-11,2012-03-11,Training/conference,REF53114189,77.4,0.0,24679.39
2012-03-11,2012-03-11,Marketing expenses,REF73020114,274.17,0.0,24405.22
2012-03-15,2012-03-15,Invoice payment - Allen PLC,REF79153810,0.0,1572.18,25977.4
2012-03-15,2012-03-15,Invoice payment - Lucas-Campos,REF39462810,0.0,2143.98,28121.38
2012-03-15,2012-03-15,Project payment - Mendez-Tyler,REF17582386,0.0,1785.4,29906.78
2012-03-15,2012-03-15,Business insurance premium,REF87735994,117.03,0.0,29789.75
2012-03-16,2012-03-16,Equipment purchase,REF16601452,149.78,0.0,29639.97
2012-03-18,2012-03-18,Office supplies,REF95815285,21.67,0.0,29618.3
2012-03-19,2012-03-19,Training/conference,REF66268949,113.58,0.0,29504.72
2012-03-20,2012-03-20,Professional services,REF85570828,247.29,0.0,29257.43
2012-03-23,2012-03-23,Internet and phone service,REF80406241,143.41,0.0,29114.02
2012-03-31,2012-03-31,Business travel,REF14245103,268.05,0.0,28845.97
2012-04-02,2012-04-02,Office supplies,REF42354059,36.15,0.0,28809.82
2012-04-02,2012-04-02,Professional services,REF84231790,369.03,0.0,28440.79
2012-04-05,2012-04-05,Office supplies,REF65259198,77.2,0.0,28363.59
2012-04-06,2012-04-06,Office supplies,REF81231150,93.02,0.0,28270.57
2012-04-09,2012-04-09,Software subscription,REF34149119,157.81,0.0,28112.76
2012-04-11,2012-04-11,Office supplies,REF21645726,60.99,0.0,28051.77
2012-04-14,2012-04-14,Professional services,REF49872487,142.72,0.0,27909.05
2012-04-15,2012-04-15,Business insurance premium,REF26258648,126.61,0.0,27782.44
2012-04-15,2012-04-15,Project payment - Allen PLC,REF88212271,0.0,1227.69,29010.13
2012-04-15,2012-04-15,Payment from Mendez-Tyler,REF73422214,0.0,1889.21,30899.34
2012-04-15,2012-04-15,Service payment - Lucas-Campos,REF30425322,0.0,1911.21,32810.55
2012-04-15,2012-04-15,Business travel,REF66355127,257.26,0.0,32553.29
2012-04-20,2012-04-20,Business travel,REF82362220,110.99,0.0,32442.3
2012-04-22,2012-04-22,Marketing expenses,REF16418094,191.84,0.0,32250.46
2012-04-27,2012-04-27,Training/conference,REF87742885,113.95,0.0,32136.51
2012-04-29,2012-04-29,Equipment purchase,REF64636269,151.93,0.0,31984.58
2012-05-04,2012-05-04,Professional services,REF70472157,173.97,0.0,31810.61
2012-05-09,2012-05-09,Software subscription,REF52985337,118.4,0.0,31692.21
2012-05-09,2012-05-09,Business travel,REF44353113,158.56,0.0,31533.65
2012-05-10,2012-05-10,Training/conference,REF78282221,172.47,0.0,31361.18
2012-05-15,2012-05-15,Business insurance premium,REF77237907,115.98,0.0,31245.2
2012-05-15,2012-05-15,Payment from Allen PLC,REF89999622,0.0,1300.37,32545.57
2012-05-15,2012-05-15,Payment from Mendez-Tyler,REF83214094,0.0,1886.17,34431.74
2012-05-15,2012-05-15,Office supplies,REF30330172,65.41,0.0,34366.33
2012-05-15,2012-05-15,Service payment - Lucas-Campos,REF45117373,0.0,1741.5,36107.83
2012-05-17,2012-05-17,Internet and phone service,REF12598999,117.84,0.0,35989.99
2012-05-19,2012-05-19,Internet and phone service,REF53433809,67.71,0.0,35922.28
2012-05-21,2012-05-21,Office supplies,REF89127408,51.18,0.0,35871.1
2012-05-22,2012-05-22,Office supplies,REF22677548,29.49,0.0,35841.61
2012-05-26,2012-05-26,Office supplies,REF40230174,50.03,0.0,35791.58
2012-05-27,2012-05-27,Office supplies,REF68960736,35.41,0.0,35756.17
2012-05-29,2012-05-29,Professional services,REF98095518,254.13,0.0,35502.04
2012-06-01,2012-06-01,Office supplies,REF67997609,44.7,0.0,35457.34
2012-06-04,2012-06-04,Business travel,REF54279787,84.56,0.0,35372.78
2012-06-08,2012-06-08,Internet and phone service,REF45736638,96.85,0.0,35275.93
2012-06-09,2012-06-09,Software subscription,REF74286808,130.44,0.0,35145.49
2012-06-09,2012-06-09,Internet and phone service,REF62981661,65.14,0.0,35080.35
2012-06-10,2012-06-10,Internet and phone service,REF50437249,92.07,0.0,34988.28
2012-06-13,2012-06-13,Training/conference,REF47720504,164.79,0.0,34823.49
2012-06-15,2012-06-15,Business insurance premium,REF74207172,111.36,0.0,34712.13
2012-06-15,2012-06-15,Payment from Lucas-Campos,REF97335565,0.0,1422.67,36134.8
2012-06-15,2012-06-15,Service payment - Mendez-Tyler,REF14510743,0.0,1244.34,37379.14
2012-06-15,2012-06-15,Payment from Allen PLC,REF81472465,0.0,890.05,38269.19
2012-06-21,2012-06-21,Office supplies,REF74184153,52.04,0.0,38217.15
2012-06-25,2012-06-25,Marketing expenses,REF93253156,163.65,0.0,38053.5
2012-06-28,2012-06-28,Marketing expenses,REF76980219,212.89,0.0,37840.61
2012-06-30,2012-06-30,Training/conference,REF36755564,54.76,0.0,37785.85
2012-07-03,2012-07-03,Business travel,REF92054842,163.62,0.0,37622.23
2012-07-06,2012-07-06,Business travel,REF20225666,124.16,0.0,37498.07
2012-07-09,2012-07-09,Software subscription,REF33610550,84.55,0.0,37413.52
2012-07-10,2012-07-10,Internet and phone service,REF68158111,51.11,0.0,37362.41
2012-07-12,2012-07-12,Marketing expenses,REF81978301,110.9,0.0,37251.51
2012-07-14,2012-07-14,Training/conference,REF96097471,80.42,0.0,37171.09
2012-07-15,2012-07-15,Business insurance premium,REF69531171,87.12,0.0,37083.97
2012-07-15,2012-07-15,Invoice payment - Allen PLC,REF39708212,0.0,987.77,38071.74
2012-07-15,2012-07-15,Payment from Mendez-Tyler,REF60145985,0.0,1365.98,39437.72
2012-07-15,2012-07-15,Service payment - Lucas-Campos,REF56451212,0.0,1204.3,40642.02
2012-07-20,2012-07-20,Training/conference,REF51653722,96.36,0.0,40545.66
2012-07-23,2012-07-23,Professional services,REF39190888,237.05,0.0,40308.61
2012-07-26,2012-07-26,Equipment purchase,REF74845494,108.31,0.0,40200.3
2012-08-02,2012-08-02,Internet and phone service,REF93807671,47.82,0.0,40152.48
2012-08-03,2012-08-03,Office supplies,REF50242091,41.91,0.0,40110.57
2012-08-05,2012-08-05,Office supplies,REF68519787,22.42,0.0,40088.15
2012-08-06,2012-08-06,Marketing expenses,REF62588463,146.06,0.0,39942.09
2012-08-07,2012-08-07,Business travel,REF30675776,112.96,0.0,39829.13
2012-08-09,2012-08-09,Office supplies,REF52950974,27.09,0.0,39802.04
2012-08-09,2012-08-09,Software subscription,REF88812485,122.34,0.0,39679.7
2012-08-15,2012-08-15,Project payment - Lucas-Campos,REF22210327,0.0,1578.42,41258.12
2012-08-15,2012-08-15,Business insurance premium,REF11020782,83.78,0.0,41174.34
2012-08-15,2012-08-15,Invoice payment - Allen PLC,REF12558489,0.0,657.96,41832.3
2012-08-19,2012-08-19,Office supplies,REF57508049,12.67,0.0,41819.63
2012-08-25,2012-08-25,Office supplies,REF60435651,31.89,0.0,41787.74
2012-08-26,2012-08-26,Office supplies,REF62387772,57.59,0.0,41730.15
2012-08-27,2012-08-27,Office supplies,REF78549258,40.08,0.0,41690.07
2012-09-03,2012-09-03,Marketing expenses,REF89842521,190.49,0.0,41499.58
2012-09-04,2012-09-04,Training/conference,REF78280648,111.71,0.0,41387.87
2012-09-07,2012-09-07,Business travel,REF32622571,184.0,0.0,41203.87
2012-09-09,2012-09-09,Office supplies,REF22461133,60.78,0.0,41143.09
2012-09-09,2012-09-09,Software subscription,REF24167226,170.73,0.0,40972.36
2012-09-10,2012-09-10,Office supplies,REF46888706,56.1,0.0,40916.26
2012-09-11,2012-09-11,Business travel,REF62597791,166.83,0.0,40749.43
2012-09-12,2012-09-12,Equipment purchase,REF51696899,118.08,0.0,40631.35
2012-09-14,2012-09-14,Marketing expenses,REF63812798,146.12,0.0,40485.23
2012-09-15,2012-09-15,Business insurance premium,REF47102963,132.69,0.0,40352.54
2012-09-15,2012-09-15,Office supplies,REF96971747,27.74,0.0,40324.8
2012-09-15,2012-09-15,Invoice payment - Lucas-Campos,REF22598066,0.0,2346.83,42671.63
2012-09-15,2012-09-15,Invoice payment - Allen PLC,REF84986355,0.0,1393.99,44065.62
2012-09-17,2012-09-17,Office supplies,REF19517161,32.73,0.0,44032.89
2012-09-18,2012-09-18,Equipment purchase,REF50972999,112.72,0.0,43920.17
2012-09-23,2012-09-23,Training/conference,REF78698764,173.17,0.0,43747.0
2012-09-26,2012-09-26,Marketing expenses,REF99302487,155.9,0.0,43591.1
2012-09-27,2012-09-27,Internet and phone service,REF74942816,77.21,0.0,43513.89
2012-09-29,2012-09-29,Business travel,REF98722148,198.61,0.0,43315.28
2012-09-30,2012-09-30,Business travel,REF45145014,51.07,0.0,43264.21
2012-10-09,2012-10-09,Software subscription,REF99075974,182.87,0.0,43081.34
2012-10-09,2012-10-09,Office supplies,REF81113642,76.6,0.0,43004.74
2012-10-12,2012-10-12,Office supplies,REF50661533,52.44,0.0,42952.3
2012-10-13,2012-10-13,Training/conference,REF40885066,158.34,0.0,42793.96
2012-10-15,2012-10-15,Invoice payment - Lucas-Campos,REF42536224,0.0,1787.16,44581.12
2012-10-15,2012-10-15,Business insurance premium,REF88624506,140.34,0.0,44440.78
2012-10-15,2012-10-15,Project payment - Mendez-Tyler,REF41472981,0.0,2452.2,46892.98
2012-10-15,2012-10-15,Project payment - Allen PLC,REF12529999,0.0,1397.53,48290.51
2012-10-17,2012-10-17,Office supplies,REF37676946,68.56,0.0,48221.95
2012-10-22,2012-10-22,Office supplies,REF52850053,54.2,0.0,48167.75
2012-10-23,2012-10-23,Office supplies,REF36174573,63.85,0.0,48103.9
2012-10-25,2012-10-25,Professional services,REF39060429,143.17,0.0,47960.73
2012-11-02,2012-11-02,Office supplies,REF57636946,53.54,0.0,47907.19
2012-11-03,2012-11-03,Business travel,REF63212936,215.19,0.0,47692.0
2012-11-05,2012-11-05,Business travel,REF25391140,214.4,0.0,47477.6
2012-11-07,2012-11-07,Internet and phone service,REF46343912,62.58,0.0,47415.02
2012-11-09,2012-11-09,Software subscription,REF90460648,191.14,0.0,47223.88
2012-11-12,2012-11-12,Office supplies,REF46694930,66.63,0.0,47157.25
2012-11-12,2012-11-12,Training/conference,REF45493735,146.21,0.0,47011.04
2012-11-15,2012-11-15,Service payment - Allen PLC,REF87829671,0.0,1328.4,48339.44
2012-11-15,2012-11-15,Project payment - Mendez-Tyler,REF44069067,0.0,1946.38,50285.82
2012-11-15,2012-11-15,Service payment - Lucas-Campos,REF20573525,0.0,2095.91,52381.73
2012-11-15,2012-11-15,Business insurance premium,REF56219323,140.2,0.0,52241.53
2012-11-28,2012-11-28,Office supplies,REF10372878,59.56,0.0,52181.97
2012-12-05,2012-12-05,Office supplies,REF54380636,37.29,0.0,52144.68
2012-12-08,2012-12-08,Office supplies,REF52167859,53.18,0.0,52091.5
2012-12-09,2012-12-09,Office supplies,REF70400814,35.06,0.0,52056.44
2012-12-09,2012-12-09,Software subscription,REF53948887,133.28,0.0,51923.16
2012-12-11,2012-12-11,Training/conference,REF52224472,80.79,0.0,51842.37
2012-12-14,2012-12-14,Office supplies,REF81663211,24.54,0.0,51817.83
2012-12-15,2012-12-15,Service payment - Allen PLC,REF40553799,0.0,1078.95,52896.78
2012-12-15,2012-12-15,Project payment - Mendez-Tyler,REF40361913,0.0,2152.57,55049.35
2012-12-15,2012-12-15,Payment from Lucas-Campos,REF17136159,0.0,1810.44,56859.79
2012-12-15,2012-12-15,Business insurance premium,REF38464957,112.55,0.0,56747.24
2012-12-18,2012-12-18,Marketing expenses,REF27126839,249.9,0.0,56497.34
2012-12-21,2012-12-21,Equipment purchase,REF55196725,99.05,0.0,56398.29
2012-12-28,2012-12-28,Office supplies,REF76869493,34.02,0.0,56364.27
2012-12-28,2012-12-28,Business travel,REF16517743,198.27,0.0,56166.0
2013-01-03,2013-01-03,Business travel,REF22541775,173.84,0.0,55992.16
2013-01-06,2013-01-06,Equipment purchase,REF86689192,83.32,0.0,55908.84
2013-01-09,2013-01-09,Training/conference,REF85147031,94.68,0.0,55814.16
2013-01-09,2013-01-09,Software subscription,REF71628654,142.22,0.0,55671.94
2013-01-14,2013-01-14,Office supplies,REF65855493,45.1,0.0,55626.84
2013-01-15,2013-01-15,Payment from Allen PLC,REF95628859,0.0,935.48,56562.32
2013-01-15,2013-01-15,Project payment - Mendez-Tyler,REF17687328,0.0,1377.56,57939.88
2013-01-15,2013-01-15,Payment from Lucas-Campos,REF74198844,0.0,1180.43,59120.31
2013-01-15,2013-01-15,Business insurance premium,REF79565639,101.46,0.0,59018.85
2013-01-16,2013-01-16,Marketing expenses,REF29935425,86.62,0.0,58932.23
2013-01-18,2013-01-18,Equipment purchase,REF86076120,73.12,0.0,58859.11
2013-01-20,2013-01-20,Professional services,REF65273021,136.93,0.0,58722.18
2013-01-21,2013-01-21,Equipment purchase,REF55677330,138.81,0.0,58583.37
2013-01-24,2013-01-24,Office supplies,REF28852882,26.8,0.0,58556.57
2013-01-30,2013-01-30,Equipment purchase,REF53554517,97.87,0.0,58458.7
2013-02-02,2013-02-02,Office supplies,REF23580100,49.1,0.0,58409.6
2013-02-04,2013-02-04,Business travel,REF76153678,163.13,0.0,58246.47
2013-02-08,2013-02-08,Training/conference,REF96379746,50.51,0.0,58195.96
2013-02-09,2013-02-09,Software subscription,REF57582132,136.43,0.0,58059.53
2013-02-15,2013-02-15,Invoice payment - Allen PLC,REF65703256,0.0,1129.44,59188.97
2013-02-15,2013-02-15,Project payment - Lucas-Campos,REF80640660,0.0,1813.46,61002.43
2013-02-15,2013-02-15,Service payment - Mendez-Tyler,REF11408886,0.0,1782.96,62785.39
2013-02-15,2013-02-15,Business insurance premium,REF29741570,112.0,0.0,62673.39
2013-02-18,2013-02-18,Office supplies,REF31285474,24.13,0.0,62649.26
2013-02-22,2013-02-22,Marketing expenses,REF52567908,228.58,0.0,62420.68
2013-02-24,2013-02-24,Office supplies,REF75427694,39.79,0.0,62380.89
2013-02-25,2013-02-25,Business travel,REF99080902,157.61,0.0,62223.28
2013-03-04,2013-03-04,Business travel,REF25794242,185.87,0.0,62037.41
2013-03-09,2013-03-09,Software subscription,REF59978379,190.18,0.0,61847.23
2013-03-13,2013-03-13,Professional services,REF33644506,268.16,0.0,61579.07
2013-03-13,2013-03-13,Business travel,REF80166500,41.54,0.0,61537.53
2013-03-15,2013-03-15,Business insurance premium,REF58368693,135.93,0.0,61401.6
2013-03-15,2013-03-15,Service payment - Allen PLC,REF64356510,0.0,1447.84,62849.44
2013-03-15,2013-03-15,Payment from Mendez-Tyler,REF35967227,0.0,2328.46,65177.9
2013-03-15,2013-03-15,Invoice payment - Lucas-Campos,REF29065643,0.0,2102.31,67280.21
2013-03-19,2013-03-19,Training/conference,REF15299387,107.1,0.0,67173.11
2013-03-21,2013-03-21,Internet and phone service,REF73135840,138.03,0.0,67035.08
2013-03-25,2013-03-25,Training/conference,REF97098327,146.13,0.0,66888.95
2013-03-26,2013-03-26,Training/conference,REF42298594,57.18,0.0,66831.77
2013-04-03,2013-04-03,Professional services,REF35751137,322.27,0.0,66509.5
2013-04-09,2013-04-09,Business travel,REF91545417,157.62,0.0,66351.88
2013-04-09,2013-04-09,Software subscription,REF80232519,189.26,0.0,66162.62
2013-04-10,2013-04-10,Office supplies,REF56525148,61.65,0.0,66100.97
2013-04-10,2013-04-10,Professional services,REF14347113,319.7,0.0,65781.27
2013-04-12,2013-04-12,Business travel,REF44127676,185.66,0.0,65595.61
2013-04-14,2013-04-14,Professional services,REF27098245,227.7,0.0,65367.91
2013-04-15,2013-04-15,Business insurance premium,REF13670275,123.84,0.0,65244.07
2013-04-15,2013-04-15,Service payment - Lucas-Campos,REF26448050,0.0,1606.26,66850.33
2013-04-15,2013-04-15,Payment from Allen PLC,REF86311837,0.0,1229.12,68079.45
2013-04-15,2013-04-15,Payment from Mendez-Tyler,REF85494279,0.0,1514.33,69593.78
2013-04-16,2013-04-16,Training/conference,REF72950547,110.54,0.0,69483.24
2013-04-25,2013-04-25,Equipment purchase,REF93113470,92.57,0.0,69390.67
2013-04-26,2013-04-26,Business travel,REF93899043,216.69,0.0,69173.98
2013-04-28,2013-04-28,Equipment purchase,REF29190377,102.49,0.0,69071.49
2013-05-01,2013-05-01,Office supplies,REF94264739,45.6,0.0,69025.89
2013-05-05,2013-05-05,Equipment purchase,REF60096859,107.08,0.0,68918.81
2013-05-08,2013-05-08,Office supplies,REF55323080,33.59,0.0,68885.22
2013-05-09,2013-05-09,Software subscription,REF44563407,150.32,0.0,68734.9
2013-05-12,2013-05-12,Marketing expenses,REF71254907,204.18,0.0,68530.72
2013-05-15,2013-05-15,Service payment - Lucas-Campos,REF88588411,0.0,2410.82,70941.54
2013-05-15,2013-05-15,Business insurance premium,REF89620538,116.48,0.0,70825.06
2013-05-15,2013-05-15,Payment from Allen PLC,REF87135839,0.0,1235.06,72060.12
2013-05-15,2013-05-15,Project payment - Mendez-Tyler,REF13578604,0.0,1850.09,73910.21
2013-05-17,2013-05-17,Business travel,REF60476257,184.93,0.0,73725.28
2013-05-19,2013-05-19,Office supplies,REF38148554,67.54,0.0,73657.74
2013-05-19,2013-05-19,Internet and phone service,REF77211647,60.78,0.0,73596.96
2013-05-26,2013-05-26,Training/conference,REF12999287,108.59,0.0,73488.37
2013-06-01,2013-06-01,Office supplies,REF39303729,53.75,0.0,73434.62
2013-06-01,2013-06-01,Internet and phone service,REF36165582,71.64,0.0,73362.98
2013-06-02,2013-06-02,Internet and phone service,REF32260970,77.15,0.0,73285.83
2013-06-03,2013-06-03,Office supplies,REF77375261,33.63,0.0,73252.2
2013-06-06,2013-06-06,Internet and phone service,REF64628873,58.59,0.0,73193.61
2013-06-09,2013-06-09,Software subscription,REF33615565,147.87,0.0,73045.74
2013-06-13,2013-06-13,Office supplies,REF10117259,43.1,0.0,73002.64
2013-06-13,2013-06-13,Internet and phone service,REF54330185,91.76,0.0,72910.88
2013-06-15,2013-06-15,Service payment - Mendez-Tyler,REF21149567,0.0,1170.18,74081.06
2013-06-15,2013-06-15,Business insurance premium,REF13056739,112.08,0.0,73968.98
2013-06-15,2013-06-15,Invoice payment - Allen PLC,REF72610264,0.0,856.16,74825.14
2013-06-15,2013-06-15,Project payment - Lucas-Campos,REF57385168,0.0,1554.82,76379.96
2013-06-16,2013-06-16,Office supplies,REF63544266,72.07,0.0,76307.89
2013-06-19,2013-06-19,Business travel,REF98016472,87.99,0.0,76219.9
2013-06-19,2013-06-19,Office supplies,REF48016815,28.98,0.0,76190.92
2013-06-26,2013-06-26,Training/conference,REF13973930,96.17,0.0,76094.75
2013-06-28,2013-06-28,Office supplies,REF98389971,69.11,0.0,76025.64
2013-07-06,2013-07-06,Training/conference,REF41439171,132.58,0.0,75893.06
2013-07-09,2013-07-09,Software subscription,REF76081240,118.9,0.0,75774.16
2013-07-12,2013-07-12,Business travel,REF35552213,116.51,0.0,75657.65
2013-07-15,2013-07-15,Service payment - Mendez-Tyler,REF42079098,0.0,1251.05,76908.7
2013-07-15,2013-07-15,Business insurance premium,REF57547586,93.21,0.0,76815.49
2013-07-15,2013-07-15,Payment from Lucas-Campos,REF29327558,0.0,1507.15,78322.64
2013-07-15,2013-07-15,Project payment - Allen PLC,REF76269626,0.0,893.23,79215.87
2013-07-18,2013-07-18,Business travel,REF45370982,128.51,0.0,79087.36
2013-07-22,2013-07-22,Training/conference,REF80052545,67.96,0.0,79019.4
2013-07-23,2013-07-23,Office supplies,REF96795650,35.13,0.0,78984.27
2013-08-09,2013-08-09,Software subscription,REF33832526,115.74,0.0,78868.53
2013-08-10,2013-08-10,Professional services,REF98787190,185.24,0.0,78683.29
2013-08-12,2013-08-12,Marketing expenses,REF51696453,160.8,0.0,78522.49
2013-08-15,2013-08-15,Payment from Lucas-Campos,REF12754602,0.0,1205.77,79728.26
2013-08-15,2013-08-15,Project payment - Mendez-Tyler,REF98919578,0.0,1348.97,81077.23
2013-08-15,2013-08-15,Invoice payment - Allen PLC,REF54911508,0.0,800.32,81877.55
2013-08-15,2013-08-15,Business insurance premium,REF18894674,87.3,0.0,81790.25
2013-08-19,2013-08-19,Office supplies,REF16182688,34.9,0.0,81755.35
2013-08-25,2013-08-25,Office supplies,REF16400088,42.17,0.0,81713.18
2013-08-26,2013-08-26,Office supplies,REF99593149,25.48,0.0,81687.7
2013-08-28,2013-08-28,Office supplies,REF58159684,33.72,0.0,81653.98
2013-08-31,2013-08-31,Equipment purchase,REF51704884,34.63,0.0,81619.35
2013-09-08,2013-09-08,Equipment purchase,REF83829758,132.71,0.0,81486.64
2013-09-09,2013-09-09,Software subscription,REF44665980,152.56,0.0,81334.08
2013-09-10,2013-09-10,Training/conference,REF57738387,124.65,0.0,81209.43
2013-09-11,2013-09-11,Internet and phone service,REF13411375,25.36,0.0,81184.07
2013-09-13,2013-09-13,Equipment purchase,REF15354410,110.39,0.0,81073.68
2013-09-14,2013-09-14,Professional services,REF79409375,222.31,0.0,80851.37
2013-09-15,2013-09-15,Business insurance premium,REF56968054,128.85,0.0,80722.52
2013-09-15,2013-09-15,Invoice payment - Lucas-Campos,REF86912709,0.0,2369.27,83091.79
2013-09-15,2013-09-15,Project payment - Mendez-Tyler,REF46027651,0.0,2260.76,85352.55
2013-09-15,2013-09-15,Project payment - Allen PLC,REF28008727,0.0,1651.41,87003.96
2013-09-18,2013-09-18,Marketing expenses,REF97564160,105.05,0.0,86898.91
2013-09-21,2013-09-21,Equipment purchase,REF85632891,112.54,0.0,86786.37
2013-09-25,2013-09-25,Internet and phone service,REF34196343,56.69,0.0,86729.68
2013-09-29,2013-09-29,Business travel,REF64465371,235.09,0.0,86494.59
2013-09-30,2013-09-30,Training/conference,REF44879834,181.18,0.0,86313.41
2013-10-03,2013-10-03,Marketing expenses,REF42768685,233.5,0.0,86079.91
2013-10-03,2013-10-03,Office supplies,REF10086320,35.65,0.0,86044.26
2013-10-05,2013-10-05,Equipment purchase,REF82269673,167.16,0.0,85877.1
2013-10-05,2013-10-05,Professional services,REF51347874,300.2,0.0,85576.9
2013-10-07,2013-10-07,Business travel,REF53543592,117.38,0.0,85459.52
2013-10-09,2013-10-09,Software subscription,REF20638924,175.97,0.0,85283.55
2013-10-12,2013-10-12,Office supplies,REF33152683,44.06,0.0,85239.49
2013-10-13,2013-10-13,Equipment purchase,REF61853309,110.89,0.0,85128.6
2013-10-14,2013-10-14,Business travel,REF69282177,128.09,0.0,85000.51
2013-10-15,2013-10-15,Payment from Mendez-Tyler,REF55425942,0.0,2128.29,87128.8
2013-10-15,2013-10-15,Project payment - Allen PLC,REF49394302,0.0,1489.06,88617.86
2013-10-15,2013-10-15,Project payment - Lucas-Campos,REF87581348,0.0,2038.16,90656.02
2013-10-15,2013-10-15,Business insurance premium,REF55756141,136.86,0.0,90519.16
2013-10-18,2013-10-18,Office supplies,REF30956000,58.98,0.0,90460.18
2013-10-19,2013-10-19,Marketing expenses,REF53701828,204.03,0.0,90256.15
2013-10-20,2013-10-20,Office supplies,REF36862081,45.1,0.0,90211.05
2013-10-23,2013-10-23,Marketing expenses,REF53770322,348.54,0.0,89862.51
2013-10-24,2013-10-24,Equipment purchase,REF45714962,110.21,0.0,89752.3
2013-10-26,2013-10-26,Office supplies,REF98979727,73.35,0.0,89678.95
2013-11-07,2013-11-07,Equipment purchase,REF77864812,32.23,0.0,89646.72
2013-11-07,2013-11-07,Office supplies,REF39955307,72.73,0.0,89573.99
2013-11-09,2013-11-09,Software subscription,REF20628890,173.0,0.0,89400.99
2013-11-12,2013-11-12,Marketing expenses,REF24842185,161.84,0.0,89239.15
2013-11-14,2013-11-14,Business travel,REF24583211,95.13,0.0,89144.02
2013-11-15,2013-11-15,Business insurance premium,REF53219224,135.14,0.0,89008.88
2013-11-15,2013-11-15,Project payment - Mendez-Tyler,REF59907212,0.0,2280.84,91289.72
2013-11-15,2013-11-15,Project payment - Lucas-Campos,REF98956312,0.0,1686.19,92975.91
2013-11-15,2013-11-15,Service payment - Allen PLC,REF52726450,0.0,1717.35,94693.26
2013-11-20,2013-11-20,Marketing expenses,REF77551808,203.19,0.0,94490.07
2013-11-27,2013-11-27,Internet and phone service,REF75075496,77.28,0.0,94412.79
2013-11-27,2013-11-27,Professional services,REF23628897,295.84,0.0,94116.95
2013-11-30,2013-11-30,Business travel,REF49678220,188.01,0.0,93928.94
2013-12-03,2013-12-03,Equipment purchase,REF26352003,73.08,0.0,93855.86
2013-12-08,2013-12-08,Office supplies,REF60373146,59.9,0.0,93795.96
2013-12-09,2013-12-09,Software subscription,REF16977923,126.84,0.0,93669.12
2013-12-10,2013-12-10,Business travel,REF24930583,93.34,0.0,93575.78
2013-12-11,2013-12-11,Office supplies,REF24425310,31.97,0.0,93543.81
2013-12-11,2013-12-11,Equipment purchase,REF24739472,109.29,0.0,93434.52
2013-12-12,2013-12-12,Business travel,REF50784738,151.52,0.0,93283.0
2013-12-14,2013-12-14,Internet and phone service,REF29583296,63.96,0.0,93219.04
2013-12-15,2013-12-15,Project payment - Lucas-Campos,REF66355064,0.0,1682.19,94901.23
2013-12-15,2013-12-15,Business insurance premium,REF83063517,103.79,0.0,94797.44
2013-12-15,2013-12-15,Payment from Allen PLC,REF69560598,0.0,871.36,95668.8
2013-12-15,2013-12-15,Service payment - Mendez-Tyler,REF55707322,0.0,1876.92,97545.72
2013-12-17,2013-12-17,Office supplies,REF66144876,51.41,0.0,97494.31
2013-12-17,2013-12-17,Professional services,REF90638363,175.41,0.0,97318.9
2013-12-25,2013-12-25,Office supplies,REF68955205,32.03,0.0,97286.87
2013-12-26,2013-12-26,Marketing expenses,REF46736536,168.66,0.0,97118.21
2014-01-03,2014-01-03,Training/conference,REF60065883,140.14,0.0,96978.07
2014-01-04,2014-01-04,Training/conference,REF24092369,102.0,0.0,96876.07
2014-01-06,2014-01-06,Internet and phone service,REF37504696,56.19,0.0,96819.88
2014-01-07,2014-01-07,Professional services,REF60582986,145.52,0.0,96674.36
2014-01-09,2014-01-09,Software subscription,REF72390660,106.6,0.0,96567.76
2014-01-15,2014-01-15,Business insurance premium,REF19937675,100.57,0.0,96467.19
2014-01-15,2014-01-15,Service payment - Lucas-Campos,REF43371072,0.0,1416.67,97883.86
2014-01-15,2014-01-15,Service payment - Mendez-Tyler,REF19529251,0.0,1590.62,99474.48
2014-01-15,2014-01-15,Project payment - Allen PLC,REF11833333,0.0,1066.57,100541.05
2014-01-18,2014-01-18,Marketing expenses,REF32069857,205.72,0.0,100335.33
2014-01-18,2014-01-18,Office supplies,REF70049105,47.51,0.0,100287.82
2014-01-19,2014-01-19,Training/conference,REF36851569,76.5,0.0,100211.32
2014-01-19,2014-01-19,Office supplies,REF36825978,41.13,0.0,100170.19
2014-01-21,2014-01-21,Office supplies,REF34817226,29.17,0.0,100141.02
2014-01-24,2014-01-24,Professional services,REF17133259,227.23,0.0,99913.79
2014-01-25,2014-01-25,Internet and phone service,REF53891949,63.55,0.0,99850.24
2014-01-28,2014-01-28,Office supplies,REF93595028,46.48,0.0,99803.76
2014-02-07,2014-02-07,Marketing expenses,REF87737759,212.83,0.0,99590.93
2014-02-09,2014-02-09,Software subscription,REF69494801,139.64,0.0,99451.29
2014-02-12,2014-02-12,Office supplies,REF20561725,57.54,0.0,99393.75
2014-02-15,2014-02-15,Invoice payment - Allen PLC,REF78677106,0.0,758.79,100152.54
2014-02-15,2014-02-15,Project payment - Lucas-Campos,REF70143389,0.0,1428.63,101581.17
2014-02-15,2014-02-15,Project payment - Mendez-Tyler,REF53227286,0.0,1835.65,103416.82
2014-02-15,2014-02-15,Business insurance premium,REF28167358,101.97,0.0,103314.85
2014-02-21,2014-02-21,Marketing expenses,REF59859295,198.68,0.0,103116.17
2014-03-01,2014-03-01,Business travel,REF18512711,169.38,0.0,102946.79
2014-03-01,2014-03-01,Internet and phone service,REF75192928,114.2,0.0,102832.59
2014-03-07,2014-03-07,Professional services,REF66940404,352.14,0.0,102480.45
2014-03-09,2014-03-09,Internet and phone service,REF21627718,75.76,0.0,102404.69
2014-03-09,2014-03-09,Software subscription,REF52024831,165.66,0.0,102239.03
2014-03-15,2014-03-15,Service payment - Allen PLC,REF44064764,0.0,1571.43,103810.46
2014-03-15,2014-03-15,Business insurance premium,REF44787292,129.12,0.0,103681.34
2014-03-15,2014-03-15,Payment from Mendez-Tyler,REF56365113,0.0,2039.38,105720.72
2014-03-15,2014-03-15,Payment from Lucas-Campos,REF50710522,0.0,2130.61,107851.33
2014-03-22,2014-03-22,Office supplies,REF84674553,78.48,0.0,107772.85
2014-03-26,2014-03-26,Office supplies,REF18680276,51.68,0.0,107721.17
2014-03-27,2014-03-27,Equipment purchase,REF26660656,123.15,0.0,107598.02
2014-03-27,2014-03-27,Office supplies,REF20547900,56.13,0.0,107541.89
2014-03-28,2014-03-28,Business travel,REF67112313,164.64,0.0,107377.25
2014-03-31,2014-03-31,Internet and phone service,REF28192432,55.37,0.0,107321.88
2014-04-02,2014-04-02,Office supplies,REF71395472,66.82,0.0,107255.06
2014-04-05,2014-04-05,Office supplies,REF49184939,71.04,0.0,107184.02
2014-04-08,2014-04-08,Marketing expenses,REF31628743,196.91,0.0,106987.11
2014-04-09,2014-04-09,Software subscription,REF45317167,144.71,0.0,106842.4
2014-04-13,2014-04-13,Equipment purchase,REF61567901,94.29,0.0,106748.11
2014-04-15,2014-04-15,Service payment - Allen PLC,REF42196161,0.0,1140.67,107888.78
2014-04-15,2014-04-15,Business insurance premium,REF82496685,129.12,0.0,107759.66
2014-04-15,2014-04-15,Project payment - Mendez-Tyler,REF55845714,0.0,1541.35,109301.01
2014-04-15,2014-04-15,Equipment purchase,REF53622033,121.87,0.0,109179.14
2014-04-15,2014-04-15,Project payment - Lucas-Campos,REF97590544,0.0,1421.3,110600.44
2014-04-16,2014-04-16,Business travel,REF96920798,114.96,0.0,110485.48
2014-04-18,2014-04-18,Professional services,REF95762580,290.73,0.0,110194.75
2014-04-18,2014-04-18,Office supplies,REF44035167,63.62,0.0,110131.13
2014-04-19,2014-04-19,Internet and phone service,REF20872798,56.12,0.0,110075.01
2014-04-19,2014-04-19,Equipment purchase,REF39831313,92.18,0.0,109982.83
2014-04-25,2014-04-25,Training/conference,REF54031747,102.27,0.0,109880.56
2014-04-26,2014-04-26,Professional services,REF48097367,215.48,0.0,109665.08
2014-04-28,2014-04-28,Equipment purchase,REF67904798,105.51,0.0,109559.57
2014-05-06,2014-05-06,Business travel,REF22502030,157.6,0.0,109401.97
2014-05-06,2014-05-06,Professional services,REF85072125,197.48,0.0,109204.49
2014-05-09,2014-05-09,Software subscription,REF85409359,111.15,0.0,109093.34
2014-05-10,2014-05-10,Office supplies,REF46456440,62.11,0.0,109031.23
2014-05-10,2014-05-10,Internet and phone service,REF98067910,102.78,0.0,108928.45
2014-05-12,2014-05-12,Training/conference,REF83538647,129.63,0.0,108798.82
2014-05-15,2014-05-15,Business insurance premium,REF48280613,121.33,0.0,108677.49
2014-05-15,2014-05-15,Invoice payment - Allen PLC,REF75073257,0.0,1130.58,109808.07
2014-05-15,2014-05-15,Payment from Lucas-Campos,REF41317810,0.0,1706.28,111514.35
2014-05-15,2014-05-15,Project payment - Mendez-Tyler,REF31504047,0.0,1604.73,113119.08
2014-05-16,2014-05-16,Internet and phone service,REF27365793,56.35,0.0,113062.73
2014-05-17,2014-05-17,Training/conference,REF80560902,64.67,0.0,112998.06
2014-05-20,2014-05-20,Marketing expenses,REF85304683,249.59,0.0,112748.47
2014-05-21,2014-05-21,Equipment purchase,REF84286563,109.6,0.0,112638.87
2014-05-25,2014-05-25,Office supplies,REF45732396,37.69,0.0,112601.18
2014-05-28,2014-05-28,Business travel,REF53114317,178.15,0.0,112423.03
2014-05-29,2014-05-29,Office supplies,REF23652258,53.99,0.0,112369.04
2014-05-31,2014-05-31,Professional services,REF31719402,163.6,0.0,112205.44
2014-06-09,2014-06-09,Professional services,REF69054627,242.35,0.0,111963.09
2014-06-09,2014-06-09,Software subscription,REF68473902,126.41,0.0,111836.68
2014-06-12,2014-06-12,Internet and phone service,REF22274972,66.43,0.0,111770.25
2014-06-15,2014-06-15,Project payment - Allen PLC,REF53427422,0.0,941.52,112711.77
2014-06-15,2014-06-15,Business insurance premium,REF25747659,106.21,0.0,112605.56
2014-06-15,2014-06-15,Payment from Lucas-Campos,REF42821315,0.0,1723.84,114329.4
2014-06-15,2014-06-15,Payment from Mendez-Tyler,REF36079521,0.0,2073.41,116402.81
2014-06-16,2014-06-16,Internet and phone service,REF23137103,57.38,0.0,116345.43
2014-06-18,2014-06-18,Training/conference,REF33927008,56.68,0.0,116288.75
2014-06-22,2014-06-22,Internet and phone service,REF76286983,43.08,0.0,116245.67
2014-06-22,2014-06-22,Office supplies,REF73903120,50.24,0.0,116195.43
2014-06-22,2014-06-22,Business travel,REF12360337,118.44,0.0,116076.99
2014-06-25,2014-06-25,Internet and phone service,REF97933701,57.13,0.0,116019.86
2014-06-27,2014-06-27,Professional services,REF89027930,248.08,0.0,115771.78
2014-06-30,2014-06-30,Office supplies,REF50726043,50.51,0.0,115721.27
2014-07-01,2014-07-01,Training/conference,REF78211877,72.4,0.0,115648.87
2014-07-05,2014-07-05,Business travel,REF72414876,131.63,0.0,115517.24
2014-07-06,2014-07-06,Office supplies,REF53476879,43.69,0.0,115473.55
2014-07-09,2014-07-09,Software subscription,REF64682869,128.56,0.0,115344.99
2014-07-14,2014-07-14,Business travel,REF26635682,77.0,0.0,115267.99
2014-07-14,2014-07-14,Office supplies,REF78276674,47.05,0.0,115220.94
2014-07-15,2014-07-15,Business insurance premium,REF97446159,94.58,0.0,115126.36
2014-07-15,2014-07-15,Service payment - Allen PLC,REF48149595,0.0,1181.6,116307.96
2014-07-15,2014-07-15,Project payment - Mendez-Tyler,REF76354684,0.0,1056.57,117364.53
2014-07-15,2014-07-15,Invoice payment - Lucas-Campos,REF84541588,0.0,1215.89,118580.42
2014-07-20,2014-07-20,Office supplies,REF15546622,55.11,0.0,118525.31
2014-07-24,2014-07-24,Professional services,REF79659491,274.8,0.0,118250.51
2014-07-27,2014-07-27,Office supplies,REF71171060,49.23,0.0,118201.28
2014-07-29,2014-07-29,Marketing expenses,REF32698632,142.42,0.0,118058.86
2014-07-30,2014-07-30,Training/conference,REF49081122,92.55,0.0,117966.31
2014-07-31,2014-07-31,Office supplies,REF88811694,36.35,0.0,117929.96
2014-08-09,2014-08-09,Software subscription,REF47767906,117.05,0.0,117812.91
2014-08-10,2014-08-10,Business travel,REF63195502,144.52,0.0,117668.39
2014-08-15,2014-08-15,Service payment - Mendez-Tyler,REF60142718,0.0,1264.11,118932.5
2014-08-15,2014-08-15,Service payment - Lucas-Campos,REF49363741,0.0,1441.91,120374.41
2014-08-15,2014-08-15,Business insurance premium,REF39987361,76.42,0.0,120297.99
2014-08-15,2014-08-15,Invoice payment - Allen PLC,REF43930757,0.0,848.07,121146.06
2014-08-19,2014-08-19,Internet and phone service,REF19751201,45.59,0.0,121100.47
2014-08-20,2014-08-20,Office supplies,REF22871833,42.95,0.0,121057.52
2014-08-20,2014-08-20,Business travel,REF18017903,117.08,0.0,120940.44
2014-08-23,2014-08-23,Training/conference,REF23023720,101.39,0.0,120839.05
2014-09-01,2014-09-01,Office supplies,REF78079775,38.41,0.0,120800.64
2014-09-09,2014-09-09,Software subscription,REF84203891,149.98,0.0,120650.66
2014-09-11,2014-09-11,Business travel,REF92831710,97.09,0.0,120553.57
2014-09-15,2014-09-15,Business insurance premium,REF20147156,147.23,0.0,120406.34
2014-09-15,2014-09-15,Payment from Allen PLC,REF90344275,0.0,1274.96,121681.3
2014-09-15,2014-09-15,Payment from Lucas-Campos,REF24452163,0.0,2217.74,123899.04
2014-09-15,2014-09-15,Project payment - Mendez-Tyler,REF98979161,0.0,3159.81,127058.85
2014-09-17,2014-09-17,Internet and phone service,REF66205313,110.34,0.0,126948.51
2014-09-19,2014-09-19,Training/conference,REF63938977,171.39,0.0,126777.12
2014-09-23,2014-09-23,Business travel,REF19348208,221.99,0.0,126555.13
2014-10-05,2014-10-05,Business travel,REF44112806,128.43,0.0,126426.7
2014-10-09,2014-10-09,Software subscription,REF82506947,206.28,0.0,126220.42
2014-10-09,2014-10-09,Training/conference,REF59659055,79.75,0.0,126140.67
2014-10-11,2014-10-11,Office supplies,REF14019095,47.71,0.0,126092.96
2014-10-14,2014-10-14,Business travel,REF96192048,235.4,0.0,125857.56
2014-10-15,2014-10-15,Service payment - Lucas-Campos,REF28231153,0.0,2554.55,128412.11
2014-10-15,2014-10-15,Project payment - Mendez-Tyler,REF84440361,0.0,1861.1,130273.21
2014-10-15,2014-10-15,Business insurance premium,REF66838391,133.13,0.0,130140.08
2014-10-15,2014-10-15,Payment from Allen PLC,REF20363098,0.0,1392.54,131532.62
2014-10-19,2014-10-19,Marketing expenses,REF74172355,122.18,0.0,131410.44
2014-10-20,2014-10-20,Equipment purchase,REF30084050,94.78,0.0,131315.66
2014-10-20,2014-10-20,Business travel,REF12684227,119.0,0.0,131196.66
2014-10-22,2014-10-22,Internet and phone service,REF42022097,69.94,0.0,131126.72
2014-10-23,2014-10-23,Professional services,REF63318381,445.94,0.0,130680.78
2014-10-25,2014-10-25,Marketing expenses,REF74663085,215.05,0.0,130465.73
2014-10-25,2014-10-25,Equipment purchase,REF13205420,80.29,0.0,130385.44
2014-10-29,2014-10-29,Business travel,REF67450932,164.8,0.0,130220.64
2014-10-30,2014-10-30,Internet and phone service,REF84701282,118.4,0.0,130102.24
2014-11-04,2014-11-04,Training/conference,REF70182853,94.66,0.0,130007.58
2014-11-07,2014-11-07,Office supplies,REF93656000,60.46,0.0,129947.12
2014-11-09,2014-11-09,Software subscription,REF38168649,178.43,0.0,129768.69
2014-11-12,2014-11-12,Equipment purchase,REF54342661,141.36,0.0,129627.33
2014-11-14,2014-11-14,Office supplies,REF94146830,75.43,0.0,129551.9
2014-11-14,2014-11-14,Internet and phone service,REF28184862,83.61,0.0,129468.29
2014-11-14,2014-11-14,Business travel,REF69581606,264.58,0.0,129203.71
2014-11-15,2014-11-15,Service payment - Lucas-Campos,REF69479830,0.0,1832.82,131036.53
2014-11-15,2014-11-15,Project payment - Allen PLC,REF33406166,0.0,1078.78,132115.31
2014-11-15,2014-11-15,Payment from Mendez-Tyler,REF82463816,0.0,2051.61,134166.92
2014-11-15,2014-11-15,Business insurance premium,REF43702029,141.61,0.0,134025.31
2014-11-15,2014-11-15,Internet and phone service,REF49938359,111.09,0.0,133914.22
2014-11-17,2014-11-17,Professional services,REF51304055,151.25,0.0,133762.97
2014-11-18,2014-11-18,Office supplies,REF90435180,69.42,0.0,133693.55
2014-11-26,2014-11-26,Equipment purchase,REF53670846,114.85,0.0,133578.7
2014-11-26,2014-11-26,Office supplies,REF40894450,37.46,0.0,133541.24
2014-12-02,2014-12-02,Business travel,REF66027904,86.33,0.0,133454.91
2014-12-03,2014-12-03,Office supplies,REF74894683,56.65,0.0,133398.26
2014-12-09,2014-12-09,Software subscription,REF42917690,132.07,0.0,133266.19
2014-12-14,2014-12-14,Marketing expenses,REF18999263,107.85,0.0,133158.34
2014-12-15,2014-12-15,Project payment - Mendez-Tyler,REF85763935,0.0,1863.95,135022.29
2014-12-15,2014-12-15,Service payment - Allen PLC,REF64312858,0.0,1108.22,136130.51
2014-12-15,2014-12-15,Payment from Lucas-Campos,REF33383090,0.0,1517.53,137648.04
2014-12-15,2014-12-15,Business insurance premium,REF84190675,107.16,0.0,137540.88
2014-12-17,2014-12-17,Training/conference,REF72024034,44.81,0.0,137496.07
2014-12-21,2014-12-21,Training/conference,REF67833728,72.42,0.0,137423.65
2014-12-21,2014-12-21,Office supplies,REF31853853,54.33,0.0,137369.32
2014-12-23,2014-12-23,Office supplies,REF22966704,25.01,0.0,137344.31
2014-12-24,2014-12-24,Marketing expenses,REF41133591,112.69,0.0,137231.62
2014-12-29,2014-12-29,Professional services,REF15626033,152.79,0.0,137078.83
2014-12-31,2014-12-31,Office supplies,REF32209069,60.01,0.0,137018.82
2015-01-01,2015-01-01,Office supplies,REF44210029,40.28,0.0,136978.54
2015-01-02,2015-01-02,Business travel,REF90224755,137.63,0.0,136840.91
2015-01-02,2015-01-02,Office supplies,REF68440270,35.05,0.0,136805.86
2015-01-08,2015-01-08,Equipment purchase,REF14666954,74.37,0.0,136731.49
2015-01-09,2015-01-09,Software subscription,REF46144306,112.07,0.0,136619.42
2015-01-10,2015-01-10,Business travel,REF57684394,49.73,0.0,136569.69
2015-01-15,2015-01-15,Payment from Allen PLC,REF28171682,0.0,923.81,137493.5
2015-01-15,2015-01-15,Service payment - Mendez-Tyler,REF35602713,0.0,1547.52,139041.02
2015-01-15,2015-01-15,Payment from Lucas-Campos,REF19550242,0.0,1336.9,140377.92
2015-01-15,2015-01-15,Business insurance premium,REF33260963,95.04,0.0,140282.88
2015-01-18,2015-01-18,Professional services,REF69295222,158.45,0.0,140124.43
2015-01-19,2015-01-19,Office supplies,REF42067118,24.61,0.0,140099.82
2015-01-20,2015-01-20,Professional services,REF22221203,142.76,0.0,139957.06
2015-01-24,2015-01-24,Office supplies,REF23195210,24.53,0.0,139932.53
2015-01-24,2015-01-24,Equipment purchase,REF71730278,65.12,0.0,139867.41
2015-02-01,2015-02-01,Office supplies,REF85326654,65.93,0.0,139801.48
2015-02-07,2015-02-07,Office supplies,REF21961633,39.86,0.0,139761.62
2015-02-08,2015-02-08,Internet and phone service,REF24550685,95.95,0.0,139665.67
2015-02-09,2015-02-09,Software subscription,REF67195418,130.79,0.0,139534.88
2015-02-15,2015-02-15,Business insurance premium,REF19829886,103.83,0.0,139431.05
2015-02-15,2015-02-15,Service payment - Mendez-Tyler,REF96805760,0.0,1667.1,141098.15
2015-02-20,2015-02-20,Training/conference,REF91196102,56.54,0.0,141041.61
2015-02-25,2015-02-25,Office supplies,REF27695864,37.62,0.0,141003.99
2015-02-27,2015-02-27,Office supplies,REF43869614,59.92,0.0,140944.07
2015-03-03,2015-03-03,Marketing expenses,REF43639159,160.05,0.0,140784.02
2015-03-05,2015-03-05,Marketing expenses,REF86318225,187.95,0.0,140596.07
2015-03-09,2015-03-09,Software subscription,REF57715666,159.47,0.0,140436.6
2015-03-15,2015-03-15,Invoice payment - Mendez-Tyler,REF91716046,0.0,1856.79,142293.39
2015-03-15,2015-03-15,Business insurance premium,REF79475899,122.14,0.0,142171.25
2015-03-15,2015-03-15,Payment from Allen PLC,REF42619208,0.0,1592.53,143763.78
2015-03-15,2015-03-15,Project payment - Lucas-Campos,REF50646040,0.0,2406.72,146170.5
2015-03-16,2015-03-16,Marketing expenses,REF61080492,188.05,0.0,145982.45
2015-03-19,2015-03-19,Internet and phone service,REF68196318,107.67,0.0,145874.78
2015-03-20,2015-03-20,Office supplies,REF72021797,73.71,0.0,145801.07
2015-03-21,2015-03-21,Training/conference,REF16956160,136.69,0.0,145664.38
2015-03-24,2015-03-24,Office supplies,REF80630713,56.0,0.0,145608.38
2015-03-27,2015-03-27,Internet and phone service,REF36810968,96.33,0.0,145512.05
2015-04-07,2015-04-07,Office supplies,REF90588892,31.79,0.0,145480.26
2015-04-09,2015-04-09,Software subscription,REF61517861,127.77,0.0,145352.49
2015-04-12,2015-04-12,Equipment purchase,REF22024298,89.97,0.0,145262.52
2015-04-12,2015-04-12,Training/conference,REF12405981,73.62,0.0,145188.9
2015-04-13,2015-04-13,Training/conference,REF78123349,101.73,0.0,145087.17
2015-04-14,2015-04-14,Office supplies,REF55017532,49.68,0.0,145037.49
2015-04-15,2015-04-15,Business insurance premium,REF92358995,117.24,0.0,144920.25
2015-04-15,2015-04-15,Service payment - Mendez-Tyler,REF34737031,0.0,1316.03,146236.28
2015-04-15,2015-04-15,Payment from Allen PLC,REF65859656,0.0,1438.75,147675.03
2015-04-15,2015-04-15,Business travel,REF28505668,145.2,0.0,147529.83
2015-05-08,2015-05-08,Office supplies,REF24102795,53.24,0.0,147476.59
2015-05-09,2015-05-09,Software subscription,REF99396588,143.05,0.0,147333.54
2015-05-15,2015-05-15,Business insurance premium,REF29973731,122.95,0.0,147210.59
2015-05-15,2015-05-15,Service payment - Lucas-Campos,REF29377356,0.0,1826.09,149036.68
2015-05-15,2015-05-15,Payment from Allen PLC,REF83242639,0.0,1230.83,150267.51
2015-05-15,2015-05-15,Payment from Mendez-Tyler,REF33454415,0.0,1406.25,151673.76
2015-05-17,2015-05-17,Business travel,REF25988390,122.82,0.0,151550.94
2015-05-21,2015-05-21,Office supplies,REF63640529,61.09,0.0,151489.85
2015-05-21,2015-05-21,Training/conference,REF46123938,56.16,0.0,151433.69
2015-05-22,2015-05-22,Marketing expenses,REF84576155,135.38,0.0,151298.31
2015-06-03,2015-06-03,Internet and phone service,REF48333885,52.3,0.0,151246.01
2015-06-04,2015-06-04,Office supplies,REF80767683,44.23,0.0,151201.78
2015-06-05,2015-06-05,Business travel,REF86161986,219.35,0.0,150982.43
2015-06-07,2015-06-07,Office supplies,REF61644738,34.48,0.0,150947.95
2015-06-08,2015-06-08,Training/conference,REF74847889,79.55,0.0,150868.4
2015-06-09,2015-06-09,Software subscription,REF59284621,143.4,0.0,150725.0
2015-06-11,2015-06-11,Office supplies,REF12687458,50.3,0.0,150674.7
2015-06-15,2015-06-15,Service payment - Allen PLC,REF46821457,0.0,869.63,151544.33
2015-06-15,2015-06-15,Project payment - Lucas-Campos,REF98155903,0.0,1424.28,152968.61
2015-06-15,2015-06-15,Payment from Mendez-Tyler,REF84082495,0.0,1915.97,154884.58
2015-06-15,2015-06-15,Business insurance premium,REF98636743,106.25,0.0,154778.33
2015-06-16,2015-06-16,Office supplies,REF54740392,44.1,0.0,154734.23
2015-06-21,2015-06-21,Business travel,REF66222686,62.48,0.0,154671.75
2015-06-22,2015-06-22,Training/conference,REF50705116,92.14,0.0,154579.61
2015-06-27,2015-06-27,Professional services,REF32113843,201.4,0.0,154378.21
2015-07-02,2015-07-02,Equipment purchase,REF70608330,46.48,0.0,154331.73
2015-07-06,2015-07-06,Office supplies,REF54555264,47.49,0.0,154284.24
2015-07-07,2015-07-07,Office supplies,REF16480415,49.55,0.0,154234.69
2015-07-08,2015-07-08,Business travel,REF92593121,109.71,0.0,154124.98
2015-07-09,2015-07-09,Software subscription,REF96913194,122.21,0.0,154002.77
2015-07-11,2015-07-11,Training/conference,REF60009658,44.36,0.0,153958.41
2015-07-14,2015-07-14,Office supplies,REF88862571,29.19,0.0,153929.22
2015-07-15,2015-07-15,Business insurance premium,REF14902864,103.85,0.0,153825.37
2015-07-15,2015-07-15,Service payment - Lucas-Campos,REF54221418,0.0,1575.13,155400.5
2015-07-15,2015-07-15,Payment from Allen PLC,REF59636517,0.0,776.67,156177.17
2015-07-15,2015-07-15,Project payment - Mendez-Tyler,REF76144053,0.0,1292.49,157469.66
2015-07-20,2015-07-20,Office supplies,REF86744982,42.6,0.0,157427.06
2015-07-21,2015-07-21,Professional services,REF70464335,164.86,0.0,157262.2
2015-07-22,2015-07-22,Office supplies,REF44637041,41.89,0.0,157220.31
2015-07-23,2015-07-23,Training/conference,REF45361409,63.37,0.0,157156.94
2015-07-29,2015-07-29,Office supplies,REF96242652,54.37,0.0,157102.57
2015-08-02,2015-08-02,Business travel,REF52781535,99.36,0.0,157003.21
2015-08-03,2015-08-03,Office supplies,REF82307661,31.88,0.0,156971.33
2015-08-05,2015-08-05,Office supplies,REF88929773,27.92,0.0,156943.41
2015-08-07,2015-08-07,Marketing expenses,REF63764680,70.19,0.0,156873.22
2015-08-07,2015-08-07,Professional services,REF33708777,173.64,0.0,156699.58
2015-08-08,2015-08-08,Office supplies,REF98009614,54.55,0.0,156645.03
2015-08-09,2015-08-09,Software subscription,REF45276564,108.52,0.0,156536.51
2015-08-14,2015-08-14,Office supplies,REF97761184,53.3,0.0,156483.21
2015-08-15,2015-08-15,Business insurance premium,REF66036303,86.9,0.0,156396.31
2015-08-15,2015-08-15,Payment from Lucas-Campos,REF86596930,0.0,1285.52,157681.83
2015-08-15,2015-08-15,Project payment - Allen PLC,REF95464201,0.0,702.25,158384.08
2015-08-15,2015-08-15,Project payment - Mendez-Tyler,REF30417835,0.0,1102.56,159486.64
2015-08-18,2015-08-18,Professional services,REF55309725,170.74,0.0,159315.9
2015-08-24,2015-08-24,Marketing expenses,REF12776591,97.65,0.0,159218.25
2015-08-25,2015-08-25,Office supplies,REF56673672,31.48,0.0,159186.77
2015-09-09,2015-09-09,Software subscription,REF99104140,166.36,0.0,159020.41
2015-09-10,2015-09-10,Marketing expenses,REF24964534,228.73,0.0,158791.68
2015-09-11,2015-09-11,Internet and phone service,REF60921281,83.68,0.0,158708.0
2015-09-15,2015-09-15,Business travel,REF39412727,123.98,0.0,158584.02
2015-09-15,2015-09-15,Project payment - Mendez-Tyler,REF72872954,0.0,1974.65,160558.67
2015-09-15,2015-09-15,Invoice payment - Allen PLC,REF69749415,0.0,1438.08,161996.75
2015-09-15,2015-09-15,Service payment - Lucas-Campos,REF35929894,0.0,1842.4,163839.15
2015-09-15,2015-09-15,Business insurance premium,REF22329843,146.54,0.0,163692.61
2015-09-22,2015-09-22,Office supplies,REF81828912,49.49,0.0,163643.12
2015-09-22,2015-09-22,Equipment purchase,REF95308681,115.35,0.0,163527.77
2015-09-23,2015-09-23,Internet and phone service,REF58671571,119.19,0.0,163408.58
2015-09-23,2015-09-23,Office supplies,REF55639612,39.94,0.0,163368.64
2015-09-29,2015-09-29,Training/conference,REF20041286,127.58,0.0,163241.06
2015-10-01,2015-10-01,Office supplies,REF46751961,53.96,0.0,163187.1
2015-10-03,2015-10-03,Business travel,REF92772737,271.46,0.0,162915.64
2015-10-06,2015-10-06,Office supplies,REF32030275,90.08,0.0,162825.56
2015-10-09,2015-10-09,Office supplies,REF69352471,13.58,0.0,162811.98
2015-10-09,2015-10-09,Software subscription,REF30570472,174.79,0.0,162637.19
2015-10-11,2015-10-11,Office supplies,REF43502131,73.39,0.0,162563.8
2015-10-14,2015-10-14,Office supplies,REF63226688,66.2,0.0,162497.6
2015-10-15,2015-10-15,Business insurance premium,REF36563822,142.05,0.0,162355.55
2015-10-15,2015-10-15,Project payment - Allen PLC,REF19428638,0.0,1502.8,163858.35
2015-10-15,2015-10-15,Invoice payment - Lucas-Campos,REF30205992,0.0,2518.6,166376.95
2015-10-15,2015-10-15,Service payment - Mendez-Tyler,REF34288439,0.0,2151.71,168528.66
2015-10-18,2015-10-18,Internet and phone service,REF91723106,72.62,0.0,168456.04
2015-10-23,2015-10-23,Business travel,REF35803863,135.09,0.0,168320.95
2015-10-24,2015-10-24,Internet and phone service,REF82868839,95.94,0.0,168225.01
2015-10-27,2015-10-27,Internet and phone service,REF36467281,97.22,0.0,168127.79
2015-11-03,2015-11-03,Business travel,REF91704585,218.07,0.0,167909.72
2015-11-03,2015-11-03,Equipment purchase,REF24903174,85.52,0.0,167824.2
2015-11-04,2015-11-04,Office supplies,REF66586448,49.08,0.0,167775.12
2015-11-06,2015-11-06,Business travel,REF26513027,120.73,0.0,167654.39
2015-11-09,2015-11-09,Software subscription,REF32469108,172.66,0.0,167481.73
2015-11-11,2015-11-11,Equipment purchase,REF34991193,71.35,0.0,167410.38
2015-11-12,2015-11-12,Professional services,REF90007377,355.32,0.0,167055.06
2015-11-12,2015-11-12,Business travel,REF27911300,51.51,0.0,167003.55
2015-11-15,2015-11-15,Business insurance premium,REF44317158,134.86,0.0,166868.69
2015-11-15,2015-11-15,Project payment - Mendez-Tyler,REF34216729,0.0,2334.3,169202.99
2015-11-15,2015-11-15,Project payment - Allen PLC,REF56274725,0.0,1295.69,170498.68
2015-11-15,2015-11-15,Service payment - Lucas-Campos,REF20350597,0.0,1860.12,172358.8
2015-11-16,2015-11-16,Office supplies,REF64257856,50.6,0.0,172308.2
2015-11-18,2015-11-18,Business travel,REF50829721,79.51,0.0,172228.69
2015-11-20,2015-11-20,Marketing expenses,REF93863927,183.73,0.0,172044.96
2015-11-27,2015-11-27,Office supplies,REF60433600,55.9,0.0,171989.06
2015-12-09,2015-12-09,Software subscription,REF12287444,132.8,0.0,171856.26
2015-12-09,2015-12-09,Equipment purchase,REF86593312,95.46,0.0,171760.8
2015-12-12,2015-12-12,Marketing expenses,REF13517718,172.02,0.0,171588.78
2015-12-13,2015-12-13,Office supplies,REF21245640,59.0,0.0,171529.78
2015-12-15,2015-12-15,Invoice payment - Allen PLC,REF25125047,0.0,1208.62,172738.4
2015-12-15,2015-12-15,Invoice payment - Lucas-Campos,REF56312926,0.0,1226.35,173964.75
2015-12-15,2015-12-15,Payment from Mendez-Tyler,REF92451905,0.0,1682.04,175646.79
2015-12-15,2015-12-15,Business insurance premium,REF94067067,103.08,0.0,175543.71
2015-12-16,2015-12-16,Office supplies,REF10813179,60.17,0.0,175483.54
2015-12-19,2015-12-19,Business travel,REF32008666,166.15,0.0,175317.39
2016-01-03,2016-01-03,Office supplies,REF37143101,29.82,0.0,175287.57
2016-01-09,2016-01-09,Software subscription,REF37251096,126.28,0.0,175161.29
2016-01-10,2016-01-10,Internet and phone service,REF45430630,78.92,0.0,175082.37
2016-01-10,2016-01-10,Office supplies,REF28780309,59.01,0.0,175023.36
2016-01-12,2016-01-12,Office supplies,REF58963912,52.8,0.0,174970.56
2016-01-15,2016-01-15,Business insurance premium,REF98878242,91.12,0.0,174879.44
2016-01-15,2016-01-15,Business travel,REF74044954,108.01,0.0,174771.43
2016-01-15,2016-01-15,Payment from Mendez-Tyler,REF20766689,0.0,1220.11,175991.54
2016-01-15,2016-01-15,Payment from Lucas-Campos,REF85418010,0.0,1094.51,177086.05
2016-01-15,2016-01-15,Service payment - Allen PLC,REF15604298,0.0,1191.92,178277.97
2016-01-18,2016-01-18,Training/conference,REF74289870,103.91,0.0,178174.06
2016-01-19,2016-01-19,Internet and phone service,REF89695423,7.87,0.0,178166.19
2016-01-19,2016-01-19,Office supplies,REF92800843,35.16,0.0,178131.03
2016-01-24,2016-01-24,Professional services,REF54841076,111.75,0.0,178019.28
2016-01-25,2016-01-25,Professional services,REF45117750,228.55,0.0,177790.73
2016-01-31,2016-01-31,Marketing expenses,REF58635591,139.3,0.0,177651.43
2016-02-02,2016-02-02,Office supplies,REF45271514,55.87,0.0,177595.56
2016-02-04,2016-02-04,Equipment purchase,REF90996381,101.01,0.0,177494.55
2016-02-05,2016-02-05,Business travel,REF57882108,175.05,0.0,177319.5
2016-02-07,2016-02-07,Professional services,REF49605462,255.34,0.0,177064.16
2016-02-09,2016-02-09,Software subscription,REF58180925,120.63,0.0,176943.53
2016-02-15,2016-02-15,Project payment - Lucas-Campos,REF48809809,0.0,1573.3,178516.83
2016-02-15,2016-02-15,Invoice payment - Allen PLC,REF11926504,0.0,875.3,179392.13
2016-02-15,2016-02-15,Invoice payment - Mendez-Tyler,REF50897957,0.0,938.45,180330.58
2016-02-15,2016-02-15,Business insurance premium,REF85176057,103.96,0.0,180226.62
2016-02-15,2016-02-15,Office supplies,REF88937788,29.4,0.0,180197.22
2016-02-18,2016-02-18,Office supplies,REF63016418,41.6,0.0,180155.62
2016-02-24,2016-02-24,Office supplies,REF29962443,36.45,0.0,180119.17
2016-02-29,2016-02-29,Professional services,REF77391633,234.62,0.0,179884.55
2016-03-09,2016-03-09,Software subscription,REF15900733,143.47,0.0,179741.08
2016-03-14,2016-03-14,Office supplies,REF38453665,62.8,0.0,179678.28
2016-03-15,2016-03-15,Business insurance premium,REF59560890,143.58,0.0,179534.7
2016-03-15,2016-03-15,Payment from Mendez-Tyler,REF10978998,0.0,2155.98,181690.68
2016-03-15,2016-03-15,Service payment - Allen PLC,REF28464010,0.0,1040.85,182731.53
2016-03-15,2016-03-15,Business travel,REF21511674,265.58,0.0,182465.95
2016-03-15,2016-03-15,Service payment - Lucas-Campos,REF45082239,0.0,2270.64,184736.59
2016-03-17,2016-03-17,Marketing expenses,REF48142114,137.02,0.0,184599.57
2016-03-22,2016-03-22,Professional services,REF65175680,169.61,0.0,184429.96
2016-03-22,2016-03-22,Office supplies,REF25625271,86.0,0.0,184343.96
2016-03-26,2016-03-26,Training/conference,REF42754861,155.94,0.0,184188.02
2016-03-28,2016-03-28,Equipment purchase,REF24029034,31.34,0.0,184156.68
2016-03-29,2016-03-29,Business travel,REF44069842,119.84,0.0,184036.84
2016-04-03,2016-04-03,Office supplies,REF36714222,58.0,0.0,183978.84
2016-04-05,2016-04-05,Business travel,REF34991366,202.04,0.0,183776.8
2016-04-06,2016-04-06,Office supplies,REF45269167,34.89,0.0,183741.91
2016-04-08,2016-04-08,Professional services,REF47296687,186.01,0.0,183555.9
2016-04-09,2016-04-09,Software subscription,REF84025658,162.75,0.0,183393.15
2016-04-11,2016-04-11,Marketing expenses,REF39919024,211.98,0.0,183181.17
2016-04-13,2016-04-13,Business travel,REF15062713,98.14,0.0,183083.03
2016-04-15,2016-04-15,Project payment - Allen PLC,REF95580325,0.0,1153.95,184236.98
2016-04-15,2016-04-15,Service payment - Mendez-Tyler,REF64818315,0.0,1651.31,185888.29
2016-04-15,2016-04-15,Business insurance premium,REF72287433,124.15,0.0,185764.14
2016-04-15,2016-04-15,Payment from Lucas-Campos,REF93524374,0.0,1635.93,187400.07
2016-04-16,2016-04-16,Office supplies,REF93243622,51.16,0.0,187348.91
2016-04-19,2016-04-19,Training/conference,REF15000955,135.56,0.0,187213.35
2016-04-22,2016-04-22,Office supplies,REF50746690,20.35,0.0,187193.0
2016-04-24,2016-04-24,Equipment purchase,REF29894606,61.61,0.0,187131.39
2016-04-28,2016-04-28,Office supplies,REF64343367,43.92,0.0,187087.47
2016-04-30,2016-04-30,Equipment purchase,REF24776422,102.63,0.0,186984.84
2016-05-01,2016-05-01,Equipment purchase,REF29250609,99.89,0.0,186884.95
2016-05-09,2016-05-09,Software subscription,REF92215230,142.05,0.0,186742.9
2016-05-09,2016-05-09,Office supplies,REF62382538,44.53,0.0,186698.37
2016-05-15,2016-05-15,Payment from Lucas-Campos,REF85672421,0.0,2056.4,188754.77
2016-05-15,2016-05-15,Business insurance premium,REF24599227,120.68,0.0,188634.09
2016-05-15,2016-05-15,Service payment - Allen PLC,REF30836824,0.0,1274.18,189908.27
2016-05-15,2016-05-15,Payment from Mendez-Tyler,REF56405216,0.0,1652.87,191561.14
2016-05-15,2016-05-15,Office supplies,REF82689296,34.71,0.0,191526.43
2016-05-18,2016-05-18,Training/conference,REF18990003,96.74,0.0,191429.69
2016-05-23,2016-05-23,Office supplies,REF83463256,35.07,0.0,191394.62
2016-05-25,2016-05-25,Office supplies,REF10635359,49.62,0.0,191345.0
2016-05-28,2016-05-28,Office supplies,REF60608666,45.41,0.0,191299.59
2016-05-30,2016-05-30,Equipment purchase,REF81050650,55.09,0.0,191244.5
2016-06-07,2016-06-07,Internet and phone service,REF86417212,65.5,0.0,191179.0
2016-06-09,2016-06-09,Software subscription,REF39018082,148.98,0.0,191030.02
2016-06-11,2016-06-11,Office supplies,REF92403527,48.7,0.0,190981.32
2016-06-12,2016-06-12,Professional services,REF54996310,151.13,0.0,190830.19
2016-06-14,2016-06-14,Marketing expenses,REF44319297,222.32,0.0,190607.87
2016-06-15,2016-06-15,Business insurance premium,REF94553205,100.57,0.0,190507.3
2016-06-15,2016-06-15,Payment from Lucas-Campos,REF67288058,0.0,1721.92,192229.22
2016-06-15,2016-06-15,Payment from Allen PLC,REF18488876,0.0,1031.84,193261.06
2016-06-15,2016-06-15,Service payment - Mendez-Tyler,REF35846702,0.0,1434.6,194695.66
2016-06-18,2016-06-18,Business travel,REF98192910,143.25,0.0,194552.41
2016-06-21,2016-06-21,Office supplies,REF56884829,34.85,0.0,194517.56
2016-06-24,2016-06-24,Office supplies,REF45550898,51.58,0.0,194465.98
2016-06-27,2016-06-27,Office supplies,REF84654132,67.19,0.0,194398.79
2016-07-03,2016-07-03,Office supplies,REF73826175,32.81,0.0,194365.98
2016-07-03,2016-07-03,Professional services,REF49289900,229.96,0.0,194136.02
2016-07-09,2016-07-09,Software subscription,REF67357570,118.69,0.0,194017.33
2016-07-10,2016-07-10,Internet and phone service,REF11020914,65.47,0.0,193951.86
2016-07-13,2016-07-13,Business travel,REF30074943,167.19,0.0,193784.67
2016-07-15,2016-07-15,Service payment - Mendez-Tyler,REF60353520,0.0,1860.45,195645.12
2016-07-15,2016-07-15,Invoice payment - Allen PLC,REF50402694,0.0,904.52,196549.64
2016-07-15,2016-07-15,Business insurance premium,REF35534950,101.91,0.0,196447.73
2016-07-20,2016-07-20,Marketing expenses,REF70826565,216.74,0.0,196230.99
2016-07-21,2016-07-21,Marketing expenses,REF12566892,158.97,0.0,196072.02
2016-07-21,2016-07-21,Internet and phone service,REF11622494,63.4,0.0,196008.62
2016-07-23,2016-07-23,Training/conference,REF99123696,76.61,0.0,195932.01
2016-07-24,2016-07-24,Equipment purchase,REF50460838,83.33,0.0,195848.68
2016-07-24,2016-07-24,Internet and phone service,REF56529120,63.16,0.0,195785.52
2016-07-24,2016-07-24,Marketing expenses,REF78184298,169.79,0.0,195615.73
2016-07-25,2016-07-25,Business travel,REF88985295,120.7,0.0,195495.03
2016-07-26,2016-07-26,Office supplies,REF98732072,40.14,0.0,195454.89
2016-07-30,2016-07-30,Office supplies,REF18816507,24.24,0.0,195430.65
2016-07-31,2016-07-31,Equipment purchase,REF48027833,81.82,0.0,195348.83
2016-08-09,2016-08-09,Software subscription,REF69685951,91.81,0.0,195257.02
2016-08-15,2016-08-15,Business insurance premium,REF91838652,84.68,0.0,195172.34
2016-08-15,2016-08-15,Equipment purchase,REF36748560,76.37,0.0,195095.97
2016-08-15,2016-08-15,Project payment - Lucas-Campos,REF13699729,0.0,1341.07,196437.04
2016-08-15,2016-08-15,Invoice payment - Allen PLC,REF66434691,0.0,1048.47,197485.51
2016-08-15,2016-08-15,Payment from Mendez-Tyler,REF13069670,0.0,1276.55,198762.06
2016-08-19,2016-08-19,Office supplies,REF17931033,32.65,0.0,198729.41
2016-08-23,2016-08-23,Office supplies,REF17915359,32.25,0.0,198697.16
2016-08-27,2016-08-27,Office supplies,REF82638371,23.46,0.0,198673.7
2016-08-29,2016-08-29,Business travel,REF24208284,99.23,0.0,198574.47
2016-08-30,2016-08-30,Professional services,REF87087527,207.94,0.0,198366.53
2016-09-04,2016-09-04,Office supplies,REF84219918,61.98,0.0,198304.55
2016-09-06,2016-09-06,Training/conference,REF32927652,126.38,0.0,198178.17
2016-09-08,2016-09-08,Business travel,REF36463646,108.16,0.0,198070.01
2016-09-09,2016-09-09,Software subscription,REF17318869,171.29,0.0,197898.72
2016-09-14,2016-09-14,Marketing expenses,REF90756973,206.04,0.0,197692.68
2016-09-15,2016-09-15,Invoice payment - Lucas-Campos,REF59076450,0.0,2065.27,199757.95
2016-09-15,2016-09-15,Equipment purchase,REF12140360,85.71,0.0,199672.24
2016-09-15,2016-09-15,Business insurance premium,REF12676565,126.95,0.0,199545.29
2016-09-15,2016-09-15,Invoice payment - Mendez-Tyler,REF48445691,0.0,2435.18,201980.47
2016-09-15,2016-09-15,Service payment - Allen PLC,REF77059326,0.0,1059.49,203039.96
2016-09-18,2016-09-18,Training/conference,REF46708574,145.8,0.0,202894.16
2016-09-18,2016-09-18,Office supplies,REF94251315,58.52,0.0,202835.64
2016-09-19,2016-09-19,Internet and phone service,REF12402241,125.66,0.0,202709.98
2016-09-20,2016-09-20,Professional services,REF87442794,198.97,0.0,202511.01
2016-09-23,2016-09-23,Office supplies,REF26723477,23.97,0.0,202487.04
2016-10-05,2016-10-05,Business travel,REF30596427,146.95,0.0,202340.09
2016-10-08,2016-10-08,Office supplies,REF36901636,44.16,0.0,202295.93
2016-10-09,2016-10-09,Software subscription,REF88222498,173.11,0.0,202122.82
2016-10-11,2016-10-11,Office supplies,REF32910993,70.09,0.0,202052.73
2016-10-13,2016-10-13,Internet and phone service,REF63062880,90.37,0.0,201962.36
2016-10-15,2016-10-15,Invoice payment - Lucas-Campos,REF44865448,0.0,1913.7,203876.06
2016-10-15,2016-10-15,Payment from Mendez-Tyler,REF86786412,0.0,2281.45,206157.51
2016-10-15,2016-10-15,Payment from Allen PLC,REF70953329,0.0,1280.52,207438.03
2016-10-15,2016-10-15,Business insurance premium,REF14665977,127.83,0.0,207310.2
2016-10-16,2016-10-16,Training/conference,REF25027180,151.29,0.0,207158.91
2016-10-20,2016-10-20,Marketing expenses,REF68282034,234.7,0.0,206924.21
2016-10-20,2016-10-20,Professional services,REF12155186,409.64,0.0,206514.57
2016-10-21,2016-10-21,Training/conference,REF71917486,85.62,0.0,206428.95
2016-10-21,2016-10-21,Internet and phone service,REF12949537,71.23,0.0,206357.72
2016-10-23,2016-10-23,Equipment purchase,REF51027876,107.42,0.0,206250.3
2016-10-27,2016-10-27,Internet and phone service,REF28743619,98.06,0.0,206152.24
2016-11-02,2016-11-02,Business travel,REF33293655,149.46,0.0,206002.78
2016-11-03,2016-11-03,Equipment purchase,REF22579892,101.23,0.0,205901.55
2016-11-05,2016-11-05,Training/conference,REF68865062,130.85,0.0,205770.7
2016-11-09,2016-11-09,Software subscription,REF60106054,178.55,0.0,205592.15
2016-11-13,2016-11-13,Internet and phone service,REF91677002,91.8,0.0,205500.35
2016-11-15,2016-11-15,Service payment - Lucas-Campos,REF58734744,0.0,1458.86,206959.21
2016-11-15,2016-11-15,Service payment - Allen PLC,REF62892636,0.0,1288.94,208248.15
2016-11-15,2016-11-15,Business insurance premium,REF54567554,130.67,0.0,208117.48
2016-11-15,2016-11-15,Service payment - Mendez-Tyler,REF28601971,0.0,2377.9,210495.38
2016-11-16,2016-11-16,Office supplies,REF44971976,29.31,0.0,210466.07
2016-11-17,2016-11-17,Professional services,REF39955083,261.5,0.0,210204.57
2016-11-19,2016-11-19,Marketing expenses,REF59481968,143.17,0.0,210061.4
2016-11-20,2016-11-20,Office supplies,REF21053598,43.53,0.0,210017.87
2016-11-21,2016-11-21,Office supplies,REF58987075,46.91,0.0,209970.96
2016-11-25,2016-11-25,Equipment purchase,REF23503146,145.3,0.0,209825.66
2016-11-25,2016-11-25,Training/conference,REF97251708,58.64,0.0,209767.02
2016-11-29,2016-11-29,Business travel,REF96640525,106.77,0.0,209660.25
2016-11-30,2016-11-30,Marketing expenses,REF57898173,222.49,0.0,209437.76
2016-12-09,2016-12-09,Software subscription,REF15592242,140.41,0.0,209297.35
2016-12-12,2016-12-12,Training/conference,REF76609756,85.74,0.0,209211.61
2016-12-15,2016-12-15,Service payment - Allen PLC,REF92339226,0.0,933.86,210145.47
2016-12-15,2016-12-15,Payment from Mendez-Tyler,REF64204359,0.0,1607.89,211753.36
2016-12-15,2016-12-15,Business insurance premium,REF21128420,98.43,0.0,211654.93
2016-12-15,2016-12-15,Service payment - Lucas-Campos,REF53562284,0.0,1221.65,212876.58
2016-12-16,2016-12-16,Internet and phone service,REF86403307,63.78,0.0,212812.8
2016-12-21,2016-12-21,Office supplies,REF17107751,50.63,0.0,212762.17
2016-12-24,2016-12-24,Office supplies,REF99078953,38.16,0.0,212724.01
2016-12-26,2016-12-26,Equipment purchase,REF49330721,78.44,0.0,212645.57
2016-12-28,2016-12-28,Marketing expenses,REF50897274,86.11,0.0,212559.46
2016-12-29,2016-12-29,Training/conference,REF78260604,99.65,0.0,212459.81
2016-12-30,2016-12-30,Internet and phone service,REF82558074,91.41,0.0,212368.4
2017-01-03,2017-01-03,Internet and phone service,REF64966697,106.19,0.0,212262.21
2017-01-04,2017-01-04,Professional services,REF95676786,212.34,0.0,212049.87
2017-01-09,2017-01-09,Software subscription,REF13023523,97.44,0.0,211952.43
2017-01-12,2017-01-12,Office supplies,REF16891787,47.9,0.0,211904.53
2017-01-14,2017-01-14,Business travel,REF54505681,67.78,0.0,211836.75
2017-01-15,2017-01-15,Business insurance premium,REF64432551,100.15,0.0,211736.6
2017-01-15,2017-01-15,Payment from Lucas-Campos,REF13711841,0.0,1430.14,213166.74
2017-01-15,2017-01-15,Project payment - Mendez-Tyler,REF67988621,0.0,1067.96,214234.7
2017-01-15,2017-01-15,Payment from Allen PLC,REF20827106,0.0,1017.98,215252.68
2017-01-16,2017-01-16,Office supplies,REF26458644,25.25,0.0,215227.43
2017-01-16,2017-01-16,Training/conference,REF12891009,69.69,0.0,215157.74
2017-01-18,2017-01-18,Equipment purchase,REF54640362,57.69,0.0,215100.05
2017-01-21,2017-01-21,Business travel,REF11955776,122.81,0.0,214977.24
2017-01-22,2017-01-22,Marketing expenses,REF52789339,135.4,0.0,214841.84
2017-01-24,2017-01-24,Office supplies,REF88346622,33.23,0.0,214808.61
2017-01-24,2017-01-24,Internet and phone service,REF62948980,61.98,0.0,214746.63
2017-01-28,2017-01-28,Professional services,REF78777228,192.87,0.0,214553.76
2017-02-01,2017-02-01,Office supplies,REF93329981,40.05,0.0,214513.71
2017-02-05,2017-02-05,Office supplies,REF56357361,27.86,0.0,214485.85
2017-02-08,2017-02-08,Training/conference,REF78221857,124.51,0.0,214361.34
2017-02-09,2017-02-09,Software subscription,REF44226386,125.88,0.0,214235.46
2017-02-12,2017-02-12,Business travel,REF79593241,192.86,0.0,214042.6
2017-02-13,2017-02-13,Business travel,REF49390838,261.93,0.0,213780.67
2017-02-15,2017-02-15,Service payment - Lucas-Campos,REF15066532,0.0,1249.49,215030.16
2017-02-15,2017-02-15,Business insurance premium,REF55660554,98.64,0.0,214931.52
2017-02-15,2017-02-15,Payment from Mendez-Tyler,REF29181657,0.0,1538.23,216469.75
2017-02-15,2017-02-15,Service payment - Allen PLC,REF27062481,0.0,1085.47,217555.22
2017-02-21,2017-02-21,Equipment purchase,REF25253580,43.94,0.0,217511.28
2017-02-21,2017-02-21,Business travel,REF40318315,122.01,0.0,217389.27
2017-02-22,2017-02-22,Equipment purchase,REF89412496,61.01,0.0,217328.26
2017-02-28,2017-02-28,Marketing expenses,REF72799884,104.73,0.0,217223.53
2017-03-01,2017-03-01,Equipment purchase,REF30841889,48.22,0.0,217175.31
2017-03-01,2017-03-01,Office supplies,REF63107043,67.82,0.0,217107.49
2017-03-03,2017-03-03,Marketing expenses,REF69680482,234.02,0.0,216873.47
2017-03-05,2017-03-05,Marketing expenses,REF53595654,259.99,0.0,216613.48
2017-03-06,2017-03-06,Business travel,REF92280374,161.15,0.0,216452.33
2017-03-09,2017-03-09,Software subscription,REF89133471,161.34,0.0,216290.99
2017-03-14,2017-03-14,Marketing expenses,REF41972437,298.99,0.0,215992.0
2017-03-15,2017-03-15,Business insurance premium,REF76329628,136.65,0.0,215855.35
2017-03-15,2017-03-15,Payment from Allen PLC,REF38234646,0.0,1290.71,217146.06
2017-03-15,2017-03-15,Payment from Mendez-Tyler,REF84275207,0.0,1795.37,218941.43
2017-03-15,2017-03-15,Service payment - Lucas-Campos,REF92259628,0.0,2093.31,221034.74
2017-03-20,2017-03-20,Equipment purchase,REF24057271,161.42,0.0,220873.32
2017-03-20,2017-03-20,Training/conference,REF65116040,107.36,0.0,220765.96
2017-03-21,2017-03-21,Equipment purchase,REF18813913,103.31,0.0,220662.65
2017-03-22,2017-03-22,Business travel,REF69502328,215.22,0.0,220447.43
2017-03-22,2017-03-22,Office supplies,REF64344479,31.87,0.0,220415.56
2017-03-26,2017-03-26,Office supplies,REF30228561,63.38,0.0,220352.18
2017-03-27,2017-03-27,Marketing expenses,REF73899428,281.52,0.0,220070.66
2017-03-27,2017-03-27,Equipment purchase,REF98938315,144.13,0.0,219926.53
2017-03-28,2017-03-28,Business travel,REF53653281,253.74,0.0,219672.79
2017-04-02,2017-04-02,Training/conference,REF97047011,76.9,0.0,219595.89
2017-04-02,2017-04-02,Professional services,REF49796580,327.91,0.0,219267.98
2017-04-05,2017-04-05,Internet and phone service,REF37612616,5.32,0.0,219262.66
2017-04-08,2017-04-08,Marketing expenses,REF14692645,278.65,0.0,218984.01
2017-04-09,2017-04-09,Software subscription,REF76911458,164.71,0.0,218819.3
2017-04-14,2017-04-14,Professional services,REF85458689,309.92,0.0,218509.38
2017-04-15,2017-04-15,Professional services,REF56964640,143.62,0.0,218365.76
2017-04-15,2017-04-15,Invoice payment - Lucas-Campos,REF50372013,0.0,2204.89,220570.65
2017-04-15,2017-04-15,Business insurance premium,REF76948279,119.8,0.0,220450.85
2017-04-15,2017-04-15,Project payment - Mendez-Tyler,REF62928661,0.0,2083.83,222534.68
2017-04-15,2017-04-15,Service payment - Allen PLC,REF55386923,0.0,1089.11,223623.79
2017-04-15,2017-04-15,Equipment purchase,REF50497557,60.9,0.0,223562.89
2017-04-18,2017-04-18,Business travel,REF91886714,110.57,0.0,223452.32
2017-04-20,2017-04-20,Training/conference,REF50645243,113.34,0.0,223338.98
2017-04-21,2017-04-21,Marketing expenses,REF28057666,336.29,0.0,223002.69
2017-04-26,2017-04-26,Equipment purchase,REF90335320,63.17,0.0,222939.52
2017-05-03,2017-05-03,Marketing expenses,REF37083449,308.88,0.0,222630.64
2017-05-04,2017-05-04,Professional services,REF98711784,271.35,0.0,222359.29
2017-05-04,2017-05-04,Business travel,REF77429492,177.7,0.0,222181.59
2017-05-09,2017-05-09,Software subscription,REF92030783,148.18,0.0,222033.41
2017-05-12,2017-05-12,Training/conference,REF85275351,64.75,0.0,221968.66
2017-05-13,2017-05-13,Business travel,REF68177147,134.4,0.0,221834.26
2017-05-15,2017-05-15,Payment from Lucas-Campos,REF50338132,0.0,1726.93,223561.19
2017-05-15,2017-05-15,Invoice payment - Allen PLC,REF72170987,0.0,1438.82,225000.01
2017-05-15,2017-05-15,Invoice payment - Mendez-Tyler,REF99762114,0.0,1996.75,226996.76
2017-05-15,2017-05-15,Business insurance premium,REF31018359,118.76,0.0,226878.0
2017-05-18,2017-05-18,Equipment purchase,REF13629977,86.71,0.0,226791.29
2017-05-25,2017-05-25,Office supplies,REF67309578,53.63,0.0,226737.66
2017-05-27,2017-05-27,Training/conference,REF54015079,120.02,0.0,226617.64
2017-05-28,2017-05-28,Office supplies,REF19089345,60.5,0.0,226557.14
2017-05-28,2017-05-28,Professional services,REF20333049,72.59,0.0,226484.55
2017-05-31,2017-05-31,Business travel,REF34631414,186.15,0.0,226298.4
2017-06-03,2017-06-03,Business travel,REF37110578,64.66,0.0,226233.74
2017-06-06,2017-06-06,Internet and phone service,REF25855108,95.54,0.0,226138.2
2017-06-09,2017-06-09,Software subscription,REF60102050,148.07,0.0,225990.13
2017-06-12,2017-06-12,Professional services,REF86455529,262.82,0.0,225727.31
2017-06-13,2017-06-13,Internet and phone service,REF24191495,50.7,0.0,225676.61
2017-06-15,2017-06-15,Business insurance premium,REF49029751,117.01,0.0,225559.6
2017-06-15,2017-06-15,Payment from Mendez-Tyler,REF88391562,0.0,1709.86,227269.46
2017-06-15,2017-06-15,Project payment - Allen PLC,REF68447107,0.0,1030.79,228300.25
2017-06-15,2017-06-15,Invoice payment - Lucas-Campos,REF58315154,0.0,1561.16,229861.41
2017-06-16,2017-06-16,Professional services,REF75000274,289.5,0.0,229571.91
2017-06-20,2017-06-20,Internet and phone service,REF91620344,41.2,0.0,229530.71
2017-06-21,2017-06-21,Equipment purchase,REF78940151,66.38,0.0,229464.33
2017-06-22,2017-06-22,Equipment purchase,REF31762219,92.25,0.0,229372.08
2017-06-24,2017-06-24,Office supplies,REF80205249,50.23,0.0,229321.85
2017-06-30,2017-06-30,Training/conference,REF22492972,90.3,0.0,229231.55
2017-07-01,2017-07-01,Internet and phone service,REF46774542,80.61,0.0,229150.94
2017-07-03,2017-07-03,Business travel,REF32356208,114.23,0.0,229036.71
2017-07-05,2017-07-05,Internet and phone service,REF58793439,41.36,0.0,228995.35
2017-07-08,2017-07-08,Internet and phone service,REF24988025,56.22,0.0,228939.13
2017-07-09,2017-07-09,Software subscription,REF17569650,134.72,0.0,228804.41
2017-07-10,2017-07-10,Equipment purchase,REF44061339,48.22,0.0,228756.19
2017-07-15,2017-07-15,Business insurance premium,REF39617783,95.07,0.0,228661.12
2017-07-15,2017-07-15,Payment from Lucas-Campos,REF44517855,0.0,1919.6,230580.72
2017-07-15,2017-07-15,Project payment - Mendez-Tyler,REF17056740,0.0,1654.45,232235.17
2017-07-15,2017-07-15,Payment from Allen PLC,REF53230568,0.0,705.02,232940.19
2017-07-19,2017-07-19,Internet and phone service,REF34002500,44.01,0.0,232896.18
2017-07-20,2017-07-20,Marketing expenses,REF31813544,121.66,0.0,232774.52
2017-07-21,2017-07-21,Training/conference,REF87900237,65.39,0.0,232709.13
2017-07-29,2017-07-29,Internet and phone service,REF17908024,77.01,0.0,232632.12
2017-07-30,2017-07-30,Office supplies,REF47465614,45.19,0.0,232586.93
2017-08-01,2017-08-01,Internet and phone service,REF57403869,65.66,0.0,232521.27
2017-08-03,2017-08-03,Professional services,REF76665212,140.05,0.0,232381.22
2017-08-06,2017-08-06,Marketing expenses,REF15343892,167.84,0.0,232213.38
2017-08-09,2017-08-09,Software subscription,REF20025003,100.52,0.0,232112.86
2017-08-10,2017-08-10,Business travel,REF31903817,93.02,0.0,232019.84
2017-08-13,2017-08-13,Professional services,REF75784484,100.01,0.0,231919.83
2017-08-15,2017-08-15,Equipment purchase,REF33843815,80.84,0.0,231838.99
2017-08-15,2017-08-15,Business insurance premium,REF40430393,76.46,0.0,231762.53
2017-08-15,2017-08-15,Project payment - Allen PLC,REF52417701,0.0,1090.77,232853.3
2017-08-15,2017-08-15,Invoice payment - Mendez-Tyler,REF48102416,0.0,1179.2,234032.5
2017-08-15,2017-08-15,Payment from Lucas-Campos,REF87580523,0.0,982.67,235015.17
2017-08-18,2017-08-18,Equipment purchase,REF60786546,57.91,0.0,234957.26
2017-08-24,2017-08-24,Marketing expenses,REF67809175,94.5,0.0,234862.76
2017-09-02,2017-09-02,Business travel,REF81790522,168.44,0.0,234694.32
2017-09-02,2017-09-02,Training/conference,REF86577022,84.76,0.0,234609.56
2017-09-05,2017-09-05,Business travel,REF15173362,127.89,0.0,234481.67
2017-09-05,2017-09-05,Internet and phone service,REF15215019,74.16,0.0,234407.51
2017-09-07,2017-09-07,Training/conference,REF96939341,65.78,0.0,234341.73
2017-09-09,2017-09-09,Office supplies,REF83101362,68.05,0.0,234273.68
2017-09-09,2017-09-09,Software subscription,REF78530691,171.04,0.0,234102.64
2017-09-13,2017-09-13,Office supplies,REF59202888,53.39,0.0,234049.25
2017-09-15,2017-09-15,Invoice payment - Allen PLC,REF47184165,0.0,1472.77,235522.02
2017-09-15,2017-09-15,Project payment - Lucas-Campos,REF55328638,0.0,2182.7,237704.72
2017-09-15,2017-09-15,Service payment - Mendez-Tyler,REF16141207,0.0,2033.84,239738.56
2017-09-15,2017-09-15,Business insurance premium,REF17957696,130.49,0.0,239608.07
2017-09-16,2017-09-16,Office supplies,REF86063383,46.03,0.0,239562.04
2017-09-20,2017-09-20,Equipment purchase,REF96445110,66.46,0.0,239495.58
2017-09-25,2017-09-25,Office supplies,REF44554717,71.26,0.0,239424.32
2017-09-25,2017-09-25,Professional services,REF57431115,259.09,0.0,239165.23
2017-10-03,2017-10-03,Internet and phone service,REF52219185,69.29,0.0,239095.94
2017-10-04,2017-10-04,Office supplies,REF89883239,40.78,0.0,239055.16
2017-10-06,2017-10-06,Business travel,REF10880990,213.77,0.0,238841.39
2017-10-09,2017-10-09,Software subscription,REF31889030,216.88,0.0,238624.51
2017-10-10,2017-10-10,Internet and phone service,REF79689486,55.45,0.0,238569.06
2017-10-15,2017-10-15,Project payment - Lucas-Campos,REF49237669,0.0,1927.38,240496.44
2017-10-15,2017-10-15,Business insurance premium,REF46663048,134.96,0.0,240361.48
2017-10-15,2017-10-15,Project payment - Allen PLC,REF60440276,0.0,1480.85,241842.33
2017-10-17,2017-10-17,Training/conference,REF22427930,97.64,0.0,241744.69
2017-10-20,2017-10-20,Training/conference,REF41626633,120.36,0.0,241624.33
2017-10-24,2017-10-24,Equipment purchase,REF34676512,98.86,0.0,241525.47
2017-10-25,2017-10-25,Office supplies,REF26547625,47.92,0.0,241477.55
2017-10-25,2017-10-25,Business travel,REF55850719,146.55,0.0,241331.0
2017-10-26,2017-10-26,Marketing expenses,REF61815355,320.79,0.0,241010.21
2017-10-29,2017-10-29,Office supplies,REF14619330,68.37,0.0,240941.84
2017-10-29,2017-10-29,Professional services,REF49380881,260.6,0.0,240681.24
2017-10-31,2017-10-31,Internet and phone service,REF90152872,102.7,0.0,240578.54
2017-11-04,2017-11-04,Professional services,REF19767365,283.21,0.0,240295.33
2017-11-07,2017-11-07,Business travel,REF41807769,193.93,0.0,240101.4
2017-11-09,2017-11-09,Software subscription,REF25720806,137.08,0.0,239964.32
2017-11-15,2017-11-15,Service payment - Lucas-Campos,REF20756526,0.0,1845.42,241809.74
2017-11-15,2017-11-15,Invoice payment - Allen PLC,REF78309489,0.0,1558.79,243368.53
2017-11-15,2017-11-15,Business insurance premium,REF30328252,125.19,0.0,243243.34
2017-11-15,2017-11-15,Service payment - Mendez-Tyler,REF85627203,0.0,1379.75,244623.09
2017-11-16,2017-11-16,Office supplies,REF51831065,69.62,0.0,244553.47
2017-11-17,2017-11-17,Marketing expenses,REF94110101,122.5,0.0,244430.97
2017-11-27,2017-11-27,Marketing expenses,REF23055126,279.2,0.0,244151.77
2017-12-09,2017-12-09,Software subscription,REF67819657,119.88,0.0,244031.89
2017-12-09,2017-12-09,Office supplies,REF31211615,47.02,0.0,243984.87
2017-12-15,2017-12-15,Project payment - Lucas-Campos,REF89016706,0.0,1231.32,245216.19
2017-12-15,2017-12-15,Service payment - Mendez-Tyler,REF77459923,0.0,2121.81,247338.0
2017-12-15,2017-12-15,Project payment - Allen PLC,REF22567075,0.0,1293.87,248631.87
2017-12-15,2017-12-15,Business insurance premium,REF13985217,104.51,0.0,248527.36
2017-12-16,2017-12-16,Internet and phone service,REF29843910,93.7,0.0,248433.66
2017-12-18,2017-12-18,Training/conference,REF40037497,101.41,0.0,248332.25
2017-12-18,2017-12-18,Office supplies,REF22128325,41.56,0.0,248290.69
2017-12-20,2017-12-20,Business travel,REF73088753,139.99,0.0,248150.7
2017-12-29,2017-12-29,Office supplies,REF68303855,51.2,0.0,248099.5
2018-01-06,2018-01-06,Office supplies,REF69439183,59.11,0.0,248040.39
2018-01-06,2018-01-06,Equipment purchase,REF35799064,113.42,0.0,247926.97
2018-01-09,2018-01-09,Software subscription,REF96001794,100.7,0.0,247826.27
2018-01-12,2018-01-12,Office supplies,REF38134187,54.59,0.0,247771.68
2018-01-15,2018-01-15,Business insurance premium,REF88926255,105.42,0.0,247666.26
2018-01-15,2018-01-15,Payment from Lucas-Campos,REF71772913,0.0,1775.6,249441.86
2018-01-15,2018-01-15,Project payment - Mendez-Tyler,REF26632052,0.0,1419.01,250860.87
2018-01-16,2018-01-16,Business travel,REF71463819,145.46,0.0,250715.41
2018-01-17,2018-01-17,Training/conference,REF96772222,68.13,0.0,250647.28
2018-01-19,2018-01-19,Marketing expenses,REF77678982,256.6,0.0,250390.68
2018-01-20,2018-01-20,Training/conference,REF28304348,78.08,0.0,250312.6
2018-02-02,2018-02-02,Equipment purchase,REF90765721,139.74,0.0,250172.86
2018-02-07,2018-02-07,Internet and phone service,REF90756287,50.48,0.0,250122.38
2018-02-09,2018-02-09,Software subscription,REF93858712,134.39,0.0,249987.99
2018-02-12,2018-02-12,Business travel,REF92235858,143.02,0.0,249844.97
2018-02-13,2018-02-13,Business travel,REF86545929,118.76,0.0,249726.21
2018-02-15,2018-02-15,Invoice payment - Allen PLC,REF78254173,0.0,1119.51,250845.72
2018-02-15,2018-02-15,Project payment - Mendez-Tyler,REF48463428,0.0,1726.53,252572.25
2018-02-15,2018-02-15,Project payment - Lucas-Campos,REF13596584,0.0,1727.13,254299.38
2018-02-15,2018-02-15,Business insurance premium,REF68495411,110.89,0.0,254188.49
2018-02-18,2018-02-18,Office supplies,REF45391674,70.84,0.0,254117.65
2018-02-20,2018-02-20,Internet and phone service,REF27715204,58.17,0.0,254059.48
2018-02-21,2018-02-21,Internet and phone service,REF20175439,86.12,0.0,253973.36
2018-02-28,2018-02-28,Office supplies,REF13953556,16.82,0.0,253956.54
2018-03-05,2018-03-05,Professional services,REF44261787,253.19,0.0,253703.35
2018-03-08,2018-03-08,Internet and phone service,REF70538990,105.84,0.0,253597.51
2018-03-09,2018-03-09,Marketing expenses,REF62423566,52.07,0.0,253545.44
2018-03-09,2018-03-09,Software subscription,REF67081786,194.28,0.0,253351.16
2018-03-11,2018-03-11,Office supplies,REF37273877,39.18,0.0,253311.98
2018-03-15,2018-03-15,Marketing expenses,REF27072942,156.45,0.0,253155.53
2018-03-15,2018-03-15,Office supplies,REF94322498,48.85,0.0,253106.68
2018-03-15,2018-03-15,Payment from Lucas-Campos,REF57709876,0.0,2120.64,255227.32
2018-03-15,2018-03-15,Service payment - Mendez-Tyler,REF32691821,0.0,1875.44,257102.76
2018-03-15,2018-03-15,Business insurance premium,REF44441447,132.42,0.0,256970.34
2018-03-15,2018-03-15,Payment from Allen PLC,REF95271290,0.0,1037.78,258008.12
2018-03-16,2018-03-16,Business travel,REF64219678,182.76,0.0,257825.36
2018-03-19,2018-03-19,Business travel,REF12018127,162.74,0.0,257662.62
2018-03-20,2018-03-20,Office supplies,REF58963561,72.34,0.0,257590.28
2018-03-23,2018-03-23,Business travel,REF48980706,135.5,0.0,257454.78
2018-03-26,2018-03-26,Professional services,REF13974173,412.97,0.0,257041.81
2018-04-02,2018-04-02,Office supplies,REF31108178,35.3,0.0,257006.51
2018-04-03,2018-04-03,Office supplies,REF52375849,35.08,0.0,256971.43
2018-04-04,2018-04-04,Training/conference,REF78487024,87.83,0.0,256883.6
2018-04-07,2018-04-07,Training/conference,REF41103683,103.79,0.0,256779.81
2018-04-09,2018-04-09,Software subscription,REF17740222,133.26,0.0,256646.55
2018-04-13,2018-04-13,Professional services,REF30779610,243.0,0.0,256403.55
2018-04-14,2018-04-14,Training/conference,REF50064632,88.91,0.0,256314.64
2018-04-15,2018-04-15,Business insurance premium,REF39417209,125.81,0.0,256188.83
2018-04-15,2018-04-15,Payment from Lucas-Campos,REF59661833,0.0,1865.38,258054.21
2018-04-15,2018-04-15,Project payment - Mendez-Tyler,REF73371473,0.0,1708.87,259763.08
2018-04-15,2018-04-15,Invoice payment - Allen PLC,REF64908881,0.0,1141.34,260904.42
2018-04-17,2018-04-17,Internet and phone service,REF94012652,75.71,0.0,260828.71
2018-04-22,2018-04-22,Internet and phone service,REF77672491,90.54,0.0,260738.17
2018-05-05,2018-05-05,Business travel,REF16932800,132.71,0.0,260605.46
2018-05-08,2018-05-08,Training/conference,REF30520385,136.85,0.0,260468.61
2018-05-09,2018-05-09,Software subscription,REF65397713,150.47,0.0,260318.14
2018-05-09,2018-05-09,Office supplies,REF34333623,44.55,0.0,260273.59
2018-05-11,2018-05-11,Business travel,REF22306743,154.37,0.0,260119.22
2018-05-14,2018-05-14,Equipment purchase,REF33098036,120.8,0.0,259998.42
2018-05-15,2018-05-15,Business travel,REF56787391,123.5,0.0,259874.92
2018-05-15,2018-05-15,Invoice payment - Lucas-Campos,REF69643975,0.0,1961.39,261836.31
2018-05-15,2018-05-15,Business insurance premium,REF67611175,111.39,0.0,261724.92
2018-05-15,2018-05-15,Payment from Mendez-Tyler,REF98612211,0.0,1883.89,263608.81
2018-05-15,2018-05-15,Service payment - Allen PLC,REF22680705,0.0,1429.33,265038.14
2018-05-18,2018-05-18,Marketing expenses,REF95602293,202.92,0.0,264835.22
2018-05-18,2018-05-18,Professional services,REF20399650,134.93,0.0,264700.29
2018-05-21,2018-05-21,Professional services,REF18440452,313.81,0.0,264386.48
2018-05-24,2018-05-24,Marketing expenses,REF77564046,165.4,0.0,264221.08
2018-05-26,2018-05-26,Office supplies,REF13688215,45.11,0.0,264175.97
2018-05-27,2018-05-27,Training/conference,REF33092748,107.87,0.0,264068.1
2018-06-02,2018-06-02,Professional services,REF49910379,235.03,0.0,263833.07
2018-06-05,2018-06-05,Office supplies,REF33522881,38.5,0.0,263794.57
2018-06-07,2018-06-07,Business travel,REF29348266,115.14,0.0,263679.43
2018-06-07,2018-06-07,Professional services,REF25115441,259.88,0.0,263419.55
2018-06-09,2018-06-09,Office supplies,REF58236005,46.59,0.0,263372.96
2018-06-09,2018-06-09,Software subscription,REF48650095,136.64,0.0,263236.32
2018-06-13,2018-06-13,Internet and phone service,REF54710195,89.08,0.0,263147.24
2018-06-13,2018-06-13,Office supplies,REF93685471,36.58,0.0,263110.66
2018-06-13,2018-06-13,Business travel,REF73735110,101.19,0.0,263009.47
2018-06-14,2018-06-14,Professional services,REF72648780,257.54,0.0,262751.93
2018-06-15,2018-06-15,Business insurance premium,REF68708004,109.22,0.0,262642.71
2018-06-15,2018-06-15,Service payment - Lucas-Campos,REF36288558,0.0,1422.06,264064.77
2018-06-15,2018-06-15,Service payment - Allen PLC,REF35508975,0.0,1152.79,265217.56
2018-06-15,2018-06-15,Service payment - Mendez-Tyler,REF12840894,0.0,1919.25,267136.81
2018-06-19,2018-06-19,Training/conference,REF21173125,90.62,0.0,267046.19
2018-06-20,2018-06-20,Business travel,REF65601742,155.81,0.0,266890.38
2018-06-23,2018-06-23,Office supplies,REF69408847,41.97,0.0,266848.41
2018-06-27,2018-06-27,Office supplies,REF27998034,35.87,0.0,266812.54
2018-06-28,2018-06-28,Office supplies,REF29434858,45.96,0.0,266766.58
2018-07-03,2018-07-03,Equipment purchase,REF94054418,31.16,0.0,266735.42
2018-07-05,2018-07-05,Professional services,REF78804029,240.87,0.0,266494.55
2018-07-06,2018-07-06,Office supplies,REF41254926,31.61,0.0,266462.94
2018-07-08,2018-07-08,Office supplies,REF86607448,76.88,0.0,266386.06
2018-07-09,2018-07-09,Software subscription,REF27186230,113.42,0.0,266272.64
2018-07-12,2018-07-12,Professional services,REF49209172,273.05,0.0,265999.59
2018-07-13,2018-07-13,Equipment purchase,REF66133739,29.51,0.0,265970.08
2018-07-15,2018-07-15,Business insurance premium,REF70233928,96.09,0.0,265873.99
2018-07-15,2018-07-15,Invoice payment - Lucas-Campos,REF42561000,0.0,1462.36,267336.35
2018-07-15,2018-07-15,Service payment - Allen PLC,REF30227668,0.0,1053.52,268389.87
2018-07-15,2018-07-15,Payment from Mendez-Tyler,REF16980027,0.0,1559.21,269949.08
2018-07-17,2018-07-17,Business travel,REF40938839,114.81,0.0,269834.27
2018-07-18,2018-07-18,Equipment purchase,REF95541086,78.96,0.0,269755.31
2018-07-23,2018-07-23,Marketing expenses,REF41422704,158.2,0.0,269597.11
2018-07-24,2018-07-24,Training/conference,REF41704762,80.77,0.0,269516.34
2018-08-01,2018-08-01,Office supplies,REF92823535,50.6,0.0,269465.74
2018-08-01,2018-08-01,Professional services,REF17741143,195.52,0.0,269270.22
2018-08-04,2018-08-04,Training/conference,REF56444304,42.89,0.0,269227.33
2018-08-09,2018-08-09,Software subscription,REF18621701,115.14,0.0,269112.19
2018-08-10,2018-08-10,Marketing expenses,REF34642673,164.6,0.0,268947.59
2018-08-15,2018-08-15,Payment from Lucas-Campos,REF17262513,0.0,1560.55,270508.14
2018-08-15,2018-08-15,Project payment - Allen PLC,REF62835660,0.0,725.42,271233.56
2018-08-15,2018-08-15,Business insurance premium,REF79937510,76.53,0.0,271157.03
2018-08-16,2018-08-16,Marketing expenses,REF31041722,137.31,0.0,271019.72
2018-08-16,2018-08-16,Office supplies,REF39655333,41.07,0.0,270978.65
2018-08-18,2018-08-18,Office supplies,REF97755623,32.23,0.0,270946.42
2018-08-23,2018-08-23,Professional services,REF13783550,186.91,0.0,270759.51
2018-08-23,2018-08-23,Office supplies,REF92410021,46.37,0.0,270713.14
2018-08-27,2018-08-27,Equipment purchase,REF39371374,87.61,0.0,270625.53
2018-08-28,2018-08-28,Business travel,REF94264058,80.51,0.0,270545.02
2018-08-29,2018-08-29,Professional services,REF29318277,174.45,0.0,270370.57
2018-09-02,2018-09-02,Office supplies,REF16930509,40.26,0.0,270330.31
2018-09-02,2018-09-02,Business travel,REF73071397,226.38,0.0,270103.93
2018-09-05,2018-09-05,Professional services,REF22456444,448.29,0.0,269655.64
2018-09-09,2018-09-09,Software subscription,REF28472711,158.96,0.0,269496.68
2018-09-12,2018-09-12,Marketing expenses,REF82326628,233.69,0.0,269262.99
2018-09-15,2018-09-15,Payment from Lucas-Campos,REF68730923,0.0,1938.64,271201.63
2018-09-15,2018-09-15,Invoice payment - Mendez-Tyler,REF18479748,0.0,1861.41,273063.04
2018-09-15,2018-09-15,Invoice payment - Allen PLC,REF23796001,0.0,1313.89,274376.93
2018-09-15,2018-09-15,Business insurance premium,REF13888634,137.19,0.0,274239.74
2018-09-20,2018-09-20,Office supplies,REF29267215,56.26,0.0,274183.48
2018-09-23,2018-09-23,Office supplies,REF68181282,76.89,0.0,274106.59
2018-09-24,2018-09-24,Office supplies,REF60528881,46.43,0.0,274060.16
2018-09-28,2018-09-28,Business travel,REF71448646,132.58,0.0,273927.58
2018-09-28,2018-09-28,Office supplies,REF15716692,53.56,0.0,273874.02
2018-10-05,2018-10-05,Internet and phone service,REF17530312,87.61,0.0,273786.41
2018-10-09,2018-10-09,Software subscription,REF89517128,199.66,0.0,273586.75
2018-10-15,2018-10-15,Project payment - Mendez-Tyler,REF65446592,0.0,2071.13,275657.88
2018-10-15,2018-10-15,Invoice payment - Lucas-Campos,REF16963054,0.0,2245.98,277903.86
2018-10-15,2018-10-15,Internet and phone service,REF60094493,79.41,0.0,277824.45
2018-10-15,2018-10-15,Invoice payment - Allen PLC,REF93905867,0.0,1441.43,279265.88
2018-10-15,2018-10-15,Business insurance premium,REF81174965,142.69,0.0,279123.19
2018-10-19,2018-10-19,Office supplies,REF56648527,53.08,0.0,279070.11
2018-10-20,2018-10-20,Office supplies,REF89066637,68.46,0.0,279001.65
2018-10-21,2018-10-21,Marketing expenses,REF61430914,223.62,0.0,278778.03
2018-10-25,2018-10-25,Office supplies,REF22644811,63.65,0.0,278714.38
2018-10-28,2018-10-28,Business travel,REF38563602,136.45,0.0,278577.93
2018-10-29,2018-10-29,Training/conference,REF29228547,147.11,0.0,278430.82
2018-11-07,2018-11-07,Business travel,REF41175064,220.18,0.0,278210.64
2018-11-09,2018-11-09,Equipment purchase,REF38074661,123.37,0.0,278087.27
2018-11-09,2018-11-09,Software subscription,REF63827289,151.57,0.0,277935.7
2018-11-12,2018-11-12,Training/conference,REF48550877,132.27,0.0,277803.43
2018-11-15,2018-11-15,Business insurance premium,REF83068382,124.38,0.0,277679.05
2018-11-15,2018-11-15,Payment from Allen PLC,REF95490803,0.0,1591.63,279270.68
2018-11-15,2018-11-15,Project payment - Mendez-Tyler,REF51000409,0.0,1462.59,280733.27
2018-11-15,2018-11-15,Service payment - Lucas-Campos,REF23074517,0.0,1945.69,282678.96
2018-11-18,2018-11-18,Business travel,REF37566393,201.51,0.0,282477.45
2018-11-20,2018-11-20,Training/conference,REF99716293,95.8,0.0,282381.65
2018-11-25,2018-11-25,Equipment purchase,REF23716366,67.05,0.0,282314.6
2018-11-26,2018-11-26,Professional services,REF24662103,291.03,0.0,282023.57
2018-11-26,2018-11-26,Office supplies,REF31109056,23.36,0.0,282000.21
2018-11-26,2018-11-26,Internet and phone service,REF11964577,99.65,0.0,281900.56
2018-12-03,2018-12-03,Internet and phone service,REF11433146,78.17,0.0,281822.39
2018-12-04,2018-12-04,Professional services,REF92377393,125.03,0.0,281697.36
2018-12-09,2018-12-09,Software subscription,REF47719581,115.74,0.0,281581.62
2018-12-10,2018-12-10,Office supplies,REF60043630,59.8,0.0,281521.82
2018-12-11,2018-12-11,Internet and phone service,REF52843553,61.69,0.0,281460.13
2018-12-12,2018-12-12,Marketing expenses,REF74234119,206.9,0.0,281253.23
2018-12-15,2018-12-15,Service payment - Allen PLC,REF32219283,0.0,1149.72,282402.95
2018-12-15,2018-12-15,Business insurance premium,REF53594737,107.7,0.0,282295.25
2018-12-15,2018-12-15,Project payment - Lucas-Campos,REF32472972,0.0,1108.7,283403.95
2018-12-15,2018-12-15,Project payment - Mendez-Tyler,REF59806939,0.0,1587.07,284991.02
2018-12-18,2018-12-18,Internet and phone service,REF41552418,129.21,0.0,284861.81
2018-12-22,2018-12-22,Business travel,REF44301702,113.72,0.0,284748.09
2018-12-29,2018-12-29,Equipment purchase,REF81668394,170.82,0.0,284577.27
2018-12-30,2018-12-30,Business travel,REF81365966,170.67,0.0,284406.6
2018-12-31,2018-12-31,Training/conference,REF83710398,69.02,0.0,284337.58
2019-01-01,2019-01-01,Professional services,REF81670149,245.96,0.0,284091.62
2019-01-09,2019-01-09,Software subscription,REF82757382,117.59,0.0,283974.03
2019-01-09,2019-01-09,Office supplies,REF39155355,55.17,0.0,283918.86
2019-01-10,2019-01-10,Internet and phone service,REF75426129,62.89,0.0,283855.97
2019-01-11,2019-01-11,Office supplies,REF94898520,50.01,0.0,283805.96
2019-01-12,2019-01-12,Equipment purchase,REF64927852,73.11,0.0,283732.85
2019-01-15,2019-01-15,Payment from Mendez-Tyler,REF81902753,0.0,1340.71,285073.56
2019-01-15,2019-01-15,Business insurance premium,REF99849543,102.0,0.0,284971.56
2019-01-15,2019-01-15,Project payment - Lucas-Campos,REF46179559,0.0,1091.22,286062.78
2019-01-16,2019-01-16,Business travel,REF83042534,102.21,0.0,285960.57
2019-01-21,2019-01-21,Professional services,REF18626277,274.95,0.0,285685.62
2019-01-24,2019-01-24,Professional services,REF50815460,161.93,0.0,285523.69
2019-01-24,2019-01-24,Marketing expenses,REF42585241,191.22,0.0,285332.47
2019-01-24,2019-01-24,Training/conference,REF50160930,57.28,0.0,285275.19
2019-01-25,2019-01-25,Internet and phone service,REF19602206,56.78,0.0,285218.41
2019-01-27,2019-01-27,Equipment purchase,REF34138420,116.35,0.0,285102.06
2019-01-27,2019-01-27,Office supplies,REF63917721,42.94,0.0,285059.12
2019-01-30,2019-01-30,Business travel,REF63062448,148.38,0.0,284910.74
2019-01-31,2019-01-31,Office supplies,REF15335129,51.97,0.0,284858.77
2019-02-03,2019-02-03,Marketing expenses,REF87828185,56.38,0.0,284802.39
2019-02-04,2019-02-04,Marketing expenses,REF40593837,123.21,0.0,284679.18
2019-02-05,2019-02-05,Business travel,REF65517628,198.7,0.0,284480.48
2019-02-06,2019-02-06,Marketing expenses,REF79970617,203.08,0.0,284277.4
2019-02-07,2019-02-07,Professional services,REF41408243,247.73,0.0,284029.67
2019-02-08,2019-02-08,Business travel,REF47205196,88.83,0.0,283940.84
2019-02-09,2019-02-09,Office supplies,REF81570148,61.16,0.0,283879.68
2019-02-09,2019-02-09,Software subscription,REF29127504,113.9,0.0,283765.78
2019-02-12,2019-02-12,Training/conference,REF99137031,92.98,0.0,283672.8
2019-02-13,2019-02-13,Office supplies,REF79560877,54.26,0.0,283618.54
2019-02-15,2019-02-15,Business travel,REF86917505,102.49,0.0,283516.05
2019-02-15,2019-02-15,Service payment - Lucas-Campos,REF22474146,0.0,1739.79,285255.84
2019-02-15,2019-02-15,Business insurance premium,REF76219098,111.58,0.0,285144.26
2019-02-15,2019-02-15,Project payment - Mendez-Tyler,REF35590307,0.0,1636.05,286780.31
2019-02-16,2019-02-16,Professional services,REF65665630,326.38,0.0,286453.93
2019-02-21,2019-02-21,Professional services,REF58941362,242.01,0.0,286211.92
2019-02-28,2019-02-28,Professional services,REF14659430,397.55,0.0,285814.37
2019-03-08,2019-03-08,Office supplies,REF66171499,75.16,0.0,285739.21
2019-03-09,2019-03-09,Software subscription,REF62785323,150.64,0.0,285588.57
2019-03-10,2019-03-10,Office supplies,REF43941826,85.51,0.0,285503.06
2019-03-10,2019-03-10,Internet and phone service,REF66192390,118.22,0.0,285384.84
2019-03-12,2019-03-12,Office supplies,REF37946023,48.61,0.0,285336.23
2019-03-15,2019-03-15,Business insurance premium,REF83386820,131.92,0.0,285204.31
2019-03-15,2019-03-15,Service payment - Mendez-Tyler,REF57335799,0.0,1714.68,286918.99
2019-03-15,2019-03-15,Invoice payment - Allen PLC,REF32796550,0.0,1356.14,288275.13
2019-03-15,2019-03-15,Service payment - Lucas-Campos,REF11408828,0.0,1943.45,290218.58
2019-03-19,2019-03-19,Office supplies,REF25036888,66.79,0.0,290151.79
2019-03-20,2019-03-20,Office supplies,REF90638225,65.57,0.0,290086.22
2019-03-22,2019-03-22,Professional services,REF95813377,420.87,0.0,289665.35
2019-03-24,2019-03-24,Office supplies,REF73140815,48.02,0.0,289617.33
2019-03-26,2019-03-26,Training/conference,REF51180523,67.59,0.0,289549.74
2019-03-30,2019-03-30,Marketing expenses,REF83672733,207.56,0.0,289342.18
2019-04-01,2019-04-01,Office supplies,REF38073922,47.73,0.0,289294.45
2019-04-03,2019-04-03,Marketing expenses,REF59617267,248.73,0.0,289045.72
2019-04-06,2019-04-06,Equipment purchase,REF24409647,160.9,0.0,288884.82
2019-04-06,2019-04-06,Business travel,REF47558819,225.21,0.0,288659.61
2019-04-09,2019-04-09,Professional services,REF14938192,219.04,0.0,288440.57
2019-04-09,2019-04-09,Software subscription,REF56601732,159.46,0.0,288281.11
2019-04-09,2019-04-09,Office supplies,REF56591686,40.65,0.0,288240.46
2019-04-10,2019-04-10,Training/conference,REF91902506,138.19,0.0,288102.27
2019-04-10,2019-04-10,Business travel,REF74637311,37.4,0.0,288064.87
2019-04-13,2019-04-13,Business travel,REF47319920,262.51,0.0,287802.36
2019-04-13,2019-04-13,Office supplies,REF77158276,70.08,0.0,287732.28
2019-04-14,2019-04-14,Office supplies,REF99201768,72.1,0.0,287660.18
2019-04-14,2019-04-14,Internet and phone service,REF72265832,98.23,0.0,287561.95
2019-04-15,2019-04-15,Service payment - Lucas-Campos,REF89769514,0.0,1802.03,289363.98
2019-04-15,2019-04-15,Service payment - Mendez-Tyler,REF86962483,0.0,1982.61,291346.59
2019-04-15,2019-04-15,Project payment - Allen PLC,REF90190476,0.0,1158.75,292505.34
2019-04-15,2019-04-15,Business insurance premium,REF49137404,117.35,0.0,292387.99
2019-04-19,2019-04-19,Office supplies,REF63489289,57.89,0.0,292330.1
2019-04-21,2019-04-21,Equipment purchase,REF64131085,164.64,0.0,292165.46
2019-04-22,2019-04-22,Training/conference,REF89796895,108.39,0.0,292057.07
2019-04-24,2019-04-24,Office supplies,REF46796951,87.23,0.0,291969.84
2019-04-26,2019-04-26,Office supplies,REF67362481,36.14,0.0,291933.7
2019-04-27,2019-04-27,Marketing expenses,REF96701270,135.07,0.0,291798.63
2019-04-28,2019-04-28,Marketing expenses,REF30345446,184.06,0.0,291614.57
2019-04-28,2019-04-28,Business travel,REF66900489,177.29,0.0,291437.28
2019-05-01,2019-05-01,Office supplies,REF90598392,63.47,0.0,291373.81
2019-05-07,2019-05-07,Professional services,REF13219329,256.53,0.0,291117.28
2019-05-09,2019-05-09,Software subscription,REF30332536,136.25,0.0,290981.03
2019-05-10,2019-05-10,Office supplies,REF94943044,58.11,0.0,290922.92
2019-05-15,2019-05-15,Business insurance premium,REF17545520,117.1,0.0,290805.82
2019-05-15,2019-05-15,Payment from Lucas-Campos,REF88650259,0.0,1814.59,292620.41
2019-05-15,2019-05-15,Payment from Mendez-Tyler,REF52091557,0.0,1632.46,294252.87
2019-05-16,2019-05-16,Business travel,REF48976338,187.52,0.0,294065.35
2019-05-17,2019-05-17,Professional services,REF58589982,282.52,0.0,293782.83
2019-05-18,2019-05-18,Office supplies,REF99307312,74.18,0.0,293708.65
2019-05-22,2019-05-22,Business travel,REF48240513,156.61,0.0,293552.04
2019-05-24,2019-05-24,Training/conference,REF10953215,100.86,0.0,293451.18
2019-06-05,2019-06-05,Professional services,REF75764607,254.06,0.0,293197.12
2019-06-05,2019-06-05,Business travel,REF22037917,114.81,0.0,293082.31
2019-06-05,2019-06-05,Office supplies,REF58676807,49.74,0.0,293032.57
2019-06-06,2019-06-06,Office supplies,REF21319102,33.15,0.0,292999.42
2019-06-09,2019-06-09,Software subscription,REF34239638,138.75,0.0,292860.67
2019-06-13,2019-06-13,Office supplies,REF49298639,37.31,0.0,292823.36
2019-06-15,2019-06-15,Business insurance premium,REF94832949,105.18,0.0,292718.18
2019-06-15,2019-06-15,Service payment - Mendez-Tyler,REF45671844,0.0,1552.93,294271.11
2019-06-15,2019-06-15,Project payment - Lucas-Campos,REF72712611,0.0,1394.76,295665.87
2019-06-15,2019-06-15,Service payment - Allen PLC,REF60018716,0.0,1425.54,297091.41
2019-06-17,2019-06-17,Office supplies,REF28606477,44.29,0.0,297047.12
2019-06-18,2019-06-18,Training/conference,REF46443043,88.37,0.0,296958.75
2019-06-20,2019-06-20,Professional services,REF70172711,327.46,0.0,296631.29
2019-06-25,2019-06-25,Office supplies,REF58502380,50.27,0.0,296581.02
2019-06-28,2019-06-28,Equipment purchase,REF86379560,136.41,0.0,296444.61
2019-07-05,2019-07-05,Marketing expenses,REF11296250,145.37,0.0,296299.24
2019-07-05,2019-07-05,Equipment purchase,REF19704642,68.15,0.0,296231.09
2019-07-06,2019-07-06,Office supplies,REF85145896,19.59,0.0,296211.5
2019-07-08,2019-07-08,Professional services,REF18110203,261.47,0.0,295950.03
2019-07-08,2019-07-08,Internet and phone service,REF33260299,63.36,0.0,295886.67
2019-07-09,2019-07-09,Software subscription,REF79128400,103.37,0.0,295783.3
2019-07-13,2019-07-13,Office supplies,REF93271635,47.95,0.0,295735.35
2019-07-13,2019-07-13,Internet and phone service,REF41833042,82.65,0.0,295652.7
2019-07-15,2019-07-15,Business insurance premium,REF79542011,98.37,0.0,295554.33
2019-07-15,2019-07-15,Invoice payment - Allen PLC,REF77165891,0.0,887.82,296442.15
2019-07-15,2019-07-15,Service payment - Mendez-Tyler,REF14887785,0.0,1101.25,297543.4
2019-07-15,2019-07-15,Project payment - Lucas-Campos,REF18733901,0.0,1651.91,299195.31
2019-07-20,2019-07-20,Professional services,REF85824809,240.89,0.0,298954.42
2019-07-28,2019-07-28,Office supplies,REF86015387,28.61,0.0,298925.81
2019-07-28,2019-07-28,Business travel,REF23838559,135.83,0.0,298789.98
2019-07-28,2019-07-28,Equipment purchase,REF17311814,64.13,0.0,298725.85
2019-07-29,2019-07-29,Professional services,REF35277942,222.59,0.0,298503.26
2019-08-06,2019-08-06,Internet and phone service,REF18662404,69.45,0.0,298433.81
2019-08-07,2019-08-07,Marketing expenses,REF38818486,145.04,0.0,298288.77
2019-08-07,2019-08-07,Professional services,REF40333462,157.6,0.0,298131.17
2019-08-09,2019-08-09,Software subscription,REF78523520,99.25,0.0,298031.92
2019-08-10,2019-08-10,Internet and phone service,REF19167806,61.62,0.0,297970.3
2019-08-15,2019-08-15,Business insurance premium,REF53426641,82.41,0.0,297887.89
2019-08-15,2019-08-15,Payment from Allen PLC,REF80126928,0.0,816.76,298704.65
2019-08-15,2019-08-15,Project payment - Lucas-Campos,REF74036662,0.0,1231.12,299935.77
2019-08-15,2019-08-15,Service payment - Mendez-Tyler,REF30161371,0.0,1262.79,301198.56
2019-08-16,2019-08-16,Professional services,REF72210478,205.79,0.0,300992.77
2019-08-18,2019-08-18,Business travel,REF42611609,146.95,0.0,300845.82
2019-08-19,2019-08-19,Business travel,REF54430570,76.37,0.0,300769.45
2019-08-22,2019-08-22,Marketing expenses,REF92375759,129.52,0.0,300639.93
2019-08-24,2019-08-24,Training/conference,REF17978480,50.2,0.0,300589.73
2019-08-24,2019-08-24,Internet and phone service,REF18288688,71.53,0.0,300518.2
2019-08-28,2019-08-28,Internet and phone service,REF97564127,77.11,0.0,300441.09
2019-08-29,2019-08-29,Office supplies,REF53382139,26.16,0.0,300414.93
2019-08-30,2019-08-30,Business travel,REF51885239,116.73,0.0,300298.2
2019-09-09,2019-09-09,Software subscription,REF94891677,158.97,0.0,300139.23
2019-09-10,2019-09-10,Training/conference,REF33360983,144.51,0.0,299994.72
2019-09-10,2019-09-10,Professional services,REF67620003,162.0,0.0,299832.72
2019-09-15,2019-09-15,Invoice payment - Lucas-Campos,REF32908147,0.0,2294.58,302127.3
2019-09-15,2019-09-15,Business insurance premium,REF44232057,125.67,0.0,302001.63
2019-09-15,2019-09-15,Payment from Mendez-Tyler,REF50742744,0.0,1821.97,303823.6
2019-09-15,2019-09-15,Project payment - Allen PLC,REF29451593,0.0,1222.45,305046.05
2019-10-03,2019-10-03,Marketing expenses,REF10063494,397.42,0.0,304648.63
2019-10-04,2019-10-04,Office supplies,REF19540623,72.38,0.0,304576.25
2019-10-04,2019-10-04,Training/conference,REF31246452,127.39,0.0,304448.86
2019-10-06,2019-10-06,Marketing expenses,REF80732907,229.4,0.0,304219.46
2019-10-07,2019-10-07,Business travel,REF11114086,215.04,0.0,304004.42
2019-10-09,2019-10-09,Software subscription,REF42367019,156.67,0.0,303847.75
2019-10-09,2019-10-09,Training/conference,REF65744540,111.38,0.0,303736.37
2019-10-14,2019-10-14,Office supplies,REF78001075,38.26,0.0,303698.11
2019-10-15,2019-10-15,Training/conference,REF12515984,57.32,0.0,303640.79
2019-10-15,2019-10-15,Payment from Lucas-Campos,REF51554884,0.0,2226.31,305867.1
2019-10-15,2019-10-15,Service payment - Mendez-Tyler,REF32345037,0.0,2717.24,308584.34
2019-10-15,2019-10-15,Payment from Allen PLC,REF44068611,0.0,1554.68,310139.02
2019-10-15,2019-10-15,Business insurance premium,REF19441603,146.31,0.0,309992.71
2019-10-17,2019-10-17,Business travel,REF94071285,123.7,0.0,309869.01
2019-10-18,2019-10-18,Equipment purchase,REF46974953,83.92,0.0,309785.09
2019-10-22,2019-10-22,Office supplies,REF64580201,84.73,0.0,309700.36
2019-11-07,2019-11-07,Marketing expenses,REF40375376,309.79,0.0,309390.57
2019-11-09,2019-11-09,Software subscription,REF51271039,150.92,0.0,309239.65
2019-11-10,2019-11-10,Marketing expenses,REF56018108,250.71,0.0,308988.94
2019-11-11,2019-11-11,Marketing expenses,REF57511120,220.19,0.0,308768.75
2019-11-15,2019-11-15,Business insurance premium,REF13989488,130.97,0.0,308637.78
2019-11-15,2019-11-15,Invoice payment - Lucas-Campos,REF22175824,0.0,2236.63,310874.41
2019-11-15,2019-11-15,Project payment - Allen PLC,REF24579416,0.0,1281.5,312155.91
2019-11-16,2019-11-16,Business travel,REF83069783,166.77,0.0,311989.14
2019-11-23,2019-11-23,Marketing expenses,REF52628486,243.87,0.0,311745.27
2019-11-25,2019-11-25,Training/conference,REF50476945,146.76,0.0,311598.51
2019-11-26,2019-11-26,Training/conference,REF76892250,97.85,0.0,311500.66
2019-12-05,2019-12-05,Training/conference,REF77165109,146.24,0.0,311354.42
2019-12-09,2019-12-09,Software subscription,REF95832121,116.54,0.0,311237.88
2019-12-10,2019-12-10,Equipment purchase,REF18639875,61.08,0.0,311176.8
2019-12-15,2019-12-15,Invoice payment - Mendez-Tyler,REF81770512,0.0,1517.34,312694.14
2019-12-15,2019-12-15,Invoice payment - Lucas-Campos,REF60210055,0.0,1202.65,313896.79
2019-12-15,2019-12-15,Office supplies,REF91298090,42.75,0.0,313854.04
2019-12-15,2019-12-15,Payment from Allen PLC,REF64024489,0.0,1178.44,315032.48
2019-12-15,2019-12-15,Business insurance premium,REF39449912,98.59,0.0,314933.89
2019-12-20,2019-12-20,Training/conference,REF96664819,83.55,0.0,314850.34
2019-12-25,2019-12-25,Training/conference,REF51907521,64.7,0.0,314785.64
2019-12-30,2019-12-30,Business travel,REF39474937,82.97,0.0,314702.67
2019-12-31,2019-12-31,Internet and phone service,REF11306686,68.25,0.0,314634.42
2020-01-01,2020-01-01,Training/conference,REF45496410,65.0,0.0,314569.42
2020-01-03,2020-01-03,Equipment purchase,REF51371949,105.44,0.0,314463.98
2020-01-03,2020-01-03,Office supplies,REF13892244,31.62,0.0,314432.36
2020-01-07,2020-01-07,Professional services,REF41753549,228.88,0.0,314203.48
2020-01-09,2020-01-09,Software subscription,REF33936409,127.84,0.0,314075.64
2020-01-11,2020-01-11,Office supplies,REF91523140,28.2,0.0,314047.44
2020-01-15,2020-01-15,Business insurance premium,REF97047253,97.63,0.0,313949.81
2020-01-15,2020-01-15,Invoice payment - Allen PLC,REF99324790,0.0,897.7,314847.51
2020-01-15,2020-01-15,Payment from Mendez-Tyler,REF55587063,0.0,1241.71,316089.22
2020-01-15,2020-01-15,Service payment - Lucas-Campos,REF10687317,0.0,1385.41,317474.63
2020-01-24,2020-01-24,Training/conference,REF48947263,132.47,0.0,317342.16
2020-01-26,2020-01-26,Office supplies,REF13267860,36.33,0.0,317305.83
2020-01-27,2020-01-27,Business travel,REF89956001,105.14,0.0,317200.69
2020-01-29,2020-01-29,Internet and phone service,REF40883401,70.63,0.0,317130.06
2020-02-03,2020-02-03,Internet and phone service,REF24806916,49.42,0.0,317080.64
2020-02-05,2020-02-05,Marketing expenses,REF68856841,204.36,0.0,316876.28
2020-02-09,2020-02-09,Business travel,REF95909541,210.11,0.0,316666.17
2020-02-09,2020-02-09,Software subscription,REF28008500,127.71,0.0,316538.46
2020-02-12,2020-02-12,Office supplies,REF32610898,58.15,0.0,316480.31
2020-02-13,2020-02-13,Professional services,REF26172785,204.73,0.0,316275.58
2020-02-15,2020-02-15,Service payment - Lucas-Campos,REF76584207,0.0,1561.33,317836.91
2020-02-15,2020-02-15,Service payment - Allen PLC,REF79373969,0.0,1073.15,318910.06
2020-02-15,2020-02-15,Business insurance premium,REF47277027,99.23,0.0,318810.83
2020-02-16,2020-02-16,Professional services,REF65875943,104.71,0.0,318706.12
2020-02-18,2020-02-18,Office supplies,REF38110196,29.66,0.0,318676.46
2020-02-22,2020-02-22,Marketing expenses,REF90993135,156.86,0.0,318519.6
2020-02-24,2020-02-24,Business travel,REF59108671,31.11,0.0,318488.49
2020-03-01,2020-03-01,Office supplies,REF90225892,88.22,0.0,318400.27
2020-03-03,2020-03-03,Office supplies,REF52006557,38.75,0.0,318361.52
2020-03-04,2020-03-04,Equipment purchase,REF28434372,121.67,0.0,318239.85
2020-03-09,2020-03-09,Software subscription,REF78458528,163.23,0.0,318076.62
2020-03-10,2020-03-10,Marketing expenses,REF51892456,141.18,0.0,317935.44
2020-03-14,2020-03-14,Office supplies,REF59553766,77.78,0.0,317857.66
2020-03-15,2020-03-15,Service payment - Mendez-Tyler,REF84466436,0.0,1915.32,319772.98
2020-03-15,2020-03-15,Business insurance premium,REF56946714,135.8,0.0,319637.18
2020-03-15,2020-03-15,Payment from Allen PLC,REF74359586,0.0,1229.73,320866.91
2020-03-15,2020-03-15,Equipment purchase,REF80772009,95.71,0.0,320771.2
2020-03-15,2020-03-15,Invoice payment - Lucas-Campos,REF27489017,0.0,2166.33,322937.53
2020-03-16,2020-03-16,Office supplies,REF41875334,76.5,0.0,322861.03
2020-03-18,2020-03-18,Office supplies,REF78314790,38.8,0.0,322822.23
2020-03-29,2020-03-29,Training/conference,REF29282906,97.18,0.0,322725.05
2020-03-29,2020-03-29,Office supplies,REF33558445,64.33,0.0,322660.72
2020-03-31,2020-03-31,Office supplies,REF81857795,65.52,0.0,322595.2
2020-03-31,2020-03-31,Marketing expenses,REF67550057,194.71,0.0,322400.49
2020-03-31,2020-03-31,Professional services,REF48616434,336.15,0.0,322064.34
2020-04-01,2020-04-01,Office supplies,REF50693956,42.84,0.0,322021.5
2020-04-02,2020-04-02,Training/conference,REF12262671,120.6,0.0,321900.9
2020-04-06,2020-04-06,Training/conference,REF26510181,131.09,0.0,321769.81
2020-04-08,2020-04-08,Training/conference,REF54956185,91.41,0.0,321678.4
2020-04-09,2020-04-09,Software subscription,REF29119781,149.37,0.0,321529.03
2020-04-10,2020-04-10,Office supplies,REF72658810,64.73,0.0,321464.3
2020-04-15,2020-04-15,Training/conference,REF27026046,76.53,0.0,321387.77
2020-04-15,2020-04-15,Project payment - Allen PLC,REF27022386,0.0,1038.32,322426.09
2020-04-15,2020-04-15,Business insurance premium,REF66551791,111.74,0.0,322314.35
2020-04-15,2020-04-15,Invoice payment - Lucas-Campos,REF86055870,0.0,1598.01,323912.36
2020-04-15,2020-04-15,Invoice payment - Mendez-Tyler,REF44088282,0.0,2127.18,326039.54
2020-04-16,2020-04-16,Marketing expenses,REF22059934,133.09,0.0,325906.45
2020-04-16,2020-04-16,Office supplies,REF79078090,49.07,0.0,325857.38
2020-04-17,2020-04-17,Office supplies,REF44336989,41.2,0.0,325816.18
2020-04-18,2020-04-18,Business travel,REF78590805,220.85,0.0,325595.33
2020-04-23,2020-04-23,Equipment purchase,REF65184818,78.82,0.0,325516.51
2020-04-25,2020-04-25,Professional services,REF67231069,379.02,0.0,325137.49
2020-04-26,2020-04-26,Business travel,REF86988633,168.19,0.0,324969.3
2020-04-28,2020-04-28,Business travel,REF69523387,174.84,0.0,324794.46
2020-05-03,2020-05-03,Office supplies,REF28929826,73.91,0.0,324720.55
2020-05-09,2020-05-09,Software subscription,REF48748091,151.63,0.0,324568.92
2020-05-10,2020-05-10,Business travel,REF86598250,129.48,0.0,324439.44
2020-05-13,2020-05-13,Equipment purchase,REF58133117,96.67,0.0,324342.77
2020-05-13,2020-05-13,Office supplies,REF65552529,68.24,0.0,324274.53
2020-05-15,2020-05-15,Business insurance premium,REF54225203,120.44,0.0,324154.09
2020-05-15,2020-05-15,Project payment - Mendez-Tyler,REF15803464,0.0,2004.09,326158.18
2020-05-15,2020-05-15,Project payment - Lucas-Campos,REF43872645,0.0,1790.23,327948.41
2020-05-21,2020-05-21,Training/conference,REF35525756,116.04,0.0,327832.37
2020-05-22,2020-05-22,Equipment purchase,REF58286959,85.99,0.0,327746.38
2020-05-24,2020-05-24,Equipment purchase,REF12390886,162.16,0.0,327584.22
2020-06-09,2020-06-09,Software subscription,REF65553949,121.9,0.0,327462.32
2020-06-11,2020-06-11,Marketing expenses,REF51306866,88.39,0.0,327373.93
2020-06-11,2020-06-11,Office supplies,REF82726600,54.81,0.0,327319.12
2020-06-13,2020-06-13,Internet and phone service,REF47813555,71.27,0.0,327247.85
2020-06-15,2020-06-15,Business insurance premium,REF52825483,106.69,0.0,327141.16
2020-06-15,2020-06-15,Invoice payment - Lucas-Campos,REF74219345,0.0,2086.03,329227.19
2020-06-15,2020-06-15,Payment from Mendez-Tyler,REF53076944,0.0,1569.62,330796.81
2020-06-15,2020-06-15,Project payment - Allen PLC,REF42284930,0.0,1479.51,332276.32
2020-06-18,2020-06-18,Office supplies,REF21926779,40.82,0.0,332235.5
2020-06-23,2020-06-23,Equipment purchase,REF84034960,48.0,0.0,332187.5
2020-06-30,2020-06-30,Business travel,REF84673262,175.91,0.0,332011.59
2020-07-07,2020-07-07,Equipment purchase,REF76764439,43.75,0.0,331967.84
2020-07-08,2020-07-08,Professional services,REF38595459,157.59,0.0,331810.25
2020-07-09,2020-07-09,Software subscription,REF49513610,136.08,0.0,331674.17
2020-07-14,2020-07-14,Business travel,REF38574489,147.44,0.0,331526.73
2020-07-15,2020-07-15,Business insurance premium,REF68312931,98.8,0.0,331427.93
2020-07-15,2020-07-15,Service payment - Lucas-Campos,REF68603316,0.0,1044.92,332472.85
2020-07-15,2020-07-15,Payment from Allen PLC,REF76494183,0.0,1055.01,333527.86
2020-07-15,2020-07-15,Project payment - Mendez-Tyler,REF41227225,0.0,1651.86,335179.72
2020-07-18,2020-07-18,Internet and phone service,REF88238607,77.86,0.0,335101.86
2020-07-20,2020-07-20,Equipment purchase,REF48088981,37.82,0.0,335064.04
2020-07-24,2020-07-24,Equipment purchase,REF89122638,101.4,0.0,334962.64
2020-08-02,2020-08-02,Office supplies,REF93325642,37.89,0.0,334924.75
2020-08-04,2020-08-04,Training/conference,REF51539133,87.36,0.0,334837.39
2020-08-09,2020-08-09,Software subscription,REF45372294,107.75,0.0,334729.64
2020-08-15,2020-08-15,Invoice payment - Lucas-Campos,REF42725690,0.0,1099.46,335829.1
2020-08-15,2020-08-15,Project payment - Allen PLC,REF44244977,0.0,874.9,336704.0
2020-08-15,2020-08-15,Business insurance premium,REF59857885,86.44,0.0,336617.56
2020-08-22,2020-08-22,Business travel,REF76486736,94.19,0.0,336523.37
2020-09-03,2020-09-03,Internet and phone service,REF61217432,85.04,0.0,336438.33
2020-09-04,2020-09-04,Office supplies,REF78669388,55.7,0.0,336382.63
2020-09-05,2020-09-05,Office supplies,REF14863114,57.44,0.0,336325.19
2020-09-07,2020-09-07,Internet and phone service,REF70726712,85.51,0.0,336239.68
2020-09-09,2020-09-09,Software subscription,REF45280670,184.6,0.0,336055.08
2020-09-10,2020-09-10,Internet and phone service,REF80529501,54.8,0.0,336000.28
2020-09-10,2020-09-10,Professional services,REF77553852,301.43,0.0,335698.85
2020-09-11,2020-09-11,Training/conference,REF73581662,120.14,0.0,335578.71
2020-09-15,2020-09-15,Business insurance premium,REF79299670,129.09,0.0,335449.62
2020-09-15,2020-09-15,Service payment - Lucas-Campos,REF72006743,0.0,2285.33,337734.95
2020-09-15,2020-09-15,Service payment - Allen PLC,REF20214955,0.0,1112.12,338847.07
2020-09-15,2020-09-15,Invoice payment - Mendez-Tyler,REF34363711,0.0,2428.77,341275.84
2020-09-18,2020-09-18,Equipment purchase,REF54597469,163.85,0.0,341111.99
2020-09-18,2020-09-18,Office supplies,REF69528558,26.3,0.0,341085.69
2020-09-19,2020-09-19,Business travel,REF77794690,128.56,0.0,340957.13
2020-09-21,2020-09-21,Professional services,REF94401064,274.35,0.0,340682.78
2020-09-22,2020-09-22,Equipment purchase,REF27413674,76.6,0.0,340606.18
2020-09-24,2020-09-24,Office supplies,REF12476097,87.56,0.0,340518.62
2020-09-26,2020-09-26,Marketing expenses,REF77601325,323.7,0.0,340194.92
2020-10-01,2020-10-01,Internet and phone service,REF57417360,75.69,0.0,340119.23
2020-10-06,2020-10-06,Office supplies,REF13031611,65.32,0.0,340053.91
2020-10-07,2020-10-07,Training/conference,REF99596347,138.21,0.0,339915.7
2020-10-09,2020-10-09,Software subscription,REF15262344,198.56,0.0,339717.14
2020-10-12,2020-10-12,Marketing expenses,REF23233244,179.85,0.0,339537.29
2020-10-15,2020-10-15,Business insurance premium,REF50056241,134.74,0.0,339402.55
2020-10-15,2020-10-15,Invoice payment - Allen PLC,REF72699762,0.0,1572.34,340974.89
2020-10-15,2020-10-15,Service payment - Mendez-Tyler,REF73083526,0.0,3024.64,343999.53
2020-10-15,2020-10-15,Invoice payment - Lucas-Campos,REF19467962,0.0,2219.36,346218.89
2020-10-22,2020-10-22,Internet and phone service,REF67717686,94.36,0.0,346124.53
2020-10-23,2020-10-23,Training/conference,REF35045792,97.15,0.0,346027.38
2020-10-23,2020-10-23,Business travel,REF93164070,223.31,0.0,345804.07
2020-10-25,2020-10-25,Marketing expenses,REF20283442,303.19,0.0,345500.88
2020-10-28,2020-10-28,Office supplies,REF73198207,40.94,0.0,345459.94
2020-10-29,2020-10-29,Internet and phone service,REF64068814,69.25,0.0,345390.69
2020-10-31,2020-10-31,Professional services,REF44625636,249.63,0.0,345141.06
2020-11-02,2020-11-02,Internet and phone service,REF74392975,21.18,0.0,345119.88
2020-11-04,2020-11-04,Professional services,REF33287661,133.7,0.0,344986.18
2020-11-09,2020-11-09,Software subscription,REF51227759,200.11,0.0,344786.07
2020-11-09,2020-11-09,Business travel,REF14315122,163.31,0.0,344622.76
2020-11-12,2020-11-12,Office supplies,REF60242252,37.37,0.0,344585.39
2020-11-15,2020-11-15,Service payment - Mendez-Tyler,REF87875822,0.0,1368.48,345953.87
2020-11-15,2020-11-15,Invoice payment - Lucas-Campos,REF50693824,0.0,1935.82,347889.69
2020-11-15,2020-11-15,Business insurance premium,REF88226940,127.36,0.0,347762.33
2020-11-16,2020-11-16,Office supplies,REF61812940,69.27,0.0,347693.06
2020-11-17,2020-11-17,Business travel,REF37028563,147.49,0.0,347545.57
2020-11-21,2020-11-21,Internet and phone service,REF71846231,75.84,0.0,347469.73
2020-11-28,2020-11-28,Office supplies,REF41686504,55.21,0.0,347414.52
2020-12-02,2020-12-02,Office supplies,REF58063634,48.39,0.0,347366.13
2020-12-05,2020-12-05,Equipment purchase,REF99396214,114.78,0.0,347251.35
2020-12-06,2020-12-06,Office supplies,REF95063586,30.83,0.0,347220.52
2020-12-09,2020-12-09,Software subscription,REF69043610,137.61,0.0,347082.91
2020-12-09,2020-12-09,Office supplies,REF25878245,37.84,0.0,347045.07
2020-12-10,2020-12-10,Internet and phone service,REF89056229,41.94,0.0,347003.13
2020-12-11,2020-12-11,Office supplies,REF82343368,50.12,0.0,346953.01
2020-12-15,2020-12-15,Project payment - Mendez-Tyler,REF61213878,0.0,1615.68,348568.69
2020-12-15,2020-12-15,Business insurance premium,REF47081109,114.36,0.0,348454.33
2020-12-15,2020-12-15,Service payment - Allen PLC,REF31519924,0.0,893.28,349347.61
2020-12-15,2020-12-15,Invoice payment - Lucas-Campos,REF53047135,0.0,1140.39,350488.0
2020-12-17,2020-12-17,Office supplies,REF92163237,32.72,0.0,350455.28
2020-12-23,2020-12-23,Office supplies,REF90092828,44.8,0.0,350410.48
2020-12-27,2020-12-27,Office supplies,REF93161329,54.73,0.0,350355.75
2020-12-30,2020-12-30,Office supplies,REF74673014,58.64,0.0,350297.11
2020-12-31,2020-12-31,Business travel,REF91345655,158.92,0.0,350138.19
2020-12-31,2020-12-31,Office supplies,REF42708677,39.26,0.0,350098.93
2021-01-03,2021-01-03,Equipment purchase,REF48061750,47.76,0.0,350051.17
2021-01-09,2021-01-09,Internet and phone service,REF76906925,45.19,0.0,350005.98
2021-01-09,2021-01-09,Software subscription,REF84480640,103.22,0.0,349902.76
2021-01-14,2021-01-14,Office supplies,REF91569674,34.49,0.0,349868.27
2021-01-15,2021-01-15,Service payment - Lucas-Campos,REF17817524,0.0,1312.58,351180.85
2021-01-15,2021-01-15,Service payment - Allen PLC,REF28241208,0.0,1109.36,352290.21
2021-01-15,2021-01-15,Business insurance premium,REF34531644,98.35,0.0,352191.86
2021-01-15,2021-01-15,Project payment - Mendez-Tyler,REF97371133,0.0,1407.37,353599.23
2021-01-16,2021-01-16,Office supplies,REF40203251,42.89,0.0,353556.34
2021-01-20,2021-01-20,Office supplies,REF61592974,50.93,0.0,353505.41
2021-02-05,2021-02-05,Office supplies,REF81807414,52.48,0.0,353452.93
2021-02-09,2021-02-09,Software subscription,REF71931917,128.66,0.0,353324.27
2021-02-10,2021-02-10,Equipment purchase,REF27696417,87.0,0.0,353237.27
2021-02-15,2021-02-15,Business insurance premium,REF41656776,103.54,0.0,353133.73
2021-02-15,2021-02-15,Service payment - Mendez-Tyler,REF68607394,0.0,1540.41,354674.14
2021-02-15,2021-02-15,Invoice payment - Lucas-Campos,REF29136449,0.0,1546.06,356220.2
2021-02-15,2021-02-15,Project payment - Allen PLC,REF47542538,0.0,1239.12,357459.32
2021-02-16,2021-02-16,Office supplies,REF59993625,14.78,0.0,357444.54
2021-02-16,2021-02-16,Business travel,REF60164129,134.09,0.0,357310.45
2021-02-23,2021-02-23,Business travel,REF19401582,126.25,0.0,357184.2
2021-02-24,2021-02-24,Business travel,REF78948705,155.59,0.0,357028.61
2021-02-25,2021-02-25,Office supplies,REF50598428,31.65,0.0,356996.96
2021-03-04,2021-03-04,Internet and phone service,REF12955629,74.45,0.0,356922.51
2021-03-09,2021-03-09,Software subscription,REF59241449,187.61,0.0,356734.9
2021-03-11,2021-03-11,Office supplies,REF72461638,37.34,0.0,356697.56
2021-03-15,2021-03-15,Business insurance premium,REF47986682,129.66,0.0,356567.9
2021-03-15,2021-03-15,Project payment - Lucas-Campos,REF79819527,0.0,2004.29,358572.19
2021-03-15,2021-03-15,Invoice payment - Allen PLC,REF99596002,0.0,1427.98,360000.17
2021-03-15,2021-03-15,Payment from Mendez-Tyler,REF97376519,0.0,2027.27,362027.44
2021-03-15,2021-03-15,Equipment purchase,REF61473719,95.52,0.0,361931.92
2021-03-18,2021-03-18,Internet and phone service,REF24863016,83.24,0.0,361848.68
2021-03-21,2021-03-21,Marketing expenses,REF32104867,188.53,0.0,361660.15
2021-03-27,2021-03-27,Training/conference,REF16473093,111.74,0.0,361548.41
2021-03-31,2021-03-31,Marketing expenses,REF59672422,281.5,0.0,361266.91
2021-04-05,2021-04-05,Equipment purchase,REF67606650,113.06,0.0,361153.85
2021-04-08,2021-04-08,Internet and phone service,REF12912284,98.35,0.0,361055.5
2021-04-09,2021-04-09,Software subscription,REF92496236,133.39,0.0,360922.11
2021-04-11,2021-04-11,Business travel,REF44917418,138.75,0.0,360783.36
2021-04-11,2021-04-11,Office supplies,REF20183224,24.66,0.0,360758.7
2021-04-11,2021-04-11,Training/conference,REF26479565,127.18,0.0,360631.52
2021-04-11,2021-04-11,Professional services,REF22929760,359.29,0.0,360272.23
2021-04-13,2021-04-13,Professional services,REF68854270,323.36,0.0,359948.87
2021-04-15,2021-04-15,Service payment - Allen PLC,REF14106376,0.0,1021.95,360970.82
2021-04-15,2021-04-15,Invoice payment - Mendez-Tyler,REF39267740,0.0,1690.5,362661.32
2021-04-15,2021-04-15,Business insurance premium,REF93097682,109.52,0.0,362551.8
2021-04-15,2021-04-15,Service payment - Lucas-Campos,REF65332009,0.0,1765.26,364317.06
2021-04-18,2021-04-18,Office supplies,REF54194987,71.76,0.0,364245.3
2021-04-19,2021-04-19,Professional services,REF11485330,141.63,0.0,364103.67
2021-04-20,2021-04-20,Office supplies,REF38293268,65.13,0.0,364038.54
2021-05-01,2021-05-01,Office supplies,REF83063041,55.78,0.0,363982.76
2021-05-04,2021-05-04,Marketing expenses,REF94374251,186.83,0.0,363795.93
2021-05-05,2021-05-05,Marketing expenses,REF51306014,157.25,0.0,363638.68
2021-05-06,2021-05-06,Training/conference,REF22374521,92.84,0.0,363545.84
2021-05-09,2021-05-09,Software subscription,REF62018845,158.77,0.0,363387.07
2021-05-13,2021-05-13,Office supplies,REF57591246,38.7,0.0,363348.37
2021-05-15,2021-05-15,Project payment - Allen PLC,REF32230620,0.0,1005.39,364353.76
2021-05-15,2021-05-15,Payment from Mendez-Tyler,REF77936280,0.0,1483.02,365836.78
2021-05-15,2021-05-15,Business insurance premium,REF51279759,109.94,0.0,365726.84
2021-05-15,2021-05-15,Payment from Lucas-Campos,REF38594540,0.0,2087.46,367814.3
2021-05-17,2021-05-17,Office supplies,REF22954951,30.83,0.0,367783.47
2021-05-25,2021-05-25,Office supplies,REF89037950,69.66,0.0,367713.81
2021-06-03,2021-06-03,Internet and phone service,REF64384834,103.75,0.0,367610.06
2021-06-06,2021-06-06,Training/conference,REF76109601,54.14,0.0,367555.92
2021-06-07,2021-06-07,Office supplies,REF95439659,53.66,0.0,367502.26
2021-06-09,2021-06-09,Software subscription,REF60415473,153.81,0.0,367348.45
2021-06-15,2021-06-15,Service payment - Lucas-Campos,REF43748093,0.0,1348.23,368696.68
2021-06-15,2021-06-15,Service payment - Mendez-Tyler,REF24396245,0.0,1422.85,370119.53
2021-06-15,2021-06-15,Professional services,REF59404743,182.77,0.0,369936.76
2021-06-15,2021-06-15,Service payment - Allen PLC,REF42813142,0.0,1394.12,371330.88
2021-06-15,2021-06-15,Business insurance premium,REF27939558,103.25,0.0,371227.63
2021-06-18,2021-06-18,Office supplies,REF99078469,32.3,0.0,371195.33
2021-06-28,2021-06-28,Business travel,REF59718922,154.74,0.0,371040.59
2021-06-30,2021-06-30,Professional services,REF56657295,206.9,0.0,370833.69
2021-06-30,2021-06-30,Office supplies,REF16831808,61.01,0.0,370772.68
2021-07-01,2021-07-01,Business travel,REF70554546,133.5,0.0,370639.18
2021-07-01,2021-07-01,Training/conference,REF34990743,93.39,0.0,370545.79
2021-07-06,2021-07-06,Business travel,REF50423626,160.14,0.0,370385.65
2021-07-07,2021-07-07,Business travel,REF56534093,71.57,0.0,370314.08
2021-07-09,2021-07-09,Software subscription,REF32442122,121.44,0.0,370192.64
2021-07-13,2021-07-13,Professional services,REF24986507,192.61,0.0,370000.03
2021-07-14,2021-07-14,Office supplies,REF58038808,60.3,0.0,369939.73
2021-07-15,2021-07-15,Business insurance premium,REF84095712,91.68,0.0,369848.05
2021-07-15,2021-07-15,Invoice payment - Mendez-Tyler,REF27211880,0.0,1007.1,370855.15
2021-07-15,2021-07-15,Project payment - Allen PLC,REF74175667,0.0,917.17,371772.32
2021-07-15,2021-07-15,Service payment - Lucas-Campos,REF41268722,0.0,1878.33,373650.65
2021-07-17,2021-07-17,Internet and phone service,REF56056972,84.95,0.0,373565.7
2021-07-18,2021-07-18,Marketing expenses,REF40154565,192.0,0.0,373373.7
2021-07-18,2021-07-18,Business travel,REF98952322,190.92,0.0,373182.78
2021-07-20,2021-07-20,Business travel,REF62553508,126.83,0.0,373055.95
2021-07-29,2021-07-29,Marketing expenses,REF44547663,182.95,0.0,372873.0
2021-08-01,2021-08-01,Marketing expenses,REF36511198,179.31,0.0,372693.69
2021-08-07,2021-08-07,Equipment purchase,REF58341678,66.72,0.0,372626.97
2021-08-09,2021-08-09,Software subscription,REF91583975,106.02,0.0,372520.95
2021-08-13,2021-08-13,Office supplies,REF30527855,42.42,0.0,372478.53
2021-08-14,2021-08-14,Internet and phone service,REF34115263,67.19,0.0,372411.34
2021-08-15,2021-08-15,Office supplies,REF55178150,23.38,0.0,372387.96
2021-08-15,2021-08-15,Business travel,REF84552261,89.05,0.0,372298.91
2021-08-15,2021-08-15,Service payment - Lucas-Campos,REF13041423,0.0,1273.87,373572.78
2021-08-15,2021-08-15,Business insurance premium,REF95692710,85.41,0.0,373487.37
2021-08-15,2021-08-15,Invoice payment - Allen PLC,REF10741270,0.0,698.79,374186.16
2021-08-15,2021-08-15,Payment from Mendez-Tyler,REF30339884,0.0,1310.64,375496.8
2021-08-16,2021-08-16,Professional services,REF53209739,226.8,0.0,375270.0
2021-08-21,2021-08-21,Equipment purchase,REF82440342,57.37,0.0,375212.63
2021-08-29,2021-08-29,Office supplies,REF14192964,43.33,0.0,375169.3
2021-08-30,2021-08-30,Office supplies,REF48846551,43.58,0.0,375125.72
2021-08-30,2021-08-30,Training/conference,REF51232269,56.5,0.0,375069.22
2021-09-09,2021-09-09,Software subscription,REF42128412,166.75,0.0,374902.47
2021-09-10,2021-09-10,Business travel,REF97681994,135.7,0.0,374766.77
2021-09-13,2021-09-13,Professional services,REF64720415,125.46,0.0,374641.31
2021-09-15,2021-09-15,Business insurance premium,REF29415048,120.61,0.0,374520.7
2021-09-15,2021-09-15,Invoice payment - Lucas-Campos,REF24307880,0.0,2307.44,376828.14
2021-09-15,2021-09-15,Office supplies,REF88007376,20.7,0.0,376807.44
2021-09-15,2021-09-15,Invoice payment - Allen PLC,REF74504012,0.0,1204.05,378011.49
2021-09-15,2021-09-15,Invoice payment - Mendez-Tyler,REF62212821,0.0,2163.49,380174.98
2021-09-19,2021-09-19,Professional services,REF97813196,283.74,0.0,379891.24
2021-09-26,2021-09-26,Equipment purchase,REF58822275,108.95,0.0,379782.29
2021-09-27,2021-09-27,Marketing expenses,REF23149491,247.54,0.0,379534.75
2021-09-28,2021-09-28,Business travel,REF98660295,153.61,0.0,379381.14
2021-10-04,2021-10-04,Professional services,REF30841158,307.59,0.0,379073.55
2021-10-06,2021-10-06,Equipment purchase,REF13658609,144.2,0.0,378929.35
2021-10-07,2021-10-07,Office supplies,REF97182333,59.14,0.0,378870.21
2021-10-09,2021-10-09,Software subscription,REF44822400,198.68,0.0,378671.53
2021-10-10,2021-10-10,Office supplies,REF74449912,59.93,0.0,378611.6
2021-10-15,2021-10-15,Business insurance premium,REF67706783,145.49,0.0,378466.11
2021-10-15,2021-10-15,Project payment - Lucas-Campos,REF65261878,0.0,2077.7,380543.81
2021-10-15,2021-10-15,Service payment - Allen PLC,REF24408063,0.0,1423.85,381967.66
2021-10-15,2021-10-15,Service payment - Mendez-Tyler,REF57279378,0.0,1573.28,383540.94
2021-10-20,2021-10-20,Office supplies,REF51672657,42.59,0.0,383498.35
2021-10-20,2021-10-20,Training/conference,REF20437844,180.32,0.0,383318.03
2021-10-23,2021-10-23,Office supplies,REF36578452,35.03,0.0,383283.0
2021-10-23,2021-10-23,Marketing expenses,REF89831886,295.96,0.0,382987.04
2021-10-24,2021-10-24,Equipment purchase,REF26920303,139.73,0.0,382847.31
2021-10-29,2021-10-29,Office supplies,REF10364237,64.32,0.0,382782.99
2021-11-02,2021-11-02,Office supplies,REF40838633,25.08,0.0,382757.91
2021-11-08,2021-11-08,Business travel,REF40848706,205.64,0.0,382552.27
2021-11-08,2021-11-08,Equipment purchase,REF25160455,87.02,0.0,382465.25
2021-11-09,2021-11-09,Software subscription,REF68453737,178.57,0.0,382286.68
2021-11-15,2021-11-15,Project payment - Allen PLC,REF75567168,0.0,1596.08,383882.76
2021-11-15,2021-11-15,Payment from Lucas-Campos,REF66034731,0.0,1860.04,385742.8
2021-11-15,2021-11-15,Payment from Mendez-Tyler,REF76490744,0.0,1808.49,387551.29
2021-11-15,2021-11-15,Business insurance premium,REF86821489,145.9,0.0,387405.39
2021-11-16,2021-11-16,Marketing expenses,REF12348111,342.8,0.0,387062.59
2021-11-19,2021-11-19,Office supplies,REF32639409,71.24,0.0,386991.35
2021-11-19,2021-11-19,Business travel,REF40720450,226.64,0.0,386764.71
2021-11-20,2021-11-20,Office supplies,REF93076156,49.11,0.0,386715.6
2021-11-24,2021-11-24,Marketing expenses,REF85456261,270.25,0.0,386445.35
2021-11-26,2021-11-26,Office supplies,REF23405002,38.9,0.0,386406.45
2021-11-27,2021-11-27,Office supplies,REF18021804,51.95,0.0,386354.5
2021-11-30,2021-11-30,Business travel,REF87637213,209.31,0.0,386145.19
2021-12-02,2021-12-02,Marketing expenses,REF48000543,164.74,0.0,385980.45
2021-12-02,2021-12-02,Professional services,REF83953770,126.08,0.0,385854.37
2021-12-05,2021-12-05,Professional services,REF27130702,236.0,0.0,385618.37
2021-12-05,2021-12-05,Equipment purchase,REF41611703,64.06,0.0,385554.31
2021-12-09,2021-12-09,Software subscription,REF81807230,106.88,0.0,385447.43
2021-12-10,2021-12-10,Office supplies,REF58063320,37.46,0.0,385409.97
2021-12-11,2021-12-11,Internet and phone service,REF74173000,74.79,0.0,385335.18
2021-12-14,2021-12-14,Office supplies,REF76074542,60.38,0.0,385274.8
2021-12-15,2021-12-15,Invoice payment - Mendez-Tyler,REF13326939,0.0,1821.92,387096.72
2021-12-15,2021-12-15,Invoice payment - Lucas-Campos,REF61306394,0.0,1642.02,388738.74
2021-12-15,2021-12-15,Invoice payment - Allen PLC,REF64310401,0.0,1084.44,389823.18
2021-12-15,2021-12-15,Business insurance premium,REF77893010,107.07,0.0,389716.11
2021-12-16,2021-12-16,Professional services,REF83712778,85.44,0.0,389630.67
2021-12-16,2021-12-16,Training/conference,REF53393319,94.64,0.0,389536.03
2021-12-18,2021-12-18,Office supplies,REF77947128,61.87,0.0,389474.16
2021-12-22,2021-12-22,Professional services,REF78803860,330.44,0.0,389143.72
2021-12-28,2021-12-28,Marketing expenses,REF61539470,179.17,0.0,388964.55
2021-12-29,2021-12-29,Equipment purchase,REF21189023,74.84,0.0,388889.71
2022-01-02,2022-01-02,Equipment purchase,REF62904731,57.75,0.0,388831.96
2022-01-07,2022-01-07,Marketing expenses,REF62718579,141.95,0.0,388690.01
2022-01-07,2022-01-07,Office supplies,REF76853180,42.56,0.0,388647.45
2022-01-08,2022-01-08,Office supplies,REF16191367,30.38,0.0,388617.07
2022-01-09,2022-01-09,Business travel,REF39080467,130.1,0.0,388486.97
2022-01-09,2022-01-09,Software subscription,REF32526118,117.7,0.0,388369.27
2022-01-10,2022-01-10,Business travel,REF58025002,132.91,0.0,388236.36
2022-01-13,2022-01-13,Office supplies,REF44814604,35.92,0.0,388200.44
2022-01-14,2022-01-14,Business travel,REF10707936,118.28,0.0,388082.16
2022-01-15,2022-01-15,Internet and phone service,REF39380558,86.12,0.0,387996.04
2022-01-15,2022-01-15,Business insurance premium,REF52423287,95.35,0.0,387900.69
2022-01-15,2022-01-15,Invoice payment - Lucas-Campos,REF93463924,0.0,1755.65,389656.34
2022-01-15,2022-01-15,Payment from Allen PLC,REF91930459,0.0,1140.14,390796.48
2022-01-15,2022-01-15,Service payment - Mendez-Tyler,REF44061608,0.0,1483.19,392279.67
2022-01-18,2022-01-18,Professional services,REF27955843,165.0,0.0,392114.67
2022-01-19,2022-01-19,Office supplies,REF84487734,47.6,0.0,392067.07
2022-01-20,2022-01-20,Internet and phone service,REF50105149,56.42,0.0,392010.65
2022-01-24,2022-01-24,Office supplies,REF65054223,38.78,0.0,391971.87
2022-01-25,2022-01-25,Office supplies,REF75117943,35.16,0.0,391936.71
2022-01-30,2022-01-30,Office supplies,REF26053588,54.59,0.0,391882.12
2022-01-31,2022-01-31,Business travel,REF74992472,161.35,0.0,391720.77
2022-02-01,2022-02-01,Equipment purchase,REF42673880,113.16,0.0,391607.61
2022-02-02,2022-02-02,Office supplies,REF88232165,38.86,0.0,391568.75
2022-02-03,2022-02-03,Business travel,REF86158933,144.12,0.0,391424.63
2022-02-09,2022-02-09,Software subscription,REF48863030,131.55,0.0,391293.08
2022-02-10,2022-02-10,Equipment purchase,REF92508600,89.42,0.0,391203.66
2022-02-13,2022-02-13,Office supplies,REF62298135,42.46,0.0,391161.2
2022-02-15,2022-02-15,Business insurance premium,REF54167222,106.06,0.0,391055.14
2022-02-15,2022-02-15,Service payment - Lucas-Campos,REF49440658,0.0,1971.92,393027.06
2022-02-15,2022-02-15,Payment from Mendez-Tyler,REF69765187,0.0,1486.69,394513.75
2022-02-15,2022-02-15,Office supplies,REF41660904,24.69,0.0,394489.06
2022-02-15,2022-02-15,Project payment - Allen PLC,REF68832672,0.0,1099.56,395588.62
2022-02-18,2022-02-18,Equipment purchase,REF76627775,47.48,0.0,395541.14
2022-02-20,2022-02-20,Office supplies,REF97946805,56.46,0.0,395484.68
2022-03-02,2022-03-02,Office supplies,REF80364736,43.87,0.0,395440.81
2022-03-04,2022-03-04,Equipment purchase,REF49652540,128.13,0.0,395312.68
2022-03-08,2022-03-08,Business travel,REF75251171,182.55,0.0,395130.13
2022-03-08,2022-03-08,Office supplies,REF31126274,60.75,0.0,395069.38
2022-03-09,2022-03-09,Software subscription,REF86068548,171.28,0.0,394898.1
2022-03-10,2022-03-10,Office supplies,REF95633436,36.23,0.0,394861.87
2022-03-11,2022-03-11,Business travel,REF19649605,190.33,0.0,394671.54
2022-03-11,2022-03-11,Training/conference,REF81351456,53.01,0.0,394618.53
2022-03-15,2022-03-15,Business insurance premium,REF68115640,131.49,0.0,394487.04
2022-03-15,2022-03-15,Project payment - Allen PLC,REF38739741,0.0,1312.4,395799.44
2022-03-15,2022-03-15,Invoice payment - Mendez-Tyler,REF47919941,0.0,2116.36,397915.8
2022-03-22,2022-03-22,Training/conference,REF86718235,146.69,0.0,397769.11
2022-03-23,2022-03-23,Internet and phone service,REF84986356,62.02,0.0,397707.09
2022-03-24,2022-03-24,Internet and phone service,REF99514423,79.79,0.0,397627.3
2022-03-27,2022-03-27,Training/conference,REF56504086,24.19,0.0,397603.11
2022-03-28,2022-03-28,Internet and phone service,REF17938961,91.83,0.0,397511.28
2022-04-03,2022-04-03,Marketing expenses,REF10182162,214.97,0.0,397296.31
2022-04-03,2022-04-03,Business travel,REF87414273,73.11,0.0,397223.2
2022-04-06,2022-04-06,Internet and phone service,REF33025858,96.36,0.0,397126.84
2022-04-06,2022-04-06,Office supplies,REF50395109,62.01,0.0,397064.83
2022-04-09,2022-04-09,Software subscription,REF78798243,141.63,0.0,396923.2
2022-04-09,2022-04-09,Internet and phone service,REF37435312,90.09,0.0,396833.11
2022-04-10,2022-04-10,Professional services,REF29684732,201.88,0.0,396631.23
2022-04-15,2022-04-15,Business insurance premium,REF37157441,118.29,0.0,396512.94
2022-04-15,2022-04-15,Project payment - Mendez-Tyler,REF37375571,0.0,1403.44,397916.38
2022-04-15,2022-04-15,Payment from Lucas-Campos,REF52474883,0.0,1670.78,399587.16
2022-04-15,2022-04-15,Project payment - Allen PLC,REF82728190,0.0,1313.25,400900.41
2022-04-15,2022-04-15,Business travel,REF92128594,132.9,0.0,400767.51
2022-04-16,2022-04-16,Business travel,REF96087261,109.53,0.0,400657.98
2022-04-16,2022-04-16,Office supplies,REF71645287,49.22,0.0,400608.76
2022-04-19,2022-04-19,Business travel,REF10077532,99.08,0.0,400509.68
2022-04-21,2022-04-21,Marketing expenses,REF12797158,199.38,0.0,400310.3
2022-04-26,2022-04-26,Training/conference,REF24340988,133.6,0.0,400176.7
2022-04-26,2022-04-26,Internet and phone service,REF50356776,77.09,0.0,400099.61
2022-04-29,2022-04-29,Office supplies,REF71650301,27.39,0.0,400072.22
2022-04-29,2022-04-29,Business travel,REF56515121,122.09,0.0,399950.13
2022-05-08,2022-05-08,Internet and phone service,REF89678913,55.68,0.0,399894.45
2022-05-09,2022-05-09,Office supplies,REF56229338,58.28,0.0,399836.17
2022-05-09,2022-05-09,Software subscription,REF59415431,151.28,0.0,399684.89
2022-05-12,2022-05-12,Internet and phone service,REF87506754,65.88,0.0,399619.01
2022-05-15,2022-05-15,Business insurance premium,REF76820257,124.88,0.0,399494.13
2022-05-15,2022-05-15,Invoice payment - Lucas-Campos,REF20072792,0.0,1352.26,400846.39
2022-05-15,2022-05-15,Training/conference,REF74337252,137.52,0.0,400708.87
2022-05-15,2022-05-15,Project payment - Allen PLC,REF78710588,0.0,1442.75,402151.62
2022-05-15,2022-05-15,Service payment - Mendez-Tyler,REF61554909,0.0,1606.55,403758.17
2022-05-18,2022-05-18,Office supplies,REF38622119,64.44,0.0,403693.73
2022-05-21,2022-05-21,Office supplies,REF71728467,40.53,0.0,403653.2
2022-05-26,2022-05-26,Marketing expenses,REF84174645,219.29,0.0,403433.91
2022-05-26,2022-05-26,Internet and phone service,REF78597822,80.81,0.0,403353.1
2022-05-30,2022-05-30,Marketing expenses,REF70885604,127.29,0.0,403225.81
2022-06-01,2022-06-01,Office supplies,REF97543469,24.25,0.0,403201.56
2022-06-08,2022-06-08,Office supplies,REF42627713,41.91,0.0,403159.65
2022-06-08,2022-06-08,Marketing expenses,REF24921133,177.52,0.0,402982.13
2022-06-09,2022-06-09,Software subscription,REF12431159,128.95,0.0,402853.18
2022-06-15,2022-06-15,Business insurance premium,REF13413645,104.61,0.0,402748.57
2022-06-15,2022-06-15,Invoice payment - Lucas-Campos,REF64673323,0.0,1632.24,404380.81
2022-06-15,2022-06-15,Business travel,REF20581520,119.68,0.0,404261.13
2022-06-15,2022-06-15,Invoice payment - Allen PLC,REF67684429,0.0,915.4,405176.53
2022-06-15,2022-06-15,Service payment - Mendez-Tyler,REF47195999,0.0,1991.17,407167.7
2022-06-17,2022-06-17,Professional services,REF21855400,256.41,0.0,406911.29
2022-06-21,2022-06-21,Office supplies,REF44778193,44.39,0.0,406866.9
2022-07-09,2022-07-09,Software subscription,REF57039656,101.41,0.0,406765.49
2022-07-12,2022-07-12,Office supplies,REF74124403,41.42,0.0,406724.07
2022-07-15,2022-07-15,Invoice payment - Allen PLC,REF86423136,0.0,1052.63,407776.7
2022-07-15,2022-07-15,Business insurance premium,REF20488664,97.92,0.0,407678.78
2022-07-15,2022-07-15,Marketing expenses,REF93942241,196.56,0.0,407482.22
2022-07-15,2022-07-15,Invoice payment - Lucas-Campos,REF18672593,0.0,1694.27,409176.49
2022-07-15,2022-07-15,Service payment - Mendez-Tyler,REF99580387,0.0,1557.21,410733.7
2022-07-22,2022-07-22,Office supplies,REF69475799,47.04,0.0,410686.66
2022-07-24,2022-07-24,Business travel,REF46011345,137.36,0.0,410549.3
2022-07-28,2022-07-28,Business travel,REF11169457,88.29,0.0,410461.01
2022-08-05,2022-08-05,Office supplies,REF71178865,20.97,0.0,410440.04
2022-08-07,2022-08-07,Professional services,REF37916280,235.95,0.0,410204.09
2022-08-07,2022-08-07,Marketing expenses,REF21531520,178.84,0.0,410025.25
2022-08-09,2022-08-09,Software subscription,REF62774400,102.86,0.0,409922.39
2022-08-14,2022-08-14,Business travel,REF23578249,69.83,0.0,409852.56
2022-08-15,2022-08-15,Payment from Allen PLC,REF88836167,0.0,824.85,410677.41
2022-08-15,2022-08-15,Payment from Lucas-Campos,REF74465573,0.0,1080.85,411758.26
2022-08-15,2022-08-15,Payment from Mendez-Tyler,REF24130246,0.0,1182.96,412941.22
2022-08-15,2022-08-15,Business insurance premium,REF20814870,82.04,0.0,412859.18
2022-08-17,2022-08-17,Professional services,REF69601301,189.44,0.0,412669.74
2022-08-20,2022-08-20,Office supplies,REF79470689,31.96,0.0,412637.78
2022-09-03,2022-09-03,Marketing expenses,REF56196415,190.91,0.0,412446.87
2022-09-04,2022-09-04,Professional services,REF89207119,298.46,0.0,412148.41
2022-09-06,2022-09-06,Professional services,REF64335881,283.3,0.0,411865.11
2022-09-09,2022-09-09,Software subscription,REF47073412,147.34,0.0,411717.77
2022-09-09,2022-09-09,Equipment purchase,REF23189444,141.61,0.0,411576.16
2022-09-14,2022-09-14,Office supplies,REF98213427,49.13,0.0,411527.03
2022-09-15,2022-09-15,Business insurance premium,REF12417428,130.19,0.0,411396.84
2022-09-15,2022-09-15,Payment from Mendez-Tyler,REF94205425,0.0,1788.39,413185.23
2022-09-15,2022-09-15,Service payment - Lucas-Campos,REF63465407,0.0,1903.43,415088.66
2022-09-15,2022-09-15,Invoice payment - Allen PLC,REF22537411,0.0,1296.51,416385.17
2022-09-15,2022-09-15,Internet and phone service,REF42049251,50.11,0.0,416335.06
2022-09-17,2022-09-17,Office supplies,REF65721555,31.37,0.0,416303.69
2022-09-22,2022-09-22,Business travel,REF52147560,150.66,0.0,416153.03
2022-09-24,2022-09-24,Marketing expenses,REF58324673,235.98,0.0,415917.05
2022-09-26,2022-09-26,Equipment purchase,REF70100027,83.84,0.0,415833.21
2022-09-29,2022-09-29,Professional services,REF69513377,244.59,0.0,415588.62
2022-09-29,2022-09-29,Business travel,REF69460823,256.84,0.0,415331.78
2022-10-01,2022-10-01,Office supplies,REF65551944,38.2,0.0,415293.58
2022-10-02,2022-10-02,Office supplies,REF79511198,76.89,0.0,415216.69
2022-10-02,2022-10-02,Professional services,REF49014892,245.32,0.0,414971.37
2022-10-05,2022-10-05,Business travel,REF79333931,254.72,0.0,414716.65
2022-10-06,2022-10-06,Business travel,REF29241141,141.41,0.0,414575.24
2022-10-07,2022-10-07,Equipment purchase,REF22259765,148.02,0.0,414427.22
2022-10-08,2022-10-08,Office supplies,REF18217399,76.4,0.0,414350.82
2022-10-09,2022-10-09,Software subscription,REF97928692,193.58,0.0,414157.24
2022-10-09,2022-10-09,Marketing expenses,REF81900554,133.89,0.0,414023.35
2022-10-11,2022-10-11,Professional services,REF56029027,165.41,0.0,413857.94
2022-10-12,2022-10-12,Business travel,REF67718894,221.42,0.0,413636.52
2022-10-15,2022-10-15,Business insurance premium,REF46375699,131.3,0.0,413505.22
2022-10-15,2022-10-15,Project payment - Allen PLC,REF34312431,0.0,1561.64,415066.86
2022-10-15,2022-10-15,Payment from Lucas-Campos,REF14643076,0.0,2666.09,417732.95
2022-10-17,2022-10-17,Business travel,REF68311324,260.12,0.0,417472.83
2022-10-18,2022-10-18,Training/conference,REF44151533,131.68,0.0,417341.15
2022-10-19,2022-10-19,Marketing expenses,REF34498709,296.38,0.0,417044.77
2022-10-24,2022-10-24,Marketing expenses,REF70866558,238.05,0.0,416806.72
2022-10-28,2022-10-28,Marketing expenses,REF60336532,271.72,0.0,416535.0
2022-10-29,2022-10-29,Office supplies,REF98721922,55.55,0.0,416479.45
2022-11-01,2022-11-01,Office supplies,REF92698157,66.09,0.0,416413.36
2022-11-03,2022-11-03,Office supplies,REF30150886,37.57,0.0,416375.79
2022-11-09,2022-11-09,Software subscription,REF81082031,120.52,0.0,416255.27
2022-11-09,2022-11-09,Office supplies,REF73518468,53.75,0.0,416201.52
2022-11-12,2022-11-12,Internet and phone service,REF44271051,69.18,0.0,416132.34
2022-11-15,2022-11-15,Business insurance premium,REF57060384,136.64,0.0,415995.7
2022-11-15,2022-11-15,Service payment - Lucas-Campos,REF10431456,0.0,2032.31,418028.01
2022-11-15,2022-11-15,Service payment - Mendez-Tyler,REF30695803,0.0,1737.37,419765.38
2022-11-15,2022-11-15,Payment from Allen PLC,REF86761983,0.0,1725.69,421491.07
2022-11-16,2022-11-16,Professional services,REF61333248,261.81,0.0,421229.26
2022-11-17,2022-11-17,Internet and phone service,REF67743036,73.47,0.0,421155.79
2022-11-21,2022-11-21,Office supplies,REF97395919,82.72,0.0,421073.07
2022-11-24,2022-11-24,Equipment purchase,REF84053102,118.65,0.0,420954.42
2022-11-25,2022-11-25,Business travel,REF47376372,156.79,0.0,420797.63
2022-11-25,2022-11-25,Marketing expenses,REF46746768,123.74,0.0,420673.89
2022-11-26,2022-11-26,Training/conference,REF51024640,115.11,0.0,420558.78
2022-12-07,2022-12-07,Office supplies,REF41168913,45.15,0.0,420513.63
2022-12-09,2022-12-09,Software subscription,REF43361496,153.21,0.0,420360.42
2022-12-13,2022-12-13,Office supplies,REF39583021,22.21,0.0,420338.21
2022-12-15,2022-12-15,Business insurance premium,REF48658737,106.95,0.0,420231.26
2022-12-15,2022-12-15,Project payment - Mendez-Tyler,REF87616797,0.0,1917.8,422149.06
2022-12-15,2022-12-15,Service payment - Allen PLC,REF87262449,0.0,1117.09,423266.15
2022-12-15,2022-12-15,Project payment - Lucas-Campos,REF86043842,0.0,1852.16,425118.31
2022-12-16,2022-12-16,Training/conference,REF74240062,104.91,0.0,425013.4
2022-12-18,2022-12-18,Office supplies,REF18956374,36.61,0.0,424976.79
2022-12-21,2022-12-21,Business travel,REF86755567,233.21,0.0,424743.58
2022-12-23,2022-12-23,Office supplies,REF87085631,56.92,0.0,424686.66
2022-12-26,2022-12-26,Training/conference,REF27413607,110.4,0.0,424576.26
2022-12-29,2022-12-29,Business travel,REF47239458,89.31,0.0,424486.95
2022-12-31,2022-12-31,Office supplies,REF56733851,53.34,0.0,424433.61
2023-01-02,2023-01-02,Professional services,REF48610859,252.46,0.0,424181.15
2023-01-03,2023-01-03,Professional services,REF56695796,295.43,0.0,423885.72
2023-01-08,2023-01-08,Office supplies,REF37361121,5.0,0.0,423880.72
2023-01-08,2023-01-08,Equipment purchase,REF37636822,85.31,0.0,423795.41
2023-01-09,2023-01-09,Business travel,REF46634687,86.41,0.0,423709.0
2023-01-09,2023-01-09,Software subscription,REF52804498,136.06,0.0,423572.94
2023-01-10,2023-01-10,Business travel,REF34651300,144.49,0.0,423428.45
2023-01-10,2023-01-10,Office supplies,REF92531117,38.29,0.0,423390.16
2023-01-13,2023-01-13,Office supplies,REF37868803,56.15,0.0,423334.01
2023-01-14,2023-01-14,Business travel,REF41061368,96.13,0.0,423237.88
2023-01-15,2023-01-15,Project payment - Allen PLC,REF95354456,0.0,669.71,423907.59
2023-01-15,2023-01-15,Project payment - Lucas-Campos,REF86796181,0.0,1341.21,425248.8
2023-01-15,2023-01-15,Business insurance premium,REF69652451,92.93,0.0,425155.87
2023-01-16,2023-01-16,Professional services,REF39888297,216.63,0.0,424939.24
2023-01-18,2023-01-18,Marketing expenses,REF13456808,182.11,0.0,424757.13
2023-01-20,2023-01-20,Internet and phone service,REF88095758,81.17,0.0,424675.96
2023-01-22,2023-01-22,Office supplies,REF64366558,33.8,0.0,424642.16
2023-01-24,2023-01-24,Business travel,REF27979686,161.73,0.0,424480.43
2023-01-25,2023-01-25,Office supplies,REF26719731,53.65,0.0,424426.78
2023-01-27,2023-01-27,Equipment purchase,REF10398189,90.04,0.0,424336.74
2023-01-30,2023-01-30,Office supplies,REF84493072,34.89,0.0,424301.85
2023-01-30,2023-01-30,Marketing expenses,REF29830158,147.96,0.0,424153.89
2023-02-02,2023-02-02,Professional services,REF15522762,303.91,0.0,423849.98
2023-02-02,2023-02-02,Office supplies,REF92740159,24.58,0.0,423825.4
2023-02-04,2023-02-04,Internet and phone service,REF15533884,79.79,0.0,423745.61
2023-02-07,2023-02-07,Office supplies,REF41823042,36.51,0.0,423709.1
2023-02-09,2023-02-09,Software subscription,REF31339504,129.91,0.0,423579.19
2023-02-13,2023-02-13,Office supplies,REF36134524,55.4,0.0,423523.79
2023-02-15,2023-02-15,Business insurance premium,REF13958713,111.04,0.0,423412.75
2023-02-15,2023-02-15,Payment from Allen PLC,REF81759129,0.0,843.68,424256.43
2023-02-15,2023-02-15,Payment from Mendez-Tyler,REF32353291,0.0,1304.15,425560.58
2023-02-15,2023-02-15,Equipment purchase,REF77386099,76.88,0.0,425483.7
2023-02-15,2023-02-15,Payment from Lucas-Campos,REF83204110,0.0,2432.52,427916.22
2023-02-19,2023-02-19,Office supplies,REF92454434,31.07,0.0,427885.15
2023-02-20,2023-02-20,Marketing expenses,REF57959721,198.39,0.0,427686.76
2023-02-21,2023-02-21,Office supplies,REF26460032,47.8,0.0,427638.96
2023-02-25,2023-02-25,Business travel,REF95568203,131.54,0.0,427507.42
2023-02-28,2023-02-28,Equipment purchase,REF82379927,93.5,0.0,427413.92
2023-03-09,2023-03-09,Training/conference,REF40857278,124.4,0.0,427289.52
2023-03-09,2023-03-09,Software subscription,REF27464874,158.81,0.0,427130.71
2023-03-11,2023-03-11,Office supplies,REF49839123,65.23,0.0,427065.48
2023-03-12,2023-03-12,Marketing expenses,REF14827967,318.83,0.0,426746.65
2023-03-15,2023-03-15,Business insurance premium,REF83876408,135.16,0.0,426611.49
2023-03-15,2023-03-15,Project payment - Allen PLC,REF88241836,0.0,1590.06,428201.55
2023-03-15,2023-03-15,Payment from Mendez-Tyler,REF24561874,0.0,2120.64,430322.19
2023-03-15,2023-03-15,Payment from Lucas-Campos,REF99159800,0.0,1639.75,431961.94
2023-03-23,2023-03-23,Office supplies,REF55893008,59.2,0.0,431902.74
2023-03-26,2023-03-26,Office supplies,REF64346964,45.31,0.0,431857.43
2023-03-30,2023-03-30,Marketing expenses,REF41061155,310.65,0.0,431546.78
2023-04-05,2023-04-05,Equipment purchase,REF39203467,79.38,0.0,431467.4
2023-04-09,2023-04-09,Software subscription,REF29493839,139.74,0.0,431327.66
2023-04-10,2023-04-10,Office supplies,REF22555170,65.91,0.0,431261.75
2023-04-12,2023-04-12,Business travel,REF56889060,187.83,0.0,431073.92
2023-04-14,2023-04-14,Office supplies,REF69296315,43.6,0.0,431030.32
2023-04-15,2023-04-15,Internet and phone service,REF95742045,103.55,0.0,430926.77
2023-04-15,2023-04-15,Business insurance premium,REF19286143,114.15,0.0,430812.62
2023-04-15,2023-04-15,Project payment - Allen PLC,REF30873782,0.0,1447.97,432260.59
2023-04-15,2023-04-15,Project payment - Mendez-Tyler,REF96268385,0.0,1633.92,433894.51
2023-04-25,2023-04-25,Office supplies,REF51925558,80.58,0.0,433813.93
2023-05-09,2023-05-09,Software subscription,REF92471359,141.06,0.0,433672.87
2023-05-13,2023-05-13,Office supplies,REF89974182,62.66,0.0,433610.21
2023-05-14,2023-05-14,Marketing expenses,REF88854338,176.95,0.0,433433.26
2023-05-15,2023-05-15,Service payment - Allen PLC,REF55200612,0.0,1267.96,434701.22
2023-05-15,2023-05-15,Project payment - Lucas-Campos,REF26305012,0.0,1764.35,436465.57
2023-05-15,2023-05-15,Business insurance premium,REF44069188,119.38,0.0,436346.19
2023-05-15,2023-05-15,Office supplies,REF95257955,72.93,0.0,436273.26
2023-05-21,2023-05-21,Marketing expenses,REF17335713,182.02,0.0,436091.24
2023-05-24,2023-05-24,Office supplies,REF70330025,52.11,0.0,436039.13
2023-05-25,2023-05-25,Office supplies,REF20165386,55.84,0.0,435983.29
2023-05-29,2023-05-29,Internet and phone service,REF18586244,101.98,0.0,435881.31
2023-05-30,2023-05-30,Equipment purchase,REF69820490,47.82,0.0,435833.49
2023-05-30,2023-05-30,Office supplies,REF66612976,31.77,0.0,435801.72
2023-06-04,2023-06-04,Equipment purchase,REF91799593,120.46,0.0,435681.26
2023-06-04,2023-06-04,Professional services,REF62963707,276.83,0.0,435404.43
2023-06-08,2023-06-08,Training/conference,REF16745360,102.63,0.0,435301.8
2023-06-09,2023-06-09,Software subscription,REF83878912,124.79,0.0,435177.01
2023-06-13,2023-06-13,Business travel,REF99640064,158.08,0.0,435018.93
2023-06-15,2023-06-15,Payment from Allen PLC,REF67284281,0.0,1039.53,436058.46
2023-06-15,2023-06-15,Payment from Mendez-Tyler,REF17692001,0.0,1535.0,437593.46
2023-06-15,2023-06-15,Business insurance premium,REF94187558,116.28,0.0,437477.18
2023-06-20,2023-06-20,Business travel,REF74128102,95.91,0.0,437381.27
2023-06-24,2023-06-24,Office supplies,REF81790068,45.04,0.0,437336.23
2023-06-28,2023-06-28,Office supplies,REF12227831,33.53,0.0,437302.7
2023-07-07,2023-07-07,Marketing expenses,REF51818504,157.69,0.0,437145.01
2023-07-07,2023-07-07,Internet and phone service,REF68467256,76.91,0.0,437068.1
2023-07-08,2023-07-08,Internet and phone service,REF15984686,48.02,0.0,437020.08
2023-07-09,2023-07-09,Professional services,REF37324403,255.3,0.0,436764.78
2023-07-09,2023-07-09,Software subscription,REF69881006,122.05,0.0,436642.73
2023-07-10,2023-07-10,Professional services,REF57566151,296.6,0.0,436346.13
2023-07-11,2023-07-11,Professional services,REF74924215,272.45,0.0,436073.68
2023-07-13,2023-07-13,Office supplies,REF80421385,38.15,0.0,436035.53
2023-07-15,2023-07-15,Invoice payment - Allen PLC,REF64147034,0.0,807.85,436843.38
2023-07-15,2023-07-15,Project payment - Lucas-Campos,REF29977007,0.0,1405.69,438249.07
2023-07-15,2023-07-15,Business insurance premium,REF90279400,87.14,0.0,438161.93
2023-07-18,2023-07-18,Equipment purchase,REF35758711,78.25,0.0,438083.68
2023-07-21,2023-07-21,Business travel,REF53600574,93.56,0.0,437990.12
2023-07-22,2023-07-22,Professional services,REF20415071,258.89,0.0,437731.23
2023-08-01,2023-08-01,Business travel,REF61470347,97.26,0.0,437633.97
2023-08-02,2023-08-02,Equipment purchase,REF97198855,78.99,0.0,437554.98
2023-08-07,2023-08-07,Business travel,REF28279817,69.37,0.0,437485.61
2023-08-09,2023-08-09,Software subscription,REF89320033,97.79,0.0,437387.82
2023-08-12,2023-08-12,Office supplies,REF44770801,47.36,0.0,437340.46
2023-08-14,2023-08-14,Internet and phone service,REF21733033,67.51,0.0,437272.95
2023-08-15,2023-08-15,Service payment - Lucas-Campos,REF70353854,0.0,1004.4,438277.35
2023-08-15,2023-08-15,Business insurance premium,REF77525838,80.05,0.0,438197.3
2023-08-22,2023-08-22,Office supplies,REF41011019,35.99,0.0,438161.31
2023-08-25,2023-08-25,Professional services,REF43775903,162.69,0.0,437998.62
2023-08-27,2023-08-27,Marketing expenses,REF62925295,137.26,0.0,437861.36
2023-08-28,2023-08-28,Marketing expenses,REF74131107,143.14,0.0,437718.22
2023-08-28,2023-08-28,Office supplies,REF27192717,33.53,0.0,437684.69
2023-09-01,2023-09-01,Training/conference,REF74698306,95.21,0.0,437589.48
2023-09-07,2023-09-07,Office supplies,REF52443590,56.18,0.0,437533.3
2023-09-09,2023-09-09,Software subscription,REF34858047,168.43,0.0,437364.87
2023-09-11,2023-09-11,Business travel,REF43819734,149.7,0.0,437215.17
2023-09-13,2023-09-13,Business travel,REF82357118,129.04,0.0,437086.13
2023-09-15,2023-09-15,Office supplies,REF24185463,53.44,0.0,437032.69
2023-09-15,2023-09-15,Project payment - Allen PLC,REF94385271,0.0,1573.24,438605.93
2023-09-15,2023-09-15,Service payment - Mendez-Tyler,REF88176764,0.0,2210.88,440816.81
2023-09-15,2023-09-15,Business insurance premium,REF21836500,131.67,0.0,440685.14
2023-09-15,2023-09-15,Payment from Lucas-Campos,REF67953451,0.0,1949.89,442635.03
2023-09-25,2023-09-25,Internet and phone service,REF74475805,61.82,0.0,442573.21
2023-09-25,2023-09-25,Office supplies,REF42108014,37.58,0.0,442535.63
2023-09-28,2023-09-28,Office supplies,REF58040662,66.56,0.0,442469.07
2023-10-02,2023-10-02,Business travel,REF32723356,215.63,0.0,442253.44
2023-10-02,2023-10-02,Office supplies,REF92372401,70.98,0.0,442182.46
2023-10-05,2023-10-05,Office supplies,REF12840427,59.08,0.0,442123.38
2023-10-06,2023-10-06,Marketing expenses,REF10413892,327.2,0.0,441796.18
2023-10-09,2023-10-09,Software subscription,REF61616221,157.95,0.0,441638.23
2023-10-09,2023-10-09,Office supplies,REF15539873,45.32,0.0,441592.91
2023-10-15,2023-10-15,Business insurance premium,REF46586646,137.74,0.0,441455.17
2023-10-15,2023-10-15,Office supplies,REF23993188,84.02,0.0,441371.15
2023-10-15,2023-10-15,Project payment - Allen PLC,REF24880048,0.0,1298.86,442670.01
2023-10-15,2023-10-15,Project payment - Mendez-Tyler,REF99561632,0.0,2491.94,445161.95
2023-10-15,2023-10-15,Service payment - Lucas-Campos,REF82950874,0.0,1561.62,446723.57
2023-10-18,2023-10-18,Office supplies,REF73833639,85.81,0.0,446637.76
2023-10-26,2023-10-26,Office supplies,REF99291921,78.24,0.0,446559.52
2023-10-28,2023-10-28,Office supplies,REF84397271,53.23,0.0,446506.29
2023-10-30,2023-10-30,Professional services,REF34577281,298.82,0.0,446207.47
2023-10-31,2023-10-31,Business travel,REF14752331,178.66,0.0,446028.81
2023-11-01,2023-11-01,Office supplies,REF93158661,65.98,0.0,445962.83
2023-11-02,2023-11-02,Equipment purchase,REF43854863,102.27,0.0,445860.56
2023-11-06,2023-11-06,Marketing expenses,REF38930222,295.41,0.0,445565.15
2023-11-09,2023-11-09,Software subscription,REF66224767,164.05,0.0,445401.1
2023-11-10,2023-11-10,Business travel,REF83234827,162.91,0.0,445238.19
2023-11-14,2023-11-14,Office supplies,REF91376116,95.04,0.0,445143.15
2023-11-15,2023-11-15,Invoice payment - Mendez-Tyler,REF31452778,0.0,1737.6,446880.75
2023-11-15,2023-11-15,Business insurance premium,REF74442229,146.27,0.0,446734.48
2023-11-15,2023-11-15,Project payment - Lucas-Campos,REF36029140,0.0,2054.85,448789.33
2023-11-15,2023-11-15,Service payment - Allen PLC,REF94677587,0.0,1214.44,450003.77
2023-11-17,2023-11-17,Professional services,REF48215990,300.17,0.0,449703.6
2023-11-17,2023-11-17,Business travel,REF16018707,186.86,0.0,449516.74
2023-11-21,2023-11-21,Office supplies,REF76247120,37.39,0.0,449479.35
2023-11-25,2023-11-25,Business travel,REF77138255,150.78,0.0,449328.57
2023-12-01,2023-12-01,Office supplies,REF49412809,39.01,0.0,449289.56
2023-12-02,2023-12-02,Office supplies,REF40028925,25.98,0.0,449263.58
2023-12-09,2023-12-09,Software subscription,REF24177822,154.05,0.0,449109.53
2023-12-09,2023-12-09,Equipment purchase,REF64718641,109.78,0.0,448999.75
2023-12-09,2023-12-09,Office supplies,REF91778256,39.73,0.0,448960.02
2023-12-13,2023-12-13,Business travel,REF99376085,151.6,0.0,448808.42
2023-12-15,2023-12-15,Payment from Mendez-Tyler,REF42156071,0.0,1484.68,450293.1
2023-12-15,2023-12-15,Project payment - Allen PLC,REF39502573,0.0,1049.78,451342.88
2023-12-15,2023-12-15,Payment from Lucas-Campos,REF40470102,0.0,1285.7,452628.58
2023-12-15,2023-12-15,Business insurance premium,REF84656670,110.84,0.0,452517.74
2023-12-24,2023-12-24,Business travel,REF65099841,162.76,0.0,452354.98
2023-12-29,2023-12-29,Equipment purchase,REF96044944,59.68,0.0,452295.3
2024-01-07,2024-01-07,Business travel,REF59372802,158.72,0.0,452136.58
2024-01-09,2024-01-09,Software subscription,REF63905610,107.76,0.0,452028.82
2024-01-11,2024-01-11,Internet and phone service,REF57828598,60.95,0.0,451967.87
2024-01-13,2024-01-13,Office supplies,REF64715138,24.28,0.0,451943.59
2024-01-15,2024-01-15,Business insurance premium,REF17354873,94.33,0.0,451849.26
2024-01-15,2024-01-15,Service payment - Allen PLC,REF76261408,0.0,1086.26,452935.52
2024-01-15,2024-01-15,Invoice payment - Mendez-Tyler,REF37228666,0.0,1751.04,454686.56
2024-01-15,2024-01-15,Invoice payment - Lucas-Campos,REF30867627,0.0,1650.6,456337.16
2024-01-15,2024-01-15,Business travel,REF28291549,134.32,0.0,456202.84
2024-01-18,2024-01-18,Business travel,REF48800924,131.51,0.0,456071.33
2024-01-24,2024-01-24,Office supplies,REF40255572,55.32,0.0,456016.01
2024-01-25,2024-01-25,Professional services,REF47523014,218.23,0.0,455797.78
2024-01-26,2024-01-26,Professional services,REF88961507,361.57,0.0,455436.21
2024-01-26,2024-01-26,Office supplies,REF31361828,45.71,0.0,455390.5
2024-01-27,2024-01-27,Training/conference,REF72013918,132.21,0.0,455258.29
2024-01-27,2024-01-27,Office supplies,REF66531984,42.39,0.0,455215.9
2024-01-31,2024-01-31,Business travel,REF16995460,184.2,0.0,455031.7
2024-02-02,2024-02-02,Equipment purchase,REF61603683,93.07,0.0,454938.63
2024-02-02,2024-02-02,Business travel,REF21951964,66.15,0.0,454872.48
2024-02-03,2024-02-03,Marketing expenses,REF92318701,146.49,0.0,454725.99
2024-02-04,2024-02-04,Office supplies,REF79310464,69.97,0.0,454656.02
2024-02-05,2024-02-05,Professional services,REF15456232,204.53,0.0,454451.49
2024-02-07,2024-02-07,Office supplies,REF16067649,61.47,0.0,454390.02
2024-02-09,2024-02-09,Software subscription,REF31306460,123.47,0.0,454266.55
2024-02-11,2024-02-11,Office supplies,REF14115246,74.79,0.0,454191.76
2024-02-15,2024-02-15,Service payment - Lucas-Campos,REF27305441,0.0,1219.55,455411.31
2024-02-15,2024-02-15,Business insurance premium,REF98058007,113.82,0.0,455297.49
2024-02-15,2024-02-15,Payment from Mendez-Tyler,REF86015966,0.0,1388.3,456685.79
2024-02-15,2024-02-15,Payment from Allen PLC,REF62063698,0.0,932.04,457617.83
2024-02-18,2024-02-18,Marketing expenses,REF24725267,198.12,0.0,457419.71
2024-02-19,2024-02-19,Office supplies,REF83652498,27.34,0.0,457392.37
2024-02-29,2024-02-29,Office supplies,REF88871653,45.62,0.0,457346.75
2024-03-08,2024-03-08,Marketing expenses,REF18901945,223.57,0.0,457123.18
2024-03-09,2024-03-09,Internet and phone service,REF58583974,108.62,0.0,457014.56
2024-03-09,2024-03-09,Software subscription,REF93269519,151.13,0.0,456863.43
2024-03-14,2024-03-14,Office supplies,REF49094793,51.89,0.0,456811.54
2024-03-15,2024-03-15,Business insurance premium,REF31358111,136.12,0.0,456675.42
2024-03-15,2024-03-15,Project payment - Allen PLC,REF13862459,0.0,1461.97,458137.39
2024-03-15,2024-03-15,Project payment - Lucas-Campos,REF35401838,0.0,1764.43,459901.82
2024-03-18,2024-03-18,Office supplies,REF18873535,28.91,0.0,459872.91
2024-03-20,2024-03-20,Office supplies,REF78452540,61.16,0.0,459811.75
2024-03-20,2024-03-20,Business travel,REF20113664,203.56,0.0,459608.19
2024-03-23,2024-03-23,Office supplies,REF13408789,50.37,0.0,459557.82
2024-03-25,2024-03-25,Office supplies,REF79476580,64.7,0.0,459493.12
2024-03-29,2024-03-29,Training/conference,REF86572342,145.76,0.0,459347.36
2024-03-30,2024-03-30,Business travel,REF87498134,192.15,0.0,459155.21
2024-03-31,2024-03-31,Office supplies,REF11252464,73.51,0.0,459081.7
2024-04-06,2024-04-06,Professional services,REF15411358,133.81,0.0,458947.89
2024-04-08,2024-04-08,Office supplies,REF52965060,48.2,0.0,458899.69
2024-04-09,2024-04-09,Internet and phone service,REF61221945,89.1,0.0,458810.59
2024-04-09,2024-04-09,Software subscription,REF91605375,165.32,0.0,458645.27
2024-04-15,2024-04-15,Invoice payment - Mendez-Tyler,REF55494144,0.0,1803.2,460448.47
2024-04-15,2024-04-15,Payment from Lucas-Campos,REF77702801,0.0,1703.01,462151.48
2024-04-15,2024-04-15,Project payment - Allen PLC,REF25019785,0.0,1487.33,463638.81
2024-04-15,2024-04-15,Business insurance premium,REF36481097,115.6,0.0,463523.21
2024-04-26,2024-04-26,Marketing expenses,REF75923777,60.75,0.0,463462.46
2024-04-30,2024-04-30,Marketing expenses,REF86237897,205.92,0.0,463256.54
2024-05-05,2024-05-05,Business travel,REF43696567,112.63,0.0,463143.91
2024-05-09,2024-05-09,Software subscription,REF37438842,162.6,0.0,462981.31
2024-05-11,2024-05-11,Equipment purchase,REF39502390,117.05,0.0,462864.26
2024-05-13,2024-05-13,Office supplies,REF84534750,70.38,0.0,462793.88
2024-05-14,2024-05-14,Office supplies,REF49272728,86.54,0.0,462707.34
2024-05-15,2024-05-15,Business insurance premium,REF93895616,121.51,0.0,462585.83
2024-05-15,2024-05-15,Payment from Mendez-Tyler,REF66068026,0.0,1586.59,464172.42
2024-05-15,2024-05-15,Service payment - Lucas-Campos,REF15854812,0.0,2097.95,466270.37
2024-05-24,2024-05-24,Equipment purchase,REF49333298,67.54,0.0,466202.83
2024-05-24,2024-05-24,Marketing expenses,REF83321183,215.88,0.0,465986.95
2024-05-26,2024-05-26,Marketing expenses,REF31479216,162.39,0.0,465824.56
2024-06-01,2024-06-01,Office supplies,REF51780557,62.02,0.0,465762.54
2024-06-09,2024-06-09,Software subscription,REF98839041,135.67,0.0,465626.87
2024-06-09,2024-06-09,Professional services,REF44648736,309.65,0.0,465317.22
2024-06-10,2024-06-10,Business travel,REF76703506,63.59,0.0,465253.63
2024-06-15,2024-06-15,Business insurance premium,REF87132272,109.97,0.0,465143.66
2024-06-15,2024-06-15,Payment from Mendez-Tyler,REF33412187,0.0,1876.28,467019.94
2024-06-15,2024-06-15,Project payment - Allen PLC,REF82829006,0.0,1107.25,468127.19
2024-06-15,2024-06-15,Service payment - Lucas-Campos,REF39699910,0.0,1603.93,469731.12
2024-06-16,2024-06-16,Equipment purchase,REF44032037,65.52,0.0,469665.6
2024-06-24,2024-06-24,Equipment purchase,REF88626137,65.0,0.0,469600.6
2024-06-27,2024-06-27,Business travel,REF40667372,121.38,0.0,469479.22
2024-07-03,2024-07-03,Training/conference,REF35221278,124.23,0.0,469354.99
2024-07-04,2024-07-04,Business travel,REF38908026,149.03,0.0,469205.96
2024-07-09,2024-07-09,Professional services,REF90435480,309.88,0.0,468896.08
2024-07-09,2024-07-09,Software subscription,REF88634129,117.73,0.0,468778.35
2024-07-10,2024-07-10,Equipment purchase,REF78417036,82.43,0.0,468695.92
2024-07-11,2024-07-11,Marketing expenses,REF37152175,104.73,0.0,468591.19
2024-07-12,2024-07-12,Business travel,REF70159123,179.47,0.0,468411.72
2024-07-14,2024-07-14,Office supplies,REF17822886,32.9,0.0,468378.82
2024-07-14,2024-07-14,Equipment purchase,REF91912524,92.36,0.0,468286.46
2024-07-15,2024-07-15,Payment from Allen PLC,REF22096308,0.0,957.42,469243.88
2024-07-15,2024-07-15,Service payment - Lucas-Campos,REF37047614,0.0,1528.96,470772.84
2024-07-15,2024-07-15,Business insurance premium,REF84631304,95.13,0.0,470677.71
2024-07-18,2024-07-18,Professional services,REF32264120,198.84,0.0,470478.87
2024-07-20,2024-07-20,Equipment purchase,REF88415730,96.53,0.0,470382.34
2024-07-26,2024-07-26,Office supplies,REF13971234,47.56,0.0,470334.78
2024-07-28,2024-07-28,Marketing expenses,REF66758210,142.81,0.0,470191.97
2024-07-28,2024-07-28,Internet and phone service,REF45083825,74.72,0.0,470117.25
2024-07-29,2024-07-29,Office supplies,REF25455988,53.49,0.0,470063.76
2024-07-29,2024-07-29,Professional services,REF91580278,206.17,0.0,469857.59
2024-08-01,2024-08-01,Office supplies,REF76641226,31.65,0.0,469825.94
2024-08-05,2024-08-05,Office supplies,REF79254645,40.16,0.0,469785.78
2024-08-06,2024-08-06,Equipment purchase,REF69713438,39.36,0.0,469746.42
2024-08-08,2024-08-08,Professional services,REF63562151,23.01,0.0,469723.41
2024-08-09,2024-08-09,Software subscription,REF27697350,94.88,0.0,469628.53
2024-08-11,2024-08-11,Equipment purchase,REF83262428,70.25,0.0,469558.28
2024-08-12,2024-08-12,Office supplies,REF71961949,26.95,0.0,469531.33
2024-08-15,2024-08-15,Payment from Mendez-Tyler,REF34885567,0.0,984.8,470516.13
2024-08-15,2024-08-15,Service payment - Allen PLC,REF39863225,0.0,843.1,471359.23
2024-08-15,2024-08-15,Business insurance premium,REF44874394,76.61,0.0,471282.62
2024-08-15,2024-08-15,Project payment - Lucas-Campos,REF12059101,0.0,1392.4,472675.02
2012-08-26,2012-08-26,Business travel,REF32058951,97.16,0.0,5337.83
2012-08-29,2012-08-29,Office supplies,REF15391499,23.68,0.0,5314.15
2012-09-04,2012-09-04,Office supplies,REF68482678,58.5,0.0,5255.65
2012-09-08,2012-09-08,Office supplies,REF14917151,40.22,0.0,5215.43
2012-09-09,2012-09-09,Software subscription,REF18414030,177.12,0.0,5038.31
2012-09-11,2012-09-11,Business travel,REF30532764,162.05,0.0,4876.26
2012-09-12,2012-09-12,Business travel,REF47037957,166.49,0.0,4709.77
2012-09-12,2012-09-12,Internet and phone service,REF61396527,94.7,0.0,4615.07
2012-09-14,2012-09-14,Office supplies,REF55952782,53.54,0.0,4561.53
2012-09-15,2012-09-15,Business insurance premium,REF99309329,130.69,0.0,4430.84
2012-09-15,2012-09-15,"Project payment - Patrick, Franklin and Martinez",REF11348508,0.0,2092.2,6523.04
2012-09-15,2012-09-15,"Payment from Hill, Adams and King",REF51299054,0.0,1240.7,7763.74
2012-09-15,2012-09-15,Service payment - Morgan-Foster,REF52394860,0.0,1130.21,8893.95
2012-09-17,2012-09-17,Office supplies,REF71027200,80.48,0.0,8813.47
2012-09-21,2012-09-21,Business travel,REF30543578,156.36,0.0,8657.11
2012-09-26,2012-09-26,Professional services,REF35051732,312.43,0.0,8344.68
2012-09-26,2012-09-26,Business travel,REF92552604,131.38,0.0,8213.3
2012-09-30,2012-09-30,Office supplies,REF16093954,79.39,0.0,8133.91
2012-10-02,2012-10-02,Marketing expenses,REF79136140,152.78,0.0,7981.13
2012-10-04,2012-10-04,Marketing expenses,REF91190240,324.15,0.0,7656.98
2012-10-06,2012-10-06,Internet and phone service,REF78190916,95.63,0.0,7561.35
2012-10-07,2012-10-07,Office supplies,REF12888998,74.82,0.0,7486.53
2012-10-09,2012-10-09,Software subscription,REF92405971,170.29,0.0,7316.24
2012-10-11,2012-10-11,Office supplies,REF59229860,27.74,0.0,7288.5
2012-10-14,2012-10-14,Business travel,REF56905157,175.21,0.0,7113.29
2012-10-15,2012-10-15,Service payment - Morgan-Foster,REF52525640,0.0,1226.48,8339.77
2012-10-15,2012-10-15,"Payment from Hill, Adams and King",REF23857922,0.0,1129.52,9469.29
2012-10-15,2012-10-15,"Payment from Patrick, Franklin and Martinez",REF59126407,0.0,2051.65,11520.94
2012-10-15,2012-10-15,Business insurance premium,REF85998016,144.41,0.0,11376.53
2012-10-16,2012-10-16,Equipment purchase,REF35862017,186.38,0.0,11190.15
2012-10-24,2012-10-24,Business travel,REF71962174,171.77,0.0,11018.38
2012-10-26,2012-10-26,Office supplies,REF82228318,74.32,0.0,10944.06
2012-11-03,2012-11-03,Office supplies,REF42280975,48.1,0.0,10895.96
2012-11-09,2012-11-09,Software subscription,REF76472289,145.68,0.0,10750.28
2012-11-13,2012-11-13,Marketing expenses,REF19067296,116.74,0.0,10633.54
2012-11-13,2012-11-13,Training/conference,REF45045844,136.04,0.0,10497.5
2012-11-15,2012-11-15,Business insurance premium,REF73857344,134.9,0.0,10362.6
2012-11-15,2012-11-15,"Service payment - Hill, Adams and King",REF80207402,0.0,954.8,11317.4
2012-11-15,2012-11-15,Invoice payment - Morgan-Foster,REF70540618,0.0,1548.62,12866.02
2012-11-22,2012-11-22,Office supplies,REF42638068,36.82,0.0,12829.2
2012-12-06,2012-12-06,Office supplies,REF69690949,53.05,0.0,12776.15
2012-12-07,2012-12-07,Marketing expenses,REF84552988,114.09,0.0,12662.06
2012-12-09,2012-12-09,Software subscription,REF94761543,156.94,0.0,12505.12
2012-12-12,2012-12-12,Office supplies,REF75747419,53.44,0.0,12451.68
2012-12-13,2012-12-13,Office supplies,REF59173086,46.8,0.0,12404.88
2012-12-15,2012-12-15,Business insurance premium,REF20938510,103.07,0.0,12301.81
2012-12-15,2012-12-15,"Invoice payment - Hill, Adams and King",REF89066339,0.0,928.08,13229.89
2012-12-15,2012-12-15,"Payment from Patrick, Franklin and Martinez",REF21016796,0.0,1267.37,14497.26
2012-12-15,2012-12-15,Marketing expenses,REF14675009,168.39,0.0,14328.87
2012-12-15,2012-12-15,Payment from Morgan-Foster,REF96543344,0.0,1065.48,15394.35
2012-12-18,2012-12-18,Office supplies,REF84946190,41.84,0.0,15352.51
2012-12-21,2012-12-21,Internet and phone service,REF88461789,67.83,0.0,15284.68
2012-12-23,2012-12-23,Marketing expenses,REF77153195,220.13,0.0,15064.55
2012-12-24,2012-12-24,Professional services,REF97644829,304.44,0.0,14760.11
2012-12-26,2012-12-26,Training/conference,REF49430567,122.77,0.0,14637.34
2012-12-30,2012-12-30,Office supplies,REF47509722,44.19,0.0,14593.15
2013-01-07,2013-01-07,Professional services,REF69475983,156.52,0.0,14436.63
2013-01-08,2013-01-08,Office supplies,REF57068429,41.84,0.0,14394.79
2013-01-09,2013-01-09,Software subscription,REF49165538,110.29,0.0,14284.5
2013-01-11,2013-01-11,Training/conference,REF34397264,89.43,0.0,14195.07
2013-01-13,2013-01-13,Training/conference,REF67275767,54.57,0.0,14140.5
2013-01-15,2013-01-15,Business insurance premium,REF50640265,90.65,0.0,14049.85
2013-01-15,2013-01-15,Payment from Morgan-Foster,REF93060827,0.0,830.91,14880.76
2013-01-15,2013-01-15,"Payment from Hill, Adams and King",REF68136742,0.0,847.23,15727.99
2013-01-15,2013-01-15,"Invoice payment - Patrick, Franklin and Martinez",REF88105537,0.0,1291.18,17019.17
2013-01-19,2013-01-19,Internet and phone service,REF33773882,70.6,0.0,16948.57
2013-01-19,2013-01-19,Professional services,REF34927686,122.12,0.0,16826.45
2013-01-23,2013-01-23,Business travel,REF92825208,87.48,0.0,16738.97
2013-01-24,2013-01-24,Internet and phone service,REF18254970,74.62,0.0,16664.35
2013-01-29,2013-01-29,Office supplies,REF99085019,49.08,0.0,16615.27
2013-02-05,2013-02-05,Equipment purchase,REF25343138,39.23,0.0,16576.04
2013-02-09,2013-02-09,Software subscription,REF79881155,131.34,0.0,16444.7
2013-02-11,2013-02-11,Marketing expenses,REF71286559,148.02,0.0,16296.68
2013-02-13,2013-02-13,Equipment purchase,REF75183765,112.89,0.0,16183.79
2013-02-13,2013-02-13,Office supplies,REF59363454,62.65,0.0,16121.14
2013-02-15,2013-02-15,Business travel,REF52685727,100.27,0.0,16020.87
2013-02-15,2013-02-15,"Project payment - Patrick, Franklin and Martinez",REF19755418,0.0,1705.77,17726.64
2013-02-15,2013-02-15,Invoice payment - Morgan-Foster,REF62501054,0.0,875.38,18602.02
2013-02-15,2013-02-15,"Project payment - Hill, Adams and King",REF89822239,0.0,869.85,19471.87
2013-02-15,2013-02-15,Business insurance premium,REF29867404,103.93,0.0,19367.94
2013-02-19,2013-02-19,Internet and phone service,REF75298349,72.25,0.0,19295.69
2013-02-20,2013-02-20,Office supplies,REF19533445,28.38,0.0,19267.31
2013-02-26,2013-02-26,Marketing expenses,REF16126204,105.36,0.0,19161.95
2013-03-05,2013-03-05,Business travel,REF96428024,109.37,0.0,19052.58
2013-03-09,2013-03-09,Marketing expenses,REF45956410,158.93,0.0,18893.65
2013-03-09,2013-03-09,Software subscription,REF76270138,135.93,0.0,18757.72
2013-03-12,2013-03-12,Office supplies,REF92074077,59.52,0.0,18698.2
2013-03-15,2013-03-15,Business travel,REF21759148,165.8,0.0,18532.4
2013-03-15,2013-03-15,Project payment - Morgan-Foster,REF13949440,0.0,1297.56,19829.96
2013-03-15,2013-03-15,"Service payment - Patrick, Franklin and Martinez",REF45077020,0.0,1722.22,21552.18
2013-03-15,2013-03-15,Business insurance premium,REF92394712,129.86,0.0,21422.32
2013-03-15,2013-03-15,"Payment from Hill, Adams and King",REF54818356,0.0,1303.3,22725.62
2013-03-19,2013-03-19,Internet and phone service,REF18701026,114.71,0.0,22610.91
2013-03-19,2013-03-19,Business travel,REF76712649,244.69,0.0,22366.22
2013-03-21,2013-03-21,Internet and phone service,REF73509759,132.38,0.0,22233.84
2013-03-22,2013-03-22,Professional services,REF73155083,193.85,0.0,22039.99
2013-03-25,2013-03-25,Marketing expenses,REF99071688,285.6,0.0,21754.39
2013-03-26,2013-03-26,Equipment purchase,REF80985746,108.84,0.0,21645.55
2013-03-30,2013-03-30,Training/conference,REF43068012,86.66,0.0,21558.89
2013-04-02,2013-04-02,Office supplies,REF48750570,42.82,0.0,21516.07
2013-04-07,2013-04-07,Internet and phone service,REF42924478,59.38,0.0,21456.69
2013-04-07,2013-04-07,Professional services,REF53269233,303.62,0.0,21153.07
2013-04-07,2013-04-07,Training/conference,REF75978098,112.02,0.0,21041.05
2013-04-09,2013-04-09,Software subscription,REF48969395,150.39,0.0,20890.66
2013-04-11,2013-04-11,Office supplies,REF61955261,56.81,0.0,20833.85
2013-04-13,2013-04-13,Office supplies,REF85508539,53.32,0.0,20780.53
2013-04-15,2013-04-15,Business insurance premium,REF16617085,119.91,0.0,20660.62
2013-04-15,2013-04-15,"Service payment - Hill, Adams and King",REF28276189,0.0,1084.09,21744.71
2013-04-15,2013-04-15,Invoice payment - Morgan-Foster,REF71065314,0.0,882.24,22626.95
2013-04-15,2013-04-15,"Invoice payment - Patrick, Franklin and Martinez",REF97304157,0.0,1312.99,23939.94
2013-04-19,2013-04-19,Business travel,REF57257039,99.32,0.0,23840.62
2013-05-02,2013-05-02,Internet and phone service,REF95445730,108.87,0.0,23731.75
2013-05-07,2013-05-07,Office supplies,REF18526072,56.82,0.0,23674.93
2013-05-09,2013-05-09,Software subscription,REF72312689,149.72,0.0,23525.21
2013-05-15,2013-05-15,"Service payment - Hill, Adams and King",REF33767957,0.0,1091.06,24616.27
2013-05-15,2013-05-15,Project payment - Morgan-Foster,REF83269571,0.0,1155.35,25771.62
2013-05-15,2013-05-15,"Service payment - Patrick, Franklin and Martinez",REF70479233,0.0,1524.37,27295.99
2013-05-15,2013-05-15,Business insurance premium,REF36331776,116.69,0.0,27179.3
2013-05-19,2013-05-19,Training/conference,REF63398865,155.76,0.0,27023.54
2013-05-19,2013-05-19,Office supplies,REF15862556,51.33,0.0,26972.21
2013-05-20,2013-05-20,Business travel,REF23128518,91.14,0.0,26881.07
2013-05-23,2013-05-23,Internet and phone service,REF76352494,60.58,0.0,26820.49
2013-05-24,2013-05-24,Business travel,REF12122753,136.08,0.0,26684.41
2013-05-28,2013-05-28,Marketing expenses,REF70507086,188.33,0.0,26496.08
2013-06-01,2013-06-01,Office supplies,REF56552870,43.23,0.0,26452.85
2013-06-01,2013-06-01,Equipment purchase,REF46770857,126.12,0.0,26326.73
2013-06-03,2013-06-03,Internet and phone service,REF62229268,79.87,0.0,26246.86
2013-06-09,2013-06-09,Software subscription,REF19758919,127.46,0.0,26119.4
2013-06-11,2013-06-11,Internet and phone service,REF29687047,59.27,0.0,26060.13
2013-06-11,2013-06-11,Training/conference,REF29873505,89.23,0.0,25970.9
2013-06-15,2013-06-15,"Service payment - Hill, Adams and King",REF90169345,0.0,1135.55,27106.45
2013-06-15,2013-06-15,"Project payment - Patrick, Franklin and Martinez",REF94441660,0.0,1310.28,28416.73
2013-06-15,2013-06-15,Payment from Morgan-Foster,REF66553176,0.0,1341.3,29758.03
2013-06-15,2013-06-15,Business insurance premium,REF76717712,108.95,0.0,29649.08
2013-06-20,2013-06-20,Office supplies,REF80691962,50.54,0.0,29598.54
2013-06-27,2013-06-27,Office supplies,REF97193355,32.31,0.0,29566.23
2013-06-28,2013-06-28,Internet and phone service,REF23123358,59.06,0.0,29507.17
2013-07-02,2013-07-02,Office supplies,REF98787705,37.23,0.0,29469.94
2013-07-03,2013-07-03,Training/conference,REF26926211,75.25,0.0,29394.69
2013-07-03,2013-07-03,Office supplies,REF45066155,56.87,0.0,29337.82
2013-07-05,2013-07-05,Equipment purchase,REF57197599,74.18,0.0,29263.64
2013-07-08,2013-07-08,Professional services,REF46553079,321.04,0.0,28942.6
2013-07-09,2013-07-09,Software subscription,REF34282738,120.14,0.0,28822.46
2013-07-14,2013-07-14,Marketing expenses,REF77276278,203.65,0.0,28618.81
2013-07-15,2013-07-15,Business insurance premium,REF83798755,98.21,0.0,28520.6
2013-07-15,2013-07-15,Service payment - Morgan-Foster,REF89762297,0.0,1071.02,29591.62
2013-07-15,2013-07-15,"Invoice payment - Hill, Adams and King",REF88441063,0.0,879.57,30471.19
2013-07-15,2013-07-15,"Invoice payment - Patrick, Franklin and Martinez",REF72098065,0.0,1476.04,31947.23
2013-07-16,2013-07-16,Office supplies,REF66819233,34.13,0.0,31913.1
2013-07-19,2013-07-19,Office supplies,REF73335532,32.22,0.0,31880.88
2013-07-25,2013-07-25,Training/conference,REF10314198,63.88,0.0,31817.0
2013-07-28,2013-07-28,Office supplies,REF73248124,47.85,0.0,31769.15
2013-07-30,2013-07-30,Professional services,REF67744152,135.91,0.0,31633.24
2013-07-30,2013-07-30,Equipment purchase,REF20283860,71.65,0.0,31561.59
2013-08-04,2013-08-04,Business travel,REF65280553,70.34,0.0,31491.25
2013-08-09,2013-08-09,Office supplies,REF22994690,44.83,0.0,31446.42
2013-08-09,2013-08-09,Software subscription,REF16278433,97.83,0.0,31348.59
2013-08-11,2013-08-11,Professional services,REF85817381,154.72,0.0,31193.87
2013-08-12,2013-08-12,Office supplies,REF49936056,45.15,0.0,31148.72
2013-08-13,2013-08-13,Office supplies,REF97256893,49.06,0.0,31099.66
2013-08-14,2013-08-14,Professional services,REF18801485,225.03,0.0,30874.63
2013-08-14,2013-08-14,Office supplies,REF25170819,32.69,0.0,30841.94
2013-08-15,2013-08-15,Business insurance premium,REF21815648,83.78,0.0,30758.16
2013-08-15,2013-08-15,Service payment - Morgan-Foster,REF34831916,0.0,913.16,31671.32
2013-08-15,2013-08-15,"Payment from Hill, Adams and King",REF98275838,0.0,760.47,32431.79
2013-08-17,2013-08-17,Office supplies,REF43528653,41.23,0.0,32390.56
2013-08-19,2013-08-19,Business travel,REF38565452,112.63,0.0,32277.93
2013-08-24,2013-08-24,Marketing expenses,REF52694286,145.94,0.0,32131.99
2013-08-30,2013-08-30,Business travel,REF82072628,102.53,0.0,32029.46
2013-08-30,2013-08-30,Office supplies,REF15412246,21.9,0.0,32007.56
2013-09-05,2013-09-05,Training/conference,REF82473387,113.65,0.0,31893.91
2013-09-05,2013-09-05,Marketing expenses,REF21502716,251.86,0.0,31642.05
2013-09-05,2013-09-05,Professional services,REF61135996,342.38,0.0,31299.67
2013-09-07,2013-09-07,Business travel,REF91876423,133.57,0.0,31166.1
2013-09-09,2013-09-09,Software subscription,REF88237825,164.18,0.0,31001.92
2013-09-15,2013-09-15,Business insurance premium,REF70770141,133.45,0.0,30868.47
2013-09-15,2013-09-15,"Payment from Patrick, Franklin and Martinez",REF32034102,0.0,2000.49,32868.96
2013-09-15,2013-09-15,Project payment - Morgan-Foster,REF16311475,0.0,1799.62,34668.58
2013-09-15,2013-09-15,"Payment from Hill, Adams and King",REF92285872,0.0,1082.58,35751.16
2013-09-16,2013-09-16,Internet and phone service,REF58860358,45.86,0.0,35705.3
2013-09-22,2013-09-22,Training/conference,REF18861232,105.13,0.0,35600.17
2013-09-24,2013-09-24,Internet and phone service,REF26981185,99.43,0.0,35500.74
2013-09-29,2013-09-29,Training/conference,REF76449379,98.86,0.0,35401.88
2013-10-02,2013-10-02,Training/conference,REF42656571,78.5,0.0,35323.38
2013-10-02,2013-10-02,Internet and phone service,REF66477688,49.89,0.0,35273.49
2013-10-03,2013-10-03,Marketing expenses,REF16035038,311.44,0.0,34962.05
2013-10-06,2013-10-06,Office supplies,REF95708617,21.03,0.0,34941.02
2013-10-09,2013-10-09,Software subscription,REF35434772,176.74,0.0,34764.28
2013-10-13,2013-10-13,Business travel,REF56420912,134.55,0.0,34629.73
2013-10-15,2013-10-15,"Invoice payment - Patrick, Franklin and Martinez",REF90333238,0.0,2031.72,36661.45
2013-10-15,2013-10-15,Business insurance premium,REF12345749,150.1,0.0,36511.35
2013-10-15,2013-10-15,"Project payment - Hill, Adams and King",REF89557762,0.0,1313.62,37824.97
2013-10-16,2013-10-16,Business travel,REF92740076,254.96,0.0,37570.01
2013-10-25,2013-10-25,Equipment purchase,REF44440414,51.17,0.0,37518.84
2013-10-28,2013-10-28,Equipment purchase,REF42404337,131.64,0.0,37387.2
2013-11-01,2013-11-01,Office supplies,REF27246475,59.6,0.0,37327.6
2013-11-01,2013-11-01,Marketing expenses,REF67750601,190.41,0.0,37137.19
2013-11-05,2013-11-05,Professional services,REF60677700,387.62,0.0,36749.57
2013-11-06,2013-11-06,Training/conference,REF45531358,113.2,0.0,36636.37
2013-11-08,2013-11-08,Marketing expenses,REF40435104,316.83,0.0,36319.54
2013-11-09,2013-11-09,Software subscription,REF27918024,168.92,0.0,36150.62
2013-11-10,2013-11-10,Business travel,REF51613524,200.97,0.0,35949.65
2013-11-11,2013-11-11,Office supplies,REF96804327,72.81,0.0,35876.84
2013-11-12,2013-11-12,Internet and phone service,REF91686359,81.13,0.0,35795.71
2013-11-12,2013-11-12,Office supplies,REF96689712,59.43,0.0,35736.28
2013-11-15,2013-11-15,"Invoice payment - Hill, Adams and King",REF88835066,0.0,1151.52,36887.8
2013-11-15,2013-11-15,Invoice payment - Morgan-Foster,REF81612785,0.0,1124.83,38012.63
2013-11-15,2013-11-15,"Invoice payment - Patrick, Franklin and Martinez",REF58288511,0.0,2432.57,40445.2
2013-11-15,2013-11-15,Business insurance premium,REF34717353,124.79,0.0,40320.41
2013-11-21,2013-11-21,Office supplies,REF49436096,75.21,0.0,40245.2
2013-11-24,2013-11-24,Business travel,REF87886610,149.0,0.0,40096.2
2013-12-02,2013-12-02,Training/conference,REF75478309,74.57,0.0,40021.63
2013-12-03,2013-12-03,Equipment purchase,REF20036117,80.37,0.0,39941.26
2013-12-07,2013-12-07,Office supplies,REF50422168,35.85,0.0,39905.41
2013-12-09,2013-12-09,Software subscription,REF98529629,121.38,0.0,39784.03
2013-12-11,2013-12-11,Office supplies,REF42556742,37.81,0.0,39746.22
2013-12-11,2013-12-11,Professional services,REF85868576,296.52,0.0,39449.7
2013-12-15,2013-12-15,"Payment from Hill, Adams and King",REF97712942,0.0,958.21,40407.91
2013-12-15,2013-12-15,"Service payment - Patrick, Franklin and Martinez",REF38673073,0.0,1582.6,41990.51
2013-12-15,2013-12-15,Invoice payment - Morgan-Foster,REF39429014,0.0,1435.1,43425.61
2013-12-15,2013-12-15,Business insurance premium,REF37619344,101.5,0.0,43324.11
2013-12-16,2013-12-16,Office supplies,REF25484307,61.38,0.0,43262.73
2013-12-23,2013-12-23,Training/conference,REF80076138,95.09,0.0,43167.64
2013-12-25,2013-12-25,Office supplies,REF10859163,69.78,0.0,43097.86
2013-12-25,2013-12-25,Business travel,REF23642866,115.33,0.0,42982.53
2013-12-27,2013-12-27,Office supplies,REF56056620,36.66,0.0,42945.87
2013-12-28,2013-12-28,Internet and phone service,REF26946136,96.48,0.0,42849.39
2014-01-02,2014-01-02,Office supplies,REF92956364,23.98,0.0,42825.41
2014-01-06,2014-01-06,Business travel,REF11162728,151.0,0.0,42674.41
2014-01-09,2014-01-09,Software subscription,REF26454931,113.43,0.0,42560.98
2014-01-13,2014-01-13,Training/conference,REF34489543,64.09,0.0,42496.89
2014-01-15,2014-01-15,"Payment from Hill, Adams and King",REF84480036,0.0,730.21,43227.1
2014-01-15,2014-01-15,Project payment - Morgan-Foster,REF40782049,0.0,921.63,44148.73
2014-01-15,2014-01-15,Business insurance premium,REF27343813,94.13,0.0,44054.6
2014-01-22,2014-01-22,Office supplies,REF17021510,37.78,0.0,44016.82
2014-01-25,2014-01-25,Marketing expenses,REF48072524,192.54,0.0,43824.28
2014-01-27,2014-01-27,Office supplies,REF62760274,60.25,0.0,43764.03
2014-01-29,2014-01-29,Office supplies,REF63190925,32.45,0.0,43731.58
2014-02-04,2014-02-04,Business travel,REF47411742,125.53,0.0,43606.05
2014-02-05,2014-02-05,Office supplies,REF10770724,26.26,0.0,43579.79
2014-02-08,2014-02-08,Professional services,REF50245757,166.3,0.0,43413.49
2014-02-09,2014-02-09,Marketing expenses,REF11849227,234.23,0.0,43179.26
2014-02-09,2014-02-09,Software subscription,REF57284557,133.98,0.0,43045.28
2014-02-14,2014-02-14,Professional services,REF85878279,215.97,0.0,42829.31
2014-02-14,2014-02-14,Office supplies,REF45370238,31.53,0.0,42797.78
2014-02-15,2014-02-15,Payment from Morgan-Foster,REF39853986,0.0,1081.3,43879.08
2014-02-15,2014-02-15,Business insurance premium,REF38440665,105.57,0.0,43773.51
2014-02-15,2014-02-15,"Invoice payment - Patrick, Franklin and Martinez",REF52159749,0.0,1831.48,45604.99
2014-02-15,2014-02-15,"Invoice payment - Hill, Adams and King",REF59236424,0.0,553.86,46158.85
2014-02-28,2014-02-28,Office supplies,REF64883521,41.76,0.0,46117.09
2014-03-02,2014-03-02,Office supplies,REF13240761,50.61,0.0,46066.48
2014-03-04,2014-03-04,Business travel,REF66134112,265.97,0.0,45800.51
2014-03-09,2014-03-09,Software subscription,REF27904238,147.35,0.0,45653.16
2014-03-15,2014-03-15,Internet and phone service,REF32388315,86.99,0.0,45566.17
2014-03-15,2014-03-15,"Service payment - Hill, Adams and King",REF99200644,0.0,1368.42,46934.59
2014-03-15,2014-03-15,Business insurance premium,REF32096321,124.96,0.0,46809.63
2014-03-15,2014-03-15,Payment from Morgan-Foster,REF53411961,0.0,1371.67,48181.3
2014-03-15,2014-03-15,"Project payment - Patrick, Franklin and Martinez",REF27887323,0.0,2072.1,50253.4
2014-03-22,2014-03-22,Training/conference,REF82631255,132.54,0.0,50120.86
2014-03-29,2014-03-29,Business travel,REF19863676,104.64,0.0,50016.22
2014-04-03,2014-04-03,Training/conference,REF28325684,135.99,0.0,49880.23
2014-04-07,2014-04-07,Office supplies,REF33273830,80.8,0.0,49799.43
2014-04-09,2014-04-09,Software subscription,REF37782700,146.29,0.0,49653.14
2014-04-11,2014-04-11,Business travel,REF98291474,174.87,0.0,49478.27
2014-04-13,2014-04-13,Business travel,REF49490405,102.63,0.0,49375.64
2014-04-15,2014-04-15,Office supplies,REF15745140,20.17,0.0,49355.47
2014-04-15,2014-04-15,Business insurance premium,REF39662860,119.26,0.0,49236.21
2014-04-15,2014-04-15,"Project payment - Hill, Adams and King",REF18594355,0.0,920.23,50156.44
2014-04-15,2014-04-15,Project payment - Morgan-Foster,REF76903122,0.0,1422.03,51578.47
2014-04-17,2014-04-17,Office supplies,REF83179942,41.93,0.0,51536.54
2014-04-19,2014-04-19,Office supplies,REF21238896,65.41,0.0,51471.13
2014-05-02,2014-05-02,Office supplies,REF97326591,34.48,0.0,51436.65
2014-05-05,2014-05-05,Office supplies,REF72670260,64.4,0.0,51372.25
2014-05-08,2014-05-08,Office supplies,REF24041323,26.05,0.0,51346.2
2014-05-09,2014-05-09,Software subscription,REF47890284,155.58,0.0,51190.62
2014-05-12,2014-05-12,Training/conference,REF51595108,122.78,0.0,51067.84
2014-05-13,2014-05-13,Business travel,REF45097087,76.07,0.0,50991.77
2014-05-14,2014-05-14,Marketing expenses,REF62043352,252.75,0.0,50739.02
2014-05-15,2014-05-15,"Project payment - Hill, Adams and King",REF46538667,0.0,940.55,51679.57
2014-05-15,2014-05-15,Business insurance premium,REF77608335,122.15,0.0,51557.42
2014-05-15,2014-05-15,Payment from Morgan-Foster,REF11534494,0.0,1008.99,52566.41
2014-05-15,2014-05-15,"Invoice payment - Patrick, Franklin and Martinez",REF37434415,0.0,1855.3,54421.71
2014-05-17,2014-05-17,Marketing expenses,REF76490919,229.07,0.0,54192.64
2014-05-21,2014-05-21,Training/conference,REF33466604,95.76,0.0,54096.88
2014-05-21,2014-05-21,Office supplies,REF73021628,57.54,0.0,54039.34
2014-05-24,2014-05-24,Internet and phone service,REF42683832,104.05,0.0,53935.29
2014-05-25,2014-05-25,Business travel,REF83198607,93.6,0.0,53841.69
2014-05-27,2014-05-27,Business travel,REF52710510,185.56,0.0,53656.13
2014-05-30,2014-05-30,Training/conference,REF31647454,104.69,0.0,53551.44
2014-05-30,2014-05-30,Business travel,REF41031197,163.22,0.0,53388.22
2014-05-31,2014-05-31,Business travel,REF73418856,123.03,0.0,53265.19
2014-06-04,2014-06-04,Office supplies,REF89484845,23.4,0.0,53241.79
2014-06-05,2014-06-05,Office supplies,REF28865202,44.81,0.0,53196.98
2014-06-06,2014-06-06,Business travel,REF87157880,189.22,0.0,53007.76
2014-06-07,2014-06-07,Office supplies,REF18029187,43.84,0.0,52963.92
2014-06-08,2014-06-08,Training/conference,REF62555394,105.58,0.0,52858.34
2014-06-09,2014-06-09,Software subscription,REF58216427,132.69,0.0,52725.65
2014-06-10,2014-06-10,Training/conference,REF75278346,105.62,0.0,52620.03
2014-06-11,2014-06-11,Internet and phone service,REF13980396,108.29,0.0,52511.74
2014-06-15,2014-06-15,"Service payment - Hill, Adams and King",REF94522362,0.0,960.47,53472.21
2014-06-15,2014-06-15,"Payment from Patrick, Franklin and Martinez",REF19896869,0.0,1859.41,55331.62
2014-06-15,2014-06-15,Invoice payment - Morgan-Foster,REF16241978,0.0,926.19,56257.81
2014-06-15,2014-06-15,Business insurance premium,REF45270196,104.54,0.0,56153.27
2014-06-18,2014-06-18,Training/conference,REF50170479,84.27,0.0,56069.0
2014-06-23,2014-06-23,Office supplies,REF33879067,31.86,0.0,56037.14
2014-06-26,2014-06-26,Business travel,REF36803350,126.18,0.0,55910.96
2014-06-29,2014-06-29,Equipment purchase,REF56531627,35.69,0.0,55875.27
2014-06-29,2014-06-29,Marketing expenses,REF48785182,156.08,0.0,55719.19
2014-07-02,2014-07-02,Office supplies,REF33242662,37.64,0.0,55681.55
2014-07-04,2014-07-04,Office supplies,REF16117871,57.24,0.0,55624.31
2014-07-06,2014-07-06,Equipment purchase,REF78974055,85.38,0.0,55538.93
2014-07-09,2014-07-09,Software subscription,REF59867356,158.66,0.0,55380.27
2014-07-15,2014-07-15,"Project payment - Patrick, Franklin and Martinez",REF56659490,0.0,1307.64,56687.91
2014-07-15,2014-07-15,Project payment - Morgan-Foster,REF64533486,0.0,1319.87,58007.78
2014-07-15,2014-07-15,"Project payment - Hill, Adams and King",REF98138435,0.0,878.47,58886.25
2014-07-15,2014-07-15,Business insurance premium,REF40407070,104.09,0.0,58782.16
2014-07-24,2014-07-24,Office supplies,REF19580451,27.57,0.0,58754.59
2014-07-25,2014-07-25,Business travel,REF40153983,141.94,0.0,58612.65
2014-07-30,2014-07-30,Marketing expenses,REF53351349,183.34,0.0,58429.31
2014-07-31,2014-07-31,Professional services,REF35852331,153.74,0.0,58275.57
2014-08-08,2014-08-08,Office supplies,REF34879129,54.64,0.0,58220.93
2014-08-09,2014-08-09,Software subscription,REF27830806,111.29,0.0,58109.64
2014-08-13,2014-08-13,Office supplies,REF29076231,29.31,0.0,58080.33
2014-08-14,2014-08-14,Office supplies,REF69931981,39.78,0.0,58040.55
2014-08-15,2014-08-15,Project payment - Morgan-Foster,REF31982397,0.0,552.75,58593.3
2014-08-15,2014-08-15,"Project payment - Patrick, Franklin and Martinez",REF54339869,0.0,1442.59,60035.89
2014-08-15,2014-08-15,"Service payment - Hill, Adams and King",REF50476729,0.0,834.65,60870.54
2014-08-15,2014-08-15,Marketing expenses,REF21294367,147.61,0.0,60722.93
2014-08-15,2014-08-15,Business insurance premium,REF43859938,80.48,0.0,60642.45
2014-08-17,2014-08-17,Business travel,REF23926323,89.02,0.0,60553.43
2014-08-19,2014-08-19,Marketing expenses,REF49035785,90.8,0.0,60462.63
2014-08-20,2014-08-20,Professional services,REF72381903,102.19,0.0,60360.44
2014-08-20,2014-08-20,Business travel,REF26746176,83.17,0.0,60277.27
2014-08-22,2014-08-22,Office supplies,REF45096647,37.13,0.0,60240.14
2014-08-24,2014-08-24,Professional services,REF21656792,243.89,0.0,59996.25
2014-08-25,2014-08-25,Business travel,REF80744637,100.1,0.0,59896.15
2014-08-26,2014-08-26,Office supplies,REF76180355,43.13,0.0,59853.02
2014-08-28,2014-08-28,Office supplies,REF15110540,34.49,0.0,59818.53
2014-09-01,2014-09-01,Internet and phone service,REF44062709,62.51,0.0,59756.02
2014-09-09,2014-09-09,Business travel,REF76593416,168.51,0.0,59587.51
2014-09-09,2014-09-09,Software subscription,REF52784172,161.07,0.0,59426.44
2014-09-11,2014-09-11,Training/conference,REF79267800,109.83,0.0,59316.61
2014-09-12,2014-09-12,Office supplies,REF13795043,43.43,0.0,59273.18
2014-09-15,2014-09-15,Business insurance premium,REF45030344,137.11,0.0,59136.07
2014-09-15,2014-09-15,"Project payment - Hill, Adams and King",REF86497396,0.0,1136.92,60272.99
2014-09-15,2014-09-15,"Invoice payment - Patrick, Franklin and Martinez",REF56441582,0.0,2240.93,62513.92
2014-09-15,2014-09-15,Payment from Morgan-Foster,REF96262135,0.0,1367.8,63881.72
2014-09-20,2014-09-20,Marketing expenses,REF31619509,187.96,0.0,63693.76
2014-09-26,2014-09-26,Office supplies,REF79099548,58.68,0.0,63635.08
2014-10-01,2014-10-01,Professional services,REF49136115,258.96,0.0,63376.12
2014-10-08,2014-10-08,Office supplies,REF48835375,46.72,0.0,63329.4
2014-10-09,2014-10-09,Software subscription,REF82941128,183.45,0.0,63145.95
2014-10-11,2014-10-11,Internet and phone service,REF35337342,41.4,0.0,63104.55
2014-10-12,2014-10-12,Office supplies,REF64293029,66.05,0.0,63038.5
2014-10-13,2014-10-13,Office supplies,REF52089074,71.37,0.0,62967.13
2014-10-15,2014-10-15,Business insurance premium,REF44892779,157.99,0.0,62809.14
2014-10-15,2014-10-15,"Payment from Hill, Adams and King",REF14140509,0.0,1428.94,64238.08
2014-10-15,2014-10-15,Project payment - Morgan-Foster,REF76066828,0.0,1236.18,65474.26
2014-10-15,2014-10-15,"Payment from Patrick, Franklin and Martinez",REF32982493,0.0,1828.03,67302.29
2014-10-21,2014-10-21,Business travel,REF78724112,215.6,0.0,67086.69
2014-10-24,2014-10-24,Training/conference,REF40329233,82.94,0.0,67003.75
2014-10-29,2014-10-29,Equipment purchase,REF55620553,101.14,0.0,66902.61
2014-10-31,2014-10-31,Equipment purchase,REF97403575,61.25,0.0,66841.36
2014-11-01,2014-11-01,Internet and phone service,REF27268121,102.77,0.0,66738.59
2014-11-06,2014-11-06,Office supplies,REF49339091,83.26,0.0,66655.33
2014-11-09,2014-11-09,Software subscription,REF54330981,135.47,0.0,66519.86
2014-11-13,2014-11-13,Office supplies,REF84912331,54.17,0.0,66465.69
2014-11-15,2014-11-15,"Service payment - Patrick, Franklin and Martinez",REF96552016,0.0,1615.41,68081.1
2014-11-15,2014-11-15,Business insurance premium,REF57524309,129.12,0.0,67951.98
2014-11-15,2014-11-15,Project payment - Morgan-Foster,REF42749155,0.0,1334.02,69286.0
2014-11-15,2014-11-15,"Service payment - Hill, Adams and King",REF68719920,0.0,1045.56,70331.56
2014-11-19,2014-11-19,Training/conference,REF84411728,49.11,0.0,70282.45
2014-11-20,2014-11-20,Office supplies,REF50958309,79.74,0.0,70202.71
2014-11-25,2014-11-25,Training/conference,REF64959139,92.04,0.0,70110.67
2014-11-27,2014-11-27,Marketing expenses,REF75040949,282.11,0.0,69828.56
2014-11-29,2014-11-29,Professional services,REF91023407,85.19,0.0,69743.37
2014-12-01,2014-12-01,Professional services,REF56780684,298.84,0.0,69444.53
2014-12-05,2014-12-05,Professional services,REF46305800,322.67,0.0,69121.86
2014-12-09,2014-12-09,Software subscription,REF33327297,158.69,0.0,68963.17
2014-12-10,2014-12-10,Training/conference,REF99449884,127.17,0.0,68836.0
2014-12-11,2014-12-11,Training/conference,REF12920344,126.46,0.0,68709.54
2014-12-14,2014-12-14,Office supplies,REF67571271,59.91,0.0,68649.63
2014-12-15,2014-12-15,Project payment - Morgan-Foster,REF65882341,0.0,1147.44,69797.07
2014-12-15,2014-12-15,"Invoice payment - Patrick, Franklin and Martinez",REF92607527,0.0,1641.94,71439.01
2014-12-15,2014-12-15,Business insurance premium,REF12953778,107.5,0.0,71331.51
2014-12-18,2014-12-18,Equipment purchase,REF98999343,74.12,0.0,71257.39
2014-12-18,2014-12-18,Marketing expenses,REF72259756,239.47,0.0,71017.92
2014-12-20,2014-12-20,Office supplies,REF91297967,46.32,0.0,70971.6
2014-12-23,2014-12-23,Professional services,REF96939053,169.46,0.0,70802.14
2014-12-28,2014-12-28,Internet and phone service,REF17315861,105.56,0.0,70696.58
2014-12-28,2014-12-28,Office supplies,REF68543352,13.9,0.0,70682.68
2015-01-02,2015-01-02,Office supplies,REF57329845,43.17,0.0,70639.51
2015-01-03,2015-01-03,Equipment purchase,REF68501139,98.69,0.0,70540.82
2015-01-09,2015-01-09,Software subscription,REF69040739,102.7,0.0,70438.12
2015-01-14,2015-01-14,Office supplies,REF97486075,38.47,0.0,70399.65
2015-01-15,2015-01-15,"Project payment - Patrick, Franklin and Martinez",REF92903872,0.0,1721.94,72121.59
2015-01-15,2015-01-15,"Payment from Hill, Adams and King",REF24706980,0.0,860.37,72981.96
2015-01-15,2015-01-15,Payment from Morgan-Foster,REF62374154,0.0,937.25,73919.21
2015-01-15,2015-01-15,Office supplies,REF29082988,39.42,0.0,73879.79
2015-01-15,2015-01-15,Business insurance premium,REF84817344,96.81,0.0,73782.98
2015-01-16,2015-01-16,Business travel,REF78433079,89.95,0.0,73693.03
2015-01-22,2015-01-22,Marketing expenses,REF90635550,171.61,0.0,73521.42
2015-01-23,2015-01-23,Office supplies,REF69152517,48.06,0.0,73473.36
2015-01-26,2015-01-26,Equipment purchase,REF68253873,30.51,0.0,73442.85
2015-02-06,2015-02-06,Marketing expenses,REF45340552,176.8,0.0,73266.05
2015-02-07,2015-02-07,Training/conference,REF92390552,61.84,0.0,73204.21
2015-02-08,2015-02-08,Professional services,REF23078506,309.82,0.0,72894.39
2015-02-09,2015-02-09,Software subscription,REF92257727,135.43,0.0,72758.96
2015-02-13,2015-02-13,Office supplies,REF50026989,40.55,0.0,72718.41
2015-02-14,2015-02-14,Internet and phone service,REF73629161,76.71,0.0,72641.7
2015-02-15,2015-02-15,Business insurance premium,REF81150665,106.31,0.0,72535.39
2015-02-15,2015-02-15,"Project payment - Hill, Adams and King",REF10772760,0.0,1039.98,73575.37
2015-02-15,2015-02-15,Invoice payment - Morgan-Foster,REF82505966,0.0,1100.34,74675.71
2015-02-15,2015-02-15,"Project payment - Patrick, Franklin and Martinez",REF33311355,0.0,1178.65,75854.36
2015-02-24,2015-02-24,Marketing expenses,REF15793225,218.19,0.0,75636.17
2015-02-25,2015-02-25,Office supplies,REF86476131,48.91,0.0,75587.26
2015-02-26,2015-02-26,Marketing expenses,REF81397696,232.51,0.0,75354.75
2015-03-02,2015-03-02,Equipment purchase,REF31847419,84.68,0.0,75270.07
2015-03-04,2015-03-04,Training/conference,REF24299320,101.53,0.0,75168.54
2015-03-05,2015-03-05,Office supplies,REF19072456,67.42,0.0,75101.12
2015-03-07,2015-03-07,Office supplies,REF28823956,71.84,0.0,75029.28
2015-03-09,2015-03-09,Software subscription,REF81368689,180.26,0.0,74849.02
2015-03-15,2015-03-15,Business insurance premium,REF24528829,124.82,0.0,74724.2
2015-03-15,2015-03-15,"Payment from Hill, Adams and King",REF24130748,0.0,1154.21,75878.41
2015-03-16,2015-03-16,Internet and phone service,REF79864966,76.93,0.0,75801.48
2015-03-17,2015-03-17,Office supplies,REF62944955,52.49,0.0,75748.99
2015-03-19,2015-03-19,Internet and phone service,REF17484325,99.64,0.0,75649.35
2015-03-20,2015-03-20,Office supplies,REF52998298,42.23,0.0,75607.12
2015-03-26,2015-03-26,Office supplies,REF14036357,61.38,0.0,75545.74
2015-03-27,2015-03-27,Internet and phone service,REF31632520,97.41,0.0,75448.33
2015-03-31,2015-03-31,Internet and phone service,REF21345662,94.54,0.0,75353.79
2015-04-01,2015-04-01,Business travel,REF50620452,245.65,0.0,75108.14
2015-04-05,2015-04-05,Office supplies,REF86228620,49.44,0.0,75058.7
2015-04-07,2015-04-07,Office supplies,REF36919258,34.89,0.0,75023.81
2015-04-09,2015-04-09,Software subscription,REF87391149,162.98,0.0,74860.83
2015-04-12,2015-04-12,Business travel,REF10932976,142.86,0.0,74717.97
2015-04-14,2015-04-14,Business travel,REF86392611,93.63,0.0,74624.34
2015-04-15,2015-04-15,Marketing expenses,REF36562270,167.61,0.0,74456.73
2015-04-15,2015-04-15,"Project payment - Patrick, Franklin and Martinez",REF18048721,0.0,2235.98,76692.71
2015-04-15,2015-04-15,"Project payment - Hill, Adams and King",REF39046756,0.0,1195.43,77888.14
2015-04-15,2015-04-15,Project payment - Morgan-Foster,REF26923241,0.0,1393.81,79281.95
2015-04-15,2015-04-15,Business travel,REF20895308,162.93,0.0,79119.02
2015-04-15,2015-04-15,Business insurance premium,REF67183129,119.84,0.0,78999.18
2015-04-18,2015-04-18,Business travel,REF65123071,156.76,0.0,78842.42
2015-04-19,2015-04-19,Office supplies,REF42551710,62.58,0.0,78779.84
2015-04-20,2015-04-20,Internet and phone service,REF55415347,93.21,0.0,78686.63
2015-04-25,2015-04-25,Equipment purchase,REF16603630,130.82,0.0,78555.81
2015-05-02,2015-05-02,Internet and phone service,REF66801956,64.08,0.0,78491.73
2015-05-04,2015-05-04,Training/conference,REF85864824,91.43,0.0,78400.3
2015-05-07,2015-05-07,Office supplies,REF30380149,67.3,0.0,78333.0
2015-05-09,2015-05-09,Software subscription,REF36999939,149.53,0.0,78183.47
2015-05-15,2015-05-15,Business insurance premium,REF98353861,127.77,0.0,78055.7
2015-05-15,2015-05-15,"Invoice payment - Hill, Adams and King",REF51639061,0.0,1027.7,79083.4
2015-05-15,2015-05-15,Payment from Morgan-Foster,REF79422361,0.0,1205.03,80288.43
2015-05-15,2015-05-15,"Project payment - Patrick, Franklin and Martinez",REF19556864,0.0,1713.54,82001.97
2015-05-19,2015-05-19,Marketing expenses,REF48593432,235.72,0.0,81766.25
2015-05-20,2015-05-20,Office supplies,REF76060187,58.3,0.0,81707.95
2015-05-21,2015-05-21,Internet and phone service,REF90133790,65.85,0.0,81642.1
2015-05-22,2015-05-22,Equipment purchase,REF83937964,111.02,0.0,81531.08
2015-05-23,2015-05-23,Business travel,REF55985671,74.9,0.0,81456.18
2015-05-24,2015-05-24,Business travel,REF29575270,156.3,0.0,81299.88
2015-05-24,2015-05-24,Marketing expenses,REF84409329,216.7,0.0,81083.18
2015-05-25,2015-05-25,Marketing expenses,REF76860164,227.75,0.0,80855.43
2015-06-08,2015-06-08,Training/conference,REF17320690,115.61,0.0,80739.82
2015-06-08,2015-06-08,Office supplies,REF79317059,53.21,0.0,80686.61
2015-06-09,2015-06-09,Business travel,REF96507178,102.59,0.0,80584.02
2015-06-09,2015-06-09,Software subscription,REF51062127,146.3,0.0,80437.72
2015-06-12,2015-06-12,Office supplies,REF87595697,42.0,0.0,80395.72
2015-06-15,2015-06-15,Business insurance premium,REF66283949,105.61,0.0,80290.11
2015-06-15,2015-06-15,Service payment - Morgan-Foster,REF15016896,0.0,1051.11,81341.22
2015-06-15,2015-06-15,"Project payment - Hill, Adams and King",REF30293998,0.0,1039.14,82380.36
2015-06-15,2015-06-15,"Invoice payment - Patrick, Franklin and Martinez",REF30359080,0.0,1849.91,84230.27
2015-06-17,2015-06-17,Marketing expenses,REF34362804,141.92,0.0,84088.35
2015-06-19,2015-06-19,Office supplies,REF50860438,42.23,0.0,84046.12
2015-06-19,2015-06-19,Business travel,REF73196104,116.55,0.0,83929.57
2015-06-24,2015-06-24,Business travel,REF43404275,105.43,0.0,83824.14
2015-07-06,2015-07-06,Professional services,REF61663652,205.59,0.0,83618.55
2015-07-09,2015-07-09,Software subscription,REF77326864,121.7,0.0,83496.85
2015-07-13,2015-07-13,Internet and phone service,REF33016884,72.85,0.0,83424.0
2015-07-14,2015-07-14,Office supplies,REF28537648,36.72,0.0,83387.28
2015-07-15,2015-07-15,Invoice payment - Morgan-Foster,REF82444014,0.0,1065.22,84452.5
2015-07-15,2015-07-15,"Service payment - Patrick, Franklin and Martinez",REF10252027,0.0,1599.67,86052.17
2015-07-15,2015-07-15,Business insurance premium,REF50353076,92.73,0.0,85959.44
2015-07-21,2015-07-21,Office supplies,REF71737658,24.35,0.0,85935.09
2015-07-23,2015-07-23,Internet and phone service,REF80064240,42.14,0.0,85892.95
2015-07-27,2015-07-27,Office supplies,REF40575918,26.75,0.0,85866.2
2015-07-28,2015-07-28,Marketing expenses,REF25136490,146.34,0.0,85719.86
2015-08-01,2015-08-01,Business travel,REF27497868,157.19,0.0,85562.67
2015-08-07,2015-08-07,Professional services,REF42056475,144.16,0.0,85418.51
2015-08-09,2015-08-09,Software subscription,REF95224425,80.8,0.0,85337.71
2015-08-09,2015-08-09,Office supplies,REF13256493,39.53,0.0,85298.18
2015-08-10,2015-08-10,Equipment purchase,REF71940520,63.93,0.0,85234.25
2015-08-13,2015-08-13,Professional services,REF68267308,295.43,0.0,84938.82
2015-08-15,2015-08-15,Business insurance premium,REF45686271,81.83,0.0,84856.99
2015-08-15,2015-08-15,Invoice payment - Morgan-Foster,REF70415345,0.0,852.13,85709.12
2015-08-15,2015-08-15,"Invoice payment - Patrick, Franklin and Martinez",REF29636661,0.0,1090.78,86799.9
2015-08-15,2015-08-15,"Project payment - Hill, Adams and King",REF42521664,0.0,712.02,87511.92
2015-08-19,2015-08-19,Training/conference,REF98969438,77.94,0.0,87433.98
2015-08-23,2015-08-23,Business travel,REF96625512,104.46,0.0,87329.52
2015-08-24,2015-08-24,Office supplies,REF28045544,41.91,0.0,87287.61
2015-08-24,2015-08-24,Training/conference,REF97799262,67.16,0.0,87220.45
2015-08-27,2015-08-27,Business travel,REF89714137,162.93,0.0,87057.52
2015-08-28,2015-08-28,Equipment purchase,REF88853831,61.44,0.0,86996.08
2015-08-31,2015-08-31,Internet and phone service,REF31180856,50.65,0.0,86945.43
2015-09-06,2015-09-06,Business travel,REF64743125,267.53,0.0,86677.9
2015-09-07,2015-09-07,Internet and phone service,REF47953543,89.48,0.0,86588.42
2015-09-08,2015-09-08,Professional services,REF93506750,279.02,0.0,86309.4
2015-09-09,2015-09-09,Software subscription,REF53849470,193.78,0.0,86115.62
2015-09-09,2015-09-09,Office supplies,REF98225132,52.3,0.0,86063.32
2015-09-11,2015-09-11,Marketing expenses,REF20252088,107.74,0.0,85955.58
2015-09-15,2015-09-15,Business insurance premium,REF46119925,136.4,0.0,85819.18
2015-09-15,2015-09-15,Payment from Morgan-Foster,REF92426091,0.0,1294.89,87114.07
2015-09-15,2015-09-15,Office supplies,REF53881424,44.9,0.0,87069.17
2015-09-15,2015-09-15,"Payment from Hill, Adams and King",REF30678889,0.0,1095.88,88165.05
2015-09-15,2015-09-15,"Service payment - Patrick, Franklin and Martinez",REF97850661,0.0,1894.66,90059.71
2015-09-16,2015-09-16,Marketing expenses,REF95933188,145.17,0.0,89914.54
2015-09-21,2015-09-21,Office supplies,REF70014401,65.86,0.0,89848.68
2015-09-22,2015-09-22,Office supplies,REF48165533,79.18,0.0,89769.5
2015-09-23,2015-09-23,Training/conference,REF25426350,88.76,0.0,89680.74
2015-09-23,2015-09-23,Office supplies,REF39815091,56.99,0.0,89623.75
2015-09-27,2015-09-27,Equipment purchase,REF64926388,173.6,0.0,89450.15
2015-10-02,2015-10-02,Business travel,REF94521090,226.28,0.0,89223.87
2015-10-02,2015-10-02,Professional services,REF62431556,458.74,0.0,88765.13
2015-10-05,2015-10-05,Office supplies,REF92802121,60.24,0.0,88704.89
2015-10-08,2015-10-08,Internet and phone service,REF73577575,104.75,0.0,88600.14
2015-10-09,2015-10-09,Software subscription,REF39205623,181.69,0.0,88418.45
2015-10-12,2015-10-12,Office supplies,REF91140765,55.13,0.0,88363.32
2015-10-13,2015-10-13,Equipment purchase,REF37824698,172.78,0.0,88190.54
2015-10-15,2015-10-15,Service payment - Morgan-Foster,REF22885521,0.0,1845.84,90036.38
2015-10-15,2015-10-15,"Payment from Hill, Adams and King",REF25707434,0.0,1550.26,91586.64
2015-10-15,2015-10-15,"Payment from Patrick, Franklin and Martinez",REF64398409,0.0,1882.21,93468.85
2015-10-15,2015-10-15,Business insurance premium,REF77304976,142.28,0.0,93326.57
2015-10-16,2015-10-16,Training/conference,REF72988690,81.34,0.0,93245.23
2015-10-17,2015-10-17,Office supplies,REF94174178,63.11,0.0,93182.12
2015-10-19,2015-10-19,Marketing expenses,REF64944524,317.57,0.0,92864.55
2015-10-23,2015-10-23,Office supplies,REF70150404,75.41,0.0,92789.14
2015-10-23,2015-10-23,Internet and phone service,REF12623637,89.2,0.0,92699.94
2015-10-24,2015-10-24,Office supplies,REF70602951,77.06,0.0,92622.88
2015-10-25,2015-10-25,Professional services,REF62882804,315.84,0.0,92307.04
2015-10-25,2015-10-25,Office supplies,REF65465528,77.82,0.0,92229.22
2015-10-31,2015-10-31,Business travel,REF16453883,211.27,0.0,92017.95
2015-11-06,2015-11-06,Training/conference,REF72656457,12.13,0.0,92005.82
2015-11-06,2015-11-06,Marketing expenses,REF77213217,186.64,0.0,91819.18
2015-11-07,2015-11-07,Business travel,REF33563211,90.25,0.0,91728.93
2015-11-09,2015-11-09,Software subscription,REF33051914,162.1,0.0,91566.83
2015-11-15,2015-11-15,Professional services,REF72866887,284.14,0.0,91282.69
2015-11-15,2015-11-15,"Invoice payment - Hill, Adams and King",REF69281741,0.0,1214.09,92496.78
2015-11-15,2015-11-15,"Service payment - Patrick, Franklin and Martinez",REF92543643,0.0,1859.61,94356.39
2015-11-15,2015-11-15,Invoice payment - Morgan-Foster,REF11512794,0.0,1259.32,95615.71
2015-11-15,2015-11-15,Business insurance premium,REF65696134,132.68,0.0,95483.03
2015-11-17,2015-11-17,Business travel,REF82435609,190.45,0.0,95292.58
2015-11-19,2015-11-19,Equipment purchase,REF19570094,116.85,0.0,95175.73
2015-11-23,2015-11-23,Office supplies,REF31106399,39.97,0.0,95135.76
2015-11-25,2015-11-25,Equipment purchase,REF36231505,95.47,0.0,95040.29
2015-11-29,2015-11-29,Business travel,REF62343714,128.92,0.0,94911.37
2015-12-06,2015-12-06,Office supplies,REF85522556,57.84,0.0,94853.53
2015-12-09,2015-12-09,Software subscription,REF90888249,131.07,0.0,94722.46
2015-12-11,2015-12-11,Internet and phone service,REF70642034,91.35,0.0,94631.11
2015-12-14,2015-12-14,Business travel,REF60362498,187.43,0.0,94443.68
2015-12-14,2015-12-14,Office supplies,REF72661906,50.35,0.0,94393.33
2015-12-15,2015-12-15,"Project payment - Patrick, Franklin and Martinez",REF72567584,0.0,1537.84,95931.17
2015-12-15,2015-12-15,"Service payment - Hill, Adams and King",REF12465092,0.0,780.02,96711.19
2015-12-15,2015-12-15,Project payment - Morgan-Foster,REF48925835,0.0,1240.3,97951.49
2015-12-15,2015-12-15,Business insurance premium,REF74273338,107.94,0.0,97843.55
2015-12-18,2015-12-18,Professional services,REF51565693,386.53,0.0,97457.02
2015-12-21,2015-12-21,Equipment purchase,REF32235170,91.86,0.0,97365.16
2015-12-23,2015-12-23,Equipment purchase,REF61385489,82.53,0.0,97282.63
2015-12-26,2015-12-26,Internet and phone service,REF90429261,38.82,0.0,97243.81
2015-12-29,2015-12-29,Office supplies,REF97438677,45.96,0.0,97197.85
2016-01-04,2016-01-04,Internet and phone service,REF64160682,42.64,0.0,97155.21
2016-01-07,2016-01-07,Business travel,REF37045537,81.97,0.0,97073.24
2016-01-09,2016-01-09,Software subscription,REF20805809,124.85,0.0,96948.39
2016-01-14,2016-01-14,Professional services,REF10507831,242.69,0.0,96705.7
2016-01-14,2016-01-14,Office supplies,REF89430026,63.1,0.0,96642.6
2016-01-15,2016-01-15,Service payment - Morgan-Foster,REF96720455,0.0,863.07,97505.67
2016-01-15,2016-01-15,"Project payment - Hill, Adams and King",REF36322681,0.0,914.12,98419.79
2016-01-15,2016-01-15,Training/conference,REF15483715,99.85,0.0,98319.94
2016-01-15,2016-01-15,"Project payment - Patrick, Franklin and Martinez",REF62301931,0.0,1633.09,99953.03
2016-01-15,2016-01-15,Business insurance premium,REF78740370,89.86,0.0,99863.17
2016-01-17,2016-01-17,Office supplies,REF61404698,56.62,0.0,99806.55
2016-01-18,2016-01-18,Business travel,REF98751705,150.61,0.0,99655.94
2016-01-18,2016-01-18,Professional services,REF47151437,91.15,0.0,99564.79
2016-01-18,2016-01-18,Office supplies,REF18617961,35.59,0.0,99529.2
2016-01-22,2016-01-22,Professional services,REF57465512,240.28,0.0,99288.92
2016-01-27,2016-01-27,Professional services,REF41797271,138.66,0.0,99150.26
2016-01-28,2016-01-28,Training/conference,REF23188754,104.29,0.0,99045.97
2016-01-28,2016-01-28,Professional services,REF93099915,281.09,0.0,98764.88
2016-02-04,2016-02-04,Training/conference,REF59695438,53.16,0.0,98711.72
2016-02-07,2016-02-07,Internet and phone service,REF23861904,64.51,0.0,98647.21
2016-02-07,2016-02-07,Office supplies,REF90384969,46.0,0.0,98601.21
2016-02-09,2016-02-09,Software subscription,REF43334683,117.64,0.0,98483.57
2016-02-10,2016-02-10,Office supplies,REF16684570,22.0,0.0,98461.57
2016-02-10,2016-02-10,Business travel,REF33351792,125.38,0.0,98336.19
2016-02-13,2016-02-13,Professional services,REF78451739,197.09,0.0,98139.1
2016-02-15,2016-02-15,"Payment from Patrick, Franklin and Martinez",REF15138260,0.0,1970.63,100109.73
2016-02-15,2016-02-15,Business insurance premium,REF96873263,101.66,0.0,100008.07
2016-02-15,2016-02-15,Project payment - Morgan-Foster,REF56544815,0.0,1003.67,101011.74
2016-02-20,2016-02-20,Business travel,REF35787880,37.51,0.0,100974.23
2016-02-21,2016-02-21,Office supplies,REF40383063,67.58,0.0,100906.65
2016-02-21,2016-02-21,Business travel,REF58423383,121.74,0.0,100784.91
2016-02-27,2016-02-27,Marketing expenses,REF60506712,129.6,0.0,100655.31
2016-03-09,2016-03-09,Office supplies,REF33915372,27.36,0.0,100627.95
2016-03-09,2016-03-09,Software subscription,REF40736022,151.82,0.0,100476.13
2016-03-10,2016-03-10,Training/conference,REF26624624,119.7,0.0,100356.43
2016-03-11,2016-03-11,Professional services,REF18924106,244.55,0.0,100111.88
2016-03-15,2016-03-15,"Payment from Patrick, Franklin and Martinez",REF30508301,0.0,1760.51,101872.39
2016-03-15,2016-03-15,Business insurance premium,REF58842358,126.8,0.0,101745.59
2016-03-15,2016-03-15,Service payment - Morgan-Foster,REF81367683,0.0,1109.08,102854.67
2016-03-19,2016-03-19,Equipment purchase,REF48980684,130.13,0.0,102724.54
2016-03-20,2016-03-20,Office supplies,REF25830080,64.86,0.0,102659.68
2016-04-09,2016-04-09,Office supplies,REF71605574,24.71,0.0,102634.97
2016-04-09,2016-04-09,Training/conference,REF39804106,81.39,0.0,102553.58
2016-04-09,2016-04-09,Software subscription,REF52715749,157.9,0.0,102395.68
2016-04-12,2016-04-12,Business travel,REF44448497,98.87,0.0,102296.81
2016-04-15,2016-04-15,"Invoice payment - Hill, Adams and King",REF24536379,0.0,932.15,103228.96
2016-04-15,2016-04-15,Payment from Morgan-Foster,REF65472323,0.0,1299.53,104528.49
2016-04-15,2016-04-15,Business insurance premium,REF82010851,127.0,0.0,104401.49
2016-04-15,2016-04-15,"Payment from Patrick, Franklin and Martinez",REF34461243,0.0,2089.68,106491.17
2016-04-16,2016-04-16,Business travel,REF47791963,145.84,0.0,106345.33
2016-04-17,2016-04-17,Business travel,REF59966911,159.68,0.0,106185.65
2016-04-17,2016-04-17,Office supplies,REF13353138,51.1,0.0,106134.55
2016-04-22,2016-04-22,Business travel,REF65976432,103.8,0.0,106030.75
2016-04-23,2016-04-23,Marketing expenses,REF54660371,288.38,0.0,105742.37
2016-04-24,2016-04-24,Business travel,REF71407958,130.97,0.0,105611.4
2016-04-25,2016-04-25,Professional services,REF99288820,70.51,0.0,105540.89
2016-04-29,2016-04-29,Professional services,REF28160943,379.91,0.0,105160.98
2016-04-30,2016-04-30,Internet and phone service,REF67754317,51.15,0.0,105109.83
2016-05-01,2016-05-01,Office supplies,REF52703183,45.47,0.0,105064.36
2016-05-08,2016-05-08,Office supplies,REF23930642,56.37,0.0,105007.99
2016-05-09,2016-05-09,Software subscription,REF87239020,174.04,0.0,104833.95
2016-05-12,2016-05-12,Office supplies,REF80597028,51.5,0.0,104782.45
2016-05-14,2016-05-14,Training/conference,REF88650979,133.88,0.0,104648.57
2016-05-15,2016-05-15,Business travel,REF54612599,84.04,0.0,104564.53
2016-05-15,2016-05-15,"Service payment - Patrick, Franklin and Martinez",REF50124808,0.0,2220.13,106784.66
2016-05-15,2016-05-15,Invoice payment - Morgan-Foster,REF33957163,0.0,1204.44,107989.1
2016-05-15,2016-05-15,Business insurance premium,REF20251161,122.29,0.0,107866.81
2016-05-15,2016-05-15,"Service payment - Hill, Adams and King",REF53465236,0.0,923.11,108789.92
2016-05-18,2016-05-18,Internet and phone service,REF51319553,119.32,0.0,108670.6
2016-05-20,2016-05-20,Office supplies,REF57337092,75.61,0.0,108594.99
2016-05-25,2016-05-25,Business travel,REF82605175,112.82,0.0,108482.17
2016-05-26,2016-05-26,Equipment purchase,REF73049756,96.21,0.0,108385.96
2016-06-01,2016-06-01,Business travel,REF28351904,169.42,0.0,108216.54
2016-06-05,2016-06-05,Professional services,REF11159393,225.44,0.0,107991.1
2016-06-09,2016-06-09,Software subscription,REF32066919,122.4,0.0,107868.7
2016-06-10,2016-06-10,Office supplies,REF67678245,59.58,0.0,107809.12
2016-06-15,2016-06-15,Business insurance premium,REF97714141,110.65,0.0,107698.47
2016-06-15,2016-06-15,"Project payment - Hill, Adams and King",REF34834736,0.0,1286.78,108985.25
2016-06-15,2016-06-15,Project payment - Morgan-Foster,REF70384529,0.0,1026.87,110012.12
2016-06-15,2016-06-15,"Payment from Patrick, Franklin and Martinez",REF23429436,0.0,1436.95,111449.07
2016-06-18,2016-06-18,Internet and phone service,REF49626991,65.16,0.0,111383.91
2016-06-22,2016-06-22,Training/conference,REF22274326,52.79,0.0,111331.12
2016-06-22,2016-06-22,Business travel,REF27527453,150.93,0.0,111180.19
2016-06-23,2016-06-23,Training/conference,REF69219951,75.59,0.0,111104.6
2016-06-30,2016-06-30,Office supplies,REF20714617,44.19,0.0,111060.41
2016-07-04,2016-07-04,Business travel,REF49621221,221.29,0.0,110839.12
2016-07-04,2016-07-04,Internet and phone service,REF37141680,85.44,0.0,110753.68
2016-07-05,2016-07-05,Internet and phone service,REF65158555,104.99,0.0,110648.69
2016-07-05,2016-07-05,Business travel,REF54703443,104.68,0.0,110544.01
2016-07-05,2016-07-05,Office supplies,REF18444424,46.41,0.0,110497.6
2016-07-08,2016-07-08,Business travel,REF52764151,115.37,0.0,110382.23
2016-07-09,2016-07-09,Office supplies,REF36850367,69.05,0.0,110313.18
2016-07-09,2016-07-09,Software subscription,REF32322922,119.35,0.0,110193.83
2016-07-13,2016-07-13,Internet and phone service,REF13592815,53.26,0.0,110140.57
2016-07-13,2016-07-13,Office supplies,REF81952753,45.52,0.0,110095.05
2016-07-14,2016-07-14,Professional services,REF95450752,191.15,0.0,109903.9
2016-07-14,2016-07-14,Office supplies,REF44043575,35.97,0.0,109867.93
2016-07-15,2016-07-15,Business insurance premium,REF60416333,87.09,0.0,109780.84
2016-07-15,2016-07-15,"Payment from Patrick, Franklin and Martinez",REF11980102,0.0,1516.45,111297.29
2016-07-15,2016-07-15,Payment from Morgan-Foster,REF19006186,0.0,1175.2,112472.49
2016-07-15,2016-07-15,"Project payment - Hill, Adams and King",REF33689548,0.0,841.48,113313.97
2016-07-18,2016-07-18,Internet and phone service,REF63797746,60.37,0.0,113253.6
2016-07-20,2016-07-20,Office supplies,REF58040028,24.56,0.0,113229.04
2016-07-25,2016-07-25,Business travel,REF85072903,69.9,0.0,113159.14
2016-07-27,2016-07-27,Equipment purchase,REF28559918,51.84,0.0,113107.3
2016-07-28,2016-07-28,Office supplies,REF80263750,47.74,0.0,113059.56
2016-07-31,2016-07-31,Office supplies,REF24857986,47.46,0.0,113012.1
2016-08-02,2016-08-02,Professional services,REF48289237,238.77,0.0,112773.33
2016-08-03,2016-08-03,Professional services,REF66110553,209.18,0.0,112564.15
2016-08-05,2016-08-05,Internet and phone service,REF14449400,59.16,0.0,112504.99
2016-08-09,2016-08-09,Software subscription,REF18445934,98.24,0.0,112406.75
2016-08-13,2016-08-13,Equipment purchase,REF84409612,46.94,0.0,112359.81
2016-08-14,2016-08-14,Office supplies,REF13821438,42.98,0.0,112316.83
2016-08-15,2016-08-15,"Payment from Hill, Adams and King",REF43115618,0.0,752.0,113068.83
2016-08-15,2016-08-15,"Invoice payment - Patrick, Franklin and Martinez",REF17360532,0.0,1207.64,114276.47
2016-08-15,2016-08-15,Business travel,REF32804164,129.6,0.0,114146.87
2016-08-15,2016-08-15,Business insurance premium,REF32535941,81.6,0.0,114065.27
2016-08-27,2016-08-27,Internet and phone service,REF92262622,70.49,0.0,113994.78
2016-09-02,2016-09-02,Equipment purchase,REF60192892,125.74,0.0,113869.04
2016-09-04,2016-09-04,Marketing expenses,REF92787649,119.65,0.0,113749.39
2016-09-05,2016-09-05,Business travel,REF76347936,114.91,0.0,113634.48
2016-09-09,2016-09-09,Software subscription,REF41340657,180.2,0.0,113454.28
2016-09-13,2016-09-13,Professional services,REF57969839,255.25,0.0,113199.03
2016-09-15,2016-09-15,Business insurance premium,REF49631733,137.57,0.0,113061.46
2016-09-15,2016-09-15,"Payment from Patrick, Franklin and Martinez",REF21113671,0.0,1878.66,114940.12
2016-09-15,2016-09-15,"Invoice payment - Hill, Adams and King",REF72388460,0.0,1067.04,116007.16
2016-09-24,2016-09-24,Office supplies,REF36696280,39.19,0.0,115967.97
2016-09-26,2016-09-26,Office supplies,REF67092981,36.37,0.0,115931.6
2016-09-28,2016-09-28,Marketing expenses,REF25654069,159.5,0.0,115772.1
2016-10-01,2016-10-01,Marketing expenses,REF61693091,265.75,0.0,115506.35
2016-10-01,2016-10-01,Office supplies,REF97899881,59.54,0.0,115446.81
2016-10-03,2016-10-03,Business travel,REF79321823,150.05,0.0,115296.76
2016-10-03,2016-10-03,Office supplies,REF22666575,101.26,0.0,115195.5
2016-10-05,2016-10-05,Training/conference,REF60266041,25.29,0.0,115170.21
2016-10-07,2016-10-07,Marketing expenses,REF73697549,371.57,0.0,114798.64
2016-10-08,2016-10-08,Training/conference,REF80744314,103.87,0.0,114694.77
2016-10-09,2016-10-09,Software subscription,REF94925203,174.6,0.0,114520.17
2016-10-10,2016-10-10,Training/conference,REF41663823,159.88,0.0,114360.29
2016-10-15,2016-10-15,Business insurance premium,REF38491426,137.51,0.0,114222.78
2016-10-15,2016-10-15,"Payment from Hill, Adams and King",REF58105814,0.0,1546.77,115769.55
2016-10-15,2016-10-15,"Payment from Patrick, Franklin and Martinez",REF94790481,0.0,1645.74,117415.29
2016-10-15,2016-10-15,Service payment - Morgan-Foster,REF22188448,0.0,1433.99,118849.28
2016-10-24,2016-10-24,Business travel,REF33272937,119.79,0.0,118729.49
2016-10-26,2016-10-26,Internet and phone service,REF93715492,46.27,0.0,118683.22
2016-10-28,2016-10-28,Equipment purchase,REF62373404,114.01,0.0,118569.21
2016-10-31,2016-10-31,Equipment purchase,REF36143926,96.8,0.0,118472.41
2016-11-01,2016-11-01,Professional services,REF88307804,243.77,0.0,118228.64
2016-11-01,2016-11-01,Office supplies,REF32636697,46.7,0.0,118181.94
2016-11-02,2016-11-02,Office supplies,REF66561836,54.42,0.0,118127.52
2016-11-03,2016-11-03,Office supplies,REF57894232,63.62,0.0,118063.9
2016-11-05,2016-11-05,Professional services,REF95848200,471.35,0.0,117592.55
2016-11-09,2016-11-09,Software subscription,REF32699192,164.25,0.0,117428.3
2016-11-10,2016-11-10,Equipment purchase,REF26352506,122.05,0.0,117306.25
2016-11-14,2016-11-14,Marketing expenses,REF42139785,214.65,0.0,117091.6
2016-11-15,2016-11-15,Business insurance premium,REF58510296,141.91,0.0,116949.69
2016-11-15,2016-11-15,"Project payment - Hill, Adams and King",REF26392722,0.0,1180.38,118130.07
2016-11-15,2016-11-15,Payment from Morgan-Foster,REF40656401,0.0,1557.0,119687.07
2016-11-17,2016-11-17,Marketing expenses,REF74882501,289.29,0.0,119397.78
2016-11-17,2016-11-17,Internet and phone service,REF22446469,119.61,0.0,119278.17
2016-11-18,2016-11-18,Internet and phone service,REF42500057,29.32,0.0,119248.85
2016-11-22,2016-11-22,Training/conference,REF94848685,102.36,0.0,119146.49
2016-11-26,2016-11-26,Office supplies,REF23434905,36.82,0.0,119109.67
2016-11-26,2016-11-26,Business travel,REF90484846,126.12,0.0,118983.55
2016-11-29,2016-11-29,Business travel,REF90373950,113.98,0.0,118869.57
2016-12-09,2016-12-09,Software subscription,REF97512846,135.94,0.0,118733.63
2016-12-10,2016-12-10,Internet and phone service,REF79595362,65.57,0.0,118668.06
2016-12-14,2016-12-14,Marketing expenses,REF14746680,208.89,0.0,118459.17
2016-12-15,2016-12-15,"Project payment - Hill, Adams and King",REF14371197,0.0,1314.59,119773.76
2016-12-15,2016-12-15,"Invoice payment - Patrick, Franklin and Martinez",REF93740513,0.0,1821.27,121595.03
2016-12-15,2016-12-15,Business insurance premium,REF75556396,104.2,0.0,121490.83
2016-12-15,2016-12-15,Project payment - Morgan-Foster,REF53690435,0.0,1231.15,122721.98
2016-12-17,2016-12-17,Office supplies,REF21283801,60.17,0.0,122661.81
2016-12-24,2016-12-24,Training/conference,REF90416681,80.61,0.0,122581.2
2016-12-26,2016-12-26,Business travel,REF27841326,150.31,0.0,122430.89
2016-12-28,2016-12-28,Business travel,REF81181325,128.74,0.0,122302.15
2016-12-29,2016-12-29,Business travel,REF67181481,125.72,0.0,122176.43
2017-01-01,2017-01-01,Office supplies,REF40744439,27.82,0.0,122148.61
2017-01-09,2017-01-09,Software subscription,REF76585127,117.24,0.0,122031.37
2017-01-09,2017-01-09,Office supplies,REF89988238,31.62,0.0,121999.75
2017-01-15,2017-01-15,Business insurance premium,REF71124675,104.74,0.0,121895.01
2017-01-15,2017-01-15,Invoice payment - Morgan-Foster,REF59045136,0.0,1053.19,122948.2
2017-01-15,2017-01-15,"Project payment - Patrick, Franklin and Martinez",REF34518877,0.0,1592.24,124540.44
2017-01-15,2017-01-15,"Payment from Hill, Adams and King",REF60971395,0.0,995.94,125536.38
2017-01-21,2017-01-21,Marketing expenses,REF54964829,147.74,0.0,125388.64
2017-01-21,2017-01-21,Office supplies,REF77923352,45.92,0.0,125342.72
2017-01-23,2017-01-23,Office supplies,REF32142601,18.11,0.0,125324.61
2017-01-25,2017-01-25,Office supplies,REF97159857,45.25,0.0,125279.36
2017-02-02,2017-02-02,Professional services,REF38357690,279.87,0.0,124999.49
2017-02-05,2017-02-05,Equipment purchase,REF19555221,65.23,0.0,124934.26
2017-02-05,2017-02-05,Office supplies,REF46193937,32.39,0.0,124901.87
2017-02-07,2017-02-07,Business travel,REF33290735,219.32,0.0,124682.55
2017-02-07,2017-02-07,Office supplies,REF67853123,43.75,0.0,124638.8
2017-02-09,2017-02-09,Training/conference,REF25446857,82.02,0.0,124556.78
2017-02-09,2017-02-09,Office supplies,REF42373265,32.98,0.0,124523.8
2017-02-09,2017-02-09,Software subscription,REF74863519,124.14,0.0,124399.66
2017-02-15,2017-02-15,"Project payment - Patrick, Franklin and Martinez",REF81243803,0.0,1681.65,126081.31
2017-02-15,2017-02-15,"Invoice payment - Hill, Adams and King",REF63041691,0.0,1132.16,127213.47
2017-02-15,2017-02-15,Service payment - Morgan-Foster,REF30619241,0.0,1178.4,128391.87
2017-02-15,2017-02-15,Business insurance premium,REF72836347,114.82,0.0,128277.05
2017-02-21,2017-02-21,Office supplies,REF58853715,65.17,0.0,128211.88
2017-02-22,2017-02-22,Professional services,REF94190640,84.26,0.0,128127.62
2017-02-23,2017-02-23,Equipment purchase,REF34592387,66.96,0.0,128060.66
2017-02-27,2017-02-27,Internet and phone service,REF85009913,87.81,0.0,127972.85
2017-03-03,2017-03-03,Office supplies,REF42919900,43.47,0.0,127929.38
2017-03-07,2017-03-07,Marketing expenses,REF59458676,230.87,0.0,127698.51
2017-03-07,2017-03-07,Office supplies,REF84764087,61.26,0.0,127637.25
2017-03-09,2017-03-09,Software subscription,REF99260267,146.88,0.0,127490.37
2017-03-14,2017-03-14,Office supplies,REF26008748,15.96,0.0,127474.41
2017-03-15,2017-03-15,Business insurance premium,REF20125256,137.36,0.0,127337.05
2017-03-15,2017-03-15,Invoice payment - Morgan-Foster,REF91077316,0.0,1424.39,128761.44
2017-03-15,2017-03-15,"Service payment - Hill, Adams and King",REF15923739,0.0,979.42,129740.86
2017-03-15,2017-03-15,"Service payment - Patrick, Franklin and Martinez",REF20508845,0.0,2276.8,132017.66
2017-03-22,2017-03-22,Office supplies,REF13332255,66.5,0.0,131951.16
2017-03-23,2017-03-23,Internet and phone service,REF13740393,100.71,0.0,131850.45
2017-03-24,2017-03-24,Business travel,REF19354673,105.93,0.0,131744.52
2017-03-26,2017-03-26,Training/conference,REF80617421,119.95,0.0,131624.57
2017-03-27,2017-03-27,Office supplies,REF30172015,51.13,0.0,131573.44
2017-03-29,2017-03-29,Business travel,REF11406379,137.7,0.0,131435.74
2017-03-29,2017-03-29,Professional services,REF97321801,405.07,0.0,131030.67
2017-03-30,2017-03-30,Office supplies,REF94501083,69.02,0.0,130961.65
2017-03-31,2017-03-31,Business travel,REF15169799,127.43,0.0,130834.22
2017-04-02,2017-04-02,Office supplies,REF72094002,69.04,0.0,130765.18
2017-04-05,2017-04-05,Office supplies,REF76483273,37.16,0.0,130728.02
2017-04-08,2017-04-08,Office supplies,REF38424710,62.93,0.0,130665.09
2017-04-09,2017-04-09,Software subscription,REF22194409,153.87,0.0,130511.22
2017-04-15,2017-04-15,Business insurance premium,REF76588844,117.99,0.0,130393.23
2017-04-15,2017-04-15,Project payment - Morgan-Foster,REF26285406,0.0,873.86,131267.09
2017-04-15,2017-04-15,"Payment from Patrick, Franklin and Martinez",REF53381034,0.0,2076.37,133343.46
2017-04-16,2017-04-16,Marketing expenses,REF14526363,203.47,0.0,133139.99
2017-04-17,2017-04-17,Business travel,REF77859731,79.18,0.0,133060.81
2017-04-21,2017-04-21,Business travel,REF32427173,156.1,0.0,132904.71
2017-04-21,2017-04-21,Office supplies,REF52013845,47.51,0.0,132857.2
2017-05-09,2017-05-09,Software subscription,REF45942060,136.24,0.0,132720.96
2017-05-09,2017-05-09,Equipment purchase,REF98751881,97.86,0.0,132623.1
2017-05-11,2017-05-11,Internet and phone service,REF29066207,65.03,0.0,132558.07
2017-05-15,2017-05-15,Business insurance premium,REF34445073,111.52,0.0,132446.55
2017-05-15,2017-05-15,Payment from Morgan-Foster,REF99866489,0.0,1038.28,133484.83
2017-05-15,2017-05-15,"Project payment - Patrick, Franklin and Martinez",REF70977727,0.0,1378.45,134863.28
2017-05-15,2017-05-15,"Invoice payment - Hill, Adams and King",REF30628692,0.0,1137.73,136001.01
2017-05-26,2017-05-26,Business travel,REF16384862,243.71,0.0,135757.3
2017-05-27,2017-05-27,Internet and phone service,REF73541059,61.47,0.0,135695.83
2017-05-27,2017-05-27,Marketing expenses,REF86968465,196.52,0.0,135499.31
2017-05-30,2017-05-30,Internet and phone service,REF93687594,87.92,0.0,135411.39
2017-06-03,2017-06-03,Training/conference,REF67923241,110.93,0.0,135300.46
2017-06-04,2017-06-04,Office supplies,REF32087019,55.2,0.0,135245.26
2017-06-05,2017-06-05,Office supplies,REF63579516,33.95,0.0,135211.31
2017-06-09,2017-06-09,Software subscription,REF65610664,166.24,0.0,135045.07
2017-06-15,2017-06-15,"Payment from Patrick, Franklin and Martinez",REF90259520,0.0,1788.08,136833.15
2017-06-15,2017-06-15,"Service payment - Hill, Adams and King",REF43520502,0.0,1007.87,137841.02
2017-06-15,2017-06-15,Business insurance premium,REF28140254,107.54,0.0,137733.48
2017-06-20,2017-06-20,Internet and phone service,REF31110909,46.18,0.0,137687.3
2017-06-20,2017-06-20,Marketing expenses,REF63233710,109.06,0.0,137578.24
2017-06-27,2017-06-27,Business travel,REF25375311,127.78,0.0,137450.46
2017-06-28,2017-06-28,Training/conference,REF46241253,109.49,0.0,137340.97
2017-06-28,2017-06-28,Equipment purchase,REF61929108,77.92,0.0,137263.05
2017-06-29,2017-06-29,Professional services,REF23603506,320.65,0.0,136942.4
2017-07-09,2017-07-09,Software subscription,REF58250175,123.95,0.0,136818.45
2017-07-15,2017-07-15,Business insurance premium,REF22461855,92.15,0.0,136726.3
2017-07-15,2017-07-15,Service payment - Morgan-Foster,REF97159315,0.0,781.88,137508.18
2017-07-15,2017-07-15,"Service payment - Hill, Adams and King",REF52676462,0.0,925.08,138433.26
2017-07-17,2017-07-17,Office supplies,REF74551109,32.18,0.0,138401.08
2017-07-18,2017-07-18,Business travel,REF90228636,115.84,0.0,138285.24
2017-07-19,2017-07-19,Equipment purchase,REF46442279,52.24,0.0,138233.0
2017-07-19,2017-07-19,Office supplies,REF82376630,13.19,0.0,138219.81
2017-07-25,2017-07-25,Office supplies,REF72663538,45.05,0.0,138174.76
2017-07-27,2017-07-27,Office supplies,REF35847665,24.45,0.0,138150.31
2017-07-31,2017-07-31,Training/conference,REF15327348,105.35,0.0,138044.96
2017-08-09,2017-08-09,Software subscription,REF97641629,112.28,0.0,137932.68
2017-08-10,2017-08-10,Training/conference,REF40909326,64.52,0.0,137868.16
2017-08-12,2017-08-12,Office supplies,REF96896329,49.18,0.0,137818.98
2017-08-15,2017-08-15,"Service payment - Hill, Adams and King",REF51416065,0.0,765.44,138584.42
2017-08-15,2017-08-15,Project payment - Morgan-Foster,REF29462869,0.0,700.28,139284.7
2017-08-15,2017-08-15,Business insurance premium,REF77369027,87.87,0.0,139196.83
2017-08-15,2017-08-15,"Payment from Patrick, Franklin and Martinez",REF55089149,0.0,1509.75,140706.58
2017-08-29,2017-08-29,Professional services,REF51293549,99.75,0.0,140606.83
2017-08-30,2017-08-30,Office supplies,REF11607095,18.29,0.0,140588.54
2017-08-30,2017-08-30,Marketing expenses,REF42908037,114.47,0.0,140474.07
2017-08-31,2017-08-31,Equipment purchase,REF91730156,75.84,0.0,140398.23
2017-09-01,2017-09-01,Office supplies,REF47550668,59.69,0.0,140338.54
2017-09-02,2017-09-02,Marketing expenses,REF35883375,232.37,0.0,140106.17
2017-09-03,2017-09-03,Office supplies,REF10801885,51.09,0.0,140055.08
2017-09-04,2017-09-04,Professional services,REF39706208,363.57,0.0,139691.51
2017-09-05,2017-09-05,Internet and phone service,REF62349418,85.31,0.0,139606.2
2017-09-06,2017-09-06,Equipment purchase,REF55261792,105.22,0.0,139500.98
2017-09-07,2017-09-07,Business travel,REF98446511,157.74,0.0,139343.24
2017-09-09,2017-09-09,Software subscription,REF33161183,166.98,0.0,139176.26
2017-09-15,2017-09-15,Business insurance premium,REF29304932,140.95,0.0,139035.31
2017-09-15,2017-09-15,Business travel,REF32372249,153.6,0.0,138881.71
2017-09-15,2017-09-15,"Project payment - Patrick, Franklin and Martinez",REF27184488,0.0,1771.44,140653.15
2017-09-15,2017-09-15,Payment from Morgan-Foster,REF66492037,0.0,1276.13,141929.28
2017-09-15,2017-09-15,"Service payment - Hill, Adams and King",REF84924120,0.0,1304.54,143233.82
2017-09-19,2017-09-19,Office supplies,REF50003556,64.1,0.0,143169.72
2017-09-21,2017-09-21,Internet and phone service,REF83197978,102.94,0.0,143066.78
2017-09-26,2017-09-26,Equipment purchase,REF69897060,154.2,0.0,142912.58
2017-10-02,2017-10-02,Equipment purchase,REF81004104,158.74,0.0,142753.84
2017-10-02,2017-10-02,Business travel,REF43446207,188.59,0.0,142565.25
2017-10-05,2017-10-05,Office supplies,REF54931882,83.13,0.0,142482.12
2017-10-09,2017-10-09,Software subscription,REF51063822,166.69,0.0,142315.43
2017-10-15,2017-10-15,"Service payment - Patrick, Franklin and Martinez",REF68004373,0.0,2485.42,144800.85
2017-10-15,2017-10-15,"Project payment - Hill, Adams and King",REF87898839,0.0,1210.39,146011.24
2017-10-15,2017-10-15,Payment from Morgan-Foster,REF38471954,0.0,1368.59,147379.83
2017-10-15,2017-10-15,Business insurance premium,REF23807951,146.72,0.0,147233.11
2017-10-18,2017-10-18,Training/conference,REF74518815,117.21,0.0,147115.9
2017-10-21,2017-10-21,Professional services,REF66218762,217.73,0.0,146898.17
2017-10-23,2017-10-23,Training/conference,REF72141738,109.4,0.0,146788.77
2017-10-27,2017-10-27,Office supplies,REF75593316,81.5,0.0,146707.27
2017-11-01,2017-11-01,Business travel,REF34339090,235.9,0.0,146471.37
2017-11-01,2017-11-01,Office supplies,REF76855313,56.7,0.0,146414.67
2017-11-02,2017-11-02,Office supplies,REF19037871,63.24,0.0,146351.43
2017-11-08,2017-11-08,Training/conference,REF22436811,109.84,0.0,146241.59
2017-11-09,2017-11-09,Software subscription,REF60129874,152.09,0.0,146089.5
2017-11-10,2017-11-10,Office supplies,REF14355735,9.63,0.0,146079.87
2017-11-11,2017-11-11,Office supplies,REF47700980,61.15,0.0,146018.72
2017-11-13,2017-11-13,Professional services,REF16316774,372.41,0.0,145646.31
2017-11-15,2017-11-15,"Invoice payment - Patrick, Franklin and Martinez",REF26753957,0.0,2266.65,147912.96
2017-11-15,2017-11-15,"Invoice payment - Hill, Adams and King",REF91618800,0.0,1125.0,149037.96
2017-11-15,2017-11-15,Business insurance premium,REF56371811,137.14,0.0,148900.82
2017-11-15,2017-11-15,Service payment - Morgan-Foster,REF61986430,0.0,1666.75,150567.57
2017-11-18,2017-11-18,Office supplies,REF39753420,36.27,0.0,150531.3
2017-11-19,2017-11-19,Internet and phone service,REF62301997,97.16,0.0,150434.14
2017-11-25,2017-11-25,Marketing expenses,REF68244879,247.07,0.0,150187.07
2017-11-27,2017-11-27,Office supplies,REF56035882,36.37,0.0,150150.7
2017-11-28,2017-11-28,Business travel,REF30877834,109.94,0.0,150040.76
2017-12-02,2017-12-02,Internet and phone service,REF57914397,71.82,0.0,149968.94
2017-12-06,2017-12-06,Office supplies,REF14176971,89.63,0.0,149879.31
2017-12-09,2017-12-09,Software subscription,REF11417903,140.85,0.0,149738.46
2017-12-09,2017-12-09,Business travel,REF29529034,110.82,0.0,149627.64
2017-12-15,2017-12-15,"Invoice payment - Patrick, Franklin and Martinez",REF71987254,0.0,1485.24,151112.88
2017-12-15,2017-12-15,Business insurance premium,REF79077441,107.74,0.0,151005.14
2017-12-15,2017-12-15,"Payment from Hill, Adams and King",REF71024950,0.0,969.7,151974.84
2017-12-15,2017-12-15,Project payment - Morgan-Foster,REF39347553,0.0,1207.87,153182.71
2017-12-17,2017-12-17,Internet and phone service,REF80396906,58.14,0.0,153124.57
2017-12-18,2017-12-18,Office supplies,REF34786023,46.82,0.0,153077.75
2017-12-30,2017-12-30,Office supplies,REF12353656,43.25,0.0,153034.5
2018-01-07,2018-01-07,Office supplies,REF23610254,33.82,0.0,153000.68
2018-01-09,2018-01-09,Software subscription,REF79190592,128.96,0.0,152871.72
2018-01-09,2018-01-09,Business travel,REF46651311,194.33,0.0,152677.39
2018-01-11,2018-01-11,Professional services,REF25344495,157.4,0.0,152519.99
2018-01-13,2018-01-13,Internet and phone service,REF91132942,69.95,0.0,152450.04
2018-01-15,2018-01-15,Invoice payment - Morgan-Foster,REF78490944,0.0,967.17,153417.21
2018-01-15,2018-01-15,"Payment from Patrick, Franklin and Martinez",REF91074279,0.0,1488.32,154905.53
2018-01-15,2018-01-15,"Payment from Hill, Adams and King",REF20454872,0.0,777.72,155683.25
2018-01-15,2018-01-15,Business insurance premium,REF51616172,95.7,0.0,155587.55
2018-01-20,2018-01-20,Business travel,REF44276523,80.15,0.0,155507.4
2018-01-25,2018-01-25,Office supplies,REF57116327,49.47,0.0,155457.93
2018-01-26,2018-01-26,Equipment purchase,REF77862898,71.21,0.0,155386.72
2018-01-29,2018-01-29,Office supplies,REF55689582,74.17,0.0,155312.55
2018-02-03,2018-02-03,Internet and phone service,REF76667250,100.12,0.0,155212.43
2018-02-05,2018-02-05,Internet and phone service,REF34764408,70.07,0.0,155142.36
2018-02-09,2018-02-09,Software subscription,REF87416788,134.1,0.0,155008.26
2018-02-15,2018-02-15,Business insurance premium,REF38291524,100.0,0.0,154908.26
2018-02-15,2018-02-15,"Project payment - Patrick, Franklin and Martinez",REF81078905,0.0,1620.52,156528.78
2018-02-15,2018-02-15,Service payment - Morgan-Foster,REF69185371,0.0,1274.25,157803.03
2018-02-20,2018-02-20,Office supplies,REF17311037,48.0,0.0,157755.03
2018-02-23,2018-02-23,Internet and phone service,REF58637165,51.45,0.0,157703.58
2018-02-28,2018-02-28,Equipment purchase,REF22053829,89.6,0.0,157613.98
2018-02-28,2018-02-28,Training/conference,REF68686280,131.49,0.0,157482.49
2018-03-02,2018-03-02,Office supplies,REF35444182,32.19,0.0,157450.3
2018-03-06,2018-03-06,Office supplies,REF69456295,61.88,0.0,157388.42
2018-03-07,2018-03-07,Internet and phone service,REF82814819,138.87,0.0,157249.55
2018-03-09,2018-03-09,Software subscription,REF80326419,196.61,0.0,157052.94
2018-03-11,2018-03-11,Marketing expenses,REF26783119,220.63,0.0,156832.31
2018-03-12,2018-03-12,Internet and phone service,REF13521526,81.97,0.0,156750.34
2018-03-13,2018-03-13,Business travel,REF74635858,150.65,0.0,156599.69
2018-03-15,2018-03-15,Invoice payment - Morgan-Foster,REF19030819,0.0,1435.34,158035.03
2018-03-15,2018-03-15,"Payment from Hill, Adams and King",REF67187232,0.0,981.73,159016.76
2018-03-15,2018-03-15,Office supplies,REF80537007,41.66,0.0,158975.1
2018-03-15,2018-03-15,Business insurance premium,REF32380169,130.6,0.0,158844.5
2018-03-17,2018-03-17,Office supplies,REF37207567,32.73,0.0,158811.77
2018-03-19,2018-03-19,Internet and phone service,REF29636555,55.98,0.0,158755.79
2018-03-20,2018-03-20,Equipment purchase,REF85530946,118.42,0.0,158637.37
2018-03-21,2018-03-21,Office supplies,REF54712224,80.97,0.0,158556.4
2018-03-25,2018-03-25,Business travel,REF37535485,186.49,0.0,158369.91
2018-03-25,2018-03-25,Equipment purchase,REF38244035,153.36,0.0,158216.55
2018-03-26,2018-03-26,Office supplies,REF36628546,40.2,0.0,158176.35
2018-03-28,2018-03-28,Office supplies,REF18021815,27.87,0.0,158148.48
2018-04-09,2018-04-09,Software subscription,REF31428946,158.63,0.0,157989.85
2018-04-11,2018-04-11,Equipment purchase,REF95522561,134.39,0.0,157855.46
2018-04-15,2018-04-15,Business insurance premium,REF51660017,127.98,0.0,157727.48
2018-04-15,2018-04-15,Internet and phone service,REF48610650,81.52,0.0,157645.96
2018-04-15,2018-04-15,"Service payment - Patrick, Franklin and Martinez",REF11426980,0.0,1760.3,159406.26
2018-04-15,2018-04-15,"Service payment - Hill, Adams and King",REF94435618,0.0,1318.76,160725.02
2018-04-17,2018-04-17,Training/conference,REF69761388,87.97,0.0,160637.05
2018-04-18,2018-04-18,Marketing expenses,REF90955000,267.08,0.0,160369.97
2018-04-19,2018-04-19,Office supplies,REF66043002,65.04,0.0,160304.93
2018-04-20,2018-04-20,Professional services,REF45563538,213.08,0.0,160091.85
2018-04-25,2018-04-25,Marketing expenses,REF89736622,283.65,0.0,159808.2
2018-04-28,2018-04-28,Business travel,REF24876123,122.18,0.0,159686.02
2018-04-30,2018-04-30,Office supplies,REF95719787,37.92,0.0,159648.1
2018-05-09,2018-05-09,Software subscription,REF68065652,140.55,0.0,159507.55
2018-05-15,2018-05-15,"Invoice payment - Patrick, Franklin and Martinez",REF66831638,0.0,1788.77,161296.32
2018-05-15,2018-05-15,"Invoice payment - Hill, Adams and King",REF65561341,0.0,910.13,162206.45
2018-05-15,2018-05-15,Business insurance premium,REF35843961,102.79,0.0,162103.66
2018-05-19,2018-05-19,Training/conference,REF32892299,47.77,0.0,162055.89
2018-05-20,2018-05-20,Equipment purchase,REF19630488,86.2,0.0,161969.69
2018-05-25,2018-05-25,Marketing expenses,REF64798904,347.54,0.0,161622.15
2018-05-27,2018-05-27,Professional services,REF39685727,233.03,0.0,161389.12
2018-05-27,2018-05-27,Office supplies,REF72205254,31.82,0.0,161357.3
2018-05-27,2018-05-27,Training/conference,REF22570123,76.47,0.0,161280.83
2018-05-28,2018-05-28,Marketing expenses,REF77291264,171.63,0.0,161109.2
2018-05-29,2018-05-29,Office supplies,REF72364646,41.89,0.0,161067.31
2018-06-02,2018-06-02,Internet and phone service,REF17379573,96.82,0.0,160970.49
2018-06-05,2018-06-05,Equipment purchase,REF78991597,31.55,0.0,160938.94
2018-06-06,2018-06-06,Equipment purchase,REF51174844,53.98,0.0,160884.96
2018-06-07,2018-06-07,Office supplies,REF74447715,39.3,0.0,160845.66
2018-06-09,2018-06-09,Software subscription,REF76172154,130.06,0.0,160715.6
2018-06-10,2018-06-10,Professional services,REF51385592,214.33,0.0,160501.27
2018-06-11,2018-06-11,Marketing expenses,REF17411797,208.29,0.0,160292.98
2018-06-12,2018-06-12,Training/conference,REF82343542,103.06,0.0,160189.92
2018-06-15,2018-06-15,Business insurance premium,REF48679874,109.26,0.0,160080.66
2018-06-15,2018-06-15,"Invoice payment - Patrick, Franklin and Martinez",REF35386943,0.0,1767.84,161848.5
2018-06-15,2018-06-15,"Invoice payment - Hill, Adams and King",REF19778331,0.0,898.73,162747.23
2018-06-16,2018-06-16,Marketing expenses,REF48275291,191.11,0.0,162556.12
2018-06-18,2018-06-18,Marketing expenses,REF58081176,201.34,0.0,162354.78
2018-06-24,2018-06-24,Office supplies,REF16683629,70.85,0.0,162283.93
2018-06-28,2018-06-28,Office supplies,REF34385379,28.86,0.0,162255.07
2018-06-29,2018-06-29,Equipment purchase,REF13373639,110.71,0.0,162144.36
2018-07-03,2018-07-03,Office supplies,REF37680840,26.43,0.0,162117.93
2018-07-09,2018-07-09,Software subscription,REF10416884,113.91,0.0,162004.02
2018-07-10,2018-07-10,Office supplies,REF34667174,31.23,0.0,161972.79
2018-07-15,2018-07-15,"Invoice payment - Hill, Adams and King",REF17614423,0.0,731.4,162704.19
2018-07-15,2018-07-15,Business insurance premium,REF73056873,94.89,0.0,162609.3
2018-07-15,2018-07-15,Invoice payment - Morgan-Foster,REF67756949,0.0,1293.11,163902.41
2018-07-15,2018-07-15,"Invoice payment - Patrick, Franklin and Martinez",REF22728052,0.0,1422.81,165325.22
2018-07-20,2018-07-20,Training/conference,REF78074603,97.5,0.0,165227.72
2018-07-22,2018-07-22,Office supplies,REF71652696,63.05,0.0,165164.67
2018-07-28,2018-07-28,Office supplies,REF39384933,27.7,0.0,165136.97
2018-07-28,2018-07-28,Internet and phone service,REF84258264,63.98,0.0,165072.99
2018-07-30,2018-07-30,Professional services,REF41187658,198.56,0.0,164874.43
2018-08-04,2018-08-04,Professional services,REF81181741,167.27,0.0,164707.16
2018-08-05,2018-08-05,Office supplies,REF65920807,30.01,0.0,164677.15
2018-08-09,2018-08-09,Software subscription,REF15167095,107.4,0.0,164569.75
2018-08-09,2018-08-09,Office supplies,REF73695574,16.97,0.0,164552.78
2018-08-09,2018-08-09,Professional services,REF30078636,205.61,0.0,164347.17
2018-08-11,2018-08-11,Business travel,REF55450030,109.19,0.0,164237.98
2018-08-11,2018-08-11,Office supplies,REF55906247,26.56,0.0,164211.42
2018-08-12,2018-08-12,Training/conference,REF77496215,43.48,0.0,164167.94
2018-08-14,2018-08-14,Business travel,REF57471838,70.57,0.0,164097.37
2018-08-14,2018-08-14,Equipment purchase,REF45354123,39.41,0.0,164057.96
2018-08-15,2018-08-15,Business insurance premium,REF94066811,82.18,0.0,163975.78
2018-08-15,2018-08-15,"Project payment - Patrick, Franklin and Martinez",REF35228749,0.0,1648.44,165624.22
2018-08-15,2018-08-15,Payment from Morgan-Foster,REF31721665,0.0,696.19,166320.41
2018-08-15,2018-08-15,"Project payment - Hill, Adams and King",REF52142668,0.0,777.73,167098.14
2018-08-23,2018-08-23,Office supplies,REF97797032,51.29,0.0,167046.85
2018-08-24,2018-08-24,Equipment purchase,REF38673744,45.61,0.0,167001.24
2018-08-29,2018-08-29,Internet and phone service,REF37979930,83.11,0.0,166918.13
2018-08-29,2018-08-29,Training/conference,REF97778713,78.18,0.0,166839.95
2018-08-29,2018-08-29,Marketing expenses,REF82581009,202.48,0.0,166637.47
2018-08-31,2018-08-31,Office supplies,REF62260215,26.51,0.0,166610.96
2018-09-02,2018-09-02,Office supplies,REF62904440,61.82,0.0,166549.14
2018-09-04,2018-09-04,Training/conference,REF61925712,87.57,0.0,166461.57
2018-09-05,2018-09-05,Professional services,REF76672602,175.97,0.0,166285.6
2018-09-06,2018-09-06,Business travel,REF89901689,127.39,0.0,166158.21
2018-09-07,2018-09-07,Professional services,REF95547120,190.5,0.0,165967.71
2018-09-09,2018-09-09,Office supplies,REF12016306,59.12,0.0,165908.59
2018-09-09,2018-09-09,Software subscription,REF53656694,178.06,0.0,165730.53
2018-09-11,2018-09-11,Equipment purchase,REF71170741,40.23,0.0,165690.3
2018-09-13,2018-09-13,Business travel,REF91363864,176.01,0.0,165514.29
2018-09-15,2018-09-15,Business insurance premium,REF32468194,121.18,0.0,165393.11
2018-09-15,2018-09-15,Office supplies,REF20143362,78.69,0.0,165314.42
2018-09-15,2018-09-15,Invoice payment - Morgan-Foster,REF84745041,0.0,1403.42,166717.84
2018-09-15,2018-09-15,"Project payment - Patrick, Franklin and Martinez",REF94370744,0.0,1662.84,168380.68
2018-09-15,2018-09-15,"Service payment - Hill, Adams and King",REF99340302,0.0,1159.34,169540.02
2018-09-16,2018-09-16,Office supplies,REF77954824,42.1,0.0,169497.92
2018-09-18,2018-09-18,Office supplies,REF75388561,60.27,0.0,169437.65
2018-09-18,2018-09-18,Business travel,REF42701637,238.38,0.0,169199.27
2018-09-27,2018-09-27,Business travel,REF33944010,208.03,0.0,168991.24
2018-10-09,2018-10-09,Software subscription,REF43308977,176.34,0.0,168814.9
2018-10-09,2018-10-09,Business travel,REF11905900,190.22,0.0,168624.68
2018-10-15,2018-10-15,"Project payment - Patrick, Franklin and Martinez",REF72299502,0.0,2612.88,171237.56
2018-10-15,2018-10-15,Service payment - Morgan-Foster,REF43647354,0.0,1320.46,172558.02
2018-10-15,2018-10-15,Business insurance premium,REF57060732,140.94,0.0,172417.08
2018-10-15,2018-10-15,"Service payment - Hill, Adams and King",REF66609120,0.0,1183.56,173600.64
2018-10-16,2018-10-16,Office supplies,REF24680211,64.14,0.0,173536.5
2018-10-18,2018-10-18,Office supplies,REF68662199,54.61,0.0,173481.89
2018-10-19,2018-10-19,Marketing expenses,REF53190635,341.55,0.0,173140.34
2018-10-20,2018-10-20,Office supplies,REF47613303,42.16,0.0,173098.18
2018-10-21,2018-10-21,Office supplies,REF78310530,34.87,0.0,173063.31
2018-10-23,2018-10-23,Marketing expenses,REF32623024,252.06,0.0,172811.25
2018-10-24,2018-10-24,Office supplies,REF81501188,64.37,0.0,172746.88
2018-10-26,2018-10-26,Office supplies,REF12501925,43.15,0.0,172703.73
2018-10-29,2018-10-29,Professional services,REF51067499,324.4,0.0,172379.33
2018-10-29,2018-10-29,Marketing expenses,REF48007941,305.45,0.0,172073.88
2018-11-03,2018-11-03,Internet and phone service,REF37584902,84.39,0.0,171989.49
2018-11-03,2018-11-03,Professional services,REF12984190,249.37,0.0,171740.12
2018-11-07,2018-11-07,Equipment purchase,REF12355593,127.22,0.0,171612.9
2018-11-09,2018-11-09,Software subscription,REF68824697,168.54,0.0,171444.36
2018-11-15,2018-11-15,"Invoice payment - Hill, Adams and King",REF12390148,0.0,1362.07,172806.43
2018-11-15,2018-11-15,"Project payment - Patrick, Franklin and Martinez",REF64318832,0.0,1519.72,174326.15
2018-11-15,2018-11-15,Business insurance premium,REF18739829,133.61,0.0,174192.54
2018-11-15,2018-11-15,Project payment - Morgan-Foster,REF42369007,0.0,1306.45,175498.99
2018-11-18,2018-11-18,Office supplies,REF73034361,49.04,0.0,175449.95
2018-11-18,2018-11-18,Equipment purchase,REF94090161,123.76,0.0,175326.19
2018-11-21,2018-11-21,Equipment purchase,REF46341632,121.62,0.0,175204.57
2018-11-21,2018-11-21,Office supplies,REF65473757,46.04,0.0,175158.53
2018-11-22,2018-11-22,Business travel,REF45091799,119.92,0.0,175038.61
2018-11-22,2018-11-22,Marketing expenses,REF59690156,223.14,0.0,174815.47
2018-11-23,2018-11-23,Internet and phone service,REF84161164,132.49,0.0,174682.98
2018-11-27,2018-11-27,Marketing expenses,REF23579653,233.91,0.0,174449.07
2018-12-03,2018-12-03,Equipment purchase,REF46248533,100.57,0.0,174348.5
2018-12-08,2018-12-08,Office supplies,REF90439750,33.47,0.0,174315.03
2018-12-09,2018-12-09,Software subscription,REF59717265,115.87,0.0,174199.16
2018-12-15,2018-12-15,Business insurance premium,REF63016984,104.66,0.0,174094.5
2018-12-15,2018-12-15,"Project payment - Patrick, Franklin and Martinez",REF66829988,0.0,1759.61,175854.11
2018-12-15,2018-12-15,"Payment from Hill, Adams and King",REF56127976,0.0,984.07,176838.18
2018-12-16,2018-12-16,Business travel,REF32428763,171.9,0.0,176666.28
2018-12-21,2018-12-21,Office supplies,REF79978086,62.71,0.0,176603.57
2018-12-27,2018-12-27,Business travel,REF14565687,153.4,0.0,176450.17
2018-12-29,2018-12-29,Office supplies,REF10843826,48.75,0.0,176401.42
2018-12-31,2018-12-31,Business travel,REF40035378,149.5,0.0,176251.92
2019-01-02,2019-01-02,Office supplies,REF45722398,44.54,0.0,176207.38
2019-01-03,2019-01-03,Training/conference,REF86377267,118.33,0.0,176089.05
2019-01-07,2019-01-07,Office supplies,REF32620671,22.28,0.0,176066.77
2019-01-08,2019-01-08,Equipment purchase,REF64166562,84.82,0.0,175981.95
2019-01-09,2019-01-09,Software subscription,REF58747286,131.66,0.0,175850.29
2019-01-11,2019-01-11,Professional services,REF49354830,123.85,0.0,175726.44
2019-01-15,2019-01-15,Business insurance premium,REF48582849,98.41,0.0,175628.03
2019-01-15,2019-01-15,Project payment - Morgan-Foster,REF72265523,0.0,1174.31,176802.34
2019-01-15,2019-01-15,"Payment from Hill, Adams and King",REF52075317,0.0,766.91,177569.25
2019-01-15,2019-01-15,"Payment from Patrick, Franklin and Martinez",REF40045534,0.0,1510.15,179079.4
2019-01-27,2019-01-27,Internet and phone service,REF92523084,87.19,0.0,178992.21
2019-01-31,2019-01-31,Equipment purchase,REF45090058,52.58,0.0,178939.63
2019-01-31,2019-01-31,Business travel,REF89694391,86.08,0.0,178853.55
2019-01-31,2019-01-31,Training/conference,REF75881615,88.36,0.0,178765.19
2019-02-08,2019-02-08,Office supplies,REF82506864,33.28,0.0,178731.91
2019-02-09,2019-02-09,Software subscription,REF52207305,142.89,0.0,178589.02
2019-02-12,2019-02-12,Training/conference,REF13787578,63.69,0.0,178525.33
2019-02-13,2019-02-13,Internet and phone service,REF87396806,41.14,0.0,178484.19
2019-02-15,2019-02-15,Business insurance premium,REF83302678,101.66,0.0,178382.53
2019-02-15,2019-02-15,Invoice payment - Morgan-Foster,REF29835354,0.0,942.75,179325.28
2019-02-15,2019-02-15,"Project payment - Hill, Adams and King",REF37944015,0.0,1050.57,180375.85
2019-02-15,2019-02-15,"Payment from Patrick, Franklin and Martinez",REF56994314,0.0,1328.62,181704.47
2019-02-22,2019-02-22,Training/conference,REF92434445,103.03,0.0,181601.44
2019-02-26,2019-02-26,Office supplies,REF49288581,16.05,0.0,181585.39
2019-02-26,2019-02-26,Marketing expenses,REF39583999,190.2,0.0,181395.19
2019-03-07,2019-03-07,Business travel,REF60203670,203.28,0.0,181191.91
2019-03-09,2019-03-09,Software subscription,REF84513234,163.99,0.0,181027.92
2019-03-09,2019-03-09,Equipment purchase,REF98909210,111.44,0.0,180916.48
2019-03-12,2019-03-12,Marketing expenses,REF66439889,249.51,0.0,180666.97
2019-03-14,2019-03-14,Office supplies,REF92916045,33.81,0.0,180633.16
2019-03-15,2019-03-15,Business insurance premium,REF92993622,134.65,0.0,180498.51
2019-03-15,2019-03-15,"Project payment - Patrick, Franklin and Martinez",REF84051553,0.0,1914.76,182413.27
2019-03-15,2019-03-15,"Payment from Hill, Adams and King",REF30777394,0.0,930.62,183343.89
2019-03-15,2019-03-15,Project payment - Morgan-Foster,REF96645987,0.0,1430.78,184774.67
2019-03-18,2019-03-18,Business travel,REF92147910,132.23,0.0,184642.44
2019-03-21,2019-03-21,Business travel,REF43894684,121.52,0.0,184520.92
2019-03-22,2019-03-22,Business travel,REF61265021,161.7,0.0,184359.22
2019-03-22,2019-03-22,Office supplies,REF21846375,39.68,0.0,184319.54
2019-03-26,2019-03-26,Professional services,REF37059476,276.08,0.0,184043.46
2019-03-27,2019-03-27,Training/conference,REF38584976,114.35,0.0,183929.11
2019-03-28,2019-03-28,Business travel,REF58639851,143.91,0.0,183785.2
2019-03-30,2019-03-30,Professional services,REF94151139,240.04,0.0,183545.16
2019-04-05,2019-04-05,Office supplies,REF57204637,46.46,0.0,183498.7
2019-04-09,2019-04-09,Software subscription,REF46442843,146.29,0.0,183352.41
2019-04-09,2019-04-09,Training/conference,REF50557016,125.74,0.0,183226.67
2019-04-10,2019-04-10,Professional services,REF77139736,304.33,0.0,182922.34
2019-04-14,2019-04-14,Business travel,REF89232781,102.59,0.0,182819.75
2019-04-15,2019-04-15,Invoice payment - Morgan-Foster,REF76675665,0.0,1292.68,184112.43
2019-04-15,2019-04-15,"Payment from Hill, Adams and King",REF20613909,0.0,736.32,184848.75
2019-04-15,2019-04-15,"Invoice payment - Patrick, Franklin and Martinez",REF48270297,0.0,1916.11,186764.86
2019-04-15,2019-04-15,Business insurance premium,REF31221487,123.16,0.0,186641.7
2019-04-20,2019-04-20,Business travel,REF72981066,222.26,0.0,186419.44
2019-04-23,2019-04-23,Office supplies,REF67073929,65.19,0.0,186354.25
2019-04-28,2019-04-28,Marketing expenses,REF33089461,246.98,0.0,186107.27
2019-05-02,2019-05-02,Equipment purchase,REF19430506,61.04,0.0,186046.23
2019-05-04,2019-05-04,Office supplies,REF13727395,74.21,0.0,185972.02
2019-05-04,2019-05-04,Equipment purchase,REF80103330,103.52,0.0,185868.5
2019-05-09,2019-05-09,Software subscription,REF73191772,175.31,0.0,185693.19
2019-05-09,2019-05-09,Business travel,REF24012330,109.0,0.0,185584.19
2019-05-12,2019-05-12,Equipment purchase,REF69734439,97.5,0.0,185486.69
2019-05-15,2019-05-15,Business insurance premium,REF55582035,108.12,0.0,185378.57
2019-05-15,2019-05-15,Project payment - Morgan-Foster,REF98856604,0.0,1318.82,186697.39
2019-05-15,2019-05-15,"Invoice payment - Patrick, Franklin and Martinez",REF26454306,0.0,2296.78,188994.17
2019-05-15,2019-05-15,"Payment from Hill, Adams and King",REF33997472,0.0,911.82,189905.99
2019-05-19,2019-05-19,Marketing expenses,REF11355049,294.17,0.0,189611.82
2019-05-21,2019-05-21,Office supplies,REF94958404,71.77,0.0,189540.05
2019-05-23,2019-05-23,Training/conference,REF83855921,100.22,0.0,189439.83
2019-05-23,2019-05-23,Office supplies,REF71413352,57.51,0.0,189382.32
2019-05-26,2019-05-26,Training/conference,REF92626328,50.11,0.0,189332.21
2019-05-27,2019-05-27,Training/conference,REF71280641,182.3,0.0,189149.91
2019-05-29,2019-05-29,Office supplies,REF32754411,52.44,0.0,189097.47
2019-06-01,2019-06-01,Marketing expenses,REF20837434,120.68,0.0,188976.79
2019-06-04,2019-06-04,Business travel,REF91302573,212.1,0.0,188764.69
2019-06-06,2019-06-06,Professional services,REF85371436,189.07,0.0,188575.62
2019-06-09,2019-06-09,Software subscription,REF76255296,141.24,0.0,188434.38
2019-06-11,2019-06-11,Business travel,REF61694798,120.43,0.0,188313.95
2019-06-14,2019-06-14,Business travel,REF70940736,108.35,0.0,188205.6
2019-06-14,2019-06-14,Office supplies,REF11848622,44.8,0.0,188160.8
2019-06-15,2019-06-15,Business insurance premium,REF32287884,99.59,0.0,188061.21
2019-06-15,2019-06-15,"Project payment - Hill, Adams and King",REF87051893,0.0,781.47,188842.68
2019-06-15,2019-06-15,"Service payment - Patrick, Franklin and Martinez",REF87549542,0.0,1856.49,190699.17
2019-06-15,2019-06-15,Service payment - Morgan-Foster,REF74438902,0.0,1272.68,191971.85
2019-06-21,2019-06-21,Professional services,REF28295411,278.13,0.0,191693.72
2019-06-21,2019-06-21,Business travel,REF22627285,152.9,0.0,191540.82
2019-06-21,2019-06-21,Equipment purchase,REF15485003,68.95,0.0,191471.87
2019-06-22,2019-06-22,Professional services,REF31394909,244.54,0.0,191227.33
2019-06-25,2019-06-25,Office supplies,REF10365155,52.07,0.0,191175.26
2019-07-03,2019-07-03,Office supplies,REF95295808,55.19,0.0,191120.07
2019-07-05,2019-07-05,Business travel,REF60016918,78.94,0.0,191041.13
2019-07-05,2019-07-05,Training/conference,REF74542225,117.32,0.0,190923.81
2019-07-06,2019-07-06,Marketing expenses,REF57197474,157.47,0.0,190766.34
2019-07-09,2019-07-09,Software subscription,REF10855348,119.13,0.0,190647.21
2019-07-10,2019-07-10,Equipment purchase,REF21239463,95.14,0.0,190552.07
2019-07-15,2019-07-15,Business insurance premium,REF74992746,91.22,0.0,190460.85
2019-07-15,2019-07-15,Project payment - Morgan-Foster,REF93280000,0.0,881.46,191342.31
2019-07-15,2019-07-15,"Project payment - Hill, Adams and King",REF61065126,0.0,802.73,192145.04
2019-07-15,2019-07-15,"Service payment - Patrick, Franklin and Martinez",REF81619960,0.0,1430.4,193575.44
2019-07-19,2019-07-19,Office supplies,REF50100640,30.15,0.0,193545.29
2019-07-23,2019-07-23,Training/conference,REF51476420,109.2,0.0,193436.09
2019-07-26,2019-07-26,Business travel,REF93621541,80.15,0.0,193355.94
2019-07-26,2019-07-26,Training/conference,REF28747522,79.18,0.0,193276.76
2019-07-28,2019-07-28,Business travel,REF10637287,130.23,0.0,193146.53
2019-07-29,2019-07-29,Office supplies,REF73659034,51.95,0.0,193094.58
2019-08-06,2019-08-06,Marketing expenses,REF41918010,163.78,0.0,192930.8
2019-08-06,2019-08-06,Office supplies,REF98692975,36.25,0.0,192894.55
2019-08-08,2019-08-08,Business travel,REF57240745,111.53,0.0,192783.02
2019-08-09,2019-08-09,Software subscription,REF40279984,113.61,0.0,192669.41
2019-08-10,2019-08-10,Office supplies,REF24618012,35.09,0.0,192634.32
2019-08-14,2019-08-14,Professional services,REF51567013,38.63,0.0,192595.69
2019-08-14,2019-08-14,Office supplies,REF40410023,45.08,0.0,192550.61
2019-08-15,2019-08-15,Business insurance premium,REF98209958,86.04,0.0,192464.57
2019-08-15,2019-08-15,"Payment from Patrick, Franklin and Martinez",REF48398102,0.0,1235.04,193699.61
2019-08-15,2019-08-15,Invoice payment - Morgan-Foster,REF49804278,0.0,578.28,194277.89
2019-08-15,2019-08-15,"Project payment - Hill, Adams and King",REF80509790,0.0,535.85,194813.74
2019-08-21,2019-08-21,Equipment purchase,REF21446097,95.29,0.0,194718.45
2019-08-23,2019-08-23,Training/conference,REF75346604,85.47,0.0,194632.98
2019-08-31,2019-08-31,Office supplies,REF43138241,63.71,0.0,194569.27
2019-09-06,2019-09-06,Professional services,REF79666103,183.17,0.0,194386.1
2019-09-09,2019-09-09,Software subscription,REF81238838,161.97,0.0,194224.13
2019-09-11,2019-09-11,Training/conference,REF99081203,125.56,0.0,194098.57
2019-09-15,2019-09-15,"Invoice payment - Hill, Adams and King",REF10648575,0.0,1054.18,195152.75
2019-09-15,2019-09-15,"Service payment - Patrick, Franklin and Martinez",REF85379418,0.0,1750.41,196903.16
2019-09-15,2019-09-15,Payment from Morgan-Foster,REF10669554,0.0,1388.96,198292.12
2019-09-15,2019-09-15,Business insurance premium,REF55714581,135.03,0.0,198157.09
2019-09-19,2019-09-19,Equipment purchase,REF58817775,123.89,0.0,198033.2
2019-09-23,2019-09-23,Business travel,REF37947952,57.66,0.0,197975.54
2019-09-24,2019-09-24,Office supplies,REF78113852,26.21,0.0,197949.33
2019-09-26,2019-09-26,Office supplies,REF86848478,57.08,0.0,197892.25
2019-09-29,2019-09-29,Office supplies,REF59941134,51.33,0.0,197840.92
2019-10-03,2019-10-03,Marketing expenses,REF83409955,128.81,0.0,197712.11
2019-10-04,2019-10-04,Internet and phone service,REF23434748,80.64,0.0,197631.47
2019-10-09,2019-10-09,Software subscription,REF99714101,177.56,0.0,197453.91
2019-10-10,2019-10-10,Business travel,REF24299338,188.53,0.0,197265.38
2019-10-15,2019-10-15,Business insurance premium,REF41486023,131.2,0.0,197134.18
2019-10-15,2019-10-15,Payment from Morgan-Foster,REF24438052,0.0,1356.73,198490.91
2019-10-15,2019-10-15,"Payment from Hill, Adams and King",REF47255726,0.0,1131.92,199622.83
2019-10-15,2019-10-15,"Project payment - Patrick, Franklin and Martinez",REF16245689,0.0,1937.96,201560.79
2019-10-17,2019-10-17,Training/conference,REF63509585,212.54,0.0,201348.25
2019-10-17,2019-10-17,Business travel,REF53163218,200.47,0.0,201147.78
2019-10-19,2019-10-19,Equipment purchase,REF59986914,135.96,0.0,201011.82
2019-10-22,2019-10-22,Office supplies,REF70769658,72.87,0.0,200938.95
2019-10-24,2019-10-24,Marketing expenses,REF10616962,359.05,0.0,200579.9
2019-10-26,2019-10-26,Office supplies,REF30312531,78.28,0.0,200501.62
2019-10-31,2019-10-31,Professional services,REF94092428,322.61,0.0,200179.01
2019-11-03,2019-11-03,Business travel,REF14097773,268.49,0.0,199910.52
2019-11-04,2019-11-04,Business travel,REF28329990,178.76,0.0,199731.76
2019-11-04,2019-11-04,Office supplies,REF89285417,82.02,0.0,199649.74
2019-11-07,2019-11-07,Professional services,REF88360981,276.1,0.0,199373.64
2019-11-09,2019-11-09,Software subscription,REF46176677,158.66,0.0,199214.98
2019-11-12,2019-11-12,Marketing expenses,REF97924916,249.24,0.0,198965.74
2019-11-12,2019-11-12,Professional services,REF69234146,279.93,0.0,198685.81
2019-11-15,2019-11-15,Business insurance premium,REF19784519,139.11,0.0,198546.7
2019-11-15,2019-11-15,Service payment - Morgan-Foster,REF59389798,0.0,1155.04,199701.74
2019-11-15,2019-11-15,"Project payment - Hill, Adams and King",REF14985125,0.0,1028.29,200730.03
2019-11-15,2019-11-15,Office supplies,REF56915326,42.56,0.0,200687.47
2019-11-15,2019-11-15,"Project payment - Patrick, Franklin and Martinez",REF56261508,0.0,1546.24,202233.71
2019-11-21,2019-11-21,Training/conference,REF77680760,98.15,0.0,202135.56
2019-11-29,2019-11-29,Office supplies,REF55718221,86.22,0.0,202049.34
2019-11-30,2019-11-30,Equipment purchase,REF19530794,146.05,0.0,201903.29
2019-12-03,2019-12-03,Office supplies,REF44235130,45.25,0.0,201858.04
2019-12-06,2019-12-06,Internet and phone service,REF65087172,84.26,0.0,201773.78
2019-12-07,2019-12-07,Internet and phone service,REF49166761,110.01,0.0,201663.77
2019-12-07,2019-12-07,Business travel,REF59501345,164.94,0.0,201498.83
2019-12-09,2019-12-09,Software subscription,REF25363803,142.76,0.0,201356.07
2019-12-12,2019-12-12,Office supplies,REF23096695,49.77,0.0,201306.3
2019-12-12,2019-12-12,Business travel,REF85203558,169.26,0.0,201137.04
2019-12-15,2019-12-15,Business insurance premium,REF76877887,99.02,0.0,201038.02
2019-12-15,2019-12-15,Marketing expenses,REF88697279,144.01,0.0,200894.01
2019-12-15,2019-12-15,Equipment purchase,REF76190020,61.05,0.0,200832.96
2019-12-15,2019-12-15,"Payment from Hill, Adams and King",REF93758978,0.0,772.03,201604.99
2019-12-16,2019-12-16,Office supplies,REF33972584,19.05,0.0,201585.94
2019-12-18,2019-12-18,Office supplies,REF42800206,19.36,0.0,201566.58
2019-12-21,2019-12-21,Office supplies,REF88148276,65.08,0.0,201501.5
2019-12-26,2019-12-26,Training/conference,REF14394035,100.55,0.0,201400.95
2019-12-27,2019-12-27,Office supplies,REF44359651,38.71,0.0,201362.24
2019-12-30,2019-12-30,Professional services,REF85568671,353.42,0.0,201008.82
2020-01-09,2020-01-09,Software subscription,REF83301213,96.63,0.0,200912.19
2020-01-12,2020-01-12,Business travel,REF92756779,115.14,0.0,200797.05
2020-01-15,2020-01-15,"Invoice payment - Hill, Adams and King",REF39325773,0.0,916.83,201713.88
2020-01-15,2020-01-15,Business insurance premium,REF15383360,89.97,0.0,201623.91
2020-01-15,2020-01-15,Invoice payment - Morgan-Foster,REF27668266,0.0,1031.26,202655.17
2020-01-15,2020-01-15,"Payment from Patrick, Franklin and Martinez",REF47759450,0.0,1808.38,204463.55
2020-01-16,2020-01-16,Equipment purchase,REF72948605,36.79,0.0,204426.76
2020-01-20,2020-01-20,Professional services,REF24036261,276.69,0.0,204150.07
2020-01-30,2020-01-30,Equipment purchase,REF12367554,46.36,0.0,204103.71
2020-01-31,2020-01-31,Office supplies,REF86326078,24.56,0.0,204079.15
2020-02-06,2020-02-06,Internet and phone service,REF15749185,79.41,0.0,203999.74
2020-02-09,2020-02-09,Software subscription,REF60193698,139.96,0.0,203859.78
2020-02-12,2020-02-12,Office supplies,REF94001004,39.59,0.0,203820.19
2020-02-15,2020-02-15,"Invoice payment - Patrick, Franklin and Martinez",REF13449184,0.0,1581.53,205401.72
2020-02-15,2020-02-15,"Invoice payment - Hill, Adams and King",REF16366890,0.0,879.31,206281.03
2020-02-15,2020-02-15,Business insurance premium,REF67659868,107.74,0.0,206173.29
2020-02-22,2020-02-22,Business travel,REF34858080,191.68,0.0,205981.61
2020-02-22,2020-02-22,Marketing expenses,REF16474549,109.35,0.0,205872.26
2020-03-02,2020-03-02,Office supplies,REF13621586,57.06,0.0,205815.2
2020-03-05,2020-03-05,Equipment purchase,REF10696519,102.19,0.0,205713.01
2020-03-06,2020-03-06,Office supplies,REF27974945,69.26,0.0,205643.75
2020-03-09,2020-03-09,Software subscription,REF21873897,159.6,0.0,205484.15
2020-03-14,2020-03-14,Office supplies,REF88639237,43.54,0.0,205440.61
2020-03-14,2020-03-14,Internet and phone service,REF66593522,66.65,0.0,205373.96
2020-03-15,2020-03-15,Business insurance premium,REF54556059,127.61,0.0,205246.35
2020-03-15,2020-03-15,"Project payment - Hill, Adams and King",REF64900840,0.0,1111.74,206358.09
2020-03-15,2020-03-15,"Service payment - Patrick, Franklin and Martinez",REF91463323,0.0,2014.05,208372.14
2020-03-15,2020-03-15,Project payment - Morgan-Foster,REF41277108,0.0,1540.76,209912.9
2020-03-17,2020-03-17,Office supplies,REF45997433,73.41,0.0,209839.49
2020-03-18,2020-03-18,Marketing expenses,REF43555655,187.26,0.0,209652.23
2020-03-20,2020-03-20,Marketing expenses,REF80955011,186.34,0.0,209465.89
2020-03-29,2020-03-29,Marketing expenses,REF93782814,195.33,0.0,209270.56
2020-04-02,2020-04-02,Equipment purchase,REF21008909,65.44,0.0,209205.12
2020-04-04,2020-04-04,Professional services,REF85676819,279.91,0.0,208925.21
2020-04-09,2020-04-09,Software subscription,REF34743332,162.67,0.0,208762.54
2020-04-11,2020-04-11,Professional services,REF69358746,169.57,0.0,208592.97
2020-04-11,2020-04-11,Business travel,REF65467756,154.22,0.0,208438.75
2020-04-15,2020-04-15,Business insurance premium,REF34856005,121.11,0.0,208317.64
2020-04-15,2020-04-15,"Service payment - Patrick, Franklin and Martinez",REF65260962,0.0,1352.39,209670.03
2020-04-15,2020-04-15,Project payment - Morgan-Foster,REF91434575,0.0,1292.37,210962.4
2020-04-15,2020-04-15,"Invoice payment - Hill, Adams and King",REF19531868,0.0,1235.9,212198.3
2020-04-15,2020-04-15,Marketing expenses,REF84019973,236.48,0.0,211961.82
2020-04-17,2020-04-17,Office supplies,REF65266190,73.39,0.0,211888.43
2020-04-23,2020-04-23,Business travel,REF92163008,156.06,0.0,211732.37
2020-04-24,2020-04-24,Office supplies,REF19318405,36.73,0.0,211695.64
2020-04-24,2020-04-24,Internet and phone service,REF36576790,60.05,0.0,211635.59
2020-04-24,2020-04-24,Equipment purchase,REF44429158,118.17,0.0,211517.42
2020-04-25,2020-04-25,Internet and phone service,REF41240441,76.6,0.0,211440.82
2020-04-28,2020-04-28,Office supplies,REF33093520,49.44,0.0,211391.38
2020-04-30,2020-04-30,Internet and phone service,REF56805442,115.07,0.0,211276.31
2020-05-05,2020-05-05,Office supplies,REF76363294,60.03,0.0,211216.28
2020-05-06,2020-05-06,Business travel,REF46215468,135.11,0.0,211081.17
2020-05-08,2020-05-08,Marketing expenses,REF25134763,153.78,0.0,210927.39
2020-05-08,2020-05-08,Office supplies,REF75497670,19.97,0.0,210907.42
2020-05-09,2020-05-09,Software subscription,REF83497461,125.03,0.0,210782.39
2020-05-13,2020-05-13,Business travel,REF14228757,173.99,0.0,210608.4
2020-05-15,2020-05-15,"Invoice payment - Patrick, Franklin and Martinez",REF67581072,0.0,2111.48,212719.88
2020-05-15,2020-05-15,Business insurance premium,REF34635843,117.47,0.0,212602.41
2020-05-21,2020-05-21,Office supplies,REF79345207,61.53,0.0,212540.88
2020-05-23,2020-05-23,Professional services,REF94128264,168.36,0.0,212372.52
2020-05-27,2020-05-27,Professional services,REF74741384,379.97,0.0,211992.55
2020-05-30,2020-05-30,Marketing expenses,REF74085225,181.37,0.0,211811.18
2020-05-31,2020-05-31,Marketing expenses,REF20295937,158.92,0.0,211652.26
2020-06-03,2020-06-03,Office supplies,REF40362912,55.91,0.0,211596.35
2020-06-06,2020-06-06,Equipment purchase,REF61837350,116.77,0.0,211479.58
2020-06-06,2020-06-06,Office supplies,REF87485826,57.56,0.0,211422.02
2020-06-09,2020-06-09,Software subscription,REF46308232,130.03,0.0,211291.99
2020-06-09,2020-06-09,Professional services,REF16638561,111.72,0.0,211180.27
2020-06-09,2020-06-09,Marketing expenses,REF41502354,203.08,0.0,210977.19
2020-06-11,2020-06-11,Business travel,REF75007016,212.42,0.0,210764.77
2020-06-12,2020-06-12,Business travel,REF24884130,163.05,0.0,210601.72
2020-06-15,2020-06-15,"Invoice payment - Hill, Adams and King",REF94427750,0.0,940.47,211542.19
2020-06-15,2020-06-15,"Invoice payment - Patrick, Franklin and Martinez",REF80928836,0.0,1513.73,213055.92
2020-06-15,2020-06-15,Project payment - Morgan-Foster,REF80355196,0.0,1025.85,214081.77
2020-06-15,2020-06-15,Business travel,REF51485278,39.48,0.0,214042.29
2020-06-15,2020-06-15,Business insurance premium,REF60887593,113.59,0.0,213928.7
2020-06-19,2020-06-19,Business travel,REF65845809,184.99,0.0,213743.71
2020-06-28,2020-06-28,Training/conference,REF38374659,118.46,0.0,213625.25
2020-07-01,2020-07-01,Office supplies,REF39906001,44.02,0.0,213581.23
2020-07-02,2020-07-02,Professional services,REF11607238,246.72,0.0,213334.51
2020-07-05,2020-07-05,Marketing expenses,REF80459101,32.54,0.0,213301.97
2020-07-07,2020-07-07,Marketing expenses,REF53102341,101.05,0.0,213200.92
2020-07-08,2020-07-08,Office supplies,REF20442316,56.94,0.0,213143.98
2020-07-09,2020-07-09,Business travel,REF83401735,162.52,0.0,212981.46
2020-07-09,2020-07-09,Software subscription,REF44983595,120.54,0.0,212860.92
2020-07-12,2020-07-12,Equipment purchase,REF67805890,61.57,0.0,212799.35
2020-07-14,2020-07-14,Office supplies,REF94326781,41.26,0.0,212758.09
2020-07-15,2020-07-15,Business insurance premium,REF23354516,92.6,0.0,212665.49
2020-07-15,2020-07-15,"Payment from Patrick, Franklin and Martinez",REF98728766,0.0,1376.11,214041.6
2020-07-15,2020-07-15,Office supplies,REF76310240,50.4,0.0,213991.2
2020-07-15,2020-07-15,Service payment - Morgan-Foster,REF43996768,0.0,1057.69,215048.89
2020-07-18,2020-07-18,Office supplies,REF67216344,69.15,0.0,214979.74
2020-07-18,2020-07-18,Professional services,REF69552478,118.99,0.0,214860.75
2020-07-26,2020-07-26,Marketing expenses,REF39700518,223.65,0.0,214637.1
2020-08-02,2020-08-02,Internet and phone service,REF91992670,34.69,0.0,214602.41
2020-08-09,2020-08-09,Software subscription,REF31565620,112.99,0.0,214489.42
2020-08-10,2020-08-10,Office supplies,REF86127851,22.43,0.0,214466.99
2020-08-13,2020-08-13,Office supplies,REF47083485,27.77,0.0,214439.22
2020-08-15,2020-08-15,Business insurance premium,REF25406875,89.16,0.0,214350.06
2020-08-15,2020-08-15,Service payment - Morgan-Foster,REF78591513,0.0,831.23,215181.29
2020-08-15,2020-08-15,"Payment from Patrick, Franklin and Martinez",REF58904872,0.0,1285.94,216467.23
2020-08-15,2020-08-15,"Invoice payment - Hill, Adams and King",REF64696803,0.0,748.04,217215.27
2020-08-18,2020-08-18,Office supplies,REF52024765,39.15,0.0,217176.12
2020-08-19,2020-08-19,Equipment purchase,REF93359667,83.05,0.0,217093.07
2020-08-21,2020-08-21,Internet and phone service,REF30990707,58.38,0.0,217034.69
2020-08-24,2020-08-24,Training/conference,REF72297673,57.78,0.0,216976.91
2020-08-25,2020-08-25,Equipment purchase,REF82242746,64.57,0.0,216912.34
2020-08-30,2020-08-30,Training/conference,REF84979689,70.6,0.0,216841.74
2020-08-30,2020-08-30,Office supplies,REF57225932,48.28,0.0,216793.46
2020-09-02,2020-09-02,Office supplies,REF37748639,63.68,0.0,216729.78
2020-09-07,2020-09-07,Equipment purchase,REF54048300,121.41,0.0,216608.37
2020-09-07,2020-09-07,Internet and phone service,REF22796534,129.6,0.0,216478.77
2020-09-09,2020-09-09,Software subscription,REF41079056,166.96,0.0,216311.81
2020-09-12,2020-09-12,Equipment purchase,REF10074468,111.48,0.0,216200.33
2020-09-15,2020-09-15,Business insurance premium,REF37999466,123.94,0.0,216076.39
2020-09-15,2020-09-15,Office supplies,REF91659511,52.17,0.0,216024.22
2020-09-15,2020-09-15,Business travel,REF94617574,187.64,0.0,215836.58
2020-09-15,2020-09-15,Payment from Morgan-Foster,REF51486718,0.0,1246.22,217082.8
2020-09-15,2020-09-15,"Payment from Hill, Adams and King",REF37254441,0.0,1259.33,218342.13
2020-09-15,2020-09-15,"Service payment - Patrick, Franklin and Martinez",REF58652735,0.0,1796.74,220138.87
2020-09-17,2020-09-17,Marketing expenses,REF50373136,167.72,0.0,219971.15
2020-09-19,2020-09-19,Office supplies,REF20426677,34.07,0.0,219937.08
2020-09-20,2020-09-20,Professional services,REF54911297,250.34,0.0,219686.74
2020-09-20,2020-09-20,Marketing expenses,REF57099050,155.3,0.0,219531.44
2020-09-22,2020-09-22,Office supplies,REF96556927,68.23,0.0,219463.21
2020-09-27,2020-09-27,Professional services,REF79928707,320.67,0.0,219142.54
2020-09-28,2020-09-28,Marketing expenses,REF27171050,213.73,0.0,218928.81
2020-10-01,2020-10-01,Equipment purchase,REF13285000,150.24,0.0,218778.57
2020-10-04,2020-10-04,Training/conference,REF66962398,98.39,0.0,218680.18
2020-10-05,2020-10-05,Marketing expenses,REF95610845,314.56,0.0,218365.62
2020-10-06,2020-10-06,Office supplies,REF14158033,65.09,0.0,218300.53
2020-10-09,2020-10-09,Software subscription,REF14586779,217.67,0.0,218082.86
2020-10-12,2020-10-12,Internet and phone service,REF61662426,93.02,0.0,217989.84
2020-10-12,2020-10-12,Marketing expenses,REF40255568,234.06,0.0,217755.78
2020-10-13,2020-10-13,Business travel,REF37487126,128.48,0.0,217627.3
2020-10-14,2020-10-14,Office supplies,REF93926815,61.94,0.0,217565.36
2020-10-15,2020-10-15,Internet and phone service,REF79391166,64.27,0.0,217501.09
2020-10-15,2020-10-15,"Payment from Hill, Adams and King",REF42921205,0.0,1161.93,218663.02
2020-10-15,2020-10-15,Project payment - Morgan-Foster,REF88092583,0.0,1614.54,220277.56
2020-10-15,2020-10-15,Business insurance premium,REF67871181,134.79,0.0,220142.77
2020-10-15,2020-10-15,"Project payment - Patrick, Franklin and Martinez",REF95386884,0.0,2468.75,222611.52
2020-10-19,2020-10-19,Business travel,REF23348856,172.76,0.0,222438.76
2020-10-22,2020-10-22,Business travel,REF75134725,293.01,0.0,222145.75
2020-10-26,2020-10-26,Internet and phone service,REF43723968,116.74,0.0,222029.01
2020-10-27,2020-10-27,Business travel,REF95203104,143.7,0.0,221885.31
2020-10-28,2020-10-28,Office supplies,REF41249480,59.12,0.0,221826.19
2020-10-29,2020-10-29,Office supplies,REF40164323,36.99,0.0,221789.2
2020-10-30,2020-10-30,Internet and phone service,REF41294606,102.51,0.0,221686.69
2020-11-02,2020-11-02,Business travel,REF67926805,181.65,0.0,221505.04
2020-11-09,2020-11-09,Software subscription,REF52145897,161.42,0.0,221343.62
2020-11-11,2020-11-11,Business travel,REF63739393,176.32,0.0,221167.3
2020-11-12,2020-11-12,Training/conference,REF81703191,97.5,0.0,221069.8
2020-11-14,2020-11-14,Office supplies,REF31302977,70.6,0.0,220999.2
2020-11-15,2020-11-15,Business insurance premium,REF15858928,131.08,0.0,220868.12
2020-11-15,2020-11-15,Service payment - Morgan-Foster,REF21282119,0.0,1816.49,222684.61
2020-11-15,2020-11-15,"Service payment - Hill, Adams and King",REF80452764,0.0,1334.64,224019.25
2020-11-15,2020-11-15,"Project payment - Patrick, Franklin and Martinez",REF22790122,0.0,1709.75,225729.0
2020-11-18,2020-11-18,Internet and phone service,REF23274667,87.32,0.0,225641.68
2020-11-23,2020-11-23,Equipment purchase,REF90567663,80.99,0.0,225560.69
2020-11-23,2020-11-23,Internet and phone service,REF86675384,48.81,0.0,225511.88
2020-12-01,2020-12-01,Office supplies,REF57461106,55.78,0.0,225456.1
2020-12-03,2020-12-03,Internet and phone service,REF91804415,65.33,0.0,225390.77
2020-12-05,2020-12-05,Business travel,REF11272750,203.9,0.0,225186.87
2020-12-07,2020-12-07,Professional services,REF34008745,273.21,0.0,224913.66
2020-12-09,2020-12-09,Software subscription,REF74379449,149.34,0.0,224764.32
2020-12-13,2020-12-13,Business travel,REF68534789,91.63,0.0,224672.69
2020-12-15,2020-12-15,Business insurance premium,REF84892958,112.88,0.0,224559.81
2020-12-15,2020-12-15,Project payment - Morgan-Foster,REF23126412,0.0,1136.88,225696.69
2020-12-15,2020-12-15,"Invoice payment - Patrick, Franklin and Martinez",REF43562713,0.0,1665.01,227361.7
2020-12-15,2020-12-15,"Payment from Hill, Adams and King",REF23911594,0.0,1142.06,228503.76
2020-12-15,2020-12-15,Internet and phone service,REF97383912,60.2,0.0,228443.56
2020-12-18,2020-12-18,Office supplies,REF33753161,20.56,0.0,228423.0
2020-12-20,2020-12-20,Professional services,REF61995283,304.9,0.0,228118.1
2020-12-20,2020-12-20,Marketing expenses,REF65376648,148.32,0.0,227969.78
2020-12-23,2020-12-23,Office supplies,REF60714512,74.23,0.0,227895.55
2020-12-28,2020-12-28,Equipment purchase,REF14871547,114.55,0.0,227781.0
2021-01-03,2021-01-03,Office supplies,REF67243036,48.15,0.0,227732.85
2021-01-06,2021-01-06,Business travel,REF78441451,181.21,0.0,227551.64
2021-01-08,2021-01-08,Training/conference,REF71756757,49.85,0.0,227501.79
2021-01-09,2021-01-09,Software subscription,REF71536176,131.17,0.0,227370.62
2021-01-10,2021-01-10,Training/conference,REF45857712,74.64,0.0,227295.98
2021-01-13,2021-01-13,Marketing expenses,REF94605329,73.63,0.0,227222.35
2021-01-15,2021-01-15,Payment from Morgan-Foster,REF94007007,0.0,958.51,228180.86
2021-01-15,2021-01-15,"Invoice payment - Hill, Adams and King",REF33957712,0.0,1008.38,229189.24
2021-01-15,2021-01-15,"Project payment - Patrick, Franklin and Martinez",REF74407497,0.0,1538.09,230727.33
2021-01-15,2021-01-15,Business insurance premium,REF86206738,97.57,0.0,230629.76
2021-01-17,2021-01-17,Business travel,REF35001732,92.75,0.0,230537.01
2021-01-21,2021-01-21,Equipment purchase,REF77197002,97.89,0.0,230439.12
2021-01-24,2021-01-24,Office supplies,REF29296234,41.72,0.0,230397.4
2021-01-27,2021-01-27,Office supplies,REF94844988,11.65,0.0,230385.75
2021-01-28,2021-01-28,Office supplies,REF41889490,47.03,0.0,230338.72
2021-01-31,2021-01-31,Internet and phone service,REF86701280,39.1,0.0,230299.62
2021-02-01,2021-02-01,Professional services,REF11896787,211.14,0.0,230088.48
2021-02-01,2021-02-01,Training/conference,REF62968819,25.86,0.0,230062.62
2021-02-02,2021-02-02,Office supplies,REF26768045,48.94,0.0,230013.68
2021-02-05,2021-02-05,Internet and phone service,REF93165929,103.35,0.0,229910.33
2021-02-06,2021-02-06,Business travel,REF60940592,154.04,0.0,229756.29
2021-02-06,2021-02-06,Internet and phone service,REF59386491,77.65,0.0,229678.64
2021-02-09,2021-02-09,Software subscription,REF50035392,138.37,0.0,229540.27
2021-02-14,2021-02-14,Office supplies,REF35765871,44.18,0.0,229496.09
2021-02-15,2021-02-15,Office supplies,REF65596712,50.02,0.0,229446.07
2021-02-15,2021-02-15,"Invoice payment - Hill, Adams and King",REF25482817,0.0,973.12,230419.19
2021-02-15,2021-02-15,Project payment - Morgan-Foster,REF65071157,0.0,1270.61,231689.8
2021-02-15,2021-02-15,Business insurance premium,REF63256958,118.22,0.0,231571.58
2021-02-26,2021-02-26,Business travel,REF65454008,125.66,0.0,231445.92
2021-03-09,2021-03-09,Software subscription,REF38358370,163.98,0.0,231281.94
2021-03-11,2021-03-11,Business travel,REF46250979,219.26,0.0,231062.68
2021-03-11,2021-03-11,Office supplies,REF59813938,46.05,0.0,231016.63
2021-03-13,2021-03-13,Office supplies,REF89032697,35.06,0.0,230981.57
2021-03-15,2021-03-15,Office supplies,REF80166679,83.71,0.0,230897.86
2021-03-15,2021-03-15,Business insurance premium,REF92235247,142.62,0.0,230755.24
2021-03-15,2021-03-15,"Invoice payment - Hill, Adams and King",REF29373852,0.0,891.64,231646.88
2021-03-15,2021-03-15,"Project payment - Patrick, Franklin and Martinez",REF59082353,0.0,1234.76,232881.64
2021-03-15,2021-03-15,Project payment - Morgan-Foster,REF60897454,0.0,1373.43,234255.07
2021-03-18,2021-03-18,Office supplies,REF83493012,60.25,0.0,234194.82
2021-03-19,2021-03-19,Equipment purchase,REF38879020,90.45,0.0,234104.37
2021-03-20,2021-03-20,Office supplies,REF77369374,53.67,0.0,234050.7
2021-03-23,2021-03-23,Marketing expenses,REF19571522,248.66,0.0,233802.04
2021-03-24,2021-03-24,Office supplies,REF73619995,62.87,0.0,233739.17
2021-03-29,2021-03-29,Training/conference,REF83246854,105.6,0.0,233633.57
2021-03-30,2021-03-30,Marketing expenses,REF53656746,299.75,0.0,233333.82
2021-03-31,2021-03-31,Office supplies,REF42381682,69.96,0.0,233263.86
2021-04-02,2021-04-02,Office supplies,REF70763227,52.35,0.0,233211.51
2021-04-07,2021-04-07,Office supplies,REF16649595,43.72,0.0,233167.79
2021-04-09,2021-04-09,Software subscription,REF98729710,143.8,0.0,233023.99
2021-04-09,2021-04-09,Internet and phone service,REF14323047,77.71,0.0,232946.28
2021-04-11,2021-04-11,Marketing expenses,REF81505371,172.98,0.0,232773.3
2021-04-11,2021-04-11,Office supplies,REF74464803,31.98,0.0,232741.32
2021-04-12,2021-04-12,Business travel,REF17476862,126.44,0.0,232614.88
2021-04-15,2021-04-15,"Invoice payment - Patrick, Franklin and Martinez",REF60509041,0.0,2047.56,234662.44
2021-04-15,2021-04-15,Business insurance premium,REF34057948,122.2,0.0,234540.24
2021-04-15,2021-04-15,Project payment - Morgan-Foster,REF26705389,0.0,1069.46,235609.7
2021-04-15,2021-04-15,"Project payment - Hill, Adams and King",REF34574224,0.0,967.79,236577.49
2021-04-16,2021-04-16,Marketing expenses,REF34899381,85.87,0.0,236491.62
2021-04-19,2021-04-19,Office supplies,REF82393012,56.18,0.0,236435.44
2021-04-20,2021-04-20,Office supplies,REF12325384,35.17,0.0,236400.27
2021-04-21,2021-04-21,Office supplies,REF71894021,55.85,0.0,236344.42
2021-04-22,2021-04-22,Office supplies,REF53712526,47.73,0.0,236296.69
2021-04-27,2021-04-27,Office supplies,REF65273106,59.14,0.0,236237.55
2021-04-28,2021-04-28,Office supplies,REF14677223,68.61,0.0,236168.94
2021-04-28,2021-04-28,Training/conference,REF48577615,114.61,0.0,236054.33
2021-05-05,2021-05-05,Office supplies,REF63591803,61.55,0.0,235992.78
2021-05-08,2021-05-08,Internet and phone service,REF27345527,65.64,0.0,235927.14
2021-05-09,2021-05-09,Software subscription,REF80834650,135.03,0.0,235792.11
2021-05-12,2021-05-12,Professional services,REF17098251,156.35,0.0,235635.76
2021-05-15,2021-05-15,Business insurance premium,REF94160434,126.45,0.0,235509.31
2021-05-15,2021-05-15,"Project payment - Patrick, Franklin and Martinez",REF31660329,0.0,1709.15,237218.46
2021-05-15,2021-05-15,Payment from Morgan-Foster,REF69006551,0.0,1234.8,238453.26
2021-05-15,2021-05-15,"Project payment - Hill, Adams and King",REF86692220,0.0,1154.01,239607.27
2021-05-19,2021-05-19,Business travel,REF89423971,130.17,0.0,239477.1
2021-05-26,2021-05-26,Training/conference,REF12221155,97.5,0.0,239379.6
2021-05-30,2021-05-30,Internet and phone service,REF84714202,120.0,0.0,239259.6
2021-05-31,2021-05-31,Professional services,REF91001297,245.88,0.0,239013.72
2021-06-03,2021-06-03,Office supplies,REF26739041,72.09,0.0,238941.63
2021-06-04,2021-06-04,Internet and phone service,REF99916659,118.07,0.0,238823.56
2021-06-07,2021-06-07,Office supplies,REF46806702,65.84,0.0,238757.72
2021-06-08,2021-06-08,Office supplies,REF37067636,25.55,0.0,238732.17
2021-06-09,2021-06-09,Business travel,REF67179412,135.61,0.0,238596.56
2021-06-09,2021-06-09,Equipment purchase,REF65453157,52.69,0.0,238543.87
2021-06-09,2021-06-09,Software subscription,REF71296239,138.86,0.0,238405.01
2021-06-10,2021-06-10,Office supplies,REF21208832,60.32,0.0,238344.69
2021-06-12,2021-06-12,Training/conference,REF52336249,78.04,0.0,238266.65
2021-06-15,2021-06-15,Marketing expenses,REF15574296,174.64,0.0,238092.01
2021-06-15,2021-06-15,Office supplies,REF24846068,45.07,0.0,238046.94
2021-06-15,2021-06-15,"Project payment - Hill, Adams and King",REF91993161,0.0,1041.26,239088.2
2021-06-15,2021-06-15,Project payment - Morgan-Foster,REF40486766,0.0,1086.77,240174.97
2021-06-15,2021-06-15,"Payment from Patrick, Franklin and Martinez",REF42218055,0.0,2089.0,242263.97
2021-06-15,2021-06-15,Business insurance premium,REF90223826,109.17,0.0,242154.8
2021-06-27,2021-06-27,Office supplies,REF33174474,41.58,0.0,242113.22
2021-07-04,2021-07-04,Professional services,REF12335110,246.03,0.0,241867.19
2021-07-05,2021-07-05,Internet and phone service,REF54925770,83.31,0.0,241783.88
2021-07-09,2021-07-09,Software subscription,REF19944475,120.43,0.0,241663.45
2021-07-11,2021-07-11,Marketing expenses,REF17142811,203.75,0.0,241459.7
2021-07-11,2021-07-11,Office supplies,REF67224734,22.86,0.0,241436.84
2021-07-12,2021-07-12,Office supplies,REF63778081,50.76,0.0,241386.08
2021-07-15,2021-07-15,"Payment from Patrick, Franklin and Martinez",REF96359091,0.0,1556.29,242942.37
2021-07-15,2021-07-15,Service payment - Morgan-Foster,REF64724098,0.0,1243.32,244185.69
2021-07-15,2021-07-15,Business insurance premium,REF75680534,92.87,0.0,244092.82
2021-07-24,2021-07-24,Professional services,REF37575473,218.59,0.0,243874.23
2021-07-25,2021-07-25,Business travel,REF64237807,97.87,0.0,243776.36
2021-07-30,2021-07-30,Office supplies,REF13928808,53.07,0.0,243723.29
2021-07-31,2021-07-31,Business travel,REF12238054,134.25,0.0,243589.04
2021-08-04,2021-08-04,Equipment purchase,REF28421405,46.95,0.0,243542.09
2021-08-06,2021-08-06,Business travel,REF40741132,66.72,0.0,243475.37
2021-08-09,2021-08-09,Software subscription,REF92417039,122.78,0.0,243352.59
2021-08-09,2021-08-09,Office supplies,REF38082744,34.3,0.0,243318.29
2021-08-10,2021-08-10,Business travel,REF88584790,117.97,0.0,243200.32
2021-08-10,2021-08-10,Marketing expenses,REF72457765,174.78,0.0,243025.54
2021-08-10,2021-08-10,Training/conference,REF82602855,45.7,0.0,242979.84
2021-08-15,2021-08-15,Invoice payment - Morgan-Foster,REF98057499,0.0,1078.55,244058.39
2021-08-15,2021-08-15,"Project payment - Hill, Adams and King",REF39312993,0.0,596.92,244655.31
2021-08-15,2021-08-15,Business insurance premium,REF85480609,80.78,0.0,244574.53
2021-08-15,2021-08-15,"Invoice payment - Patrick, Franklin and Martinez",REF25428542,0.0,1292.44,245866.97
2021-08-23,2021-08-23,Marketing expenses,REF19360106,140.49,0.0,245726.48
2021-08-23,2021-08-23,Training/conference,REF31916991,72.6,0.0,245653.88
2021-08-29,2021-08-29,Business travel,REF73409119,99.11,0.0,245554.77
2021-08-30,2021-08-30,Equipment purchase,REF63134858,88.53,0.0,245466.24
2021-09-02,2021-09-02,Office supplies,REF86163953,17.55,0.0,245448.69
2021-09-03,2021-09-03,Office supplies,REF17604719,28.15,0.0,245420.54
2021-09-05,2021-09-05,Office supplies,REF10667993,39.2,0.0,245381.34
2021-09-09,2021-09-09,Software subscription,REF36171082,175.68,0.0,245205.66
2021-09-15,2021-09-15,"Invoice payment - Patrick, Franklin and Martinez",REF80627090,0.0,2323.52,247529.18
2021-09-15,2021-09-15,Project payment - Morgan-Foster,REF83844894,0.0,1570.56,249099.74
2021-09-15,2021-09-15,"Invoice payment - Hill, Adams and King",REF27249773,0.0,1049.7,250149.44
2021-09-15,2021-09-15,Business insurance premium,REF47392161,119.65,0.0,250029.79
2021-09-16,2021-09-16,Equipment purchase,REF26063998,83.24,0.0,249946.55
2021-09-17,2021-09-17,Business travel,REF38867224,123.38,0.0,249823.17
2021-09-20,2021-09-20,Professional services,REF30777808,317.31,0.0,249505.86
2021-09-21,2021-09-21,Internet and phone service,REF15925687,92.77,0.0,249413.09
2021-09-26,2021-09-26,Training/conference,REF10409794,110.15,0.0,249302.94
2021-09-27,2021-09-27,Internet and phone service,REF58025121,86.47,0.0,249216.47
2021-09-29,2021-09-29,Business travel,REF92958547,188.65,0.0,249027.82
2021-10-01,2021-10-01,Professional services,REF16345014,432.27,0.0,248595.55
2021-10-04,2021-10-04,Professional services,REF69305172,404.19,0.0,248191.36
2021-10-08,2021-10-08,Office supplies,REF10304688,78.94,0.0,248112.42
2021-10-09,2021-10-09,Software subscription,REF91453502,161.68,0.0,247950.74
2021-10-11,2021-10-11,Business travel,REF70074190,218.8,0.0,247731.94
2021-10-13,2021-10-13,Marketing expenses,REF65390019,199.17,0.0,247532.77
2021-10-15,2021-10-15,Invoice payment - Morgan-Foster,REF78366615,0.0,1719.05,249251.82
2021-10-15,2021-10-15,"Invoice payment - Patrick, Franklin and Martinez",REF60165877,0.0,1517.31,250769.13
2021-10-15,2021-10-15,"Project payment - Hill, Adams and King",REF61640530,0.0,1047.14,251816.27
2021-10-15,2021-10-15,Business insurance premium,REF23860682,147.01,0.0,251669.26
2021-10-16,2021-10-16,Training/conference,REF34776180,143.82,0.0,251525.44
2021-10-20,2021-10-20,Business travel,REF13016518,245.59,0.0,251279.85
2021-10-21,2021-10-21,Training/conference,REF44469633,143.83,0.0,251136.02
2021-10-22,2021-10-22,Business travel,REF13874912,228.39,0.0,250907.63
2021-10-28,2021-10-28,Training/conference,REF22375055,155.56,0.0,250752.07
2021-10-30,2021-10-30,Internet and phone service,REF91175503,85.14,0.0,250666.93
2021-10-31,2021-10-31,Training/conference,REF33380653,58.64,0.0,250608.29
2021-11-01,2021-11-01,Marketing expenses,REF16822846,162.05,0.0,250446.24
2021-11-03,2021-11-03,Office supplies,REF21271463,73.86,0.0,250372.38
2021-11-06,2021-11-06,Training/conference,REF96256189,156.97,0.0,250215.41
2021-11-07,2021-11-07,Office supplies,REF60394613,37.23,0.0,250178.18
2021-11-09,2021-11-09,Training/conference,REF33673769,134.67,0.0,250043.51
2021-11-09,2021-11-09,Software subscription,REF26006206,152.49,0.0,249891.02
2021-11-09,2021-11-09,Office supplies,REF74209748,31.19,0.0,249859.83
2021-11-13,2021-11-13,Business travel,REF68181394,182.68,0.0,249677.15
2021-11-15,2021-11-15,"Invoice payment - Hill, Adams and King",REF15494027,0.0,991.44,250668.59
2021-11-15,2021-11-15,Payment from Morgan-Foster,REF86417796,0.0,1360.78,252029.37
2021-11-15,2021-11-15,"Service payment - Patrick, Franklin and Martinez",REF66952220,0.0,1742.72,253772.09
2021-11-15,2021-11-15,Business insurance premium,REF94285012,140.74,0.0,253631.35
2021-11-18,2021-11-18,Marketing expenses,REF99972418,108.03,0.0,253523.32
2021-11-20,2021-11-20,Professional services,REF47625101,324.76,0.0,253198.56
2021-11-25,2021-11-25,Marketing expenses,REF28718179,287.98,0.0,252910.58
2021-11-26,2021-11-26,Business travel,REF27366640,93.41,0.0,252817.17
2021-11-29,2021-11-29,Office supplies,REF68845670,18.43,0.0,252798.74
2021-12-09,2021-12-09,Software subscription,REF23542070,138.31,0.0,252660.43
2021-12-14,2021-12-14,Office supplies,REF26433243,47.22,0.0,252613.21
2021-12-15,2021-12-15,"Payment from Patrick, Franklin and Martinez",REF32878659,0.0,1330.73,253943.94
2021-12-15,2021-12-15,Business travel,REF38274417,107.35,0.0,253836.59
2021-12-15,2021-12-15,Payment from Morgan-Foster,REF30835167,0.0,1007.65,254844.24
2021-12-15,2021-12-15,Business insurance premium,REF24540651,103.16,0.0,254741.08
2021-12-16,2021-12-16,Office supplies,REF89570101,31.7,0.0,254709.38
2021-12-19,2021-12-19,Marketing expenses,REF35413115,101.64,0.0,254607.74
2021-12-19,2021-12-19,Office supplies,REF29128912,39.96,0.0,254567.78
2021-12-21,2021-12-21,Office supplies,REF30583425,41.18,0.0,254526.6
2021-12-26,2021-12-26,Office supplies,REF45935554,56.68,0.0,254469.92
2021-12-28,2021-12-28,Marketing expenses,REF18319109,198.36,0.0,254271.56
2021-12-31,2021-12-31,Office supplies,REF56997762,40.15,0.0,254231.41
2022-01-03,2022-01-03,Internet and phone service,REF89824716,65.6,0.0,254165.81
2022-01-05,2022-01-05,Equipment purchase,REF32761556,112.38,0.0,254053.43
2022-01-05,2022-01-05,Training/conference,REF78950718,117.6,0.0,253935.83
2022-01-06,2022-01-06,Office supplies,REF14104449,27.11,0.0,253908.72
2022-01-08,2022-01-08,Internet and phone service,REF26426305,32.05,0.0,253876.67
2022-01-09,2022-01-09,Software subscription,REF19718666,121.5,0.0,253755.17
2022-01-11,2022-01-11,Training/conference,REF13702204,52.74,0.0,253702.43
2022-01-12,2022-01-12,Training/conference,REF96030836,90.47,0.0,253611.96
2022-01-14,2022-01-14,Equipment purchase,REF19907235,70.5,0.0,253541.46
2022-01-15,2022-01-15,"Invoice payment - Patrick, Franklin and Martinez",REF10820839,0.0,1717.19,255258.65
2022-01-15,2022-01-15,Business insurance premium,REF26496626,99.84,0.0,255158.81
2022-01-15,2022-01-15,"Project payment - Hill, Adams and King",REF83643542,0.0,649.27,255808.08
2022-01-15,2022-01-15,Payment from Morgan-Foster,REF80767054,0.0,886.43,256694.51
2022-01-16,2022-01-16,Office supplies,REF22231291,48.02,0.0,256646.49
2022-01-17,2022-01-17,Professional services,REF40576598,269.16,0.0,256377.33
2022-01-24,2022-01-24,Office supplies,REF11748583,39.95,0.0,256337.38
2022-01-24,2022-01-24,Training/conference,REF68931636,69.86,0.0,256267.52
2022-01-26,2022-01-26,Training/conference,REF85686011,77.26,0.0,256190.26
2022-01-26,2022-01-26,Marketing expenses,REF96303904,134.62,0.0,256055.64
2022-01-28,2022-01-28,Business travel,REF49270603,26.57,0.0,256029.07
2022-02-01,2022-02-01,Business travel,REF85637085,50.44,0.0,255978.63
2022-02-02,2022-02-02,Office supplies,REF88785483,34.06,0.0,255944.57
2022-02-03,2022-02-03,Internet and phone service,REF78088244,106.7,0.0,255837.87
2022-02-03,2022-02-03,Marketing expenses,REF28228511,111.26,0.0,255726.61
2022-02-04,2022-02-04,Internet and phone service,REF93221540,54.67,0.0,255671.94
2022-02-08,2022-02-08,Professional services,REF54907004,118.57,0.0,255553.37
2022-02-09,2022-02-09,Software subscription,REF37751901,129.09,0.0,255424.28
2022-02-13,2022-02-13,Professional services,REF48006185,190.93,0.0,255233.35
2022-02-14,2022-02-14,Internet and phone service,REF30623266,85.16,0.0,255148.19
2022-02-15,2022-02-15,"Payment from Hill, Adams and King",REF99155555,0.0,1099.8,256247.99
2022-02-15,2022-02-15,Office supplies,REF39857706,32.84,0.0,256215.15
2022-02-15,2022-02-15,"Payment from Patrick, Franklin and Martinez",REF89461079,0.0,1883.44,258098.59
2022-02-15,2022-02-15,Business insurance premium,REF21054135,107.57,0.0,257991.02
2022-02-25,2022-02-25,Office supplies,REF28892343,38.59,0.0,257952.43
2022-03-01,2022-03-01,Office supplies,REF52113921,65.24,0.0,257887.19
2022-03-02,2022-03-02,Training/conference,REF61876511,113.87,0.0,257773.32
2022-03-05,2022-03-05,Marketing expenses,REF94478343,258.09,0.0,257515.23
2022-03-07,2022-03-07,Office supplies,REF45762164,54.08,0.0,257461.15
2022-03-09,2022-03-09,Software subscription,REF16327304,152.79,0.0,257308.36
2022-03-13,2022-03-13,Professional services,REF98801866,391.18,0.0,256917.18
2022-03-15,2022-03-15,Business insurance premium,REF64778998,140.49,0.0,256776.69
2022-03-15,2022-03-15,"Project payment - Hill, Adams and King",REF49188610,0.0,1123.19,257899.88
2022-03-15,2022-03-15,Project payment - Morgan-Foster,REF12998221,0.0,1210.1,259109.98
2022-03-15,2022-03-15,"Service payment - Patrick, Franklin and Martinez",REF18599978,0.0,2146.2,261256.18
2022-03-19,2022-03-19,Equipment purchase,REF79026188,108.78,0.0,261147.4
2022-03-22,2022-03-22,Training/conference,REF31598285,47.4,0.0,261100.0
2022-03-27,2022-03-27,Office supplies,REF16593557,40.19,0.0,261059.81
2022-03-29,2022-03-29,Office supplies,REF74118495,88.34,0.0,260971.47
2022-04-02,2022-04-02,Office supplies,REF35446551,46.75,0.0,260924.72
2022-04-04,2022-04-04,Office supplies,REF56088669,56.46,0.0,260868.26
2022-04-09,2022-04-09,Software subscription,REF87410647,145.05,0.0,260723.21
2022-04-15,2022-04-15,"Invoice payment - Hill, Adams and King",REF54094338,0.0,959.95,261683.16
2022-04-15,2022-04-15,Business insurance premium,REF75309479,126.48,0.0,261556.68
2022-04-15,2022-04-15,"Project payment - Patrick, Franklin and Martinez",REF95275861,0.0,2235.58,263792.26
2022-04-15,2022-04-15,Service payment - Morgan-Foster,REF30472438,0.0,1101.32,264893.58
2022-04-17,2022-04-17,Office supplies,REF62941433,29.05,0.0,264864.53
2022-04-17,2022-04-17,Internet and phone service,REF96958603,79.07,0.0,264785.46
2022-04-19,2022-04-19,Marketing expenses,REF11672543,94.24,0.0,264691.22
2022-04-20,2022-04-20,Professional services,REF89195380,71.75,0.0,264619.47
2022-04-26,2022-04-26,Professional services,REF18493415,230.8,0.0,264388.67
2022-04-28,2022-04-28,Business travel,REF60460186,48.04,0.0,264340.63
2022-04-29,2022-04-29,Business travel,REF93580619,87.2,0.0,264253.43
2022-04-29,2022-04-29,Office supplies,REF16855947,43.63,0.0,264209.8
2022-05-06,2022-05-06,Equipment purchase,REF87277322,103.3,0.0,264106.5
2022-05-09,2022-05-09,Software subscription,REF83872603,147.4,0.0,263959.1
2022-05-10,2022-05-10,Office supplies,REF16662863,38.76,0.0,263920.34
2022-05-12,2022-05-12,Training/conference,REF10525374,91.6,0.0,263828.74
2022-05-14,2022-05-14,Marketing expenses,REF15900963,280.02,0.0,263548.72
2022-05-15,2022-05-15,Business insurance premium,REF30614089,135.39,0.0,263413.33
2022-05-15,2022-05-15,"Payment from Hill, Adams and King",REF65039224,0.0,902.0,264315.33
2022-05-15,2022-05-15,Payment from Morgan-Foster,REF79815580,0.0,1202.83,265518.16
2022-05-15,2022-05-15,"Project payment - Patrick, Franklin and Martinez",REF53898661,0.0,1921.41,267439.57
2022-05-16,2022-05-16,Office supplies,REF89699006,55.31,0.0,267384.26
2022-05-16,2022-05-16,Business travel,REF76407236,120.47,0.0,267263.79
2022-05-23,2022-05-23,Office supplies,REF59542522,37.62,0.0,267226.17
2022-05-24,2022-05-24,Office supplies,REF90459756,39.59,0.0,267186.58
2022-06-02,2022-06-02,Marketing expenses,REF12781881,163.07,0.0,267023.51
2022-06-05,2022-06-05,Internet and phone service,REF71966054,59.81,0.0,266963.7
2022-06-08,2022-06-08,Training/conference,REF28081702,94.4,0.0,266869.3
2022-06-09,2022-06-09,Software subscription,REF30753056,130.71,0.0,266738.59
2022-06-10,2022-06-10,Training/conference,REF66560123,70.58,0.0,266668.01
2022-06-11,2022-06-11,Office supplies,REF15938658,16.17,0.0,266651.84
2022-06-11,2022-06-11,Professional services,REF35675020,249.42,0.0,266402.42
2022-06-13,2022-06-13,Business travel,REF96060131,130.18,0.0,266272.24
2022-06-15,2022-06-15,Business insurance premium,REF75959197,101.02,0.0,266171.22
2022-06-15,2022-06-15,"Invoice payment - Hill, Adams and King",REF41644068,0.0,1016.63,267187.85
2022-06-15,2022-06-15,Internet and phone service,REF56373794,54.74,0.0,267133.11
2022-06-15,2022-06-15,Marketing expenses,REF50350415,212.09,0.0,266921.02
2022-06-15,2022-06-15,"Service payment - Patrick, Franklin and Martinez",REF57351347,0.0,869.24,267790.26
2022-06-15,2022-06-15,Project payment - Morgan-Foster,REF88739890,0.0,1282.88,269073.14
2022-06-18,2022-06-18,Office supplies,REF12851920,53.1,0.0,269020.04
2022-06-19,2022-06-19,Office supplies,REF20782926,32.77,0.0,268987.27
2022-06-21,2022-06-21,Internet and phone service,REF39502232,69.69,0.0,268917.58
2022-06-21,2022-06-21,Training/conference,REF34213613,94.51,0.0,268823.07
2022-06-22,2022-06-22,Training/conference,REF17021780,56.75,0.0,268766.32
2022-06-25,2022-06-25,Equipment purchase,REF42423294,103.03,0.0,268663.29
2022-06-29,2022-06-29,Office supplies,REF26199906,54.46,0.0,268608.83
2022-07-04,2022-07-04,Equipment purchase,REF35896143,59.96,0.0,268548.87
2022-07-05,2022-07-05,Office supplies,REF31834548,39.57,0.0,268509.3
2022-07-05,2022-07-05,Training/conference,REF95969975,70.68,0.0,268438.62
2022-07-09,2022-07-09,Software subscription,REF12118843,135.21,0.0,268303.41
2022-07-11,2022-07-11,Training/conference,REF11652746,76.13,0.0,268227.28
2022-07-12,2022-07-12,Professional services,REF58055674,228.0,0.0,267999.28
2022-07-12,2022-07-12,Office supplies,REF55241780,29.42,0.0,267969.86
2022-07-13,2022-07-13,Equipment purchase,REF98860748,78.43,0.0,267891.43
2022-07-14,2022-07-14,Office supplies,REF33723054,23.61,0.0,267867.82
2022-07-15,2022-07-15,Business insurance premium,REF75614816,104.35,0.0,267763.47
2022-07-15,2022-07-15,"Invoice payment - Hill, Adams and King",REF50629071,0.0,930.67,268694.14
2022-07-15,2022-07-15,Project payment - Morgan-Foster,REF13828502,0.0,1102.35,269796.49
2022-07-15,2022-07-15,Office supplies,REF89341491,45.7,0.0,269750.79
2022-07-15,2022-07-15,"Payment from Patrick, Franklin and Martinez",REF96785093,0.0,1614.85,271365.64
2022-07-16,2022-07-16,Training/conference,REF71339529,83.68,0.0,271281.96
2022-07-17,2022-07-17,Office supplies,REF53375416,40.13,0.0,271241.83
2022-07-18,2022-07-18,Office supplies,REF92251849,44.95,0.0,271196.88
2022-07-24,2022-07-24,Office supplies,REF70066720,58.76,0.0,271138.12
2022-07-28,2022-07-28,Internet and phone service,REF99789406,54.35,0.0,271083.77
2022-08-03,2022-08-03,Internet and phone service,REF89024545,60.5,0.0,271023.27
2022-08-06,2022-08-06,Office supplies,REF97448187,25.6,0.0,270997.67
2022-08-06,2022-08-06,Internet and phone service,REF70004541,46.56,0.0,270951.11
2022-08-08,2022-08-08,Internet and phone service,REF57384771,66.95,0.0,270884.16
2022-08-08,2022-08-08,Office supplies,REF36800257,45.34,0.0,270838.82
2022-08-09,2022-08-09,Software subscription,REF95326411,110.71,0.0,270728.11
2022-08-09,2022-08-09,Equipment purchase,REF68343315,39.27,0.0,270688.84
2022-08-11,2022-08-11,Marketing expenses,REF56060655,56.89,0.0,270631.95
2022-08-11,2022-08-11,Professional services,REF76200776,156.13,0.0,270475.82
2022-08-15,2022-08-15,Payment from Morgan-Foster,REF90515404,0.0,927.98,271403.8
2022-08-15,2022-08-15,Business insurance premium,REF65879183,78.04,0.0,271325.76
2022-08-15,2022-08-15,"Invoice payment - Hill, Adams and King",REF39603619,0.0,638.7,271964.46
2022-08-17,2022-08-17,Professional services,REF35603477,136.65,0.0,271827.81
2022-08-19,2022-08-19,Professional services,REF47131742,208.23,0.0,271619.58
2022-08-19,2022-08-19,Office supplies,REF54582824,33.55,0.0,271586.03
2022-08-23,2022-08-23,Professional services,REF53803653,202.41,0.0,271383.62
2022-08-24,2022-08-24,Marketing expenses,REF10490298,130.62,0.0,271253.0
2022-08-26,2022-08-26,Internet and phone service,REF36883668,74.93,0.0,271178.07
2022-08-26,2022-08-26,Training/conference,REF40500398,65.72,0.0,271112.35
2022-08-27,2022-08-27,Business travel,REF82006003,139.64,0.0,270972.71
2022-09-02,2022-09-02,Training/conference,REF90398878,78.55,0.0,270894.16
2022-09-06,2022-09-06,Business travel,REF52146841,293.38,0.0,270600.78
2022-09-06,2022-09-06,Office supplies,REF53836211,43.79,0.0,270556.99
2022-09-09,2022-09-09,Software subscription,REF14881292,183.13,0.0,270373.86
2022-09-10,2022-09-10,Office supplies,REF29283183,75.59,0.0,270298.27
2022-09-15,2022-09-15,"Project payment - Patrick, Franklin and Martinez",REF22484730,0.0,1797.08,272095.35
2022-09-15,2022-09-15,Invoice payment - Morgan-Foster,REF78356789,0.0,1389.99,273485.34
2022-09-15,2022-09-15,"Service payment - Hill, Adams and King",REF49663489,0.0,1351.51,274836.85
2022-09-15,2022-09-15,Business insurance premium,REF87809004,124.57,0.0,274712.28
2022-09-16,2022-09-16,Office supplies,REF87589882,63.02,0.0,274649.26
2022-09-17,2022-09-17,Training/conference,REF73925447,102.61,0.0,274546.65
2022-09-19,2022-09-19,Professional services,REF97220182,246.94,0.0,274299.71
2022-09-21,2022-09-21,Equipment purchase,REF84637422,88.94,0.0,274210.77
2022-09-22,2022-09-22,Office supplies,REF85763778,43.39,0.0,274167.38
2022-09-24,2022-09-24,Business travel,REF61490505,176.75,0.0,273990.63
2022-09-25,2022-09-25,Internet and phone service,REF29950401,97.69,0.0,273892.94
2022-09-29,2022-09-29,Business travel,REF32595978,245.43,0.0,273647.51
2022-10-01,2022-10-01,Internet and phone service,REF65804380,97.03,0.0,273550.48
2022-10-01,2022-10-01,Professional services,REF16787103,174.2,0.0,273376.28
2022-10-06,2022-10-06,Office supplies,REF79126516,57.47,0.0,273318.81
2022-10-07,2022-10-07,Training/conference,REF75598279,158.98,0.0,273159.83
2022-10-09,2022-10-09,Software subscription,REF41427726,182.56,0.0,272977.27
2022-10-15,2022-10-15,"Invoice payment - Patrick, Franklin and Martinez",REF48260427,0.0,1983.15,274960.42
2022-10-15,2022-10-15,Payment from Morgan-Foster,REF72530756,0.0,1804.57,276764.99
2022-10-15,2022-10-15,"Invoice payment - Hill, Adams and King",REF53597592,0.0,1322.38,278087.37
2022-10-15,2022-10-15,Business insurance premium,REF94106564,129.35,0.0,277958.02
2022-10-17,2022-10-17,Equipment purchase,REF30309552,176.76,0.0,277781.26
2022-10-19,2022-10-19,Equipment purchase,REF66553415,74.88,0.0,277706.38
2022-10-21,2022-10-21,Training/conference,REF37685624,150.73,0.0,277555.65
2022-10-23,2022-10-23,Equipment purchase,REF38079602,147.36,0.0,277408.29
2022-11-09,2022-11-09,Software subscription,REF23711517,194.31,0.0,277213.98
2022-11-11,2022-11-11,Internet and phone service,REF50812109,90.52,0.0,277123.46
2022-11-14,2022-11-14,Equipment purchase,REF46460715,114.04,0.0,277009.42
2022-11-14,2022-11-14,Internet and phone service,REF81552458,54.25,0.0,276955.17
2022-11-15,2022-11-15,Invoice payment - Morgan-Foster,REF54015392,0.0,1479.74,278434.91
2022-11-15,2022-11-15,"Project payment - Hill, Adams and King",REF53169322,0.0,923.52,279358.43
2022-11-15,2022-11-15,"Project payment - Patrick, Franklin and Martinez",REF13328923,0.0,2325.07,281683.5
2022-11-15,2022-11-15,Business insurance premium,REF42182932,135.76,0.0,281547.74
2022-11-16,2022-11-16,Internet and phone service,REF72276335,100.3,0.0,281447.44
2022-11-20,2022-11-20,Office supplies,REF55826680,54.09,0.0,281393.35
2022-11-21,2022-11-21,Office supplies,REF80680517,52.7,0.0,281340.65
2022-11-22,2022-11-22,Office supplies,REF91485668,47.53,0.0,281293.12
2022-11-26,2022-11-26,Internet and phone service,REF15316272,72.54,0.0,281220.58
2022-12-01,2022-12-01,Business travel,REF39682532,95.94,0.0,281124.64
2022-12-09,2022-12-09,Software subscription,REF20525548,134.34,0.0,280990.3
2022-12-11,2022-12-11,Office supplies,REF53605803,53.02,0.0,280937.28
2022-12-15,2022-12-15,"Service payment - Patrick, Franklin and Martinez",REF94156021,0.0,1549.64,282486.92
2022-12-15,2022-12-15,Service payment - Morgan-Foster,REF73225856,0.0,1119.98,283606.9
2022-12-15,2022-12-15,"Payment from Hill, Adams and King",REF95342268,0.0,683.38,284290.28
2022-12-15,2022-12-15,Business insurance premium,REF49017137,97.18,0.0,284193.1
2022-12-17,2022-12-17,Business travel,REF38303519,92.57,0.0,284100.53
2022-12-20,2022-12-20,Office supplies,REF40201157,52.31,0.0,284048.22
2022-12-30,2022-12-30,Professional services,REF32572682,124.0,0.0,283924.22
2023-01-03,2023-01-03,Training/conference,REF77626211,24.38,0.0,283899.84
2023-01-04,2023-01-04,Training/conference,REF88692501,114.32,0.0,283785.52
2023-01-09,2023-01-09,Software subscription,REF98731106,122.34,0.0,283663.18
2023-01-11,2023-01-11,Equipment purchase,REF41456036,72.98,0.0,283590.2
2023-01-12,2023-01-12,Office supplies,REF45230920,27.39,0.0,283562.81
2023-01-15,2023-01-15,Project payment - Morgan-Foster,REF51183828,0.0,1052.41,284615.22
2023-01-15,2023-01-15,"Invoice payment - Hill, Adams and King",REF11091481,0.0,849.91,285465.13
2023-01-15,2023-01-15,Business insurance premium,REF59294135,94.27,0.0,285370.86
2023-01-15,2023-01-15,"Project payment - Patrick, Franklin and Martinez",REF15817269,0.0,1398.9,286769.76
2023-01-17,2023-01-17,Professional services,REF79075313,193.18,0.0,286576.58
2023-01-19,2023-01-19,Business travel,REF90517170,115.07,0.0,286461.51
2023-01-28,2023-01-28,Equipment purchase,REF81178025,35.46,0.0,286426.05
2023-01-31,2023-01-31,Office supplies,REF56575992,48.79,0.0,286377.26
2023-02-03,2023-02-03,Office supplies,REF80547859,54.36,0.0,286322.9
2023-02-05,2023-02-05,Equipment purchase,REF54125418,113.32,0.0,286209.58
2023-02-06,2023-02-06,Office supplies,REF86027928,21.74,0.0,286187.84
2023-02-07,2023-02-07,Training/conference,REF28512914,76.24,0.0,286111.6
2023-02-08,2023-02-08,Internet and phone service,REF99168066,98.05,0.0,286013.55
2023-02-09,2023-02-09,Office supplies,REF29656985,64.87,0.0,285948.68
2023-02-09,2023-02-09,Software subscription,REF85101042,123.31,0.0,285825.37
2023-02-11,2023-02-11,Equipment purchase,REF20904850,143.34,0.0,285682.03
2023-02-15,2023-02-15,Office supplies,REF80697479,34.09,0.0,285647.94
2023-02-15,2023-02-15,"Payment from Patrick, Franklin and Martinez",REF24116459,0.0,1918.33,287566.27
2023-02-15,2023-02-15,Business insurance premium,REF34608023,104.39,0.0,287461.88
2023-02-15,2023-02-15,"Payment from Hill, Adams and King",REF75425578,0.0,606.24,288068.12
2023-02-15,2023-02-15,Project payment - Morgan-Foster,REF98563853,0.0,1244.31,289312.43
2023-02-21,2023-02-21,Office supplies,REF49013904,31.03,0.0,289281.4
2023-02-25,2023-02-25,Training/conference,REF14170589,9.31,0.0,289272.09
2023-03-04,2023-03-04,Office supplies,REF21990681,60.72,0.0,289211.37
2023-03-09,2023-03-09,Business travel,REF93377214,135.28,0.0,289076.09
2023-03-09,2023-03-09,Software subscription,REF61462999,162.23,0.0,288913.86
2023-03-15,2023-03-15,"Invoice payment - Hill, Adams and King",REF67334638,0.0,1327.3,290241.16
2023-03-15,2023-03-15,"Service payment - Patrick, Franklin and Martinez",REF98486845,0.0,2187.57,292428.73
2023-03-15,2023-03-15,Service payment - Morgan-Foster,REF47191797,0.0,1568.48,293997.21
2023-03-15,2023-03-15,Business insurance premium,REF56289086,143.62,0.0,293853.59
2023-03-17,2023-03-17,Business travel,REF81847596,103.52,0.0,293750.07
2023-03-23,2023-03-23,Professional services,REF38663698,320.27,0.0,293429.8
2023-03-24,2023-03-24,Internet and phone service,REF76227796,109.69,0.0,293320.11
2023-03-29,2023-03-29,Business travel,REF98440671,110.95,0.0,293209.16
2023-03-30,2023-03-30,Marketing expenses,REF18346726,299.84,0.0,292909.32
2023-04-02,2023-04-02,Professional services,REF74667295,322.93,0.0,292586.39
2023-04-03,2023-04-03,Office supplies,REF18201579,60.92,0.0,292525.47
2023-04-04,2023-04-04,Training/conference,REF61862538,129.9,0.0,292395.57
2023-04-09,2023-04-09,Software subscription,REF13548550,131.79,0.0,292263.78
2023-04-10,2023-04-10,Office supplies,REF74608363,62.89,0.0,292200.89
2023-04-12,2023-04-12,Internet and phone service,REF67918040,63.04,0.0,292137.85
2023-04-13,2023-04-13,Business travel,REF49626302,126.05,0.0,292011.8
2023-04-14,2023-04-14,Office supplies,REF92757050,72.53,0.0,291939.27
2023-04-15,2023-04-15,Business insurance premium,REF80821095,127.49,0.0,291811.78
2023-04-15,2023-04-15,Service payment - Morgan-Foster,REF15808039,0.0,1556.12,293367.9
2023-04-15,2023-04-15,"Project payment - Hill, Adams and King",REF61325941,0.0,1208.69,294576.59
2023-04-15,2023-04-15,"Project payment - Patrick, Franklin and Martinez",REF57914689,0.0,1914.43,296491.02
2023-04-20,2023-04-20,Office supplies,REF58404411,20.0,0.0,296471.02
2023-04-23,2023-04-23,Office supplies,REF29920878,30.12,0.0,296440.9
2023-04-24,2023-04-24,Office supplies,REF85645304,49.83,0.0,296391.07
2023-04-25,2023-04-25,Business travel,REF18396815,166.04,0.0,296225.03
2023-05-09,2023-05-09,Software subscription,REF57560146,136.82,0.0,296088.21
2023-05-11,2023-05-11,Business travel,REF76003848,147.52,0.0,295940.69
2023-05-15,2023-05-15,Business insurance premium,REF11745836,123.49,0.0,295817.2
2023-05-15,2023-05-15,"Service payment - Patrick, Franklin and Martinez",REF95259256,0.0,1435.46,297252.66
2023-05-15,2023-05-15,Invoice payment - Morgan-Foster,REF63092572,0.0,1200.81,298453.47
2023-05-15,2023-05-15,"Project payment - Hill, Adams and King",REF72003906,0.0,1141.4,299594.87
2023-05-18,2023-05-18,Training/conference,REF41282565,74.85,0.0,299520.02
2023-05-25,2023-05-25,Office supplies,REF47928268,48.29,0.0,299471.73
2023-05-31,2023-05-31,Business travel,REF29445998,152.27,0.0,299319.46
2023-06-04,2023-06-04,Office supplies,REF74503345,41.8,0.0,299277.66
2023-06-09,2023-06-09,Software subscription,REF77006150,127.95,0.0,299149.71
2023-06-15,2023-06-15,Invoice payment - Morgan-Foster,REF45967214,0.0,1090.14,300239.85
2023-06-15,2023-06-15,"Invoice payment - Hill, Adams and King",REF40544445,0.0,1073.32,301313.17
2023-06-15,2023-06-15,Office supplies,REF49629969,34.39,0.0,301278.78
2023-06-15,2023-06-15,Business insurance premium,REF10265441,112.18,0.0,301166.6
2023-06-15,2023-06-15,"Payment from Patrick, Franklin and Martinez",REF68229543,0.0,1973.32,303139.92
2023-06-15,2023-06-15,Business travel,REF60702528,152.41,0.0,302987.51
2023-06-20,2023-06-20,Office supplies,REF61190517,38.01,0.0,302949.5
2023-06-28,2023-06-28,Office supplies,REF59996693,50.81,0.0,302898.69
2023-07-05,2023-07-05,Equipment purchase,REF18142676,79.78,0.0,302818.91
2023-07-05,2023-07-05,Internet and phone service,REF26639304,82.36,0.0,302736.55
2023-07-07,2023-07-07,Office supplies,REF39196442,45.0,0.0,302691.55
2023-07-08,2023-07-08,Professional services,REF17447868,172.74,0.0,302518.81
2023-07-08,2023-07-08,Office supplies,REF65921538,42.92,0.0,302475.89
2023-07-09,2023-07-09,Software subscription,REF93597320,112.35,0.0,302363.54
2023-07-09,2023-07-09,Office supplies,REF44414149,13.29,0.0,302350.25
2023-07-12,2023-07-12,Marketing expenses,REF46395112,184.2,0.0,302166.05
2023-07-14,2023-07-14,Equipment purchase,REF76253078,96.46,0.0,302069.59
2023-07-15,2023-07-15,Business travel,REF21569548,157.45,0.0,301912.14
2023-07-15,2023-07-15,Payment from Morgan-Foster,REF85032992,0.0,1005.73,302917.87
2023-07-15,2023-07-15,"Invoice payment - Hill, Adams and King",REF61453629,0.0,780.79,303698.66
2023-07-15,2023-07-15,"Payment from Patrick, Franklin and Martinez",REF13998629,0.0,1378.74,305077.4
2023-07-15,2023-07-15,Business insurance premium,REF97090413,89.06,0.0,304988.34
2023-07-22,2023-07-22,Internet and phone service,REF70262089,92.67,0.0,304895.67
2023-07-25,2023-07-25,Office supplies,REF92472500,45.86,0.0,304849.81
2023-07-30,2023-07-30,Marketing expenses,REF26091970,224.18,0.0,304625.63
2023-08-05,2023-08-05,Office supplies,REF28940987,23.14,0.0,304602.49
2023-08-09,2023-08-09,Software subscription,REF60622949,98.47,0.0,304504.02
2023-08-10,2023-08-10,Equipment purchase,REF90425503,54.95,0.0,304449.07
2023-08-11,2023-08-11,Office supplies,REF18318217,14.43,0.0,304434.64
2023-08-15,2023-08-15,Business insurance premium,REF94105887,79.41,0.0,304355.23
2023-08-15,2023-08-15,"Invoice payment - Patrick, Franklin and Martinez",REF68381675,0.0,1420.92,305776.15
2023-08-15,2023-08-15,Service payment - Morgan-Foster,REF74590717,0.0,807.19,306583.34
2023-08-15,2023-08-15,"Payment from Hill, Adams and King",REF56593452,0.0,900.6,307483.94
2023-08-16,2023-08-16,Office supplies,REF19730581,45.17,0.0,307438.77
2023-08-17,2023-08-17,Professional services,REF26765364,192.37,0.0,307246.4
2023-08-18,2023-08-18,Office supplies,REF70691902,27.04,0.0,307219.36
2023-08-20,2023-08-20,Office supplies,REF44153886,36.09,0.0,307183.27
2023-08-25,2023-08-25,Internet and phone service,REF65399769,57.21,0.0,307126.06
2023-08-30,2023-08-30,Internet and phone service,REF37650281,55.3,0.0,307070.76
2023-09-05,2023-09-05,Office supplies,REF51290285,61.31,0.0,307009.45
2023-09-09,2023-09-09,Software subscription,REF54572126,161.86,0.0,306847.59
2023-09-11,2023-09-11,Office supplies,REF70727066,81.42,0.0,306766.17
2023-09-11,2023-09-11,Business travel,REF50169191,237.75,0.0,306528.42
2023-09-13,2023-09-13,Business travel,REF93480678,150.42,0.0,306378.0
2023-09-15,2023-09-15,Project payment - Morgan-Foster,REF95589662,0.0,590.56,306968.56
2023-09-15,2023-09-15,Business insurance premium,REF12097885,134.83,0.0,306833.73
2023-09-15,2023-09-15,"Invoice payment - Patrick, Franklin and Martinez",REF92589446,0.0,2285.9,309119.63
2023-09-16,2023-09-16,Business travel,REF52787731,180.06,0.0,308939.57
2023-09-21,2023-09-21,Training/conference,REF52259903,165.48,0.0,308774.09
2023-09-24,2023-09-24,Office supplies,REF43736297,40.96,0.0,308733.13
2023-09-27,2023-09-27,Business travel,REF61764405,227.43,0.0,308505.7
2023-09-28,2023-09-28,Equipment purchase,REF82243973,104.45,0.0,308401.25
2023-10-02,2023-10-02,Training/conference,REF33412766,83.16,0.0,308318.09
2023-10-09,2023-10-09,Software subscription,REF99233258,175.63,0.0,308142.46
2023-10-13,2023-10-13,Marketing expenses,REF87807382,195.91,0.0,307946.55
2023-10-15,2023-10-15,Project payment - Morgan-Foster,REF82148595,0.0,1586.73,309533.28
2023-10-15,2023-10-15,"Service payment - Hill, Adams and King",REF47791878,0.0,1341.49,310874.77
2023-10-15,2023-10-15,"Project payment - Patrick, Franklin and Martinez",REF89570935,0.0,2485.76,313360.53
2023-10-15,2023-10-15,Business insurance premium,REF59509023,147.27,0.0,313213.26
2023-10-17,2023-10-17,Office supplies,REF30150797,101.98,0.0,313111.28
2023-10-21,2023-10-21,Business travel,REF17513847,76.42,0.0,313034.86
2023-10-26,2023-10-26,Office supplies,REF90655205,73.43,0.0,312961.43
2023-10-28,2023-10-28,Office supplies,REF21340885,58.77,0.0,312902.66
2023-10-29,2023-10-29,Office supplies,REF17131045,35.23,0.0,312867.43
2023-11-05,2023-11-05,Office supplies,REF32027786,49.0,0.0,312818.43
2023-11-09,2023-11-09,Software subscription,REF27648978,135.64,0.0,312682.79
2023-11-11,2023-11-11,Marketing expenses,REF90397228,139.66,0.0,312543.13
2023-11-12,2023-11-12,Training/conference,REF22706235,97.36,0.0,312445.77
2023-11-15,2023-11-15,Payment from Morgan-Foster,REF61889757,0.0,1437.16,313882.93
2023-11-15,2023-11-15,Business insurance premium,REF86401774,131.24,0.0,313751.69
2023-11-15,2023-11-15,"Invoice payment - Hill, Adams and King",REF61099220,0.0,1084.43,314836.12
2023-11-18,2023-11-18,Business travel,REF74784049,134.22,0.0,314701.9
2023-11-21,2023-11-21,Internet and phone service,REF85682582,69.53,0.0,314632.37
2023-11-27,2023-11-27,Professional services,REF77030170,299.26,0.0,314333.11
2023-12-09,2023-12-09,Software subscription,REF34683421,150.76,0.0,314182.35
2023-12-10,2023-12-10,Internet and phone service,REF17789914,84.54,0.0,314097.81
2023-12-11,2023-12-11,Internet and phone service,REF33044714,58.77,0.0,314039.04
2023-12-12,2023-12-12,Office supplies,REF34511078,19.37,0.0,314019.67
2023-12-13,2023-12-13,Marketing expenses,REF20802267,129.6,0.0,313890.07
2023-12-15,2023-12-15,"Payment from Patrick, Franklin and Martinez",REF53400755,0.0,1960.84,315850.91
2023-12-15,2023-12-15,Service payment - Morgan-Foster,REF88123654,0.0,911.97,316762.88
2023-12-15,2023-12-15,"Payment from Hill, Adams and King",REF74012515,0.0,934.98,317697.86
2023-12-15,2023-12-15,Business insurance premium,REF81650795,102.01,0.0,317595.85
2023-12-15,2023-12-15,Marketing expenses,REF89539346,305.58,0.0,317290.27
2023-12-18,2023-12-18,Equipment purchase,REF53274855,100.09,0.0,317190.18
2024-01-08,2024-01-08,Business travel,REF20863466,111.85,0.0,317078.33
2024-01-09,2024-01-09,Office supplies,REF51802806,37.0,0.0,317041.33
2024-01-09,2024-01-09,Software subscription,REF68967956,134.77,0.0,316906.56
2024-01-13,2024-01-13,Office supplies,REF51265633,41.07,0.0,316865.49
2024-01-15,2024-01-15,"Payment from Patrick, Franklin and Martinez",REF60892048,0.0,1542.05,318407.54
2024-01-15,2024-01-15,Business insurance premium,REF54981153,96.73,0.0,318310.81
2024-01-15,2024-01-15,"Project payment - Hill, Adams and King",REF32589130,0.0,845.21,319156.02
2024-01-15,2024-01-15,Invoice payment - Morgan-Foster,REF79073996,0.0,1250.73,320406.75
2024-01-17,2024-01-17,Equipment purchase,REF96725717,101.19,0.0,320305.56
2024-01-18,2024-01-18,Office supplies,REF19651075,20.48,0.0,320285.08
2024-01-20,2024-01-20,Professional services,REF78664360,210.39,0.0,320074.69
2024-01-27,2024-01-27,Business travel,REF15343234,59.15,0.0,320015.54
2024-02-01,2024-02-01,Marketing expenses,REF51239791,212.32,0.0,319803.22
2024-02-02,2024-02-02,Training/conference,REF97899555,77.2,0.0,319726.02
2024-02-07,2024-02-07,Office supplies,REF84554575,31.18,0.0,319694.84
2024-02-09,2024-02-09,Software subscription,REF25043745,130.03,0.0,319564.81
2024-02-11,2024-02-11,Office supplies,REF49155897,44.44,0.0,319520.37
2024-02-15,2024-02-15,"Payment from Patrick, Franklin and Martinez",REF31631918,0.0,1478.77,320999.14
2024-02-15,2024-02-15,"Project payment - Hill, Adams and King",REF41053884,0.0,1013.56,322012.7
2024-02-15,2024-02-15,Business insurance premium,REF60155891,108.79,0.0,321903.91
2024-02-15,2024-02-15,Project payment - Morgan-Foster,REF46413252,0.0,1266.5,323170.41
2024-02-19,2024-02-19,Office supplies,REF29712040,42.18,0.0,323128.23
2024-02-20,2024-02-20,Business travel,REF52794887,170.3,0.0,322957.93
2024-02-26,2024-02-26,Office supplies,REF26545265,44.08,0.0,322913.85
2024-02-26,2024-02-26,Professional services,REF55622159,295.95,0.0,322617.9
2024-03-01,2024-03-01,Office supplies,REF27099483,59.43,0.0,322558.47
2024-03-03,2024-03-03,Training/conference,REF59061950,92.46,0.0,322466.01
2024-03-09,2024-03-09,Software subscription,REF54945362,170.48,0.0,322295.53
2024-03-09,2024-03-09,Professional services,REF80830518,186.75,0.0,322108.78
2024-03-11,2024-03-11,Marketing expenses,REF76006403,168.18,0.0,321940.6
2024-03-15,2024-03-15,Payment from Morgan-Foster,REF48290640,0.0,1886.28,323826.88
2024-03-15,2024-03-15,"Service payment - Patrick, Franklin and Martinez",REF30091951,0.0,1633.97,325460.85
2024-03-15,2024-03-15,"Payment from Hill, Adams and King",REF50370543,0.0,1207.06,326667.91
2024-03-15,2024-03-15,Office supplies,REF13410837,66.05,0.0,326601.86
2024-03-15,2024-03-15,Business insurance premium,REF17723338,128.04,0.0,326473.82
2024-03-17,2024-03-17,Marketing expenses,REF57028200,257.78,0.0,326216.04
2024-03-19,2024-03-19,Office supplies,REF80956090,68.39,0.0,326147.65
2024-03-28,2024-03-28,Business travel,REF92603267,216.89,0.0,325930.76
2024-03-29,2024-03-29,Professional services,REF18672554,473.66,0.0,325457.1
2024-04-02,2024-04-02,Training/conference,REF55360013,72.31,0.0,325384.79
2024-04-04,2024-04-04,Marketing expenses,REF75559991,195.55,0.0,325189.24
2024-04-05,2024-04-05,Office supplies,REF13097423,34.44,0.0,325154.8
2024-04-09,2024-04-09,Software subscription,REF52636763,169.84,0.0,324984.96
2024-04-09,2024-04-09,Office supplies,REF77704237,60.33,0.0,324924.63
2024-04-11,2024-04-11,Professional services,REF10476023,303.45,0.0,324621.18
2024-04-15,2024-04-15,Business insurance premium,REF98606876,117.57,0.0,324503.61
2024-04-15,2024-04-15,"Payment from Hill, Adams and King",REF85844187,0.0,1020.46,325524.07
2024-04-15,2024-04-15,"Payment from Patrick, Franklin and Martinez",REF70287494,0.0,1835.2,327359.27
2024-04-15,2024-04-15,Invoice payment - Morgan-Foster,REF78927306,0.0,1339.98,328699.25
2024-04-18,2024-04-18,Office supplies,REF51267200,46.24,0.0,328653.01
2024-04-19,2024-04-19,Equipment purchase,REF74896198,118.39,0.0,328534.62
2024-04-25,2024-04-25,Office supplies,REF41973407,46.75,0.0,328487.87
2024-04-26,2024-04-26,Office supplies,REF84155638,68.64,0.0,328419.23
2024-04-27,2024-04-27,Office supplies,REF56329305,69.44,0.0,328349.79
2024-04-27,2024-04-27,Professional services,REF43663089,303.55,0.0,328046.24
2024-05-05,2024-05-05,Equipment purchase,REF15715757,88.86,0.0,327957.38
2024-05-07,2024-05-07,Professional services,REF82183944,94.21,0.0,327863.17
2024-05-09,2024-05-09,Software subscription,REF42211982,152.04,0.0,327711.13
2024-05-10,2024-05-10,Office supplies,REF33609772,59.12,0.0,327652.01
2024-05-11,2024-05-11,Office supplies,REF27603420,53.56,0.0,327598.45
2024-05-12,2024-05-12,Marketing expenses,REF45938823,222.42,0.0,327376.03
2024-05-13,2024-05-13,Business travel,REF52204837,82.73,0.0,327293.3
2024-05-15,2024-05-15,"Invoice payment - Hill, Adams and King",REF89780567,0.0,1006.84,328300.14
2024-05-15,2024-05-15,Business insurance premium,REF73047717,110.83,0.0,328189.31
2024-05-15,2024-05-15,"Payment from Patrick, Franklin and Martinez",REF93050433,0.0,1663.42,329852.73
2024-05-19,2024-05-19,Training/conference,REF10831202,147.41,0.0,329705.32
2024-05-29,2024-05-29,Office supplies,REF93643728,21.41,0.0,329683.91
2024-06-04,2024-06-04,Training/conference,REF85713455,70.52,0.0,329613.39
2024-06-04,2024-06-04,Marketing expenses,REF60896166,136.71,0.0,329476.68
2024-06-08,2024-06-08,Equipment purchase,REF55620530,98.02,0.0,329378.66
2024-06-09,2024-06-09,Software subscription,REF14459338,129.09,0.0,329249.57
2024-06-09,2024-06-09,Internet and phone service,REF31969981,88.15,0.0,329161.42
2024-06-10,2024-06-10,Training/conference,REF85921903,88.3,0.0,329073.12
2024-06-11,2024-06-11,Office supplies,REF94364191,64.71,0.0,329008.41
2024-06-12,2024-06-12,Office supplies,REF51443500,60.9,0.0,328947.51
2024-06-13,2024-06-13,Business travel,REF17913498,111.18,0.0,328836.33
2024-06-14,2024-06-14,Marketing expenses,REF49590904,176.94,0.0,328659.39
2024-06-15,2024-06-15,Business insurance premium,REF60975643,97.47,0.0,328561.92
2024-06-15,2024-06-15,"Payment from Hill, Adams and King",REF22616013,0.0,1004.43,329566.35
2024-06-15,2024-06-15,Payment from Morgan-Foster,REF33106315,0.0,1093.11,330659.46
2024-06-15,2024-06-15,"Service payment - Patrick, Franklin and Martinez",REF81821099,0.0,1620.78,332280.24
2024-06-16,2024-06-16,Office supplies,REF26441140,92.63,0.0,332187.61
2024-06-16,2024-06-16,Internet and phone service,REF95391683,57.78,0.0,332129.83
2024-06-17,2024-06-17,Office supplies,REF97807741,72.04,0.0,332057.79
2024-06-18,2024-06-18,Marketing expenses,REF99297212,157.15,0.0,331900.64
2024-06-22,2024-06-22,Equipment purchase,REF64434430,86.39,0.0,331814.25
2024-06-25,2024-06-25,Office supplies,REF40581355,44.36,0.0,331769.89
2024-07-04,2024-07-04,Training/conference,REF94328837,124.95,0.0,331644.94
2024-07-07,2024-07-07,Internet and phone service,REF49740323,73.86,0.0,331571.08
2024-07-09,2024-07-09,Software subscription,REF93035931,112.13,0.0,331458.95
2024-07-15,2024-07-15,Invoice payment - Morgan-Foster,REF30015923,0.0,1024.95,332483.9
2024-07-15,2024-07-15,Business insurance premium,REF17369152,96.05,0.0,332387.85
2024-07-15,2024-07-15,"Invoice payment - Patrick, Franklin and Martinez",REF27908844,0.0,1548.83,333936.68
2024-07-16,2024-07-16,Internet and phone service,REF38568579,44.48,0.0,333892.2
2024-07-29,2024-07-29,Office supplies,REF56054553,14.02,0.0,333878.18
2024-08-03,2024-08-03,Training/conference,REF29349586,91.61,0.0,333786.57
2024-08-04,2024-08-04,Internet and phone service,REF61062585,45.46,0.0,333741.11
2024-08-05,2024-08-05,Business travel,REF26490206,110.78,0.0,333630.33
2024-08-06,2024-08-06,Equipment purchase,REF95093903,80.44,0.0,333549.89
2024-08-08,2024-08-08,Office supplies,REF53691974,55.93,0.0,333493.96
2024-08-09,2024-08-09,Software subscription,REF26930302,84.08,0.0,333409.88
2024-08-13,2024-08-13,Marketing expenses,REF72817074,110.09,0.0,333299.79
2024-08-15,2024-08-15,Service payment - Morgan-Foster,REF85847670,0.0,817.6,334117.39
2024-08-15,2024-08-15,Business insurance premium,REF38247135,87.82,0.0,334029.57
2024-08-15,2024-08-15,"Project payment - Patrick, Franklin and Martinez",REF66204135,0.0,1130.28,335159.85
2024-08-15,2024-08-15,"Project payment - Hill, Adams and King",REF79812065,0.0,777.07,335936.92
2024-08-17,2024-08-17,Training/conference,REF45768329,54.56,0.0,335882.36
2013-08-30,2013-08-30,Business travel,REF79446111,72.65,0.0,4597.78
2013-09-05,2013-09-05,Business travel,REF12750970,182.04,0.0,4415.74
2013-09-07,2013-09-07,Internet and phone service,REF66118274,117.92,0.0,4297.82
2013-09-09,2013-09-09,Software subscription,REF67208642,146.83,0.0,4150.99
2013-09-09,2013-09-09,Professional services,REF67249680,154.59,0.0,3996.4
2013-09-09,2013-09-09,Internet and phone service,REF24240320,120.73,0.0,3875.67
2013-09-11,2013-09-11,Office supplies,REF67618670,35.53,0.0,3840.14
2013-09-13,2013-09-13,Marketing expenses,REF26985372,137.03,0.0,3703.11
2013-09-15,2013-09-15,Payment from Neal-Holden,REF91279381,0.0,1155.66,4858.77
2013-09-15,2013-09-15,Business insurance premium,REF66610709,130.27,0.0,4728.5
2013-09-15,2013-09-15,Project payment - Davidson and Sons,REF84503312,0.0,1224.34,5952.84
2013-09-15,2013-09-15,Service payment - Peterson Ltd,REF79541100,0.0,1698.22,7651.06
2013-09-16,2013-09-16,Office supplies,REF29929739,54.28,0.0,7596.78
2013-09-19,2013-09-19,Office supplies,REF72455632,41.83,0.0,7554.95
2013-09-20,2013-09-20,Marketing expenses,REF25867526,206.17,0.0,7348.78
2013-09-25,2013-09-25,Training/conference,REF45626517,95.57,0.0,7253.21
2013-10-01,2013-10-01,Office supplies,REF55350333,36.74,0.0,7216.47
2013-10-03,2013-10-03,Office supplies,REF50886549,19.89,0.0,7196.58
2013-10-04,2013-10-04,Professional services,REF38460087,352.84,0.0,6843.74
2013-10-07,2013-10-07,Office supplies,REF70908146,42.65,0.0,6801.09
2013-10-07,2013-10-07,Training/conference,REF45184655,160.31,0.0,6640.78
2013-10-09,2013-10-09,Software subscription,REF49792895,181.26,0.0,6459.52
2013-10-15,2013-10-15,Service payment - Neal-Holden,REF77544555,0.0,1678.17,8137.69
2013-10-15,2013-10-15,Invoice payment - Davidson and Sons,REF95140942,0.0,991.5,9129.19
2013-10-15,2013-10-15,Business insurance premium,REF89758578,149.69,0.0,8979.5
2013-10-20,2013-10-20,Business travel,REF95520733,257.82,0.0,8721.68
2013-10-23,2013-10-23,Training/conference,REF58601999,128.16,0.0,8593.52
2013-10-24,2013-10-24,Internet and phone service,REF28106332,92.08,0.0,8501.44
2013-10-28,2013-10-28,Office supplies,REF39130482,44.61,0.0,8456.83
2013-10-29,2013-10-29,Professional services,REF85197165,424.21,0.0,8032.62
2013-10-30,2013-10-30,Office supplies,REF95898842,63.32,0.0,7969.3
2013-11-03,2013-11-03,Professional services,REF71448682,422.15,0.0,7547.15
2013-11-06,2013-11-06,Professional services,REF30358301,285.19,0.0,7261.96
2013-11-09,2013-11-09,Software subscription,REF98565572,168.94,0.0,7093.02
2013-11-15,2013-11-15,Business insurance premium,REF62860413,134.2,0.0,6958.82
2013-11-15,2013-11-15,Invoice payment - Neal-Holden,REF47920960,0.0,1721.29,8680.11
2013-11-15,2013-11-15,Invoice payment - Davidson and Sons,REF36723701,0.0,1074.33,9754.44
2013-11-23,2013-11-23,Business travel,REF18129473,149.18,0.0,9605.26
2013-11-23,2013-11-23,Equipment purchase,REF37003707,82.76,0.0,9522.5
2013-11-25,2013-11-25,Office supplies,REF71058163,57.99,0.0,9464.51
2013-12-01,2013-12-01,Office supplies,REF59748004,22.52,0.0,9441.99
2013-12-02,2013-12-02,Office supplies,REF68245315,60.93,0.0,9381.06
2013-12-03,2013-12-03,Equipment purchase,REF87756748,88.32,0.0,9292.74
2013-12-04,2013-12-04,Marketing expenses,REF75471888,219.53,0.0,9073.21
2013-12-09,2013-12-09,Software subscription,REF28490871,132.18,0.0,8941.03
2013-12-13,2013-12-13,Marketing expenses,REF18583045,126.52,0.0,8814.51
2013-12-15,2013-12-15,Business insurance premium,REF66831068,102.81,0.0,8711.7
2013-12-15,2013-12-15,Service payment - Neal-Holden,REF29256181,0.0,1069.17,9780.87
2013-12-15,2013-12-15,Service payment - Peterson Ltd,REF25799829,0.0,1853.48,11634.35
2013-12-15,2013-12-15,Project payment - Davidson and Sons,REF20927243,0.0,969.41,12603.76
2013-12-15,2013-12-15,Business travel,REF56888540,48.84,0.0,12554.92
2013-12-18,2013-12-18,Training/conference,REF28569041,54.2,0.0,12500.72
2013-12-19,2013-12-19,Business travel,REF58157785,150.17,0.0,12350.55
2013-12-21,2013-12-21,Training/conference,REF18574418,89.07,0.0,12261.48
2013-12-28,2013-12-28,Professional services,REF85481938,221.69,0.0,12039.79
2013-12-28,2013-12-28,Internet and phone service,REF88500081,88.34,0.0,11951.45
2013-12-29,2013-12-29,Equipment purchase,REF29667586,67.17,0.0,11884.28
2013-12-30,2013-12-30,Professional services,REF98175466,174.56,0.0,11709.72
2013-12-31,2013-12-31,Marketing expenses,REF53077349,180.73,0.0,11528.99
2014-01-01,2014-01-01,Office supplies,REF92825771,45.64,0.0,11483.35
2014-01-09,2014-01-09,Software subscription,REF39480808,97.06,0.0,11386.29
2014-01-14,2014-01-14,Marketing expenses,REF92371117,150.63,0.0,11235.66
2014-01-15,2014-01-15,Payment from Peterson Ltd,REF98588112,0.0,1396.21,12631.87
2014-01-15,2014-01-15,Payment from Neal-Holden,REF48440914,0.0,1102.14,13734.01
2014-01-15,2014-01-15,Service payment - Davidson and Sons,REF49675947,0.0,675.94,14409.95
2014-01-15,2014-01-15,Business insurance premium,REF37986209,91.71,0.0,14318.24
2014-01-18,2014-01-18,Professional services,REF88841822,244.38,0.0,14073.86
2014-01-21,2014-01-21,Equipment purchase,REF88072733,94.41,0.0,13979.45
2014-01-26,2014-01-26,Marketing expenses,REF27346767,178.85,0.0,13800.6
2014-01-30,2014-01-30,Marketing expenses,REF42216971,38.24,0.0,13762.36
2014-01-31,2014-01-31,Professional services,REF23664899,90.97,0.0,13671.39
2014-02-01,2014-02-01,Professional services,REF39489695,194.12,0.0,13477.27
2014-02-01,2014-02-01,Internet and phone service,REF48330820,74.27,0.0,13403.0
2014-02-02,2014-02-02,Marketing expenses,REF70065027,93.04,0.0,13309.96
2014-02-06,2014-02-06,Marketing expenses,REF66261602,165.18,0.0,13144.78
2014-02-08,2014-02-08,Business travel,REF31812543,95.22,0.0,13049.56
2014-02-09,2014-02-09,Business travel,REF12200768,116.05,0.0,12933.51
2014-02-09,2014-02-09,Software subscription,REF97191308,148.89,0.0,12784.62
2014-02-15,2014-02-15,Business insurance premium,REF45773116,99.65,0.0,12684.97
2014-02-15,2014-02-15,Invoice payment - Neal-Holden,REF65658469,0.0,853.64,13538.61
2014-02-15,2014-02-15,Payment from Peterson Ltd,REF42542445,0.0,1269.1,14807.71
2014-02-15,2014-02-15,Invoice payment - Davidson and Sons,REF90014342,0.0,832.56,15640.27
2014-02-17,2014-02-17,Office supplies,REF39162741,58.89,0.0,15581.38
2014-02-19,2014-02-19,Professional services,REF74781330,227.72,0.0,15353.66
2014-02-20,2014-02-20,Marketing expenses,REF56555235,195.49,0.0,15158.17
2014-02-24,2014-02-24,Training/conference,REF43841341,100.5,0.0,15057.67
2014-02-25,2014-02-25,Business travel,REF12898163,41.61,0.0,15016.06
2014-02-25,2014-02-25,Training/conference,REF66301421,73.59,0.0,14942.47
2014-02-27,2014-02-27,Training/conference,REF89471609,36.13,0.0,14906.34
2014-02-28,2014-02-28,Equipment purchase,REF39264342,90.41,0.0,14815.93
2014-02-28,2014-02-28,Internet and phone service,REF78743954,39.97,0.0,14775.96
2014-03-04,2014-03-04,Internet and phone service,REF99321962,59.84,0.0,14716.12
2014-03-07,2014-03-07,Business travel,REF57716192,143.73,0.0,14572.39
2014-03-09,2014-03-09,Internet and phone service,REF31285407,81.75,0.0,14490.64
2014-03-09,2014-03-09,Business travel,REF87186980,173.81,0.0,14316.83
2014-03-09,2014-03-09,Office supplies,REF29543928,70.85,0.0,14245.98
2014-03-09,2014-03-09,Software subscription,REF30028012,171.64,0.0,14074.34
2014-03-09,2014-03-09,Professional services,REF47116378,216.15,0.0,13858.19
2014-03-11,2014-03-11,Office supplies,REF79845604,44.13,0.0,13814.06
2014-03-15,2014-03-15,Service payment - Neal-Holden,REF34231122,0.0,1143.52,14957.58
2014-03-15,2014-03-15,Project payment - Davidson and Sons,REF28893250,0.0,794.0,15751.58
2014-03-15,2014-03-15,Project payment - Peterson Ltd,REF75955163,0.0,1570.45,17322.03
2014-03-15,2014-03-15,Business insurance premium,REF74508448,136.2,0.0,17185.83
2014-03-30,2014-03-30,Business travel,REF94285708,137.81,0.0,17048.02
2014-04-06,2014-04-06,Internet and phone service,REF91179653,64.42,0.0,16983.6
2014-04-08,2014-04-08,Equipment purchase,REF36307261,113.45,0.0,16870.15
2014-04-09,2014-04-09,Software subscription,REF55270567,174.57,0.0,16695.58
2014-04-11,2014-04-11,Office supplies,REF43294191,46.56,0.0,16649.02
2014-04-13,2014-04-13,Equipment purchase,REF94073305,100.42,0.0,16548.6
2014-04-13,2014-04-13,Business travel,REF69237226,142.5,0.0,16406.1
2014-04-15,2014-04-15,Service payment - Peterson Ltd,REF97691347,0.0,1383.67,17789.77
2014-04-15,2014-04-15,Payment from Davidson and Sons,REF13295725,0.0,702.2,18491.97
2014-04-15,2014-04-15,Invoice payment - Neal-Holden,REF27641770,0.0,1167.1,19659.07
2014-04-15,2014-04-15,Business insurance premium,REF26939634,132.58,0.0,19526.49
2014-04-18,2014-04-18,Office supplies,REF27392353,59.6,0.0,19466.89
2014-04-22,2014-04-22,Professional services,REF41278216,198.32,0.0,19268.57
2014-04-28,2014-04-28,Marketing expenses,REF36699816,187.17,0.0,19081.4
2014-05-05,2014-05-05,Office supplies,REF90790372,63.79,0.0,19017.61
2014-05-05,2014-05-05,Equipment purchase,REF43466776,107.29,0.0,18910.32
2014-05-07,2014-05-07,Office supplies,REF80382786,60.02,0.0,18850.3
2014-05-07,2014-05-07,Internet and phone service,REF45590368,41.41,0.0,18808.89
2014-05-09,2014-05-09,Software subscription,REF83507959,150.86,0.0,18658.03
2014-05-10,2014-05-10,Equipment purchase,REF61255843,107.84,0.0,18550.19
2014-05-15,2014-05-15,Payment from Peterson Ltd,REF51506873,0.0,1558.83,20109.02
2014-05-15,2014-05-15,Project payment - Davidson and Sons,REF52085714,0.0,925.11,21034.13
2014-05-15,2014-05-15,Business insurance premium,REF28391645,120.96,0.0,20913.17
2014-05-17,2014-05-17,Office supplies,REF73249723,37.8,0.0,20875.37
2014-05-21,2014-05-21,Business travel,REF40785700,129.45,0.0,20745.92
2014-05-26,2014-05-26,Office supplies,REF93790839,61.07,0.0,20684.85
2014-05-28,2014-05-28,Office supplies,REF85197162,58.68,0.0,20626.17
2014-06-03,2014-06-03,Office supplies,REF33691447,15.78,0.0,20610.39
2014-06-05,2014-06-05,Equipment purchase,REF24769132,123.61,0.0,20486.78
2014-06-06,2014-06-06,Marketing expenses,REF95520134,241.89,0.0,20244.89
2014-06-07,2014-06-07,Office supplies,REF82242214,56.03,0.0,20188.86
2014-06-09,2014-06-09,Software subscription,REF87843890,121.03,0.0,20067.83
2014-06-15,2014-06-15,Invoice payment - Neal-Holden,REF79694044,0.0,1199.22,21267.05
2014-06-15,2014-06-15,Business insurance premium,REF11232330,115.25,0.0,21151.8
2014-06-15,2014-06-15,Service payment - Peterson Ltd,REF49514097,0.0,804.04,21955.84
2014-06-15,2014-06-15,Payment from Davidson and Sons,REF15336215,0.0,616.67,22572.51
2014-06-19,2014-06-19,Marketing expenses,REF50418551,143.08,0.0,22429.43
2014-06-21,2014-06-21,Internet and phone service,REF61935263,78.03,0.0,22351.4
2014-06-24,2014-06-24,Equipment purchase,REF16092856,116.97,0.0,22234.43
2014-06-24,2014-06-24,Office supplies,REF32463113,45.09,0.0,22189.34
2014-07-02,2014-07-02,Professional services,REF59429239,148.36,0.0,22040.98
2014-07-04,2014-07-04,Equipment purchase,REF21342066,103.97,0.0,21937.01
2014-07-09,2014-07-09,Software subscription,REF48091054,130.44,0.0,21806.57
2014-07-13,2014-07-13,Office supplies,REF88549790,71.86,0.0,21734.71
2014-07-15,2014-07-15,Business insurance premium,REF72371665,82.16,0.0,21652.55
2014-07-15,2014-07-15,Payment from Peterson Ltd,REF38336928,0.0,1183.52,22836.07
2014-07-15,2014-07-15,Project payment - Davidson and Sons,REF62991929,0.0,435.94,23272.01
2014-07-22,2014-07-22,Business travel,REF27836292,174.72,0.0,23097.29
2014-07-22,2014-07-22,Office supplies,REF54085037,42.32,0.0,23054.97
2014-07-23,2014-07-23,Equipment purchase,REF79489846,74.05,0.0,22980.92
2014-07-26,2014-07-26,Professional services,REF15312999,236.84,0.0,22744.08
2014-07-26,2014-07-26,Marketing expenses,REF86638201,145.81,0.0,22598.27
2014-07-26,2014-07-26,Training/conference,REF41959155,95.76,0.0,22502.51
2014-08-02,2014-08-02,Office supplies,REF35730526,17.88,0.0,22484.63
2014-08-04,2014-08-04,Office supplies,REF11465159,27.43,0.0,22457.2
2014-08-08,2014-08-08,Office supplies,REF84238275,45.58,0.0,22411.62
2014-08-08,2014-08-08,Training/conference,REF67208479,60.59,0.0,22351.03
2014-08-09,2014-08-09,Software subscription,REF52983772,96.61,0.0,22254.42
2014-08-11,2014-08-11,Business travel,REF92046814,61.24,0.0,22193.18
2014-08-15,2014-08-15,Business insurance premium,REF48035949,86.42,0.0,22106.76
2014-08-15,2014-08-15,Project payment - Neal-Holden,REF99875782,0.0,1117.76,23224.52
2014-08-15,2014-08-15,Project payment - Davidson and Sons,REF34759597,0.0,594.34,23818.86
2014-08-15,2014-08-15,Service payment - Peterson Ltd,REF19512226,0.0,951.98,24770.84
2014-08-22,2014-08-22,Office supplies,REF20109364,24.74,0.0,24746.1
2014-08-23,2014-08-23,Office supplies,REF19066510,45.22,0.0,24700.88
2014-08-26,2014-08-26,Professional services,REF86247579,144.82,0.0,24556.06
2014-08-28,2014-08-28,Office supplies,REF20996725,29.37,0.0,24526.69
2014-08-29,2014-08-29,Marketing expenses,REF47907632,49.91,0.0,24476.78
2014-09-03,2014-09-03,Office supplies,REF24089704,50.98,0.0,24425.8
2014-09-09,2014-09-09,Business travel,REF80769444,164.7,0.0,24261.1
2014-09-09,2014-09-09,Software subscription,REF85730250,163.05,0.0,24098.05
2014-09-11,2014-09-11,Business travel,REF20796867,89.16,0.0,24008.89
2014-09-15,2014-09-15,Invoice payment - Davidson and Sons,REF10716718,0.0,926.6,24935.49
2014-09-15,2014-09-15,Project payment - Peterson Ltd,REF69086901,0.0,1877.98,26813.47
2014-09-15,2014-09-15,Payment from Neal-Holden,REF34478518,0.0,1610.92,28424.39
2014-09-15,2014-09-15,Business insurance premium,REF90209451,135.01,0.0,28289.38
2014-09-20,2014-09-20,Office supplies,REF66579419,43.44,0.0,28245.94
2014-09-25,2014-09-25,Office supplies,REF45242697,56.23,0.0,28189.71
2014-09-27,2014-09-27,Training/conference,REF12610787,149.7,0.0,28040.01
2014-09-28,2014-09-28,Professional services,REF38218382,287.56,0.0,27752.45
2014-10-03,2014-10-03,Office supplies,REF27891823,57.14,0.0,27695.31
2014-10-06,2014-10-06,Marketing expenses,REF40069273,335.56,0.0,27359.75
2014-10-07,2014-10-07,Business travel,REF11952865,203.54,0.0,27156.21
2014-10-09,2014-10-09,Software subscription,REF92086238,168.8,0.0,26987.41
2014-10-13,2014-10-13,Internet and phone service,REF31495687,49.94,0.0,26937.47
2014-10-15,2014-10-15,Service payment - Neal-Holden,REF57894473,0.0,1219.51,28156.98
2014-10-15,2014-10-15,Invoice payment - Peterson Ltd,REF49981014,0.0,2032.74,30189.72
2014-10-15,2014-10-15,Business travel,REF61929856,201.01,0.0,29988.71
2014-10-15,2014-10-15,Invoice payment - Davidson and Sons,REF80180429,0.0,970.7,30959.41
2014-10-15,2014-10-15,Business insurance premium,REF18325352,145.67,0.0,30813.74
2014-10-17,2014-10-17,Internet and phone service,REF10578426,35.13,0.0,30778.61
2014-10-20,2014-10-20,Marketing expenses,REF89049616,262.54,0.0,30516.07
2014-10-20,2014-10-20,Equipment purchase,REF13340391,140.56,0.0,30375.51
2014-10-22,2014-10-22,Professional services,REF42300562,385.38,0.0,29990.13
2014-10-22,2014-10-22,Marketing expenses,REF48974875,269.89,0.0,29720.24
2014-10-24,2014-10-24,Business travel,REF52024630,231.12,0.0,29489.12
2014-10-25,2014-10-25,Equipment purchase,REF14664607,144.61,0.0,29344.51
2014-10-26,2014-10-26,Office supplies,REF58473892,62.36,0.0,29282.15
2014-10-26,2014-10-26,Internet and phone service,REF51294663,81.6,0.0,29200.55
2014-10-27,2014-10-27,Business travel,REF76167115,174.54,0.0,29026.01
2014-11-07,2014-11-07,Office supplies,REF57734378,52.12,0.0,28973.89
2014-11-09,2014-11-09,Software subscription,REF62004050,172.44,0.0,28801.45
2014-11-10,2014-11-10,Office supplies,REF61993953,77.68,0.0,28723.77
2014-11-11,2014-11-11,Training/conference,REF47509922,167.96,0.0,28555.81
2014-11-12,2014-11-12,Marketing expenses,REF35690777,280.94,0.0,28274.87
2014-11-15,2014-11-15,Business insurance premium,REF64077395,144.62,0.0,28130.25
2014-11-15,2014-11-15,Service payment - Peterson Ltd,REF57824740,0.0,1438.21,29568.46
2014-11-18,2014-11-18,Office supplies,REF59385934,84.83,0.0,29483.63
2014-11-21,2014-11-21,Marketing expenses,REF93164775,235.41,0.0,29248.22
2014-11-21,2014-11-21,Office supplies,REF74741681,46.28,0.0,29201.94
2014-11-24,2014-11-24,Professional services,REF60580379,244.63,0.0,28957.31
2014-11-25,2014-11-25,Business travel,REF97286954,218.05,0.0,28739.26
2014-11-29,2014-11-29,Office supplies,REF10384488,75.92,0.0,28663.34
2014-12-01,2014-12-01,Internet and phone service,REF11216685,94.22,0.0,28569.12
2014-12-06,2014-12-06,Equipment purchase,REF27612020,58.16,0.0,28510.96
2014-12-09,2014-12-09,Software subscription,REF22996989,125.73,0.0,28385.23
2014-12-13,2014-12-13,Internet and phone service,REF71109447,59.96,0.0,28325.27
2014-12-15,2014-12-15,Invoice payment - Neal-Holden,REF61683053,0.0,1234.85,29560.12
2014-12-15,2014-12-15,Business insurance premium,REF82494928,112.13,0.0,29447.99
2014-12-15,2014-12-15,Invoice payment - Davidson and Sons,REF39536471,0.0,939.12,30387.11
2014-12-15,2014-12-15,Project payment - Peterson Ltd,REF74618526,0.0,1109.76,31496.87
2014-12-17,2014-12-17,Training/conference,REF92652276,89.83,0.0,31407.04
2014-12-19,2014-12-19,Office supplies,REF19359167,74.92,0.0,31332.12
2014-12-20,2014-12-20,Marketing expenses,REF52690523,112.09,0.0,31220.03
2014-12-28,2014-12-28,Office supplies,REF41750926,50.53,0.0,31169.5
2015-01-03,2015-01-03,Business travel,REF45877524,122.37,0.0,31047.13
2015-01-09,2015-01-09,Software subscription,REF42441176,125.89,0.0,30921.24
2015-01-10,2015-01-10,Equipment purchase,REF56679560,94.56,0.0,30826.68
2015-01-12,2015-01-12,Professional services,REF27581564,101.89,0.0,30724.79
2015-01-15,2015-01-15,Business insurance premium,REF71573890,93.16,0.0,30631.63
2015-01-15,2015-01-15,Invoice payment - Neal-Holden,REF45319819,0.0,1231.1,31862.73
2015-01-15,2015-01-15,Invoice payment - Davidson and Sons,REF64486894,0.0,654.5,32517.23
2015-01-17,2015-01-17,Marketing expenses,REF81454721,188.44,0.0,32328.79
2015-01-20,2015-01-20,Office supplies,REF39696052,21.77,0.0,32307.02
2015-02-03,2015-02-03,Training/conference,REF24799521,124.88,0.0,32182.14
2015-02-07,2015-02-07,Marketing expenses,REF85491330,95.35,0.0,32086.79
2015-02-09,2015-02-09,Software subscription,REF55461582,116.99,0.0,31969.8
2015-02-10,2015-02-10,Internet and phone service,REF56859451,49.23,0.0,31920.57
2015-02-15,2015-02-15,Equipment purchase,REF54147444,100.64,0.0,31819.93
2015-02-15,2015-02-15,Business insurance premium,REF39812689,108.26,0.0,31711.67
2015-02-15,2015-02-15,Project payment - Davidson and Sons,REF34398094,0.0,748.25,32459.92
2015-02-15,2015-02-15,Service payment - Neal-Holden,REF81014874,0.0,726.98,33186.9
2015-02-17,2015-02-17,Professional services,REF84550982,212.84,0.0,32974.06
2015-02-17,2015-02-17,Business travel,REF97087600,94.54,0.0,32879.52
2015-02-20,2015-02-20,Marketing expenses,REF17049950,313.12,0.0,32566.4
2015-02-20,2015-02-20,Professional services,REF10797985,196.37,0.0,32370.03
2015-02-23,2015-02-23,Business travel,REF99331171,159.44,0.0,32210.59
2015-02-24,2015-02-24,Office supplies,REF72731467,44.53,0.0,32166.06
2015-02-26,2015-02-26,Professional services,REF38579460,363.67,0.0,31802.39
2015-03-03,2015-03-03,Equipment purchase,REF71762216,95.85,0.0,31706.54
2015-03-04,2015-03-04,Office supplies,REF57109825,69.46,0.0,31637.08
2015-03-09,2015-03-09,Professional services,REF44048994,301.42,0.0,31335.66
2015-03-09,2015-03-09,Software subscription,REF53631038,128.34,0.0,31207.32
2015-03-10,2015-03-10,Business travel,REF73399524,211.76,0.0,30995.56
2015-03-15,2015-03-15,Business travel,REF96029550,120.58,0.0,30874.98
2015-03-15,2015-03-15,Project payment - Peterson Ltd,REF69268229,0.0,1752.63,32627.61
2015-03-15,2015-03-15,Invoice payment - Davidson and Sons,REF58877783,0.0,1009.44,33637.05
2015-03-15,2015-03-15,Service payment - Neal-Holden,REF92603806,0.0,1750.36,35387.41
2015-03-15,2015-03-15,Business insurance premium,REF94013344,119.02,0.0,35268.39
2015-03-20,2015-03-20,Training/conference,REF52055398,126.25,0.0,35142.14
2015-03-22,2015-03-22,Office supplies,REF92899122,50.84,0.0,35091.3
2015-03-24,2015-03-24,Marketing expenses,REF67484319,269.18,0.0,34822.12
2015-03-24,2015-03-24,Office supplies,REF25933777,72.28,0.0,34749.84
2015-03-27,2015-03-27,Office supplies,REF88677169,37.46,0.0,34712.38
2015-03-29,2015-03-29,Office supplies,REF21530502,57.97,0.0,34654.41
2015-04-01,2015-04-01,Professional services,REF38279545,306.4,0.0,34348.01
2015-04-08,2015-04-08,Marketing expenses,REF94812237,144.74,0.0,34203.27
2015-04-09,2015-04-09,Software subscription,REF60990447,188.73,0.0,34014.54
2015-04-13,2015-04-13,Internet and phone service,REF82556421,51.27,0.0,33963.27
2015-04-14,2015-04-14,Professional services,REF72423743,255.19,0.0,33708.08
2015-04-15,2015-04-15,Business insurance premium,REF90594675,117.83,0.0,33590.25
2015-04-15,2015-04-15,Service payment - Peterson Ltd,REF39650264,0.0,1615.25,35205.5
2015-04-15,2015-04-15,Project payment - Davidson and Sons,REF84215310,0.0,713.94,35919.44
2015-04-15,2015-04-15,Service payment - Neal-Holden,REF22259454,0.0,1624.07,37543.51
2015-04-23,2015-04-23,Office supplies,REF45690237,64.18,0.0,37479.33
2015-04-25,2015-04-25,Training/conference,REF99677514,98.58,0.0,37380.75
2015-04-25,2015-04-25,Equipment purchase,REF96396277,141.19,0.0,37239.56
2015-04-29,2015-04-29,Marketing expenses,REF42963591,283.57,0.0,36955.99
2015-04-30,2015-04-30,Marketing expenses,REF86949079,52.55,0.0,36903.44
2015-05-09,2015-05-09,Software subscription,REF45461209,130.94,0.0,36772.5
2015-05-13,2015-05-13,Office supplies,REF16202880,41.66,0.0,36730.84
2015-05-13,2015-05-13,Business travel,REF43918202,133.79,0.0,36597.05
2015-05-15,2015-05-15,Service payment - Peterson Ltd,REF11346903,0.0,1628.4,38225.45
2015-05-15,2015-05-15,Service payment - Davidson and Sons,REF89578454,0.0,836.99,39062.44
2015-05-15,2015-05-15,Business insurance premium,REF74069613,117.92,0.0,38944.52
2015-05-18,2015-05-18,Office supplies,REF51879435,21.7,0.0,38922.82
2015-05-23,2015-05-23,Office supplies,REF47609904,57.43,0.0,38865.39
2015-05-24,2015-05-24,Office supplies,REF76545113,55.97,0.0,38809.42
2015-05-27,2015-05-27,Business travel,REF45521555,154.12,0.0,38655.3
2015-05-28,2015-05-28,Business travel,REF14947077,132.33,0.0,38522.97
2015-05-29,2015-05-29,Office supplies,REF57376292,37.84,0.0,38485.13
2015-05-29,2015-05-29,Professional services,REF96043956,414.66,0.0,38070.47
2015-06-05,2015-06-05,Office supplies,REF12130050,49.6,0.0,38020.87
2015-06-08,2015-06-08,Training/conference,REF83991028,68.52,0.0,37952.35
2015-06-09,2015-06-09,Software subscription,REF79432003,131.29,0.0,37821.06
2015-06-09,2015-06-09,Internet and phone service,REF85916461,77.55,0.0,37743.51
2015-06-09,2015-06-09,Professional services,REF54220709,225.73,0.0,37517.78
2015-06-15,2015-06-15,Service payment - Peterson Ltd,REF90103827,0.0,1403.61,38921.39
2015-06-15,2015-06-15,Payment from Davidson and Sons,REF10069055,0.0,743.74,39665.13
2015-06-15,2015-06-15,Business insurance premium,REF68445997,102.3,0.0,39562.83
2015-06-21,2015-06-21,Professional services,REF87653082,269.32,0.0,39293.51
2015-06-25,2015-06-25,Marketing expenses,REF15979291,142.9,0.0,39150.61
2015-06-26,2015-06-26,Equipment purchase,REF79245962,70.5,0.0,39080.11
2015-07-06,2015-07-06,Training/conference,REF89183559,85.99,0.0,38994.12
2015-07-07,2015-07-07,Office supplies,REF99706399,53.35,0.0,38940.77
2015-07-09,2015-07-09,Software subscription,REF57762209,134.31,0.0,38806.46
2015-07-13,2015-07-13,Training/conference,REF52124541,84.83,0.0,38721.63
2015-07-15,2015-07-15,Training/conference,REF85177169,120.7,0.0,38600.93
2015-07-15,2015-07-15,Payment from Peterson Ltd,REF25725534,0.0,1741.4,40342.33
2015-07-15,2015-07-15,Service payment - Neal-Holden,REF90228757,0.0,972.63,41314.96
2015-07-15,2015-07-15,Project payment - Davidson and Sons,REF69587199,0.0,572.51,41887.47
2015-07-15,2015-07-15,Office supplies,REF16529622,27.41,0.0,41860.06
2015-07-15,2015-07-15,Business insurance premium,REF29767807,91.36,0.0,41768.7
2015-07-18,2015-07-18,Marketing expenses,REF57149590,162.9,0.0,41605.8
2015-07-20,2015-07-20,Office supplies,REF99364895,50.87,0.0,41554.93
2015-07-21,2015-07-21,Business travel,REF72908165,149.27,0.0,41405.66
2015-07-22,2015-07-22,Training/conference,REF75191189,75.89,0.0,41329.77
2015-07-24,2015-07-24,Office supplies,REF52596384,37.67,0.0,41292.1
2015-08-05,2015-08-05,Marketing expenses,REF89930963,136.85,0.0,41155.25
2015-08-09,2015-08-09,Software subscription,REF24637124,97.72,0.0,41057.53
2015-08-14,2015-08-14,Internet and phone service,REF30833341,69.02,0.0,40988.51
2015-08-15,2015-08-15,Business insurance premium,REF52707486,86.79,0.0,40901.72
2015-08-15,2015-08-15,Payment from Neal-Holden,REF13181644,0.0,716.65,41618.37
2015-08-15,2015-08-15,Project payment - Peterson Ltd,REF17938882,0.0,1520.27,43138.64
2015-08-15,2015-08-15,Marketing expenses,REF23322073,137.55,0.0,43001.09
2015-08-15,2015-08-15,Service payment - Davidson and Sons,REF95874235,0.0,635.4,43636.49
2015-08-17,2015-08-17,Training/conference,REF16487702,74.53,0.0,43561.96
2015-08-22,2015-08-22,Office supplies,REF78099371,29.78,0.0,43532.18
2015-08-24,2015-08-24,Office supplies,REF83103628,18.08,0.0,43514.1
2015-08-26,2015-08-26,Business travel,REF83221184,148.84,0.0,43365.26
2015-08-28,2015-08-28,Internet and phone service,REF77482653,88.15,0.0,43277.11
2015-08-30,2015-08-30,Business travel,REF30184638,144.76,0.0,43132.35
2015-09-09,2015-09-09,Internet and phone service,REF36978603,99.2,0.0,43033.15
2015-09-09,2015-09-09,Software subscription,REF87150131,155.93,0.0,42877.22
2015-09-13,2015-09-13,Internet and phone service,REF14206551,76.48,0.0,42800.74
2015-09-15,2015-09-15,Project payment - Peterson Ltd,REF82709122,0.0,1725.07,44525.81
2015-09-15,2015-09-15,Project payment - Davidson and Sons,REF26005468,0.0,1196.66,45722.47
2015-09-15,2015-09-15,Invoice payment - Neal-Holden,REF58377807,0.0,1402.59,47125.06
2015-09-15,2015-09-15,Business insurance premium,REF97762343,136.97,0.0,46988.09
2015-09-19,2015-09-19,Training/conference,REF16372373,105.55,0.0,46882.54
2015-09-20,2015-09-20,Internet and phone service,REF92098340,50.46,0.0,46832.08
2015-09-25,2015-09-25,Professional services,REF85517680,365.4,0.0,46466.68
2015-09-28,2015-09-28,Internet and phone service,REF95172881,89.6,0.0,46377.08
2015-09-28,2015-09-28,Professional services,REF95368428,221.33,0.0,46155.75
2015-09-30,2015-09-30,Office supplies,REF92573494,41.95,0.0,46113.8
2015-10-07,2015-10-07,Training/conference,REF19812917,166.6,0.0,45947.2
2015-10-08,2015-10-08,Professional services,REF87382497,343.27,0.0,45603.93
2015-10-09,2015-10-09,Professional services,REF33619285,358.1,0.0,45245.83
2015-10-09,2015-10-09,Software subscription,REF96087886,207.14,0.0,45038.69
2015-10-10,2015-10-10,Training/conference,REF79976343,80.32,0.0,44958.37
2015-10-12,2015-10-12,Business travel,REF65431785,163.77,0.0,44794.6
2015-10-13,2015-10-13,Office supplies,REF40942344,84.21,0.0,44710.39
2015-10-15,2015-10-15,Business insurance premium,REF27439134,152.6,0.0,44557.79
2015-10-15,2015-10-15,Service payment - Neal-Holden,REF28559751,0.0,1163.72,45721.51
2015-10-15,2015-10-15,Project payment - Peterson Ltd,REF89234937,0.0,1908.48,47629.99
2015-10-18,2015-10-18,Training/conference,REF57854848,166.98,0.0,47463.01
2015-10-23,2015-10-23,Office supplies,REF71871259,79.2,0.0,47383.81
2015-11-01,2015-11-01,Business travel,REF17848914,149.42,0.0,47234.39
2015-11-02,2015-11-02,Business travel,REF16521090,149.3,0.0,47085.09
2015-11-04,2015-11-04,Equipment purchase,REF20914879,79.91,0.0,47005.18
2015-11-08,2015-11-08,Office supplies,REF82261245,38.39,0.0,46966.79
2015-11-09,2015-11-09,Software subscription,REF15452763,163.77,0.0,46803.02
2015-11-09,2015-11-09,Office supplies,REF60680892,25.01,0.0,46778.01
2015-11-13,2015-11-13,Office supplies,REF27395852,22.52,0.0,46755.49
2015-11-15,2015-11-15,Business insurance premium,REF11392760,133.44,0.0,46622.05
2015-11-15,2015-11-15,Project payment - Peterson Ltd,REF18924580,0.0,1362.74,47984.79
2015-11-15,2015-11-15,Invoice payment - Neal-Holden,REF54204440,0.0,1196.87,49181.66
2015-11-15,2015-11-15,Payment from Davidson and Sons,REF69160004,0.0,1086.3,50267.96
2015-11-15,2015-11-15,Business travel,REF49918644,105.95,0.0,50162.01
2015-11-18,2015-11-18,Internet and phone service,REF89322626,85.31,0.0,50076.7
2015-11-18,2015-11-18,Office supplies,REF67131989,43.14,0.0,50033.56
2015-11-21,2015-11-21,Equipment purchase,REF59492249,84.83,0.0,49948.73
2015-11-22,2015-11-22,Business travel,REF10418550,158.23,0.0,49790.5
2015-11-26,2015-11-26,Internet and phone service,REF94871300,86.42,0.0,49704.08
2015-11-28,2015-11-28,Business travel,REF77282584,124.69,0.0,49579.39
2015-12-02,2015-12-02,Training/conference,REF13153958,96.32,0.0,49483.07
2015-12-09,2015-12-09,Software subscription,REF54992632,121.23,0.0,49361.84
2015-12-12,2015-12-12,Equipment purchase,REF78761357,69.55,0.0,49292.29
2015-12-12,2015-12-12,Internet and phone service,REF91284241,73.83,0.0,49218.46
2015-12-15,2015-12-15,Service payment - Neal-Holden,REF40458874,0.0,1088.08,50306.54
2015-12-15,2015-12-15,Project payment - Davidson and Sons,REF59900797,0.0,1019.65,51326.19
2015-12-15,2015-12-15,Business insurance premium,REF42401433,113.96,0.0,51212.23
2015-12-15,2015-12-15,Payment from Peterson Ltd,REF19287634,0.0,1677.73,52889.96
2015-12-19,2015-12-19,Equipment purchase,REF53302401,92.43,0.0,52797.53
2015-12-22,2015-12-22,Office supplies,REF58278088,33.76,0.0,52763.77
2015-12-24,2015-12-24,Office supplies,REF11952109,55.89,0.0,52707.88
2015-12-26,2015-12-26,Office supplies,REF78732506,39.3,0.0,52668.58
2015-12-31,2015-12-31,Office supplies,REF54709573,50.07,0.0,52618.51
2016-01-08,2016-01-08,Office supplies,REF65615395,48.13,0.0,52570.38
2016-01-09,2016-01-09,Software subscription,REF15410580,115.98,0.0,52454.4
2016-01-09,2016-01-09,Internet and phone service,REF64417495,51.06,0.0,52403.34
2016-01-09,2016-01-09,Office supplies,REF61568987,59.81,0.0,52343.53
2016-01-11,2016-01-11,Internet and phone service,REF69922848,75.89,0.0,52267.64
2016-01-15,2016-01-15,Payment from Neal-Holden,REF95894125,0.0,1077.13,53344.77
2016-01-15,2016-01-15,Project payment - Davidson and Sons,REF67625554,0.0,568.02,53912.79
2016-01-15,2016-01-15,Service payment - Peterson Ltd,REF56936809,0.0,1438.23,55351.02
2016-01-15,2016-01-15,Business insurance premium,REF56556442,100.21,0.0,55250.81
2016-01-21,2016-01-21,Office supplies,REF61763497,26.67,0.0,55224.14
2016-01-22,2016-01-22,Business travel,REF40848419,39.73,0.0,55184.41
2016-01-23,2016-01-23,Office supplies,REF59195867,25.99,0.0,55158.42
2016-01-26,2016-01-26,Training/conference,REF60366225,84.75,0.0,55073.67
2016-01-28,2016-01-28,Marketing expenses,REF44804827,159.9,0.0,54913.77
2016-01-30,2016-01-30,Office supplies,REF80292698,49.87,0.0,54863.9
2016-01-31,2016-01-31,Office supplies,REF40202361,41.83,0.0,54822.07
2016-02-05,2016-02-05,Equipment purchase,REF61715752,79.42,0.0,54742.65
2016-02-09,2016-02-09,Software subscription,REF73817357,153.01,0.0,54589.64
2016-02-15,2016-02-15,Business insurance premium,REF28893966,101.38,0.0,54488.26
2016-02-15,2016-02-15,Payment from Neal-Holden,REF52158957,0.0,1186.38,55674.64
2016-02-15,2016-02-15,Service payment - Davidson and Sons,REF34236679,0.0,957.57,56632.21
2016-02-15,2016-02-15,Payment from Peterson Ltd,REF34553874,0.0,1514.28,58146.49
2016-02-19,2016-02-19,Professional services,REF15591851,272.34,0.0,57874.15
2016-02-20,2016-02-20,Office supplies,REF21911775,43.55,0.0,57830.6
2016-02-24,2016-02-24,Business travel,REF99417179,148.66,0.0,57681.94
2016-02-27,2016-02-27,Office supplies,REF99612251,32.08,0.0,57649.86
2016-02-28,2016-02-28,Business travel,REF97424540,86.66,0.0,57563.2
2016-03-09,2016-03-09,Software subscription,REF30331767,204.15,0.0,57359.05
2016-03-15,2016-03-15,Business insurance premium,REF21148411,135.3,0.0,57223.75
2016-03-15,2016-03-15,Payment from Peterson Ltd,REF97652159,0.0,1642.39,58866.14
2016-03-15,2016-03-15,Invoice payment - Davidson and Sons,REF25825536,0.0,936.44,59802.58
2016-03-15,2016-03-15,Payment from Neal-Holden,REF14671065,0.0,1522.86,61325.44
2016-03-18,2016-03-18,Business travel,REF33679865,186.33,0.0,61139.11
2016-03-19,2016-03-19,Office supplies,REF12883457,49.19,0.0,61089.92
2016-03-22,2016-03-22,Office supplies,REF54595569,33.51,0.0,61056.41
2016-03-24,2016-03-24,Office supplies,REF63452961,52.86,0.0,61003.55
2016-03-26,2016-03-26,Office supplies,REF47454808,52.3,0.0,60951.25
2016-03-26,2016-03-26,Equipment purchase,REF24800994,90.26,0.0,60860.99
2016-03-28,2016-03-28,Office supplies,REF41687743,57.82,0.0,60803.17
2016-03-31,2016-03-31,Business travel,REF80384912,172.31,0.0,60630.86
2016-04-05,2016-04-05,Equipment purchase,REF64156512,126.6,0.0,60504.26
2016-04-08,2016-04-08,Business travel,REF59594296,226.38,0.0,60277.88
2016-04-09,2016-04-09,Software subscription,REF63371491,136.46,0.0,60141.42
2016-04-11,2016-04-11,Office supplies,REF26353577,59.19,0.0,60082.23
2016-04-12,2016-04-12,Equipment purchase,REF58853500,114.74,0.0,59967.49
2016-04-12,2016-04-12,Office supplies,REF74280680,38.08,0.0,59929.41
2016-04-15,2016-04-15,Service payment - Davidson and Sons,REF44696519,0.0,773.91,60703.32
2016-04-15,2016-04-15,Payment from Neal-Holden,REF96591353,0.0,1429.96,62133.28
2016-04-15,2016-04-15,Business insurance premium,REF24185979,111.02,0.0,62022.26
2016-04-15,2016-04-15,Project payment - Peterson Ltd,REF10829369,0.0,1128.57,63150.83
2016-04-29,2016-04-29,Equipment purchase,REF19915670,83.92,0.0,63066.91
2016-04-30,2016-04-30,Internet and phone service,REF15536648,62.2,0.0,63004.71
2016-05-05,2016-05-05,Equipment purchase,REF55250370,115.26,0.0,62889.45
2016-05-09,2016-05-09,Software subscription,REF76728666,148.76,0.0,62740.69
2016-05-10,2016-05-10,Professional services,REF86237541,395.67,0.0,62345.02
2016-05-10,2016-05-10,Office supplies,REF14765102,34.6,0.0,62310.42
2016-05-15,2016-05-15,Business insurance premium,REF64626867,121.6,0.0,62188.82
2016-05-15,2016-05-15,Payment from Peterson Ltd,REF66081959,0.0,1327.61,63516.43
2016-05-15,2016-05-15,Project payment - Davidson and Sons,REF53148468,0.0,852.62,64369.05
2016-05-15,2016-05-15,Project payment - Neal-Holden,REF57698354,0.0,995.21,65364.26
2016-05-25,2016-05-25,Office supplies,REF85836181,58.87,0.0,65305.39
2016-05-26,2016-05-26,Office supplies,REF74861251,31.87,0.0,65273.52
2016-05-30,2016-05-30,Internet and phone service,REF14585292,80.45,0.0,65193.07
2016-06-01,2016-06-01,Internet and phone service,REF55435124,93.32,0.0,65099.75
2016-06-01,2016-06-01,Office supplies,REF27168338,50.9,0.0,65048.85
2016-06-02,2016-06-02,Business travel,REF22892677,98.84,0.0,64950.01
2016-06-03,2016-06-03,Office supplies,REF70372348,48.79,0.0,64901.22
2016-06-04,2016-06-04,Office supplies,REF97472333,44.44,0.0,64856.78
2016-06-09,2016-06-09,Software subscription,REF95153080,151.25,0.0,64705.53
2016-06-10,2016-06-10,Office supplies,REF14745312,54.43,0.0,64651.1
2016-06-10,2016-06-10,Equipment purchase,REF55604702,51.76,0.0,64599.34
2016-06-11,2016-06-11,Office supplies,REF58778641,48.49,0.0,64550.85
2016-06-15,2016-06-15,Business insurance premium,REF88415497,109.47,0.0,64441.38
2016-06-15,2016-06-15,Invoice payment - Davidson and Sons,REF52829555,0.0,638.5,65079.88
2016-06-15,2016-06-15,Service payment - Neal-Holden,REF58384288,0.0,1250.41,66330.29
2016-06-15,2016-06-15,Invoice payment - Peterson Ltd,REF68845741,0.0,1705.74,68036.03
2016-06-17,2016-06-17,Internet and phone service,REF60856931,52.97,0.0,67983.06
2016-06-17,2016-06-17,Equipment purchase,REF34771335,81.99,0.0,67901.07
2016-06-18,2016-06-18,Training/conference,REF26335250,98.9,0.0,67802.17
2016-06-22,2016-06-22,Internet and phone service,REF84292515,54.5,0.0,67747.67
2016-06-23,2016-06-23,Training/conference,REF60062969,51.8,0.0,67695.87
2016-06-29,2016-06-29,Marketing expenses,REF31768484,67.34,0.0,67628.53
2016-07-01,2016-07-01,Office supplies,REF40415502,50.81,0.0,67577.72
2016-07-03,2016-07-03,Office supplies,REF60484796,45.76,0.0,67531.96
2016-07-09,2016-07-09,Software subscription,REF85555167,101.05,0.0,67430.91
2016-07-11,2016-07-11,Professional services,REF21189403,294.14,0.0,67136.77
2016-07-12,2016-07-12,Office supplies,REF64431352,24.64,0.0,67112.13
2016-07-13,2016-07-13,Training/conference,REF70990125,80.45,0.0,67031.68
2016-07-13,2016-07-13,Office supplies,REF96280587,43.74,0.0,66987.94
2016-07-14,2016-07-14,Internet and phone service,REF23381146,87.51,0.0,66900.43
2016-07-14,2016-07-14,Business travel,REF97286580,113.41,0.0,66787.02
2016-07-14,2016-07-14,Marketing expenses,REF49808080,211.62,0.0,66575.4
2016-07-15,2016-07-15,Internet and phone service,REF20441892,119.53,0.0,66455.87
2016-07-15,2016-07-15,Payment from Peterson Ltd,REF51834506,0.0,1216.69,67672.56
2016-07-15,2016-07-15,Service payment - Davidson and Sons,REF76653298,0.0,713.87,68386.43
2016-07-15,2016-07-15,Invoice payment - Neal-Holden,REF11585162,0.0,1190.86,69577.29
2016-07-15,2016-07-15,Business insurance premium,REF43816673,88.95,0.0,69488.34
2016-07-16,2016-07-16,Equipment purchase,REF56762805,62.93,0.0,69425.41
2016-07-17,2016-07-17,Internet and phone service,REF42516283,40.3,0.0,69385.11
2016-07-17,2016-07-17,Business travel,REF22894368,42.34,0.0,69342.77
2016-07-20,2016-07-20,Marketing expenses,REF78802435,189.23,0.0,69153.54
2016-07-21,2016-07-21,Office supplies,REF70147401,51.27,0.0,69102.27
2016-08-01,2016-08-01,Equipment purchase,REF34492112,73.85,0.0,69028.42
2016-08-02,2016-08-02,Marketing expenses,REF40356630,157.56,0.0,68870.86
2016-08-04,2016-08-04,Business travel,REF60699418,94.51,0.0,68776.35
2016-08-07,2016-08-07,Training/conference,REF56680792,92.84,0.0,68683.51
2016-08-07,2016-08-07,Office supplies,REF39417894,39.52,0.0,68643.99
2016-08-09,2016-08-09,Software subscription,REF72987011,104.98,0.0,68539.01
2016-08-12,2016-08-12,Professional services,REF88564028,176.01,0.0,68363.0
2016-08-15,2016-08-15,Project payment - Neal-Holden,REF41945534,0.0,991.55,69354.55
2016-08-15,2016-08-15,Project payment - Davidson and Sons,REF81121749,0.0,644.79,69999.34
2016-08-15,2016-08-15,Business insurance premium,REF49106513,83.63,0.0,69915.71
2016-08-19,2016-08-19,Training/conference,REF11029027,104.65,0.0,69811.06
2016-08-24,2016-08-24,Professional services,REF47604453,165.06,0.0,69646.0
2016-08-24,2016-08-24,Business travel,REF54853288,60.37,0.0,69585.63
2016-08-27,2016-08-27,Training/conference,REF25575889,69.89,0.0,69515.74
2016-08-28,2016-08-28,Office supplies,REF43051624,39.6,0.0,69476.14
2016-08-29,2016-08-29,Business travel,REF49455297,93.05,0.0,69383.09
2016-09-03,2016-09-03,Internet and phone service,REF86926034,79.88,0.0,69303.21
2016-09-04,2016-09-04,Marketing expenses,REF94218094,277.42,0.0,69025.79
2016-09-05,2016-09-05,Office supplies,REF77922435,50.08,0.0,68975.71
2016-09-09,2016-09-09,Office supplies,REF28326049,84.51,0.0,68891.2
2016-09-09,2016-09-09,Software subscription,REF71001074,169.61,0.0,68721.59
2016-09-11,2016-09-11,Professional services,REF42380018,159.75,0.0,68561.84
2016-09-12,2016-09-12,Internet and phone service,REF22227029,102.48,0.0,68459.36
2016-09-13,2016-09-13,Training/conference,REF34206429,102.22,0.0,68357.14
2016-09-14,2016-09-14,Equipment purchase,REF38522710,96.78,0.0,68260.36
2016-09-15,2016-09-15,Business insurance premium,REF59012029,118.32,0.0,68142.04
2016-09-15,2016-09-15,Invoice payment - Davidson and Sons,REF30084309,0.0,1261.38,69403.42
2016-09-15,2016-09-15,Project payment - Peterson Ltd,REF28739260,0.0,1465.84,70869.26
2016-09-21,2016-09-21,Office supplies,REF76828677,62.77,0.0,70806.49
2016-09-25,2016-09-25,Office supplies,REF14370921,52.3,0.0,70754.19
2016-09-26,2016-09-26,Office supplies,REF96659992,39.11,0.0,70715.08
2016-09-27,2016-09-27,Office supplies,REF56720620,53.5,0.0,70661.58
2016-09-30,2016-09-30,Office supplies,REF77848320,58.22,0.0,70603.36
2016-10-09,2016-10-09,Office supplies,REF48856364,60.61,0.0,70542.75
2016-10-09,2016-10-09,Software subscription,REF46448963,177.45,0.0,70365.3
2016-10-12,2016-10-12,Business travel,REF66209501,188.35,0.0,70176.95
2016-10-12,2016-10-12,Training/conference,REF16117951,142.36,0.0,70034.59
2016-10-15,2016-10-15,Invoice payment - Peterson Ltd,REF69714555,0.0,2015.9,72050.49
2016-10-15,2016-10-15,Marketing expenses,REF50683217,152.43,0.0,71898.06
2016-10-15,2016-10-15,Business insurance premium,REF88111081,137.18,0.0,71760.88
2016-10-15,2016-10-15,Invoice payment - Davidson and Sons,REF32155564,0.0,1344.94,73105.82
2016-10-15,2016-10-15,Project payment - Neal-Holden,REF17942286,0.0,1236.86,74342.68
2016-10-16,2016-10-16,Office supplies,REF31159363,38.38,0.0,74304.3
2016-10-19,2016-10-19,Office supplies,REF81231814,58.5,0.0,74245.8
2016-10-22,2016-10-22,Professional services,REF20811167,250.23,0.0,73995.57
2016-10-23,2016-10-23,Office supplies,REF67326203,62.04,0.0,73933.53
2016-10-23,2016-10-23,Marketing expenses,REF16719291,99.73,0.0,73833.8
2016-10-23,2016-10-23,Internet and phone service,REF79572348,100.34,0.0,73733.46
2016-10-24,2016-10-24,Marketing expenses,REF98719039,279.82,0.0,73453.64
2016-11-06,2016-11-06,Business travel,REF11612836,153.31,0.0,73300.33
2016-11-09,2016-11-09,Software subscription,REF23006021,166.21,0.0,73134.12
2016-11-11,2016-11-11,Marketing expenses,REF54448893,122.01,0.0,73012.11
2016-11-15,2016-11-15,Service payment - Neal-Holden,REF81064946,0.0,1396.98,74409.09
2016-11-15,2016-11-15,Business insurance premium,REF21522325,124.87,0.0,74284.22
2016-11-15,2016-11-15,Payment from Davidson and Sons,REF65446709,0.0,910.16,75194.38
2016-11-15,2016-11-15,Project payment - Peterson Ltd,REF87654457,0.0,1538.78,76733.16
2016-11-16,2016-11-16,Training/conference,REF55668093,94.82,0.0,76638.34
2016-11-21,2016-11-21,Equipment purchase,REF13406960,214.67,0.0,76423.67
2016-11-24,2016-11-24,Office supplies,REF15252800,64.35,0.0,76359.32
2016-11-24,2016-11-24,Internet and phone service,REF97284543,46.48,0.0,76312.84
2016-11-25,2016-11-25,Office supplies,REF43227563,53.31,0.0,76259.53
2016-11-28,2016-11-28,Training/conference,REF85011750,86.26,0.0,76173.27
2016-12-04,2016-12-04,Business travel,REF20579846,151.64,0.0,76021.63
2016-12-08,2016-12-08,Office supplies,REF90282622,37.03,0.0,75984.6
2016-12-09,2016-12-09,Software subscription,REF81527428,139.09,0.0,75845.51
2016-12-11,2016-12-11,Internet and phone service,REF55781663,66.94,0.0,75778.57
2016-12-13,2016-12-13,Internet and phone service,REF99440207,87.92,0.0,75690.65
2016-12-14,2016-12-14,Office supplies,REF41589222,69.02,0.0,75621.63
2016-12-15,2016-12-15,Business insurance premium,REF83624781,112.96,0.0,75508.67
2016-12-15,2016-12-15,Service payment - Peterson Ltd,REF76951310,0.0,1433.78,76942.45
2016-12-15,2016-12-15,Invoice payment - Davidson and Sons,REF87812071,0.0,662.31,77604.76
2016-12-15,2016-12-15,Invoice payment - Neal-Holden,REF75960733,0.0,1248.34,78853.1
2016-12-16,2016-12-16,Office supplies,REF23096090,49.7,0.0,78803.4
2016-12-19,2016-12-19,Training/conference,REF74302790,93.49,0.0,78709.91
2016-12-22,2016-12-22,Office supplies,REF94197856,56.52,0.0,78653.39
2016-12-26,2016-12-26,Office supplies,REF35035942,23.14,0.0,78630.25
2016-12-30,2016-12-30,Business travel,REF72738436,98.87,0.0,78531.38
2017-01-01,2017-01-01,Business travel,REF98956725,121.71,0.0,78409.67
2017-01-03,2017-01-03,Professional services,REF78146590,183.67,0.0,78226.0
2017-01-08,2017-01-08,Marketing expenses,REF90065527,158.16,0.0,78067.84
2017-01-09,2017-01-09,Software subscription,REF83996420,145.71,0.0,77922.13
2017-01-09,2017-01-09,Internet and phone service,REF60577172,103.56,0.0,77818.57
2017-01-10,2017-01-10,Professional services,REF25803254,159.48,0.0,77659.09
2017-01-10,2017-01-10,Marketing expenses,REF53433918,162.44,0.0,77496.65
2017-01-15,2017-01-15,Payment from Neal-Holden,REF62901331,0.0,646.46,78143.11
2017-01-15,2017-01-15,Service payment - Peterson Ltd,REF49800186,0.0,1036.01,79179.12
2017-01-15,2017-01-15,Invoice payment - Davidson and Sons,REF51330294,0.0,470.79,79649.91
2017-01-15,2017-01-15,Business insurance premium,REF63316861,91.72,0.0,79558.19
2017-01-16,2017-01-16,Business travel,REF67703953,178.98,0.0,79379.21
2017-01-17,2017-01-17,Business travel,REF88741518,31.02,0.0,79348.19
2017-01-17,2017-01-17,Internet and phone service,REF46894027,80.5,0.0,79267.69
2017-01-19,2017-01-19,Professional services,REF42442517,300.92,0.0,78966.77
2017-01-24,2017-01-24,Internet and phone service,REF67895579,57.99,0.0,78908.78
2017-01-28,2017-01-28,Business travel,REF33348167,109.67,0.0,78799.11
2017-02-01,2017-02-01,Professional services,REF99037432,317.35,0.0,78481.76
2017-02-06,2017-02-06,Equipment purchase,REF69843281,59.29,0.0,78422.47
2017-02-09,2017-02-09,Software subscription,REF34892056,130.42,0.0,78292.05
2017-02-10,2017-02-10,Business travel,REF46158053,124.89,0.0,78167.16
2017-02-12,2017-02-12,Office supplies,REF16264451,38.78,0.0,78128.38
2017-02-14,2017-02-14,Training/conference,REF85883593,78.72,0.0,78049.66
2017-02-15,2017-02-15,Service payment - Davidson and Sons,REF58538533,0.0,772.68,78822.34
2017-02-15,2017-02-15,Business insurance premium,REF91408130,109.73,0.0,78712.61
2017-02-15,2017-02-15,Payment from Neal-Holden,REF77026553,0.0,1237.54,79950.15
2017-02-15,2017-02-15,Payment from Peterson Ltd,REF49936521,0.0,1576.64,81526.79
2017-02-17,2017-02-17,Marketing expenses,REF22638395,235.28,0.0,81291.51
2017-02-18,2017-02-18,Business travel,REF97410795,109.32,0.0,81182.19
2017-02-20,2017-02-20,Business travel,REF58353188,132.5,0.0,81049.69
2017-02-24,2017-02-24,Marketing expenses,REF17752179,123.19,0.0,80926.5
2017-03-01,2017-03-01,Marketing expenses,REF76190232,298.09,0.0,80628.41
2017-03-01,2017-03-01,Office supplies,REF38874166,74.71,0.0,80553.7
2017-03-07,2017-03-07,Office supplies,REF25574730,32.88,0.0,80520.82
2017-03-09,2017-03-09,Software subscription,REF77919040,163.07,0.0,80357.75
2017-03-10,2017-03-10,Office supplies,REF28917172,53.11,0.0,80304.64
2017-03-12,2017-03-12,Office supplies,REF44854792,60.24,0.0,80244.4
2017-03-15,2017-03-15,Business insurance premium,REF64991559,132.5,0.0,80111.9
2017-03-15,2017-03-15,Payment from Peterson Ltd,REF37598126,0.0,1669.7,81781.6
2017-03-15,2017-03-15,Payment from Davidson and Sons,REF61563270,0.0,1105.18,82886.78
2017-03-15,2017-03-15,Invoice payment - Neal-Holden,REF23087534,0.0,1327.04,84213.82
2017-03-22,2017-03-22,Business travel,REF86054242,239.91,0.0,83973.91
2017-03-23,2017-03-23,Business travel,REF67537930,186.35,0.0,83787.56
2017-03-24,2017-03-24,Office supplies,REF24507116,51.1,0.0,83736.46
2017-03-24,2017-03-24,Training/conference,REF19841442,85.67,0.0,83650.79
2017-04-01,2017-04-01,Professional services,REF35787605,161.67,0.0,83489.12
2017-04-09,2017-04-09,Software subscription,REF71651189,127.78,0.0,83361.34
2017-04-15,2017-04-15,Marketing expenses,REF16770246,98.32,0.0,83263.02
2017-04-15,2017-04-15,Service payment - Davidson and Sons,REF69268700,0.0,671.14,83934.16
2017-04-15,2017-04-15,Service payment - Peterson Ltd,REF20202681,0.0,1382.33,85316.49
2017-04-15,2017-04-15,Service payment - Neal-Holden,REF40669663,0.0,1315.11,86631.6
2017-04-15,2017-04-15,Business insurance premium,REF33471336,122.38,0.0,86509.22
2017-04-29,2017-04-29,Marketing expenses,REF43404862,106.48,0.0,86402.74
2017-05-05,2017-05-05,Internet and phone service,REF29207869,89.02,0.0,86313.72
2017-05-06,2017-05-06,Training/conference,REF10440593,102.68,0.0,86211.04
2017-05-06,2017-05-06,Internet and phone service,REF61581910,96.75,0.0,86114.29
2017-05-06,2017-05-06,Equipment purchase,REF31639498,84.39,0.0,86029.9
2017-05-07,2017-05-07,Professional services,REF51319247,300.49,0.0,85729.41
2017-05-09,2017-05-09,Software subscription,REF14401232,154.38,0.0,85575.03
2017-05-15,2017-05-15,Service payment - Neal-Holden,REF43687842,0.0,1612.49,87187.52
2017-05-15,2017-05-15,Business insurance premium,REF96590281,113.77,0.0,87073.75
2017-05-15,2017-05-15,Invoice payment - Peterson Ltd,REF93276022,0.0,1472.22,88545.97
2017-05-18,2017-05-18,Marketing expenses,REF12044355,97.98,0.0,88447.99
2017-05-20,2017-05-20,Equipment purchase,REF31574748,158.06,0.0,88289.93
2017-05-23,2017-05-23,Internet and phone service,REF18893276,97.68,0.0,88192.25
2017-05-25,2017-05-25,Equipment purchase,REF89181958,37.4,0.0,88154.85
2017-05-25,2017-05-25,Business travel,REF53461276,152.24,0.0,88002.61
2017-05-26,2017-05-26,Internet and phone service,REF17037792,60.37,0.0,87942.24
2017-06-01,2017-06-01,Office supplies,REF71633054,49.03,0.0,87893.21
2017-06-02,2017-06-02,Office supplies,REF29450402,65.41,0.0,87827.8
2017-06-06,2017-06-06,Internet and phone service,REF28774629,102.4,0.0,87725.4
2017-06-08,2017-06-08,Business travel,REF64265101,84.22,0.0,87641.18
2017-06-09,2017-06-09,Software subscription,REF55465834,141.17,0.0,87500.01
2017-06-11,2017-06-11,Equipment purchase,REF59141009,81.23,0.0,87418.78
2017-06-15,2017-06-15,Business insurance premium,REF58088704,111.56,0.0,87307.22
2017-06-15,2017-06-15,Project payment - Neal-Holden,REF33657517,0.0,822.57,88129.79
2017-06-15,2017-06-15,Invoice payment - Peterson Ltd,REF89964830,0.0,1413.01,89542.8
2017-06-15,2017-06-15,Service payment - Davidson and Sons,REF71066934,0.0,821.22,90364.02
2017-06-16,2017-06-16,Marketing expenses,REF46809541,190.91,0.0,90173.11
2017-06-16,2017-06-16,Office supplies,REF11345872,39.23,0.0,90133.88
2017-06-19,2017-06-19,Business travel,REF23678478,140.54,0.0,89993.34
2017-06-19,2017-06-19,Office supplies,REF37698143,55.82,0.0,89937.52
2017-06-20,2017-06-20,Office supplies,REF53618980,45.39,0.0,89892.13
2017-06-20,2017-06-20,Equipment purchase,REF32455996,93.76,0.0,89798.37
2017-06-22,2017-06-22,Professional services,REF55209243,209.96,0.0,89588.41
2017-06-23,2017-06-23,Training/conference,REF24511584,121.26,0.0,89467.15
2017-06-27,2017-06-27,Training/conference,REF73911313,44.42,0.0,89422.73
2017-07-03,2017-07-03,Training/conference,REF66786663,121.95,0.0,89300.78
2017-07-09,2017-07-09,Software subscription,REF65248951,135.61,0.0,89165.17
2017-07-10,2017-07-10,Office supplies,REF46700730,70.82,0.0,89094.35
2017-07-14,2017-07-14,Office supplies,REF87968118,40.92,0.0,89053.43
2017-07-15,2017-07-15,Business insurance premium,REF64608058,99.87,0.0,88953.56
2017-07-15,2017-07-15,Invoice payment - Neal-Holden,REF52500335,0.0,1087.06,90040.62
2017-07-15,2017-07-15,Service payment - Davidson and Sons,REF98568666,0.0,681.55,90722.17
2017-07-15,2017-07-15,Service payment - Peterson Ltd,REF95926236,0.0,1088.95,91811.12
2017-07-19,2017-07-19,Business travel,REF64625370,86.83,0.0,91724.29
2017-07-23,2017-07-23,Marketing expenses,REF25353800,139.01,0.0,91585.28
2017-07-24,2017-07-24,Equipment purchase,REF51529878,90.24,0.0,91495.04
2017-07-27,2017-07-27,Professional services,REF63494322,159.21,0.0,91335.83
2017-07-31,2017-07-31,Office supplies,REF48406001,28.07,0.0,91307.76
2017-08-01,2017-08-01,Internet and phone service,REF55525947,47.28,0.0,91260.48
2017-08-09,2017-08-09,Software subscription,REF88554060,107.06,0.0,91153.42
2017-08-12,2017-08-12,Internet and phone service,REF58962449,89.65,0.0,91063.77
2017-08-15,2017-08-15,Business insurance premium,REF29010444,86.69,0.0,90977.08
2017-08-15,2017-08-15,Payment from Peterson Ltd,REF66445833,0.0,1320.4,92297.48
2017-08-15,2017-08-15,Service payment - Neal-Holden,REF70239504,0.0,873.15,93170.63
2017-08-15,2017-08-15,Invoice payment - Davidson and Sons,REF89329115,0.0,533.74,93704.37
2017-08-21,2017-08-21,Marketing expenses,REF59077215,183.31,0.0,93521.06
2017-08-21,2017-08-21,Training/conference,REF36039715,73.69,0.0,93447.37
2017-08-23,2017-08-23,Professional services,REF92352240,161.54,0.0,93285.83
2017-08-30,2017-08-30,Office supplies,REF76722187,32.6,0.0,93253.23
2017-09-02,2017-09-02,Internet and phone service,REF10909125,111.1,0.0,93142.13
2017-09-03,2017-09-03,Marketing expenses,REF94897001,194.0,0.0,92948.13
2017-09-03,2017-09-03,Business travel,REF98978104,196.92,0.0,92751.21
2017-09-07,2017-09-07,Internet and phone service,REF26340337,92.1,0.0,92659.11
2017-09-08,2017-09-08,Office supplies,REF37468966,47.57,0.0,92611.54
2017-09-09,2017-09-09,Software subscription,REF33956724,182.16,0.0,92429.38
2017-09-11,2017-09-11,Marketing expenses,REF23716679,131.1,0.0,92298.28
2017-09-13,2017-09-13,Business travel,REF65876107,267.12,0.0,92031.16
2017-09-15,2017-09-15,Invoice payment - Neal-Holden,REF95809828,0.0,1414.91,93446.07
2017-09-15,2017-09-15,Office supplies,REF88126769,55.4,0.0,93390.67
2017-09-15,2017-09-15,Project payment - Peterson Ltd,REF19809512,0.0,1541.95,94932.62
2017-09-15,2017-09-15,Business insurance premium,REF60158650,142.59,0.0,94790.03
2017-09-15,2017-09-15,Service payment - Davidson and Sons,REF34509875,0.0,794.48,95584.51
2017-09-16,2017-09-16,Marketing expenses,REF45368282,164.65,0.0,95419.86
2017-09-17,2017-09-17,Office supplies,REF97874085,40.9,0.0,95378.96
2017-09-18,2017-09-18,Marketing expenses,REF44857401,166.33,0.0,95212.63
2017-09-23,2017-09-23,Equipment purchase,REF95143077,87.04,0.0,95125.59
2017-09-25,2017-09-25,Internet and phone service,REF49808940,75.51,0.0,95050.08
2017-09-30,2017-09-30,Professional services,REF59689703,279.01,0.0,94771.07
2017-10-03,2017-10-03,Professional services,REF99032388,144.31,0.0,94626.76
2017-10-07,2017-10-07,Training/conference,REF21496886,124.9,0.0,94501.86
2017-10-09,2017-10-09,Business travel,REF49229589,156.42,0.0,94345.44
2017-10-09,2017-10-09,Software subscription,REF34261038,168.36,0.0,94177.08
2017-10-11,2017-10-11,Office supplies,REF66261505,55.84,0.0,94121.24
2017-10-12,2017-10-12,Business travel,REF58178232,250.69,0.0,93870.55
2017-10-14,2017-10-14,Internet and phone service,REF49069484,136.1,0.0,93734.45
2017-10-15,2017-10-15,Business insurance premium,REF36785142,153.78,0.0,93580.67
2017-10-15,2017-10-15,Invoice payment - Peterson Ltd,REF24539888,0.0,2041.31,95621.98
2017-10-15,2017-10-15,Invoice payment - Davidson and Sons,REF56680894,0.0,978.41,96600.39
2017-10-15,2017-10-15,Project payment - Neal-Holden,REF79289883,0.0,1735.55,98335.94
2017-10-17,2017-10-17,Training/conference,REF51110812,131.21,0.0,98204.73
2017-10-22,2017-10-22,Equipment purchase,REF16794795,149.55,0.0,98055.18
2017-10-25,2017-10-25,Marketing expenses,REF62087605,215.97,0.0,97839.21
2017-11-02,2017-11-02,Internet and phone service,REF73383134,72.33,0.0,97766.88
2017-11-09,2017-11-09,Software subscription,REF37706578,184.49,0.0,97582.39
2017-11-15,2017-11-15,Business insurance premium,REF49481611,121.8,0.0,97460.59
2017-11-15,2017-11-15,Service payment - Neal-Holden,REF88583573,0.0,1196.98,98657.57
2017-11-15,2017-11-15,Payment from Davidson and Sons,REF83132466,0.0,1003.48,99661.05
2017-11-15,2017-11-15,Project payment - Peterson Ltd,REF21485267,0.0,1484.25,101145.3
2017-11-16,2017-11-16,Office supplies,REF53009615,63.21,0.0,101082.09
2017-11-26,2017-11-26,Office supplies,REF69396125,38.03,0.0,101044.06
2017-11-30,2017-11-30,Business travel,REF16967740,157.98,0.0,100886.08
2017-12-02,2017-12-02,Equipment purchase,REF70122100,57.06,0.0,100829.02
2017-12-03,2017-12-03,Professional services,REF73178141,217.05,0.0,100611.97
2017-12-05,2017-12-05,Office supplies,REF98517964,49.03,0.0,100562.94
2017-12-09,2017-12-09,Software subscription,REF40830512,144.19,0.0,100418.75
2017-12-15,2017-12-15,Business insurance premium,REF94191134,108.53,0.0,100310.22
2017-12-15,2017-12-15,Service payment - Davidson and Sons,REF27888287,0.0,661.8,100972.02
2017-12-15,2017-12-15,Payment from Peterson Ltd,REF53119385,0.0,1514.88,102486.9
2017-12-17,2017-12-17,Equipment purchase,REF11169330,98.62,0.0,102388.28
2017-12-24,2017-12-24,Office supplies,REF99690154,55.39,0.0,102332.89
2017-12-27,2017-12-27,Equipment purchase,REF53195365,95.73,0.0,102237.16
2017-12-28,2017-12-28,Business travel,REF95260087,150.12,0.0,102087.04
2017-12-29,2017-12-29,Professional services,REF97594048,175.7,0.0,101911.34
2017-12-31,2017-12-31,Internet and phone service,REF70999102,20.28,0.0,101891.06
2018-01-04,2018-01-04,Office supplies,REF74014790,44.56,0.0,101846.5
2018-01-05,2018-01-05,Office supplies,REF85408603,42.36,0.0,101804.14
2018-01-07,2018-01-07,Office supplies,REF73525932,36.81,0.0,101767.33
2018-01-09,2018-01-09,Software subscription,REF85955320,142.04,0.0,101625.29
2018-01-10,2018-01-10,Professional services,REF42171823,204.59,0.0,101420.7
2018-01-11,2018-01-11,Internet and phone service,REF73242750,70.89,0.0,101349.81
2018-01-13,2018-01-13,Office supplies,REF52493130,33.6,0.0,101316.21
2018-01-14,2018-01-14,Equipment purchase,REF81243869,75.27,0.0,101240.94
2018-01-15,2018-01-15,Business insurance premium,REF28063947,101.15,0.0,101139.79
2018-01-15,2018-01-15,Invoice payment - Davidson and Sons,REF69076699,0.0,719.87,101859.66
2018-01-15,2018-01-15,Service payment - Neal-Holden,REF46327756,0.0,1064.69,102924.35
2018-01-15,2018-01-15,Service payment - Peterson Ltd,REF90938660,0.0,1207.7,104132.05
2018-01-19,2018-01-19,Professional services,REF15462064,286.64,0.0,103845.41
2018-01-21,2018-01-21,Office supplies,REF71423329,45.39,0.0,103800.02
2018-01-22,2018-01-22,Internet and phone service,REF62209383,62.73,0.0,103737.29
2018-01-25,2018-01-25,Marketing expenses,REF87101806,205.49,0.0,103531.8
2018-01-26,2018-01-26,Marketing expenses,REF58254082,150.7,0.0,103381.1
2018-02-04,2018-02-04,Office supplies,REF36956940,49.24,0.0,103331.86
2018-02-05,2018-02-05,Office supplies,REF40430425,37.49,0.0,103294.37
2018-02-05,2018-02-05,Equipment purchase,REF98259708,86.11,0.0,103208.26
2018-02-09,2018-02-09,Software subscription,REF10881297,137.07,0.0,103071.19
2018-02-12,2018-02-12,Internet and phone service,REF71950767,100.75,0.0,102970.44
2018-02-15,2018-02-15,Business insurance premium,REF12726053,104.08,0.0,102866.36
2018-02-15,2018-02-15,Project payment - Peterson Ltd,REF36886599,0.0,949.55,103815.91
2018-02-15,2018-02-15,Service payment - Neal-Holden,REF27980529,0.0,1317.37,105133.28
2018-02-15,2018-02-15,Payment from Davidson and Sons,REF65937307,0.0,803.17,105936.45
2018-02-20,2018-02-20,Office supplies,REF76644871,59.13,0.0,105877.32
2018-02-28,2018-02-28,Internet and phone service,REF52449091,75.34,0.0,105801.98
2018-02-28,2018-02-28,Office supplies,REF13175500,61.31,0.0,105740.67
2018-03-05,2018-03-05,Office supplies,REF60294173,65.11,0.0,105675.56
2018-03-06,2018-03-06,Professional services,REF82431905,268.44,0.0,105407.12
2018-03-06,2018-03-06,Internet and phone service,REF58260415,107.24,0.0,105299.88
2018-03-06,2018-03-06,Office supplies,REF93339759,31.97,0.0,105267.91
2018-03-09,2018-03-09,Software subscription,REF31276162,170.21,0.0,105097.7
2018-03-10,2018-03-10,Business travel,REF23851715,119.25,0.0,104978.45
2018-03-10,2018-03-10,Office supplies,REF90918607,60.89,0.0,104917.56
2018-03-12,2018-03-12,Training/conference,REF49754159,111.92,0.0,104805.64
2018-03-13,2018-03-13,Office supplies,REF15327806,55.77,0.0,104749.87
2018-03-14,2018-03-14,Internet and phone service,REF81245390,23.01,0.0,104726.86
2018-03-15,2018-03-15,Business insurance premium,REF84492021,140.36,0.0,104586.5
2018-03-15,2018-03-15,Service payment - Neal-Holden,REF86217985,0.0,1673.63,106260.13
2018-03-17,2018-03-17,Office supplies,REF91355560,41.92,0.0,106218.21
2018-03-19,2018-03-19,Internet and phone service,REF57994984,106.71,0.0,106111.5
2018-03-24,2018-03-24,Marketing expenses,REF66490899,265.92,0.0,105845.58
2018-03-26,2018-03-26,Training/conference,REF23410283,142.13,0.0,105703.45
2018-04-06,2018-04-06,Business travel,REF29094651,133.43,0.0,105570.02
2018-04-07,2018-04-07,Equipment purchase,REF83699674,122.59,0.0,105447.43
2018-04-07,2018-04-07,Office supplies,REF24284627,53.84,0.0,105393.59
2018-04-09,2018-04-09,Internet and phone service,REF85230661,54.56,0.0,105339.03
2018-04-09,2018-04-09,Software subscription,REF46988730,127.28,0.0,105211.75
2018-04-15,2018-04-15,Business insurance premium,REF39918105,107.28,0.0,105104.47
2018-04-15,2018-04-15,Service payment - Neal-Holden,REF71513856,0.0,1401.66,106506.13
2018-04-15,2018-04-15,Project payment - Davidson and Sons,REF90777910,0.0,1060.54,107566.67
2018-04-15,2018-04-15,Payment from Peterson Ltd,REF15735221,0.0,1308.29,108874.96
2018-04-16,2018-04-16,Office supplies,REF81016141,63.87,0.0,108811.09
2018-05-02,2018-05-02,Professional services,REF19322699,188.8,0.0,108622.29
2018-05-04,2018-05-04,Office supplies,REF34766814,63.87,0.0,108558.42
2018-05-05,2018-05-05,Marketing expenses,REF23776135,203.35,0.0,108355.07
2018-05-05,2018-05-05,Training/conference,REF19339336,152.54,0.0,108202.53
2018-05-09,2018-05-09,Software subscription,REF37143955,135.03,0.0,108067.5
2018-05-15,2018-05-15,Business insurance premium,REF94363722,120.78,0.0,107946.72
2018-05-15,2018-05-15,Project payment - Peterson Ltd,REF45041053,0.0,1603.53,109550.25
2018-05-15,2018-05-15,Project payment - Davidson and Sons,REF80298582,0.0,785.57,110335.82
2018-05-15,2018-05-15,Project payment - Neal-Holden,REF48128373,0.0,877.35,111213.17
2018-05-16,2018-05-16,Marketing expenses,REF92344252,248.78,0.0,110964.39
2018-05-17,2018-05-17,Business travel,REF26823073,181.89,0.0,110782.5
2018-05-18,2018-05-18,Marketing expenses,REF94655387,167.4,0.0,110615.1
2018-05-22,2018-05-22,Office supplies,REF61572146,37.91,0.0,110577.19
2018-05-22,2018-05-22,Business travel,REF41995189,173.58,0.0,110403.61
2018-05-28,2018-05-28,Professional services,REF87154312,263.48,0.0,110140.13
2018-05-29,2018-05-29,Office supplies,REF42555895,55.39,0.0,110084.74
2018-05-30,2018-05-30,Office supplies,REF44210076,80.61,0.0,110004.13
2018-06-03,2018-06-03,Business travel,REF43376267,201.87,0.0,109802.26
2018-06-05,2018-06-05,Internet and phone service,REF68910259,67.16,0.0,109735.1
2018-06-09,2018-06-09,Software subscription,REF84994402,164.07,0.0,109571.03
2018-06-11,2018-06-11,Equipment purchase,REF38705084,127.45,0.0,109443.58
2018-06-15,2018-06-15,Invoice payment - Neal-Holden,REF41377288,0.0,1498.56,110942.14
2018-06-15,2018-06-15,Business insurance premium,REF40308482,111.68,0.0,110830.46
2018-06-15,2018-06-15,Invoice payment - Davidson and Sons,REF17864797,0.0,786.87,111617.33
2018-06-15,2018-06-15,Payment from Peterson Ltd,REF67916489,0.0,1281.33,112898.66
2018-06-17,2018-06-17,Office supplies,REF79063995,37.82,0.0,112860.84
2018-06-27,2018-06-27,Business travel,REF95602035,82.37,0.0,112778.47
2018-06-30,2018-06-30,Internet and phone service,REF42910469,121.39,0.0,112657.08
2018-06-30,2018-06-30,Training/conference,REF90398564,56.37,0.0,112600.71
2018-06-30,2018-06-30,Office supplies,REF32743982,45.6,0.0,112555.11
2018-07-06,2018-07-06,Office supplies,REF45607429,29.61,0.0,112525.5
2018-07-07,2018-07-07,Equipment purchase,REF30732977,102.27,0.0,112423.23
2018-07-09,2018-07-09,Marketing expenses,REF14843533,206.3,0.0,112216.93
2018-07-09,2018-07-09,Software subscription,REF94155637,129.76,0.0,112087.17
2018-07-14,2018-07-14,Office supplies,REF34973092,38.07,0.0,112049.1
2018-07-15,2018-07-15,Business insurance premium,REF77828430,91.27,0.0,111957.83
2018-07-15,2018-07-15,Project payment - Peterson Ltd,REF20620819,0.0,1244.15,113201.98
2018-07-15,2018-07-15,Service payment - Davidson and Sons,REF93239188,0.0,838.92,114040.9
2018-07-15,2018-07-15,Service payment - Neal-Holden,REF35809992,0.0,1049.53,115090.43
2018-07-24,2018-07-24,Internet and phone service,REF25758706,65.49,0.0,115024.94
2018-07-28,2018-07-28,Training/conference,REF24170422,63.42,0.0,114961.52
2018-07-29,2018-07-29,Internet and phone service,REF90010187,46.37,0.0,114915.15
2018-07-30,2018-07-30,Professional services,REF92075084,174.62,0.0,114740.53
2018-07-31,2018-07-31,Business travel,REF64878567,95.22,0.0,114645.31
2018-08-04,2018-08-04,Professional services,REF83762479,216.19,0.0,114429.12
2018-08-07,2018-08-07,Office supplies,REF47544926,34.9,0.0,114394.22
2018-08-09,2018-08-09,Software subscription,REF46085496,113.75,0.0,114280.47
2018-08-13,2018-08-13,Office supplies,REF62648952,20.36,0.0,114260.11
2018-08-15,2018-08-15,Internet and phone service,REF58324942,32.69,0.0,114227.42
2018-08-15,2018-08-15,Business insurance premium,REF46161184,71.87,0.0,114155.55
2018-08-15,2018-08-15,Office supplies,REF34954376,35.12,0.0,114120.43
2018-08-15,2018-08-15,Invoice payment - Davidson and Sons,REF11282168,0.0,663.41,114783.84
2018-08-15,2018-08-15,Invoice payment - Neal-Holden,REF27112004,0.0,932.17,115716.01
2018-08-15,2018-08-15,Service payment - Peterson Ltd,REF10139254,0.0,1291.54,117007.55
2018-08-16,2018-08-16,Internet and phone service,REF33424782,49.01,0.0,116958.54
2018-08-17,2018-08-17,Business travel,REF59126822,128.16,0.0,116830.38
2018-08-21,2018-08-21,Office supplies,REF47436466,38.12,0.0,116792.26
2018-08-25,2018-08-25,Professional services,REF29198908,152.59,0.0,116639.67
2018-09-01,2018-09-01,Business travel,REF33745492,169.5,0.0,116470.17
2018-09-02,2018-09-02,Marketing expenses,REF12326747,245.42,0.0,116224.75
2018-09-05,2018-09-05,Marketing expenses,REF50444689,344.21,0.0,115880.54
2018-09-09,2018-09-09,Software subscription,REF76998613,157.14,0.0,115723.4
2018-09-10,2018-09-10,Professional services,REF91160378,232.75,0.0,115490.65
2018-09-15,2018-09-15,Business insurance premium,REF30308193,131.47,0.0,115359.18
2018-09-15,2018-09-15,Payment from Davidson and Sons,REF38629824,0.0,789.0,116148.18
2018-09-15,2018-09-15,Payment from Peterson Ltd,REF79939023,0.0,1863.94,118012.12
2018-09-15,2018-09-15,Service payment - Neal-Holden,REF34469290,0.0,1637.44,119649.56
2018-09-16,2018-09-16,Equipment purchase,REF70379550,90.63,0.0,119558.93
2018-09-19,2018-09-19,Business travel,REF49959174,183.39,0.0,119375.54
2018-09-22,2018-09-22,Business travel,REF62970778,42.51,0.0,119333.03
2018-09-26,2018-09-26,Marketing expenses,REF96952432,189.55,0.0,119143.48
2018-09-28,2018-09-28,Internet and phone service,REF47291280,77.77,0.0,119065.71
2018-10-06,2018-10-06,Internet and phone service,REF70280528,106.26,0.0,118959.45
2018-10-07,2018-10-07,Business travel,REF89174180,241.4,0.0,118718.05
2018-10-09,2018-10-09,Software subscription,REF11236892,157.12,0.0,118560.93
2018-10-14,2018-10-14,Training/conference,REF30493179,115.98,0.0,118444.95
2018-10-15,2018-10-15,Project payment - Neal-Holden,REF27621837,0.0,1432.53,119877.48
2018-10-15,2018-10-15,Business insurance premium,REF62085179,154.69,0.0,119722.79
2018-10-15,2018-10-15,Invoice payment - Davidson and Sons,REF29091122,0.0,1166.68,120889.47
2018-10-15,2018-10-15,Project payment - Peterson Ltd,REF29126358,0.0,2079.41,122968.88
2018-10-16,2018-10-16,Office supplies,REF38252868,68.28,0.0,122900.6
2018-10-25,2018-10-25,Equipment purchase,REF95004108,182.37,0.0,122718.23
2018-10-26,2018-10-26,Internet and phone service,REF56074149,31.96,0.0,122686.27
2018-11-01,2018-11-01,Office supplies,REF30223531,7.57,0.0,122678.7
2018-11-03,2018-11-03,Office supplies,REF56799369,76.04,0.0,122602.66
2018-11-06,2018-11-06,Office supplies,REF13462799,56.53,0.0,122546.13
2018-11-09,2018-11-09,Business travel,REF36810365,139.75,0.0,122406.38
2018-11-09,2018-11-09,Software subscription,REF13155397,172.62,0.0,122233.76
2018-11-10,2018-11-10,Office supplies,REF57396637,60.41,0.0,122173.35
2018-11-11,2018-11-11,Professional services,REF70494273,456.65,0.0,121716.7
2018-11-14,2018-11-14,Office supplies,REF93170015,51.07,0.0,121665.63
2018-11-15,2018-11-15,Business insurance premium,REF41647911,133.14,0.0,121532.49
2018-11-15,2018-11-15,Service payment - Peterson Ltd,REF87392643,0.0,2163.27,123695.76
2018-11-15,2018-11-15,Service payment - Davidson and Sons,REF50945964,0.0,618.14,124313.9
2018-11-15,2018-11-15,Invoice payment - Neal-Holden,REF13441222,0.0,1334.56,125648.46
2018-11-17,2018-11-17,Business travel,REF41247982,166.61,0.0,125481.85
2018-11-19,2018-11-19,Office supplies,REF69601161,67.23,0.0,125414.62
2018-11-28,2018-11-28,Training/conference,REF68687750,104.11,0.0,125310.51
2018-12-08,2018-12-08,Internet and phone service,REF69079118,74.94,0.0,125235.57
2018-12-09,2018-12-09,Professional services,REF18273212,274.46,0.0,124961.11
2018-12-09,2018-12-09,Software subscription,REF51912075,131.01,0.0,124830.1
2018-12-10,2018-12-10,Office supplies,REF64285441,63.75,0.0,124766.35
2018-12-14,2018-12-14,Training/conference,REF31704071,82.67,0.0,124683.68
2018-12-14,2018-12-14,Business travel,REF13944653,128.41,0.0,124555.27
2018-12-15,2018-12-15,Business insurance premium,REF27712248,116.98,0.0,124438.29
2018-12-15,2018-12-15,Payment from Peterson Ltd,REF26167611,0.0,1853.31,126291.6
2018-12-15,2018-12-15,Project payment - Davidson and Sons,REF13409219,0.0,518.82,126810.42
2018-12-17,2018-12-17,Business travel,REF37109020,169.83,0.0,126640.59
2018-12-19,2018-12-19,Marketing expenses,REF64543685,141.2,0.0,126499.39
2018-12-26,2018-12-26,Professional services,REF52437198,290.57,0.0,126208.82
2018-12-31,2018-12-31,Business travel,REF98552851,135.74,0.0,126073.08
2019-01-04,2019-01-04,Marketing expenses,REF36474726,212.64,0.0,125860.44
2019-01-09,2019-01-09,Software subscription,REF99193518,106.59,0.0,125753.85
2019-01-10,2019-01-10,Internet and phone service,REF66120742,39.7,0.0,125714.15
2019-01-12,2019-01-12,Business travel,REF31633702,81.42,0.0,125632.73
2019-01-13,2019-01-13,Office supplies,REF43787775,48.23,0.0,125584.5
2019-01-14,2019-01-14,Training/conference,REF47755031,90.12,0.0,125494.38
2019-01-14,2019-01-14,Business travel,REF49153958,160.18,0.0,125334.2
2019-01-15,2019-01-15,Invoice payment - Neal-Holden,REF85381358,0.0,976.97,126311.17
2019-01-15,2019-01-15,Service payment - Davidson and Sons,REF34559263,0.0,735.78,127046.95
2019-01-15,2019-01-15,Business insurance premium,REF28595017,91.35,0.0,126955.6
2019-01-15,2019-01-15,Payment from Peterson Ltd,REF95610032,0.0,1102.62,128058.22
2019-01-19,2019-01-19,Office supplies,REF40467823,43.49,0.0,128014.73
2019-01-21,2019-01-21,Office supplies,REF53916801,42.93,0.0,127971.8
2019-01-21,2019-01-21,Internet and phone service,REF44032256,76.35,0.0,127895.45
2019-01-23,2019-01-23,Office supplies,REF60211535,60.25,0.0,127835.2
2019-01-26,2019-01-26,Office supplies,REF89292594,62.74,0.0,127772.46
2019-01-27,2019-01-27,Marketing expenses,REF17307014,164.35,0.0,127608.11
2019-01-28,2019-01-28,Business travel,REF65391106,57.66,0.0,127550.45
2019-01-29,2019-01-29,Equipment purchase,REF40937929,88.47,0.0,127461.98
2019-02-02,2019-02-02,Marketing expenses,REF52214491,168.59,0.0,127293.39
2019-02-09,2019-02-09,Software subscription,REF40727141,108.85,0.0,127184.54
2019-02-09,2019-02-09,Office supplies,REF40323933,45.73,0.0,127138.81
2019-02-12,2019-02-12,Business travel,REF68414769,203.56,0.0,126935.25
2019-02-15,2019-02-15,Business insurance premium,REF43924464,111.15,0.0,126824.1
2019-02-15,2019-02-15,Payment from Neal-Holden,REF62456575,0.0,1028.36,127852.46
2019-02-15,2019-02-15,Service payment - Davidson and Sons,REF10947730,0.0,721.8,128574.26
2019-02-15,2019-02-15,Project payment - Peterson Ltd,REF97779936,0.0,1623.13,130197.39
2019-02-18,2019-02-18,Professional services,REF42102522,125.86,0.0,130071.53
2019-02-19,2019-02-19,Business travel,REF23530741,97.49,0.0,129974.04
2019-02-23,2019-02-23,Office supplies,REF65636200,39.49,0.0,129934.55
2019-02-27,2019-02-27,Professional services,REF73418315,187.43,0.0,129747.12
2019-02-27,2019-02-27,Business travel,REF73545204,173.51,0.0,129573.61
2019-02-27,2019-02-27,Internet and phone service,REF56580155,83.86,0.0,129489.75
2019-03-01,2019-03-01,Training/conference,REF53275063,116.32,0.0,129373.43
2019-03-03,2019-03-03,Business travel,REF86814582,118.07,0.0,129255.36
2019-03-09,2019-03-09,Equipment purchase,REF54393258,94.81,0.0,129160.55
2019-03-09,2019-03-09,Software subscription,REF89777528,171.94,0.0,128988.61
2019-03-09,2019-03-09,Business travel,REF26590448,115.25,0.0,128873.36
2019-03-10,2019-03-10,Office supplies,REF29957723,82.17,0.0,128791.19
2019-03-11,2019-03-11,Office supplies,REF27352769,55.41,0.0,128735.78
2019-03-15,2019-03-15,Business insurance premium,REF16255823,131.19,0.0,128604.59
2019-03-15,2019-03-15,Invoice payment - Davidson and Sons,REF74804169,0.0,814.72,129419.31
2019-03-15,2019-03-15,Payment from Peterson Ltd,REF57275709,0.0,2271.98,131691.29
2019-03-15,2019-03-15,Invoice payment - Neal-Holden,REF67262098,0.0,1458.64,133149.93
2019-03-15,2019-03-15,Office supplies,REF67380196,58.07,0.0,133091.86
2019-03-17,2019-03-17,Training/conference,REF54823815,141.49,0.0,132950.37
2019-03-26,2019-03-26,Professional services,REF25799808,177.2,0.0,132773.17
2019-03-27,2019-03-27,Internet and phone service,REF57818630,68.12,0.0,132705.05
2019-03-29,2019-03-29,Professional services,REF24034760,344.25,0.0,132360.8
2019-03-31,2019-03-31,Business travel,REF50122837,117.54,0.0,132243.26
2019-04-04,2019-04-04,Office supplies,REF20565970,45.42,0.0,132197.84
2019-04-08,2019-04-08,Professional services,REF50570852,212.66,0.0,131985.18
2019-04-09,2019-04-09,Software subscription,REF52382174,175.42,0.0,131809.76
2019-04-13,2019-04-13,Internet and phone service,REF34951653,83.29,0.0,131726.47
2019-04-15,2019-04-15,Project payment - Neal-Holden,REF53907043,0.0,1791.09,133517.56
2019-04-15,2019-04-15,Training/conference,REF51796130,56.47,0.0,133461.09
2019-04-15,2019-04-15,Project payment - Peterson Ltd,REF40920326,0.0,1185.38,134646.47
2019-04-15,2019-04-15,Project payment - Davidson and Sons,REF73312661,0.0,751.76,135398.23
2019-04-15,2019-04-15,Equipment purchase,REF60593404,97.47,0.0,135300.76
2019-04-15,2019-04-15,Business insurance premium,REF43415905,115.22,0.0,135185.54
2019-04-22,2019-04-22,Office supplies,REF21627272,43.69,0.0,135141.85
2019-04-23,2019-04-23,Marketing expenses,REF98684720,167.12,0.0,134974.73
2019-04-25,2019-04-25,Equipment purchase,REF22348584,103.38,0.0,134871.35
2019-04-26,2019-04-26,Professional services,REF72395783,270.94,0.0,134600.41
2019-04-28,2019-04-28,Equipment purchase,REF66386973,125.42,0.0,134474.99
2019-04-28,2019-04-28,Office supplies,REF10810463,64.25,0.0,134410.74
2019-04-29,2019-04-29,Internet and phone service,REF29252100,13.83,0.0,134396.91
2019-05-03,2019-05-03,Business travel,REF11146243,202.74,0.0,134194.17
2019-05-05,2019-05-05,Office supplies,REF80486239,41.81,0.0,134152.36
2019-05-09,2019-05-09,Office supplies,REF94256513,43.95,0.0,134108.41
2019-05-09,2019-05-09,Software subscription,REF47441451,164.33,0.0,133944.08
2019-05-15,2019-05-15,Business travel,REF21916298,198.9,0.0,133745.18
2019-05-15,2019-05-15,Project payment - Neal-Holden,REF74434934,0.0,1516.5,135261.68
2019-05-15,2019-05-15,Service payment - Davidson and Sons,REF40029254,0.0,975.93,136237.61
2019-05-15,2019-05-15,Business insurance premium,REF13238447,134.43,0.0,136103.18
2019-05-15,2019-05-15,Project payment - Peterson Ltd,REF24162574,0.0,1645.14,137748.32
2019-05-16,2019-05-16,Training/conference,REF17747133,90.58,0.0,137657.74
2019-05-17,2019-05-17,Business travel,REF64652941,148.55,0.0,137509.19
2019-05-18,2019-05-18,Professional services,REF38978116,334.37,0.0,137174.82
2019-05-19,2019-05-19,Equipment purchase,REF39152384,54.9,0.0,137119.92
2019-05-22,2019-05-22,Training/conference,REF76253842,104.29,0.0,137015.63
2019-05-24,2019-05-24,Training/conference,REF21676372,59.39,0.0,136956.24
2019-05-25,2019-05-25,Equipment purchase,REF19651795,88.19,0.0,136868.05
2019-05-30,2019-05-30,Equipment purchase,REF25331452,117.07,0.0,136750.98
2019-06-02,2019-06-02,Internet and phone service,REF58281814,34.85,0.0,136716.13
2019-06-02,2019-06-02,Training/conference,REF68284352,72.6,0.0,136643.53
2019-06-04,2019-06-04,Equipment purchase,REF58429052,55.36,0.0,136588.17
2019-06-08,2019-06-08,Business travel,REF16103048,125.69,0.0,136462.48
2019-06-09,2019-06-09,Software subscription,REF32452273,142.68,0.0,136319.8
2019-06-12,2019-06-12,Office supplies,REF11811492,32.45,0.0,136287.35
2019-06-12,2019-06-12,Internet and phone service,REF73632870,53.09,0.0,136234.26
2019-06-13,2019-06-13,Office supplies,REF58662545,61.63,0.0,136172.63
2019-06-15,2019-06-15,Project payment - Davidson and Sons,REF38713806,0.0,828.52,137001.15
2019-06-15,2019-06-15,Business insurance premium,REF42722146,111.37,0.0,136889.78
2019-06-15,2019-06-15,Invoice payment - Neal-Holden,REF22902429,0.0,1103.28,137993.06
2019-06-15,2019-06-15,Service payment - Peterson Ltd,REF53515770,0.0,1446.35,139439.41
2019-06-20,2019-06-20,Professional services,REF87167158,224.08,0.0,139215.33
2019-06-23,2019-06-23,Marketing expenses,REF83875143,108.19,0.0,139107.14
2019-06-27,2019-06-27,Equipment purchase,REF73564722,111.82,0.0,138995.32
2019-06-28,2019-06-28,Office supplies,REF77951038,52.76,0.0,138942.56
2019-07-05,2019-07-05,Equipment purchase,REF87833100,77.47,0.0,138865.09
2019-07-07,2019-07-07,Equipment purchase,REF80491368,126.59,0.0,138738.5
2019-07-09,2019-07-09,Software subscription,REF55055700,112.34,0.0,138626.16
2019-07-10,2019-07-10,Business travel,REF46050151,111.87,0.0,138514.29
2019-07-14,2019-07-14,Marketing expenses,REF29418839,74.8,0.0,138439.49
2019-07-15,2019-07-15,Office supplies,REF83096223,60.55,0.0,138378.94
2019-07-15,2019-07-15,Service payment - Davidson and Sons,REF52749806,0.0,832.89,139211.83
2019-07-15,2019-07-15,Payment from Neal-Holden,REF59145031,0.0,915.46,140127.29
2019-07-15,2019-07-15,Internet and phone service,REF27327010,71.35,0.0,140055.94
2019-07-15,2019-07-15,Project payment - Peterson Ltd,REF49736510,0.0,1276.08,141332.02
2019-07-15,2019-07-15,Business insurance premium,REF80643997,94.54,0.0,141237.48
2019-07-21,2019-07-21,Marketing expenses,REF16773441,125.63,0.0,141111.85
2019-07-26,2019-07-26,Marketing expenses,REF18558728,235.34,0.0,140876.51
2019-07-28,2019-07-28,Training/conference,REF59520837,89.45,0.0,140787.06
2019-08-01,2019-08-01,Office supplies,REF81543684,41.38,0.0,140745.68
2019-08-06,2019-08-06,Office supplies,REF30096712,41.35,0.0,140704.33
2019-08-07,2019-08-07,Business travel,REF69425760,43.11,0.0,140661.22
2019-08-08,2019-08-08,Business travel,REF27167630,90.84,0.0,140570.38
2019-08-08,2019-08-08,Professional services,REF27218892,172.56,0.0,140397.82
2019-08-09,2019-08-09,Software subscription,REF62566977,110.03,0.0,140287.79
2019-08-15,2019-08-15,Project payment - Neal-Holden,REF33383586,0.0,906.85,141194.64
2019-08-15,2019-08-15,Payment from Peterson Ltd,REF48288268,0.0,1083.2,142277.84
2019-08-15,2019-08-15,Payment from Davidson and Sons,REF12200834,0.0,655.96,142933.8
2019-08-15,2019-08-15,Business insurance premium,REF71902006,83.2,0.0,142850.6
2019-08-15,2019-08-15,Training/conference,REF49278860,53.94,0.0,142796.66
2019-08-17,2019-08-17,Marketing expenses,REF97535838,136.33,0.0,142660.33
2019-08-18,2019-08-18,Training/conference,REF55306287,60.15,0.0,142600.18
2019-08-25,2019-08-25,Marketing expenses,REF96729940,91.59,0.0,142508.59
2019-08-28,2019-08-28,Office supplies,REF85122124,46.57,0.0,142462.02
2019-08-28,2019-08-28,Marketing expenses,REF67797091,90.3,0.0,142371.72
2019-08-30,2019-08-30,Professional services,REF69500275,141.63,0.0,142230.09
2019-09-01,2019-09-01,Office supplies,REF52674056,44.57,0.0,142185.52
2019-09-03,2019-09-03,Office supplies,REF16437499,59.18,0.0,142126.34
2019-09-09,2019-09-09,Software subscription,REF85667167,188.0,0.0,141938.34
2019-09-10,2019-09-10,Internet and phone service,REF74460823,87.28,0.0,141851.06
2019-09-11,2019-09-11,Professional services,REF55062050,63.0,0.0,141788.06
2019-09-15,2019-09-15,Business insurance premium,REF93614292,133.71,0.0,141654.35
2019-09-15,2019-09-15,Payment from Davidson and Sons,REF44905292,0.0,753.24,142407.59
2019-09-15,2019-09-15,Service payment - Peterson Ltd,REF38313729,0.0,1500.58,143908.17
2019-09-15,2019-09-15,Payment from Neal-Holden,REF82820836,0.0,1238.49,145146.66
2019-09-28,2019-09-28,Business travel,REF39377716,79.36,0.0,145067.3
2019-10-01,2019-10-01,Office supplies,REF40595694,35.18,0.0,145032.12
2019-10-06,2019-10-06,Business travel,REF30139190,219.86,0.0,144812.26
2019-10-06,2019-10-06,Training/conference,REF29098367,38.59,0.0,144773.67
2019-10-09,2019-10-09,Software subscription,REF17024929,183.84,0.0,144589.83
2019-10-13,2019-10-13,Internet and phone service,REF64067280,72.42,0.0,144517.41
2019-10-15,2019-10-15,Office supplies,REF19162274,54.64,0.0,144462.77
2019-10-15,2019-10-15,Service payment - Davidson and Sons,REF64228592,0.0,932.95,145395.72
2019-10-15,2019-10-15,Business insurance premium,REF33422440,137.42,0.0,145258.3
2019-10-15,2019-10-15,Service payment - Peterson Ltd,REF59983835,0.0,1607.68,146865.98
2019-10-28,2019-10-28,Professional services,REF42513514,387.52,0.0,146478.46
2019-10-29,2019-10-29,Business travel,REF86101989,119.54,0.0,146358.92
2019-10-30,2019-10-30,Office supplies,REF22195600,40.39,0.0,146318.53
2019-11-02,2019-11-02,Internet and phone service,REF33613604,80.84,0.0,146237.69
2019-11-03,2019-11-03,Professional services,REF98104907,123.27,0.0,146114.42
2019-11-04,2019-11-04,Training/conference,REF40013132,113.4,0.0,146001.02
2019-11-06,2019-11-06,Professional services,REF78395700,291.07,0.0,145709.95
2019-11-07,2019-11-07,Business travel,REF27993005,97.8,0.0,145612.15
2019-11-09,2019-11-09,Software subscription,REF71753319,183.09,0.0,145429.06
2019-11-14,2019-11-14,Business travel,REF15928336,143.22,0.0,145285.84
2019-11-15,2019-11-15,Invoice payment - Peterson Ltd,REF49802120,0.0,1741.21,147027.05
2019-11-15,2019-11-15,Equipment purchase,REF69871027,82.51,0.0,146944.54
2019-11-15,2019-11-15,Office supplies,REF11735700,75.7,0.0,146868.84
2019-11-15,2019-11-15,Business insurance premium,REF86456970,122.49,0.0,146746.35
2019-11-15,2019-11-15,Service payment - Davidson and Sons,REF59577911,0.0,984.72,147731.07
2019-11-15,2019-11-15,Service payment - Neal-Holden,REF46418267,0.0,1685.36,149416.43
2019-11-19,2019-11-19,Office supplies,REF64640907,56.15,0.0,149360.28
2019-11-22,2019-11-22,Business travel,REF28625289,216.21,0.0,149144.07
2019-11-23,2019-11-23,Office supplies,REF54530005,40.93,0.0,149103.14
2019-11-27,2019-11-27,Marketing expenses,REF83366427,159.07,0.0,148944.07
2019-11-28,2019-11-28,Professional services,REF29182895,236.72,0.0,148707.35
2019-11-29,2019-11-29,Marketing expenses,REF24513474,183.1,0.0,148524.25
2019-11-29,2019-11-29,Office supplies,REF21225740,59.7,0.0,148464.55
2019-12-03,2019-12-03,Office supplies,REF54826340,36.63,0.0,148427.92
2019-12-05,2019-12-05,Training/conference,REF37117503,69.57,0.0,148358.35
2019-12-09,2019-12-09,Software subscription,REF26086546,116.46,0.0,148241.89
2019-12-15,2019-12-15,Payment from Davidson and Sons,REF40694811,0.0,724.59,148966.48
2019-12-15,2019-12-15,Business insurance premium,REF16300456,103.84,0.0,148862.64
2019-12-15,2019-12-15,Payment from Peterson Ltd,REF42241174,0.0,1534.85,150397.49
2019-12-15,2019-12-15,Project payment - Neal-Holden,REF98213668,0.0,1292.68,151690.17
2019-12-19,2019-12-19,Office supplies,REF40803992,52.47,0.0,151637.7
2019-12-21,2019-12-21,Equipment purchase,REF35477680,65.15,0.0,151572.55
2019-12-23,2019-12-23,Training/conference,REF57794803,19.45,0.0,151553.1
2019-12-23,2019-12-23,Equipment purchase,REF75318175,94.53,0.0,151458.57
2019-12-27,2019-12-27,Equipment purchase,REF23873825,172.56,0.0,151286.01
2019-12-27,2019-12-27,Business travel,REF52036762,167.97,0.0,151118.04
2019-12-29,2019-12-29,Equipment purchase,REF66381891,96.26,0.0,151021.78
2019-12-29,2019-12-29,Office supplies,REF55582088,35.78,0.0,150986.0
2020-01-01,2020-01-01,Office supplies,REF62206734,29.94,0.0,150956.06
2020-01-02,2020-01-02,Internet and phone service,REF37951443,96.28,0.0,150859.78
2020-01-03,2020-01-03,Office supplies,REF41525886,60.5,0.0,150799.28
2020-01-06,2020-01-06,Office supplies,REF64110882,37.41,0.0,150761.87
2020-01-07,2020-01-07,Office supplies,REF22170052,15.53,0.0,150746.34
2020-01-09,2020-01-09,Marketing expenses,REF40140279,207.93,0.0,150538.41
2020-01-09,2020-01-09,Software subscription,REF23815433,140.04,0.0,150398.37
2020-01-15,2020-01-15,Project payment - Davidson and Sons,REF69251256,0.0,651.1,151049.47
2020-01-15,2020-01-15,Service payment - Neal-Holden,REF73563505,0.0,1023.77,152073.24
2020-01-15,2020-01-15,Project payment - Peterson Ltd,REF36191556,0.0,1147.73,153220.97
2020-01-15,2020-01-15,Business insurance premium,REF99118120,93.54,0.0,153127.43
2020-01-19,2020-01-19,Office supplies,REF96561730,52.6,0.0,153074.83
2020-01-21,2020-01-21,Business travel,REF45456246,114.38,0.0,152960.45
2020-01-28,2020-01-28,Equipment purchase,REF13265938,61.81,0.0,152898.64
2020-01-31,2020-01-31,Office supplies,REF16455580,40.6,0.0,152858.04
2020-02-02,2020-02-02,Marketing expenses,REF48366647,168.8,0.0,152689.24
2020-02-09,2020-02-09,Software subscription,REF39521286,138.36,0.0,152550.88
2020-02-12,2020-02-12,Equipment purchase,REF61385179,129.01,0.0,152421.87
2020-02-15,2020-02-15,Business insurance premium,REF47740993,106.14,0.0,152315.73
2020-02-15,2020-02-15,Project payment - Neal-Holden,REF29717355,0.0,1146.57,153462.3
2020-02-15,2020-02-15,Service payment - Peterson Ltd,REF76721460,0.0,1385.51,154847.81
2020-02-15,2020-02-15,Service payment - Davidson and Sons,REF75496711,0.0,780.53,155628.34
2020-02-22,2020-02-22,Office supplies,REF62329612,32.75,0.0,155595.59
2020-02-24,2020-02-24,Training/conference,REF40415464,109.39,0.0,155486.2
2020-02-26,2020-02-26,Office supplies,REF38033888,38.9,0.0,155447.3
2020-02-27,2020-02-27,Equipment purchase,REF20464437,161.04,0.0,155286.26
2020-03-01,2020-03-01,Business travel,REF77867147,295.9,0.0,154990.36
2020-03-02,2020-03-02,Equipment purchase,REF23482053,101.41,0.0,154888.95
2020-03-08,2020-03-08,Business travel,REF35781772,224.52,0.0,154664.43
2020-03-09,2020-03-09,Software subscription,REF26125541,177.12,0.0,154487.31
2020-03-10,2020-03-10,Internet and phone service,REF79433007,119.49,0.0,154367.82
2020-03-15,2020-03-15,Professional services,REF84793624,274.78,0.0,154093.04
2020-03-15,2020-03-15,Invoice payment - Peterson Ltd,REF44405093,0.0,1718.95,155811.99
2020-03-15,2020-03-15,Invoice payment - Neal-Holden,REF39636009,0.0,1639.64,157451.63
2020-03-15,2020-03-15,Service payment - Davidson and Sons,REF93496549,0.0,936.28,158387.91
2020-03-15,2020-03-15,Business insurance premium,REF30836766,133.19,0.0,158254.72
2020-03-18,2020-03-18,Equipment purchase,REF30247120,129.61,0.0,158125.11
2020-03-19,2020-03-19,Training/conference,REF83996364,132.34,0.0,157992.77
2020-03-20,2020-03-20,Business travel,REF97350615,273.74,0.0,157719.03
2020-03-21,2020-03-21,Office supplies,REF65108170,64.19,0.0,157654.84
2020-03-24,2020-03-24,Office supplies,REF56347032,50.27,0.0,157604.57
2020-03-26,2020-03-26,Office supplies,REF64696609,28.91,0.0,157575.66
2020-03-27,2020-03-27,Professional services,REF94364841,177.84,0.0,157397.82
2020-03-30,2020-03-30,Internet and phone service,REF55668176,87.31,0.0,157310.51
2020-04-04,2020-04-04,Marketing expenses,REF69652203,162.03,0.0,157148.48
2020-04-09,2020-04-09,Software subscription,REF50876638,166.1,0.0,156982.38
2020-04-10,2020-04-10,Equipment purchase,REF56645805,113.89,0.0,156868.49
2020-04-10,2020-04-10,Marketing expenses,REF85563193,278.12,0.0,156590.37
2020-04-13,2020-04-13,Marketing expenses,REF90264180,238.7,0.0,156351.67
2020-04-13,2020-04-13,Equipment purchase,REF87532349,158.93,0.0,156192.74
2020-04-15,2020-04-15,Service payment - Davidson and Sons,REF22065439,0.0,898.48,157091.22
2020-04-15,2020-04-15,Payment from Peterson Ltd,REF35109642,0.0,1365.31,158456.53
2020-04-15,2020-04-15,Invoice payment - Neal-Holden,REF29005354,0.0,1194.92,159651.45
2020-04-15,2020-04-15,Business insurance premium,REF40770547,115.14,0.0,159536.31
2020-04-20,2020-04-20,Professional services,REF26905341,188.26,0.0,159348.05
2020-04-21,2020-04-21,Equipment purchase,REF95450881,52.38,0.0,159295.67
2020-04-21,2020-04-21,Marketing expenses,REF50296706,121.17,0.0,159174.5
2020-04-25,2020-04-25,Business travel,REF30708130,139.19,0.0,159035.31
2020-04-28,2020-04-28,Equipment purchase,REF39518812,131.49,0.0,158903.82
2020-04-29,2020-04-29,Training/conference,REF28975265,100.38,0.0,158803.44
2020-05-04,2020-05-04,Office supplies,REF18889321,57.0,0.0,158746.44
2020-05-05,2020-05-05,Office supplies,REF47636579,8.85,0.0,158737.59
2020-05-09,2020-05-09,Software subscription,REF69186281,134.2,0.0,158603.39
2020-05-15,2020-05-15,Payment from Neal-Holden,REF97120883,0.0,1639.06,160242.45
2020-05-15,2020-05-15,Project payment - Peterson Ltd,REF76853839,0.0,1536.9,161779.35
2020-05-15,2020-05-15,Business insurance premium,REF96207807,128.45,0.0,161650.9
2020-05-15,2020-05-15,Payment from Davidson and Sons,REF62439914,0.0,948.64,162599.54
2020-05-16,2020-05-16,Office supplies,REF82416671,50.14,0.0,162549.4
2020-05-19,2020-05-19,Training/conference,REF75370288,97.99,0.0,162451.41
2020-05-24,2020-05-24,Marketing expenses,REF36215075,139.87,0.0,162311.54
2020-05-29,2020-05-29,Equipment purchase,REF20522406,115.74,0.0,162195.8
2020-05-30,2020-05-30,Business travel,REF26276191,186.02,0.0,162009.78
2020-05-31,2020-05-31,Business travel,REF59945120,123.55,0.0,161886.23
2020-06-01,2020-06-01,Office supplies,REF96728718,37.38,0.0,161848.85
2020-06-04,2020-06-04,Office supplies,REF63255754,66.75,0.0,161782.1
2020-06-09,2020-06-09,Equipment purchase,REF12551792,67.02,0.0,161715.08
2020-06-09,2020-06-09,Software subscription,REF13112633,136.87,0.0,161578.21
2020-06-13,2020-06-13,Office supplies,REF53431860,30.84,0.0,161547.37
2020-06-13,2020-06-13,Business travel,REF93764066,148.79,0.0,161398.58
2020-06-15,2020-06-15,Project payment - Davidson and Sons,REF76396033,0.0,758.51,162157.09
2020-06-15,2020-06-15,Business insurance premium,REF14824734,104.8,0.0,162052.29
2020-06-15,2020-06-15,Payment from Peterson Ltd,REF74240878,0.0,1523.54,163575.83
2020-06-15,2020-06-15,Invoice payment - Neal-Holden,REF98535550,0.0,1367.05,164942.88
2020-06-16,2020-06-16,Equipment purchase,REF77140914,47.34,0.0,164895.54
2020-06-20,2020-06-20,Internet and phone service,REF93182239,48.91,0.0,164846.63
2020-06-24,2020-06-24,Internet and phone service,REF72962735,65.65,0.0,164780.98
2020-06-26,2020-06-26,Office supplies,REF98288320,35.82,0.0,164745.16
2020-06-29,2020-06-29,Marketing expenses,REF81464191,130.35,0.0,164614.81
2020-06-30,2020-06-30,Office supplies,REF68186936,47.39,0.0,164567.42
2020-06-30,2020-06-30,Training/conference,REF99642860,118.93,0.0,164448.49
2020-07-06,2020-07-06,Professional services,REF86361052,87.25,0.0,164361.24
2020-07-09,2020-07-09,Software subscription,REF97930247,111.07,0.0,164250.17
2020-07-15,2020-07-15,Business insurance premium,REF92995382,99.9,0.0,164150.27
2020-07-15,2020-07-15,Invoice payment - Neal-Holden,REF80388203,0.0,1088.81,165239.08
2020-07-15,2020-07-15,Service payment - Peterson Ltd,REF75950466,0.0,1247.34,166486.42
2020-07-18,2020-07-18,Office supplies,REF13676728,28.32,0.0,166458.1
2020-07-24,2020-07-24,Equipment purchase,REF28609872,10.62,0.0,166447.48
2020-07-26,2020-07-26,Equipment purchase,REF81746467,29.99,0.0,166417.49
2020-07-27,2020-07-27,Office supplies,REF17435812,37.18,0.0,166380.31
2020-08-03,2020-08-03,Equipment purchase,REF93624014,33.25,0.0,166347.06
2020-08-04,2020-08-04,Office supplies,REF97459340,13.3,0.0,166333.76
2020-08-04,2020-08-04,Internet and phone service,REF62028508,68.7,0.0,166265.06
2020-08-09,2020-08-09,Office supplies,REF68684663,59.39,0.0,166205.67
2020-08-09,2020-08-09,Software subscription,REF64144223,101.94,0.0,166103.73
2020-08-11,2020-08-11,Office supplies,REF14921334,33.74,0.0,166069.99
2020-08-11,2020-08-11,Training/conference,REF84013241,38.23,0.0,166031.76
2020-08-12,2020-08-12,Marketing expenses,REF63315903,184.55,0.0,165847.21
2020-08-15,2020-08-15,Invoice payment - Neal-Holden,REF42929337,0.0,957.9,166805.11
2020-08-15,2020-08-15,Invoice payment - Peterson Ltd,REF41893526,0.0,1325.62,168130.73
2020-08-15,2020-08-15,Business insurance premium,REF77346337,85.22,0.0,168045.51
2020-08-16,2020-08-16,Internet and phone service,REF72888960,85.09,0.0,167960.42
2020-08-17,2020-08-17,Office supplies,REF39089608,40.3,0.0,167920.12
2020-08-23,2020-08-23,Training/conference,REF46813947,90.59,0.0,167829.53
2020-08-27,2020-08-27,Office supplies,REF76345992,37.89,0.0,167791.64
2020-08-29,2020-08-29,Professional services,REF46589644,195.4,0.0,167596.24
2020-08-29,2020-08-29,Office supplies,REF74156365,54.48,0.0,167541.76
2020-09-01,2020-09-01,Business travel,REF74402820,175.04,0.0,167366.72
2020-09-02,2020-09-02,Office supplies,REF53180134,81.92,0.0,167284.8
2020-09-08,2020-09-08,Internet and phone service,REF31824423,60.89,0.0,167223.91
2020-09-08,2020-09-08,Office supplies,REF26218099,36.86,0.0,167187.05
2020-09-09,2020-09-09,Software subscription,REF51089122,183.45,0.0,167003.6
2020-09-09,2020-09-09,Business travel,REF10094912,56.45,0.0,166947.15
2020-09-11,2020-09-11,Professional services,REF62371979,289.2,0.0,166657.95
2020-09-14,2020-09-14,Marketing expenses,REF51189652,130.38,0.0,166527.57
2020-09-15,2020-09-15,Business insurance premium,REF93319172,120.56,0.0,166407.01
2020-09-15,2020-09-15,Payment from Peterson Ltd,REF13652164,0.0,1551.69,167958.7
2020-09-15,2020-09-15,Service payment - Neal-Holden,REF59625360,0.0,1220.63,169179.33
2020-09-16,2020-09-16,Office supplies,REF42587098,63.75,0.0,169115.58
2020-09-24,2020-09-24,Business travel,REF28182346,186.15,0.0,168929.43
2020-09-24,2020-09-24,Office supplies,REF20998767,50.96,0.0,168878.47
2020-09-26,2020-09-26,Training/conference,REF78413410,119.1,0.0,168759.37
2020-09-27,2020-09-27,Office supplies,REF34922200,61.62,0.0,168697.75
2020-09-28,2020-09-28,Professional services,REF87858072,286.47,0.0,168411.28
2020-10-03,2020-10-03,Office supplies,REF88942969,85.59,0.0,168325.69
2020-10-09,2020-10-09,Software subscription,REF67912674,191.6,0.0,168134.09
2020-10-09,2020-10-09,Office supplies,REF26524829,61.56,0.0,168072.53
2020-10-13,2020-10-13,Professional services,REF55573310,348.64,0.0,167723.89
2020-10-14,2020-10-14,Training/conference,REF99595108,105.6,0.0,167618.29
2020-10-15,2020-10-15,Business insurance premium,REF13734709,142.31,0.0,167475.98
2020-10-15,2020-10-15,Service payment - Davidson and Sons,REF79758984,0.0,1298.84,168774.82
2020-10-15,2020-10-15,Payment from Neal-Holden,REF68324156,0.0,1282.71,170057.53
2020-10-15,2020-10-15,Project payment - Peterson Ltd,REF55764582,0.0,1797.24,171854.77
2020-10-18,2020-10-18,Marketing expenses,REF14945962,282.35,0.0,171572.42
2020-10-18,2020-10-18,Office supplies,REF77939769,60.62,0.0,171511.8
2020-10-21,2020-10-21,Marketing expenses,REF30305019,262.43,0.0,171249.37
2020-10-24,2020-10-24,Marketing expenses,REF58987171,308.2,0.0,170941.17
2020-10-26,2020-10-26,Marketing expenses,REF98699407,212.84,0.0,170728.33
2020-10-27,2020-10-27,Internet and phone service,REF47830579,86.52,0.0,170641.81
2020-10-29,2020-10-29,Professional services,REF64446406,463.04,0.0,170178.77
2020-11-03,2020-11-03,Office supplies,REF27979431,38.3,0.0,170140.47
2020-11-05,2020-11-05,Business travel,REF86310804,219.64,0.0,169920.83
2020-11-09,2020-11-09,Software subscription,REF15959814,165.52,0.0,169755.31
2020-11-14,2020-11-14,Office supplies,REF81207365,36.04,0.0,169719.27
2020-11-15,2020-11-15,Business travel,REF44213557,186.32,0.0,169532.95
2020-11-15,2020-11-15,Equipment purchase,REF87048764,165.66,0.0,169367.29
2020-11-15,2020-11-15,Business insurance premium,REF13196448,134.89,0.0,169232.4
2020-11-15,2020-11-15,Project payment - Peterson Ltd,REF88346902,0.0,1520.29,170752.69
2020-11-15,2020-11-15,Invoice payment - Davidson and Sons,REF77852128,0.0,964.67,171717.36
2020-11-15,2020-11-15,Office supplies,REF24148079,64.84,0.0,171652.52
2020-11-21,2020-11-21,Marketing expenses,REF64688572,204.58,0.0,171447.94
2020-11-26,2020-11-26,Professional services,REF65625439,200.74,0.0,171247.2
2020-11-27,2020-11-27,Training/conference,REF77011149,133.18,0.0,171114.02
2020-11-27,2020-11-27,Marketing expenses,REF15654435,127.21,0.0,170986.81
2020-12-02,2020-12-02,Business travel,REF32260599,154.11,0.0,170832.7
2020-12-02,2020-12-02,Equipment purchase,REF55912565,96.98,0.0,170735.72
2020-12-09,2020-12-09,Software subscription,REF26733636,128.75,0.0,170606.97
2020-12-15,2020-12-15,Equipment purchase,REF62475221,118.36,0.0,170488.61
2020-12-15,2020-12-15,Service payment - Neal-Holden,REF88690373,0.0,1154.92,171643.53
2020-12-15,2020-12-15,Project payment - Davidson and Sons,REF80678466,0.0,829.41,172472.94
2020-12-15,2020-12-15,Project payment - Peterson Ltd,REF62937235,0.0,1530.89,174003.83
2020-12-15,2020-12-15,Business insurance premium,REF16843652,103.38,0.0,173900.45
2020-12-17,2020-12-17,Professional services,REF13956691,288.62,0.0,173611.83
2020-12-23,2020-12-23,Business travel,REF82635995,137.84,0.0,173473.99
2021-01-01,2021-01-01,Business travel,REF69822335,258.2,0.0,173215.79
2021-01-09,2021-01-09,Equipment purchase,REF88483888,102.71,0.0,173113.08
2021-01-09,2021-01-09,Software subscription,REF13874623,129.97,0.0,172983.11
2021-01-15,2021-01-15,Project payment - Neal-Holden,REF21550247,0.0,927.81,173910.92
2021-01-15,2021-01-15,Payment from Davidson and Sons,REF41130778,0.0,824.46,174735.38
2021-01-15,2021-01-15,Business insurance premium,REF31625342,97.45,0.0,174637.93
2021-01-18,2021-01-18,Office supplies,REF21162625,57.74,0.0,174580.19
2021-01-25,2021-01-25,Office supplies,REF30783258,40.65,0.0,174539.54
2021-01-27,2021-01-27,Equipment purchase,REF82920092,86.87,0.0,174452.67
2021-01-28,2021-01-28,Training/conference,REF84326583,77.32,0.0,174375.35
2021-01-28,2021-01-28,Equipment purchase,REF81047823,100.4,0.0,174274.95
2021-01-29,2021-01-29,Office supplies,REF43142209,56.66,0.0,174218.29
2021-01-30,2021-01-30,Office supplies,REF68571562,58.33,0.0,174159.96
2021-02-02,2021-02-02,Professional services,REF34552351,247.22,0.0,173912.74
2021-02-07,2021-02-07,Professional services,REF47134197,246.77,0.0,173665.97
2021-02-08,2021-02-08,Internet and phone service,REF11407748,93.79,0.0,173572.18
2021-02-08,2021-02-08,Professional services,REF97680888,277.9,0.0,173294.28
2021-02-09,2021-02-09,Software subscription,REF75432297,128.19,0.0,173166.09
2021-02-10,2021-02-10,Office supplies,REF69032645,13.52,0.0,173152.57
2021-02-13,2021-02-13,Business travel,REF47231048,164.86,0.0,172987.71
2021-02-15,2021-02-15,Invoice payment - Neal-Holden,REF29593038,0.0,1017.14,174004.85
2021-02-15,2021-02-15,Project payment - Peterson Ltd,REF32222599,0.0,1508.23,175513.08
2021-02-15,2021-02-15,Service payment - Davidson and Sons,REF39244523,0.0,851.14,176364.22
2021-02-15,2021-02-15,Business insurance premium,REF72710023,104.65,0.0,176259.57
2021-02-18,2021-02-18,Professional services,REF70201940,190.18,0.0,176069.39
2021-02-28,2021-02-28,Equipment purchase,REF11670931,79.51,0.0,175989.88
2021-03-02,2021-03-02,Office supplies,REF70414784,46.06,0.0,175943.82
2021-03-05,2021-03-05,Training/conference,REF31851260,92.13,0.0,175851.69
2021-03-07,2021-03-07,Business travel,REF36875165,48.88,0.0,175802.81
2021-03-09,2021-03-09,Software subscription,REF94029486,162.75,0.0,175640.06
2021-03-11,2021-03-11,Business travel,REF10929412,145.21,0.0,175494.85
2021-03-11,2021-03-11,Professional services,REF90910550,270.06,0.0,175224.79
2021-03-12,2021-03-12,Professional services,REF37855411,303.58,0.0,174921.21
2021-03-15,2021-03-15,Business insurance premium,REF97519837,122.18,0.0,174799.03
2021-03-15,2021-03-15,Invoice payment - Davidson and Sons,REF55772018,0.0,995.36,175794.39
2021-03-15,2021-03-15,Payment from Peterson Ltd,REF66813808,0.0,2069.13,177863.52
2021-03-17,2021-03-17,Office supplies,REF83814918,77.74,0.0,177785.78
2021-03-18,2021-03-18,Internet and phone service,REF78669020,92.96,0.0,177692.82
2021-03-23,2021-03-23,Training/conference,REF83991396,127.12,0.0,177565.7
2021-03-24,2021-03-24,Internet and phone service,REF80101930,90.76,0.0,177474.94
2021-03-25,2021-03-25,Business travel,REF20828998,194.85,0.0,177280.09
2021-03-25,2021-03-25,Training/conference,REF12033330,89.9,0.0,177190.19
2021-03-28,2021-03-28,Office supplies,REF43927918,30.78,0.0,177159.41
2021-03-30,2021-03-30,Professional services,REF36534257,298.87,0.0,176860.54
2021-04-05,2021-04-05,Office supplies,REF99325342,47.39,0.0,176813.15
2021-04-09,2021-04-09,Equipment purchase,REF16786084,76.61,0.0,176736.54
2021-04-09,2021-04-09,Software subscription,REF44688105,147.17,0.0,176589.37
2021-04-10,2021-04-10,Marketing expenses,REF65925233,130.38,0.0,176458.99
2021-04-15,2021-04-15,Payment from Neal-Holden,REF58379900,0.0,1223.06,177682.05
2021-04-15,2021-04-15,Payment from Davidson and Sons,REF79243979,0.0,923.89,178605.94
2021-04-15,2021-04-15,Business insurance premium,REF42341178,131.22,0.0,178474.72
2021-04-15,2021-04-15,Invoice payment - Peterson Ltd,REF41048600,0.0,1303.77,179778.49
2021-04-16,2021-04-16,Professional services,REF86427517,395.03,0.0,179383.46
2021-04-19,2021-04-19,Equipment purchase,REF33986235,51.49,0.0,179331.97
2021-05-01,2021-05-01,Office supplies,REF10030089,40.96,0.0,179291.01
2021-05-09,2021-05-09,Software subscription,REF25410839,156.46,0.0,179134.55
2021-05-09,2021-05-09,Internet and phone service,REF12448737,106.48,0.0,179028.07
2021-05-09,2021-05-09,Business travel,REF92521808,199.22,0.0,178828.85
2021-05-15,2021-05-15,Payment from Neal-Holden,REF80377430,0.0,1450.15,180279.0
2021-05-15,2021-05-15,Service payment - Davidson and Sons,REF19245739,0.0,886.65,181165.65
2021-05-15,2021-05-15,Business insurance premium,REF31808645,113.0,0.0,181052.65
2021-05-15,2021-05-15,Payment from Peterson Ltd,REF16948302,0.0,1478.74,182531.39
2021-05-22,2021-05-22,Internet and phone service,REF95920499,63.73,0.0,182467.66
2021-05-27,2021-05-27,Office supplies,REF77865859,43.96,0.0,182423.7
2021-05-27,2021-05-27,Business travel,REF31310380,105.22,0.0,182318.48
2021-05-31,2021-05-31,Office supplies,REF17138449,45.78,0.0,182272.7
2021-05-31,2021-05-31,Marketing expenses,REF58341754,179.9,0.0,182092.8
2021-06-06,2021-06-06,Marketing expenses,REF49532784,228.33,0.0,181864.47
2021-06-09,2021-06-09,Software subscription,REF58816404,126.69,0.0,181737.78
2021-06-10,2021-06-10,Office supplies,REF73736818,79.29,0.0,181658.49
2021-06-13,2021-06-13,Office supplies,REF56856678,56.99,0.0,181601.5
2021-06-15,2021-06-15,Business insurance premium,REF99007438,108.46,0.0,181493.04
2021-06-15,2021-06-15,Payment from Davidson and Sons,REF70731533,0.0,684.52,182177.56
2021-06-15,2021-06-15,Service payment - Neal-Holden,REF93552434,0.0,1236.19,183413.75
2021-06-15,2021-06-15,Service payment - Peterson Ltd,REF69645497,0.0,1198.03,184611.78
2021-06-15,2021-06-15,Business travel,REF84971052,171.37,0.0,184440.41
2021-06-16,2021-06-16,Training/conference,REF78923083,91.55,0.0,184348.86
2021-06-17,2021-06-17,Business travel,REF64449805,210.17,0.0,184138.69
2021-06-17,2021-06-17,Professional services,REF32773947,191.36,0.0,183947.33
2021-06-18,2021-06-18,Business travel,REF99512575,151.8,0.0,183795.53
2021-06-21,2021-06-21,Business travel,REF84664022,74.77,0.0,183720.76
2021-06-22,2021-06-22,Office supplies,REF58192498,63.9,0.0,183656.86
2021-06-25,2021-06-25,Business travel,REF37557167,168.03,0.0,183488.83
2021-06-27,2021-06-27,Equipment purchase,REF63854078,49.65,0.0,183439.18
2021-06-28,2021-06-28,Internet and phone service,REF22418036,85.29,0.0,183353.89
2021-07-02,2021-07-02,Office supplies,REF91011653,35.38,0.0,183318.51
2021-07-05,2021-07-05,Internet and phone service,REF66393756,115.06,0.0,183203.45
2021-07-07,2021-07-07,Office supplies,REF27466488,45.06,0.0,183158.39
2021-07-09,2021-07-09,Software subscription,REF89423440,108.1,0.0,183050.29
2021-07-12,2021-07-12,Office supplies,REF53620392,27.84,0.0,183022.45
2021-07-15,2021-07-15,Business insurance premium,REF11287971,103.53,0.0,182918.92
2021-07-15,2021-07-15,Invoice payment - Peterson Ltd,REF61574763,0.0,1206.68,184125.6
2021-07-15,2021-07-15,Project payment - Davidson and Sons,REF37747994,0.0,675.7,184801.3
2021-07-15,2021-07-15,Invoice payment - Neal-Holden,REF87862783,0.0,1369.2,186170.5
2021-07-17,2021-07-17,Office supplies,REF17962102,21.38,0.0,186149.12
2021-07-18,2021-07-18,Business travel,REF44340270,91.77,0.0,186057.35
2021-07-19,2021-07-19,Office supplies,REF83179515,46.3,0.0,186011.05
2021-07-19,2021-07-19,Professional services,REF38772111,167.23,0.0,185843.82
2021-07-24,2021-07-24,Office supplies,REF38895763,43.32,0.0,185800.5
2021-07-25,2021-07-25,Training/conference,REF23638279,79.85,0.0,185720.65
2021-07-26,2021-07-26,Office supplies,REF20011892,27.23,0.0,185693.42
2021-07-27,2021-07-27,Equipment purchase,REF64978227,84.42,0.0,185609.0
2021-08-09,2021-08-09,Software subscription,REF57985946,115.67,0.0,185493.33
2021-08-13,2021-08-13,Internet and phone service,REF63821862,85.23,0.0,185408.1
2021-08-14,2021-08-14,Equipment purchase,REF68183819,87.8,0.0,185320.3
2021-08-15,2021-08-15,Invoice payment - Davidson and Sons,REF41939367,0.0,723.0,186043.3
2021-08-15,2021-08-15,Business insurance premium,REF75628464,79.54,0.0,185963.76
2021-08-15,2021-08-15,Invoice payment - Neal-Holden,REF12459714,0.0,946.17,186909.93
2021-08-22,2021-08-22,Office supplies,REF47413093,30.57,0.0,186879.36
2021-08-30,2021-08-30,Marketing expenses,REF32955290,181.77,0.0,186697.59
2021-08-31,2021-08-31,Office supplies,REF33509315,32.64,0.0,186664.95
2021-09-04,2021-09-04,Office supplies,REF75396640,72.49,0.0,186592.46
2021-09-07,2021-09-07,Office supplies,REF70283365,59.73,0.0,186532.73
2021-09-09,2021-09-09,Office supplies,REF54504365,81.88,0.0,186450.85
2021-09-09,2021-09-09,Software subscription,REF26318045,163.37,0.0,186287.48
2021-09-12,2021-09-12,Equipment purchase,REF43127782,143.87,0.0,186143.61
2021-09-13,2021-09-13,Office supplies,REF40732822,49.1,0.0,186094.51
2021-09-14,2021-09-14,Professional services,REF93965846,200.21,0.0,185894.3
2021-09-15,2021-09-15,Business insurance premium,REF79546469,128.69,0.0,185765.61
2021-09-15,2021-09-15,Training/conference,REF68813940,135.61,0.0,185630.0
2021-09-15,2021-09-15,Payment from Neal-Holden,REF99303779,0.0,1555.15,187185.15
2021-09-15,2021-09-15,Invoice payment - Davidson and Sons,REF49888739,0.0,886.81,188071.96
2021-09-15,2021-09-15,Invoice payment - Peterson Ltd,REF52131279,0.0,1282.43,189354.39
2021-09-21,2021-09-21,Business travel,REF54264095,249.37,0.0,189105.02
2021-09-22,2021-09-22,Office supplies,REF97644842,60.63,0.0,189044.39
2021-09-23,2021-09-23,Office supplies,REF90204018,55.53,0.0,188988.86
2021-09-24,2021-09-24,Training/conference,REF88780432,144.5,0.0,188844.36
2021-09-25,2021-09-25,Professional services,REF42845557,89.95,0.0,188754.41
2021-09-29,2021-09-29,Office supplies,REF45831133,31.92,0.0,188722.49
2021-09-29,2021-09-29,Professional services,REF69336535,325.69,0.0,188396.8
2021-09-30,2021-09-30,Internet and phone service,REF50355145,81.61,0.0,188315.19
2021-10-09,2021-10-09,Software subscription,REF37602292,174.76,0.0,188140.43
2021-10-10,2021-10-10,Equipment purchase,REF37328719,99.59,0.0,188040.84
2021-10-12,2021-10-12,Training/conference,REF18866700,113.05,0.0,187927.79
2021-10-15,2021-10-15,Payment from Peterson Ltd,REF59196822,0.0,1274.05,189201.84
2021-10-15,2021-10-15,Invoice payment - Neal-Holden,REF49166997,0.0,1179.52,190381.36
2021-10-15,2021-10-15,Invoice payment - Davidson and Sons,REF30071875,0.0,766.17,191147.53
2021-10-15,2021-10-15,Business insurance premium,REF12514696,141.68,0.0,191005.85
2021-10-17,2021-10-17,Office supplies,REF70325739,52.43,0.0,190953.42
2021-10-18,2021-10-18,Office supplies,REF73015866,67.15,0.0,190886.27
2021-10-19,2021-10-19,Internet and phone service,REF92484093,114.91,0.0,190771.36
2021-10-19,2021-10-19,Marketing expenses,REF70600636,364.81,0.0,190406.55
2021-10-21,2021-10-21,Office supplies,REF65736473,73.46,0.0,190333.09
2021-10-21,2021-10-21,Equipment purchase,REF58622300,120.62,0.0,190212.47
2021-10-22,2021-10-22,Business travel,REF35846018,165.27,0.0,190047.2
2021-11-04,2021-11-04,Office supplies,REF72036122,36.1,0.0,190011.1
2021-11-06,2021-11-06,Professional services,REF61917860,180.58,0.0,189830.52
2021-11-09,2021-11-09,Software subscription,REF91449171,165.7,0.0,189664.82
2021-11-10,2021-11-10,Office supplies,REF34662454,66.66,0.0,189598.16
2021-11-15,2021-11-15,Project payment - Davidson and Sons,REF98106180,0.0,824.64,190422.8
2021-11-15,2021-11-15,Business insurance premium,REF56973825,132.19,0.0,190290.61
2021-11-15,2021-11-15,Service payment - Neal-Holden,REF30517076,0.0,1268.89,191559.5
2021-11-15,2021-11-15,Invoice payment - Peterson Ltd,REF54655625,0.0,1168.93,192728.43
2021-11-17,2021-11-17,Marketing expenses,REF86518905,186.38,0.0,192542.05
2021-11-21,2021-11-21,Equipment purchase,REF25462652,162.9,0.0,192379.15
2021-11-26,2021-11-26,Marketing expenses,REF78637866,200.05,0.0,192179.1
2021-11-28,2021-11-28,Professional services,REF39927016,145.1,0.0,192034.0
2021-11-28,2021-11-28,Internet and phone service,REF50063226,89.8,0.0,191944.2
2021-12-09,2021-12-09,Software subscription,REF83347086,169.32,0.0,191774.88
2021-12-15,2021-12-15,Business insurance premium,REF89586914,108.04,0.0,191666.84
2021-12-15,2021-12-15,Service payment - Davidson and Sons,REF37661858,0.0,710.77,192377.61
2021-12-15,2021-12-15,Invoice payment - Peterson Ltd,REF51748607,0.0,1622.52,194000.13
2021-12-19,2021-12-19,Business travel,REF19329557,86.36,0.0,193913.77
2021-12-23,2021-12-23,Internet and phone service,REF73239728,49.62,0.0,193864.15
2022-01-01,2022-01-01,Equipment purchase,REF66584258,36.68,0.0,193827.47
2022-01-04,2022-01-04,Training/conference,REF53239270,115.82,0.0,193711.65
2022-01-08,2022-01-08,Professional services,REF66902112,251.17,0.0,193460.48
2022-01-08,2022-01-08,Office supplies,REF99081316,25.23,0.0,193435.25
2022-01-09,2022-01-09,Software subscription,REF34851163,131.29,0.0,193303.96
2022-01-13,2022-01-13,Training/conference,REF64522992,71.3,0.0,193232.66
2022-01-14,2022-01-14,Professional services,REF60689724,114.99,0.0,193117.67
2022-01-15,2022-01-15,Business insurance premium,REF55431027,96.31,0.0,193021.36
2022-01-15,2022-01-15,Invoice payment - Peterson Ltd,REF38086713,0.0,1658.08,194679.44
2022-01-15,2022-01-15,Invoice payment - Neal-Holden,REF20140648,0.0,1005.95,195685.39
2022-01-15,2022-01-15,Payment from Davidson and Sons,REF91095351,0.0,811.14,196496.53
2022-01-17,2022-01-17,Internet and phone service,REF67642899,37.43,0.0,196459.1
2022-01-20,2022-01-20,Office supplies,REF99570538,46.87,0.0,196412.23
2022-01-21,2022-01-21,Office supplies,REF50243823,48.12,0.0,196364.11
2022-01-21,2022-01-21,Training/conference,REF18968220,85.38,0.0,196278.73
2022-01-30,2022-01-30,Office supplies,REF63536067,19.51,0.0,196259.22
2022-02-04,2022-02-04,Marketing expenses,REF62001453,198.67,0.0,196060.55
2022-02-08,2022-02-08,Equipment purchase,REF30974137,138.11,0.0,195922.44
2022-02-09,2022-02-09,Software subscription,REF46690566,146.17,0.0,195776.27
2022-02-15,2022-02-15,Project payment - Neal-Holden,REF37435114,0.0,1062.05,196838.32
2022-02-15,2022-02-15,Business insurance premium,REF22186926,110.24,0.0,196728.08
2022-02-15,2022-02-15,Invoice payment - Davidson and Sons,REF69073165,0.0,783.46,197511.54
2022-02-15,2022-02-15,Payment from Peterson Ltd,REF60933643,0.0,1290.13,198801.67
2022-02-19,2022-02-19,Internet and phone service,REF21089349,60.73,0.0,198740.94
2022-02-21,2022-02-21,Equipment purchase,REF87220303,77.1,0.0,198663.84
2022-02-22,2022-02-22,Office supplies,REF81982915,38.81,0.0,198625.03
2022-02-23,2022-02-23,Training/conference,REF22010522,157.02,0.0,198468.01
2022-02-26,2022-02-26,Office supplies,REF50915188,48.47,0.0,198419.54
2022-03-01,2022-03-01,Training/conference,REF47496059,129.59,0.0,198289.95
2022-03-02,2022-03-02,Office supplies,REF89220692,48.33,0.0,198241.62
2022-03-02,2022-03-02,Business travel,REF44420723,232.37,0.0,198009.25
2022-03-09,2022-03-09,Software subscription,REF22709172,168.41,0.0,197840.84
2022-03-15,2022-03-15,Office supplies,REF80509409,54.31,0.0,197786.53
2022-03-15,2022-03-15,Invoice payment - Davidson and Sons,REF94700474,0.0,914.26,198700.79
2022-03-15,2022-03-15,Payment from Peterson Ltd,REF26866755,0.0,1729.34,200430.13
2022-03-15,2022-03-15,Service payment - Neal-Holden,REF47082068,0.0,1964.67,202394.8
2022-03-15,2022-03-15,Business insurance premium,REF12673041,128.32,0.0,202266.48
2022-03-16,2022-03-16,Business travel,REF80977988,173.45,0.0,202093.03
2022-03-18,2022-03-18,Office supplies,REF29444269,67.53,0.0,202025.5
2022-03-22,2022-03-22,Office supplies,REF74371091,35.23,0.0,201990.27
2022-03-24,2022-03-24,Business travel,REF83154192,136.95,0.0,201853.32
2022-03-29,2022-03-29,Office supplies,REF32156269,38.48,0.0,201814.84
2022-04-06,2022-04-06,Office supplies,REF33041869,43.81,0.0,201771.03
2022-04-08,2022-04-08,Office supplies,REF58286132,5.0,0.0,201766.03
2022-04-09,2022-04-09,Internet and phone service,REF78754841,56.51,0.0,201709.52
2022-04-09,2022-04-09,Software subscription,REF56464203,143.05,0.0,201566.47
2022-04-13,2022-04-13,Office supplies,REF32500164,44.75,0.0,201521.72
2022-04-15,2022-04-15,Invoice payment - Neal-Holden,REF67573263,0.0,1267.57,202789.29
2022-04-15,2022-04-15,Payment from Peterson Ltd,REF85990300,0.0,1237.42,204026.71
2022-04-15,2022-04-15,Business insurance premium,REF58662833,125.14,0.0,203901.57
2022-04-15,2022-04-15,Payment from Davidson and Sons,REF64135924,0.0,936.2,204837.77
2022-04-19,2022-04-19,Training/conference,REF31462116,92.96,0.0,204744.81
2022-04-22,2022-04-22,Office supplies,REF82080879,60.75,0.0,204684.06
2022-04-23,2022-04-23,Office supplies,REF46881971,45.06,0.0,204639.0
2022-05-07,2022-05-07,Equipment purchase,REF30557674,71.06,0.0,204567.94
2022-05-09,2022-05-09,Software subscription,REF75528572,133.86,0.0,204434.08
2022-05-10,2022-05-10,Marketing expenses,REF73626994,197.25,0.0,204236.83
2022-05-13,2022-05-13,Training/conference,REF25394945,68.11,0.0,204168.72
2022-05-15,2022-05-15,Business insurance premium,REF67336616,124.59,0.0,204044.13
2022-05-15,2022-05-15,Service payment - Davidson and Sons,REF67438978,0.0,579.62,204623.75
2022-05-15,2022-05-15,Payment from Peterson Ltd,REF63953237,0.0,1585.69,206209.44
2022-05-15,2022-05-15,Project payment - Neal-Holden,REF41181841,0.0,1300.65,207510.09
2022-05-15,2022-05-15,Professional services,REF79126895,274.45,0.0,207235.64
2022-05-16,2022-05-16,Internet and phone service,REF20635337,90.26,0.0,207145.38
2022-05-17,2022-05-17,Office supplies,REF27310738,17.38,0.0,207128.0
2022-05-22,2022-05-22,Office supplies,REF14933272,67.01,0.0,207060.99
2022-05-23,2022-05-23,Training/conference,REF63418946,106.41,0.0,206954.58
2022-05-26,2022-05-26,Office supplies,REF58086151,28.73,0.0,206925.85
2022-05-30,2022-05-30,Business travel,REF96567891,137.73,0.0,206788.12
2022-06-03,2022-06-03,Office supplies,REF69046539,24.12,0.0,206764.0
2022-06-06,2022-06-06,Business travel,REF49007072,81.04,0.0,206682.96
2022-06-09,2022-06-09,Software subscription,REF60491397,158.3,0.0,206524.66
2022-06-14,2022-06-14,Office supplies,REF15929443,39.4,0.0,206485.26
2022-06-15,2022-06-15,Business insurance premium,REF86330843,107.13,0.0,206378.13
2022-06-15,2022-06-15,Invoice payment - Neal-Holden,REF26263037,0.0,1202.31,207580.44
2022-06-15,2022-06-15,Payment from Davidson and Sons,REF82343821,0.0,737.7,208318.14
2022-06-15,2022-06-15,Payment from Peterson Ltd,REF19128772,0.0,1434.94,209753.08
2022-06-19,2022-06-19,Office supplies,REF13833680,51.66,0.0,209701.42
2022-06-20,2022-06-20,Internet and phone service,REF85719032,42.14,0.0,209659.28
2022-06-23,2022-06-23,Office supplies,REF25458223,49.29,0.0,209609.99
2022-06-24,2022-06-24,Professional services,REF79307775,155.79,0.0,209454.2
2022-06-25,2022-06-25,Marketing expenses,REF61204638,181.02,0.0,209273.18
2022-06-27,2022-06-27,Equipment purchase,REF78146549,91.86,0.0,209181.32
2022-07-03,2022-07-03,Professional services,REF69067765,230.06,0.0,208951.26
2022-07-04,2022-07-04,Business travel,REF97708502,73.95,0.0,208877.31
2022-07-04,2022-07-04,Equipment purchase,REF23391706,98.39,0.0,208778.92
2022-07-05,2022-07-05,Equipment purchase,REF99424085,48.05,0.0,208730.87
2022-07-07,2022-07-07,Office supplies,REF98593840,53.44,0.0,208677.43
2022-07-09,2022-07-09,Software subscription,REF71418840,119.86,0.0,208557.57
2022-07-14,2022-07-14,Equipment purchase,REF46439648,67.8,0.0,208489.77
2022-07-15,2022-07-15,Business insurance premium,REF25926046,106.07,0.0,208383.7
2022-07-15,2022-07-15,Project payment - Peterson Ltd,REF58561289,0.0,1248.09,209631.79
2022-07-15,2022-07-15,Service payment - Neal-Holden,REF54961102,0.0,1130.75,210762.54
2022-07-15,2022-07-15,Project payment - Davidson and Sons,REF83350260,0.0,676.31,211438.85
2022-07-23,2022-07-23,Professional services,REF38794624,275.85,0.0,211163.0
2022-07-25,2022-07-25,Internet and phone service,REF43635003,67.14,0.0,211095.86
2022-07-27,2022-07-27,Office supplies,REF30814144,56.49,0.0,211039.37
2022-07-31,2022-07-31,Internet and phone service,REF34598153,79.09,0.0,210960.28
2022-08-01,2022-08-01,Office supplies,REF17666711,18.68,0.0,210941.6
2022-08-04,2022-08-04,Office supplies,REF87410649,39.16,0.0,210902.44
2022-08-05,2022-08-05,Office supplies,REF54421233,36.72,0.0,210865.72
2022-08-08,2022-08-08,Office supplies,REF79259646,26.44,0.0,210839.28
2022-08-09,2022-08-09,Software subscription,REF52520206,102.73,0.0,210736.55
2022-08-15,2022-08-15,Invoice payment - Davidson and Sons,REF88600722,0.0,547.28,211283.83
2022-08-15,2022-08-15,Project payment - Neal-Holden,REF88358345,0.0,1017.42,212301.25
2022-08-15,2022-08-15,Project payment - Peterson Ltd,REF43738787,0.0,1263.15,213564.4
2022-08-15,2022-08-15,Business insurance premium,REF68494110,75.67,0.0,213488.73
2022-08-16,2022-08-16,Marketing expenses,REF79177375,158.86,0.0,213329.87
2022-08-17,2022-08-17,Equipment purchase,REF73384221,69.58,0.0,213260.29
2022-08-18,2022-08-18,Equipment purchase,REF49498287,66.85,0.0,213193.44
2022-08-18,2022-08-18,Internet and phone service,REF92212215,38.08,0.0,213155.36
2022-08-20,2022-08-20,Office supplies,REF95665334,40.34,0.0,213115.02
2022-08-21,2022-08-21,Marketing expenses,REF67193949,144.62,0.0,212970.4
2022-08-25,2022-08-25,Equipment purchase,REF60695654,65.79,0.0,212904.61
2022-09-01,2022-09-01,Business travel,REF58411811,217.95,0.0,212686.66
2022-09-09,2022-09-09,Software subscription,REF82352666,136.2,0.0,212550.46
2022-09-13,2022-09-13,Internet and phone service,REF81216685,95.08,0.0,212455.38
2022-09-15,2022-09-15,Project payment - Peterson Ltd,REF52419129,0.0,1848.81,214304.19
2022-09-15,2022-09-15,Payment from Davidson and Sons,REF42009263,0.0,959.67,215263.86
2022-09-15,2022-09-15,Invoice payment - Neal-Holden,REF73352902,0.0,1181.86,216445.72
2022-09-15,2022-09-15,Business insurance premium,REF30998381,136.85,0.0,216308.87
2022-09-16,2022-09-16,Office supplies,REF52143128,73.27,0.0,216235.6
2022-09-17,2022-09-17,Business travel,REF20216339,91.56,0.0,216144.04
2022-09-22,2022-09-22,Equipment purchase,REF66917687,86.02,0.0,216058.02
2022-10-09,2022-10-09,Software subscription,REF29403696,192.63,0.0,215865.39
2022-10-10,2022-10-10,Office supplies,REF12789439,44.37,0.0,215821.02
2022-10-10,2022-10-10,Internet and phone service,REF33413530,100.12,0.0,215720.9
2022-10-15,2022-10-15,Project payment - Peterson Ltd,REF36988415,0.0,1839.45,217560.35
2022-10-15,2022-10-15,Project payment - Neal-Holden,REF61809778,0.0,1552.91,219113.26
2022-10-15,2022-10-15,Business insurance premium,REF78716239,149.71,0.0,218963.55
2022-10-15,2022-10-15,Service payment - Davidson and Sons,REF94702815,0.0,774.18,219737.73
2022-10-16,2022-10-16,Business travel,REF44022818,153.19,0.0,219584.54
2022-10-17,2022-10-17,Office supplies,REF69749441,53.38,0.0,219531.16
2022-10-20,2022-10-20,Professional services,REF68487581,316.1,0.0,219215.06
2022-10-22,2022-10-22,Business travel,REF29036785,82.17,0.0,219132.89
2022-10-23,2022-10-23,Office supplies,REF32221464,78.12,0.0,219054.77
2022-10-24,2022-10-24,Internet and phone service,REF51513760,168.08,0.0,218886.69
2022-10-27,2022-10-27,Business travel,REF20361451,248.32,0.0,218638.37
2022-11-07,2022-11-07,Office supplies,REF72145112,45.03,0.0,218593.34
2022-11-09,2022-11-09,Software subscription,REF13184819,160.39,0.0,218432.95
2022-11-11,2022-11-11,Office supplies,REF33636663,27.59,0.0,218405.36
2022-11-11,2022-11-11,Training/conference,REF93976340,118.77,0.0,218286.59
2022-11-15,2022-11-15,Business insurance premium,REF23942822,121.56,0.0,218165.03
2022-11-15,2022-11-15,Payment from Peterson Ltd,REF55107728,0.0,1954.66,220119.69
2022-11-15,2022-11-15,Project payment - Neal-Holden,REF99757349,0.0,1434.44,221554.13
2022-11-15,2022-11-15,Office supplies,REF40132833,49.07,0.0,221505.06
2022-11-15,2022-11-15,Invoice payment - Davidson and Sons,REF67636209,0.0,914.43,222419.49
2022-11-16,2022-11-16,Business travel,REF21994326,122.08,0.0,222297.41
2022-11-17,2022-11-17,Business travel,REF15166551,125.71,0.0,222171.7
2022-11-18,2022-11-18,Business travel,REF21683591,119.34,0.0,222052.36
2022-11-23,2022-11-23,Office supplies,REF29806466,59.48,0.0,221992.88
2022-11-27,2022-11-27,Office supplies,REF24928997,65.05,0.0,221927.83
2022-12-04,2022-12-04,Equipment purchase,REF47284673,106.13,0.0,221821.7
2022-12-05,2022-12-05,Equipment purchase,REF88261619,137.29,0.0,221684.41
2022-12-06,2022-12-06,Equipment purchase,REF59741792,146.63,0.0,221537.78
2022-12-06,2022-12-06,Internet and phone service,REF77705624,106.78,0.0,221431.0
2022-12-08,2022-12-08,Internet and phone service,REF79803668,87.8,0.0,221343.2
2022-12-09,2022-12-09,Software subscription,REF41746440,134.33,0.0,221208.87
2022-12-10,2022-12-10,Marketing expenses,REF22239671,245.65,0.0,220963.22
2022-12-11,2022-12-11,Office supplies,REF80727211,52.1,0.0,220911.12
2022-12-15,2022-12-15,Service payment - Davidson and Sons,REF66589636,0.0,678.29,221589.41
2022-12-15,2022-12-15,Business insurance premium,REF19079571,105.57,0.0,221483.84
2022-12-15,2022-12-15,Payment from Peterson Ltd,REF19257776,0.0,1836.65,223320.49
2022-12-15,2022-12-15,Invoice payment - Neal-Holden,REF35520061,0.0,1209.38,224529.87
2022-12-20,2022-12-20,Equipment purchase,REF21706669,126.25,0.0,224403.62
2022-12-23,2022-12-23,Training/conference,REF56129170,157.3,0.0,224246.32
2022-12-23,2022-12-23,Office supplies,REF70993780,41.13,0.0,224205.19
2022-12-28,2022-12-28,Marketing expenses,REF66054643,219.84,0.0,223985.35
2022-12-28,2022-12-28,Training/conference,REF91935922,108.4,0.0,223876.95
2022-12-29,2022-12-29,Equipment purchase,REF60173430,113.44,0.0,223763.51
2022-12-31,2022-12-31,Business travel,REF97405416,113.59,0.0,223649.92
2023-01-02,2023-01-02,Business travel,REF22006973,117.31,0.0,223532.61
2023-01-04,2023-01-04,Business travel,REF25406240,104.12,0.0,223428.49
2023-01-09,2023-01-09,Software subscription,REF28019993,123.79,0.0,223304.7
2023-01-12,2023-01-12,Office supplies,REF44053425,20.33,0.0,223284.37
2023-01-15,2023-01-15,Business insurance premium,REF49422063,92.94,0.0,223191.43
2023-01-15,2023-01-15,Invoice payment - Davidson and Sons,REF54038169,0.0,782.86,223974.29
2023-01-15,2023-01-15,Payment from Neal-Holden,REF75221815,0.0,1008.58,224982.87
2023-01-18,2023-01-18,Business travel,REF29882352,134.82,0.0,224848.05
2023-01-19,2023-01-19,Office supplies,REF82565523,36.87,0.0,224811.18
2023-01-25,2023-01-25,Office supplies,REF95717243,47.29,0.0,224763.89
2023-01-28,2023-01-28,Professional services,REF58842380,94.01,0.0,224669.88
2023-02-01,2023-02-01,Business travel,REF69936617,140.37,0.0,224529.51
2023-02-04,2023-02-04,Business travel,REF66004608,157.07,0.0,224372.44
2023-02-04,2023-02-04,Internet and phone service,REF47334791,68.7,0.0,224303.74
2023-02-04,2023-02-04,Equipment purchase,REF35935222,94.96,0.0,224208.78
2023-02-09,2023-02-09,Software subscription,REF88362823,116.21,0.0,224092.57
2023-02-12,2023-02-12,Marketing expenses,REF57421736,125.8,0.0,223966.77
2023-02-15,2023-02-15,Invoice payment - Davidson and Sons,REF57049423,0.0,741.91,224708.68
2023-02-15,2023-02-15,Project payment - Peterson Ltd,REF13381089,0.0,1352.79,226061.47
2023-02-15,2023-02-15,Business insurance premium,REF41897724,110.76,0.0,225950.71
2023-02-15,2023-02-15,Payment from Neal-Holden,REF54519107,0.0,1322.44,227273.15
2023-02-16,2023-02-16,Training/conference,REF33019307,108.74,0.0,227164.41
2023-02-17,2023-02-17,Professional services,REF94102939,216.32,0.0,226948.09
2023-02-23,2023-02-23,Office supplies,REF97943155,46.34,0.0,226901.75
2023-02-23,2023-02-23,Professional services,REF80560297,216.64,0.0,226685.11
2023-02-25,2023-02-25,Marketing expenses,REF91739157,131.68,0.0,226553.43
2023-02-26,2023-02-26,Business travel,REF56792128,136.76,0.0,226416.67
2023-03-09,2023-03-09,Software subscription,REF44612631,166.24,0.0,226250.43
2023-03-10,2023-03-10,Office supplies,REF55897866,63.54,0.0,226186.89
2023-03-13,2023-03-13,Office supplies,REF27186690,32.1,0.0,226154.79
2023-03-13,2023-03-13,Business travel,REF42587584,273.71,0.0,225881.08
2023-03-14,2023-03-14,Office supplies,REF90910298,81.03,0.0,225800.05
2023-03-15,2023-03-15,Service payment - Peterson Ltd,REF13386462,0.0,1845.99,227646.04
2023-03-15,2023-03-15,Business insurance premium,REF76406391,135.82,0.0,227510.22
2023-03-15,2023-03-15,Invoice payment - Davidson and Sons,REF69486982,0.0,920.73,228430.95
2023-03-15,2023-03-15,Invoice payment - Neal-Holden,REF48027918,0.0,1478.43,229909.38
2023-03-22,2023-03-22,Marketing expenses,REF49552874,324.67,0.0,229584.71
2023-03-22,2023-03-22,Professional services,REF60555323,71.77,0.0,229512.94
2023-04-03,2023-04-03,Training/conference,REF12616523,163.24,0.0,229349.7
2023-04-04,2023-04-04,Office supplies,REF71723531,62.66,0.0,229287.04
2023-04-06,2023-04-06,Business travel,REF60738048,178.07,0.0,229108.97
2023-04-09,2023-04-09,Software subscription,REF37773674,141.91,0.0,228967.06
2023-04-14,2023-04-14,Equipment purchase,REF97313216,128.07,0.0,228838.99
2023-04-15,2023-04-15,Business insurance premium,REF57500078,120.67,0.0,228718.32
2023-04-15,2023-04-15,Payment from Davidson and Sons,REF11733530,0.0,723.23,229441.55
2023-04-15,2023-04-15,Service payment - Neal-Holden,REF90086774,0.0,1193.94,230635.49
2023-04-15,2023-04-15,Invoice payment - Peterson Ltd,REF51067029,0.0,1707.75,232343.24
2023-04-17,2023-04-17,Equipment purchase,REF94988829,134.43,0.0,232208.81
2023-04-21,2023-04-21,Office supplies,REF10637774,43.12,0.0,232165.69
2023-04-22,2023-04-22,Office supplies,REF36575699,53.19,0.0,232112.5
2023-04-24,2023-04-24,Office supplies,REF31626530,54.24,0.0,232058.26
2023-04-25,2023-04-25,Office supplies,REF67722681,73.73,0.0,231984.53
2023-04-30,2023-04-30,Marketing expenses,REF91887903,236.03,0.0,231748.5
2023-05-08,2023-05-08,Office supplies,REF57198354,55.53,0.0,231692.97
2023-05-09,2023-05-09,Business travel,REF50088364,128.4,0.0,231564.57
2023-05-09,2023-05-09,Software subscription,REF87289257,151.75,0.0,231412.82
2023-05-10,2023-05-10,Training/conference,REF14828762,104.48,0.0,231308.34
2023-05-11,2023-05-11,Office supplies,REF77439712,25.76,0.0,231282.58
2023-05-12,2023-05-12,Office supplies,REF21141174,41.58,0.0,231241.0
2023-05-13,2023-05-13,Office supplies,REF82318256,34.78,0.0,231206.22
2023-05-13,2023-05-13,Equipment purchase,REF22904830,158.55,0.0,231047.67
2023-05-15,2023-05-15,Office supplies,REF83450018,38.36,0.0,231009.31
2023-05-15,2023-05-15,Service payment - Neal-Holden,REF75244273,0.0,860.17,231869.48
2023-05-15,2023-05-15,Invoice payment - Davidson and Sons,REF70088427,0.0,872.44,232741.92
2023-05-15,2023-05-15,Business insurance premium,REF75847090,114.44,0.0,232627.48
2023-05-19,2023-05-19,Internet and phone service,REF46736477,60.2,0.0,232567.28
2023-05-22,2023-05-22,Professional services,REF97495335,181.67,0.0,232385.61
2023-05-27,2023-05-27,Business travel,REF72476490,91.98,0.0,232293.63
2023-05-27,2023-05-27,Office supplies,REF69545189,49.58,0.0,232244.05
2023-06-09,2023-06-09,Software subscription,REF80415278,149.19,0.0,232094.86
2023-06-12,2023-06-12,Professional services,REF58854125,196.65,0.0,231898.21
2023-06-15,2023-06-15,Invoice payment - Neal-Holden,REF59769507,0.0,1204.48,233102.69
2023-06-15,2023-06-15,Business insurance premium,REF26524861,108.27,0.0,232994.42
2023-06-15,2023-06-15,Service payment - Peterson Ltd,REF80196550,0.0,1425.97,234420.39
2023-06-18,2023-06-18,Professional services,REF22993332,187.12,0.0,234233.27
2023-06-25,2023-06-25,Professional services,REF18721281,31.16,0.0,234202.11
2023-07-02,2023-07-02,Office supplies,REF18635285,50.13,0.0,234151.98
2023-07-07,2023-07-07,Professional services,REF12623509,219.86,0.0,233932.12
2023-07-09,2023-07-09,Business travel,REF63018187,77.3,0.0,233854.82
2023-07-09,2023-07-09,Software subscription,REF52044319,135.05,0.0,233719.77
2023-07-09,2023-07-09,Internet and phone service,REF78593382,97.29,0.0,233622.48
2023-07-10,2023-07-10,Training/conference,REF84756756,102.88,0.0,233519.6
2023-07-10,2023-07-10,Office supplies,REF98811372,22.33,0.0,233497.27
2023-07-13,2023-07-13,Office supplies,REF60259635,39.57,0.0,233457.7
2023-07-15,2023-07-15,Internet and phone service,REF92204153,42.68,0.0,233415.02
2023-07-15,2023-07-15,Project payment - Davidson and Sons,REF91700892,0.0,721.64,234136.66
2023-07-15,2023-07-15,Invoice payment - Neal-Holden,REF42336689,0.0,1016.67,235153.33
2023-07-15,2023-07-15,Business insurance premium,REF55536663,87.68,0.0,235065.65
2023-07-15,2023-07-15,Invoice payment - Peterson Ltd,REF37290970,0.0,1131.69,236197.34
2023-07-21,2023-07-21,Office supplies,REF82002839,45.19,0.0,236152.15
2023-07-24,2023-07-24,Office supplies,REF98345127,53.97,0.0,236098.18
2023-07-30,2023-07-30,Internet and phone service,REF11989210,54.67,0.0,236043.51
2023-07-30,2023-07-30,Training/conference,REF23132930,81.33,0.0,235962.18
2023-08-01,2023-08-01,Marketing expenses,REF65506571,77.96,0.0,235884.22
2023-08-02,2023-08-02,Internet and phone service,REF48650328,62.82,0.0,235821.4
2023-08-03,2023-08-03,Office supplies,REF27865946,44.44,0.0,235776.96
2023-08-06,2023-08-06,Business travel,REF84144057,116.81,0.0,235660.15
2023-08-06,2023-08-06,Professional services,REF47832730,115.73,0.0,235544.42
2023-08-09,2023-08-09,Software subscription,REF26342537,105.79,0.0,235438.63
2023-08-11,2023-08-11,Office supplies,REF37082361,46.18,0.0,235392.45
2023-08-15,2023-08-15,Invoice payment - Neal-Holden,REF45300609,0.0,999.28,236391.73
2023-08-15,2023-08-15,Invoice payment - Davidson and Sons,REF87671604,0.0,689.25,237080.98
2023-08-15,2023-08-15,Business insurance premium,REF70067949,85.81,0.0,236995.17
2023-08-15,2023-08-15,Service payment - Peterson Ltd,REF54308136,0.0,985.87,237981.04
2023-08-24,2023-08-24,Office supplies,REF47549730,11.0,0.0,237970.04
2023-08-26,2023-08-26,Office supplies,REF42492595,31.01,0.0,237939.03
2023-08-27,2023-08-27,Marketing expenses,REF81092329,164.88,0.0,237774.15
2023-08-29,2023-08-29,Office supplies,REF63331086,56.66,0.0,237717.49
2023-09-05,2023-09-05,Marketing expenses,REF37394912,137.83,0.0,237579.66
2023-09-06,2023-09-06,Office supplies,REF59577983,67.1,0.0,237512.56
2023-09-09,2023-09-09,Software subscription,REF81649541,184.45,0.0,237328.11
2023-09-12,2023-09-12,Business travel,REF43710097,198.52,0.0,237129.59
2023-09-14,2023-09-14,Marketing expenses,REF27519381,175.19,0.0,236954.4
2023-09-15,2023-09-15,Invoice payment - Peterson Ltd,REF56168725,0.0,1579.58,238533.98
2023-09-15,2023-09-15,Business insurance premium,REF76897731,146.81,0.0,238387.17
2023-09-15,2023-09-15,Project payment - Davidson and Sons,REF62761221,0.0,1216.12,239603.29
2023-09-17,2023-09-17,Professional services,REF46484054,246.99,0.0,239356.3
2023-09-18,2023-09-18,Professional services,REF68737673,151.95,0.0,239204.35
2023-09-20,2023-09-20,Office supplies,REF16765757,27.05,0.0,239177.3
2023-09-21,2023-09-21,Marketing expenses,REF32272870,182.32,0.0,238994.98
2023-09-24,2023-09-24,Marketing expenses,REF27131954,232.79,0.0,238762.19
2023-09-25,2023-09-25,Professional services,REF45410407,216.25,0.0,238545.94
2023-09-27,2023-09-27,Training/conference,REF33376713,118.19,0.0,238427.75
2023-10-09,2023-10-09,Software subscription,REF38149375,192.49,0.0,238235.26
2023-10-14,2023-10-14,Professional services,REF75564471,407.98,0.0,237827.28
2023-10-15,2023-10-15,Service payment - Davidson and Sons,REF46997117,0.0,1120.7,238947.98
2023-10-15,2023-10-15,Business insurance premium,REF35499405,145.7,0.0,238802.28
2023-10-15,2023-10-15,Service payment - Neal-Holden,REF32733071,0.0,1295.43,240097.71
2023-10-15,2023-10-15,Project payment - Peterson Ltd,REF93472026,0.0,1920.25,242017.96
2023-10-18,2023-10-18,Internet and phone service,REF65542689,66.86,0.0,241951.1
2023-10-18,2023-10-18,Office supplies,REF33706899,75.13,0.0,241875.97
2023-10-21,2023-10-21,Training/conference,REF91175904,117.29,0.0,241758.68
2023-10-21,2023-10-21,Office supplies,REF75873414,56.07,0.0,241702.61
2023-10-27,2023-10-27,Equipment purchase,REF74939983,99.57,0.0,241603.04
2023-10-27,2023-10-27,Marketing expenses,REF58326033,268.94,0.0,241334.1
2023-10-28,2023-10-28,Marketing expenses,REF87648611,273.35,0.0,241060.75
2023-10-31,2023-10-31,Training/conference,REF64342339,102.88,0.0,240957.87
2023-11-01,2023-11-01,Office supplies,REF20252502,82.99,0.0,240874.88
2023-11-05,2023-11-05,Office supplies,REF19180529,75.37,0.0,240799.51
2023-11-06,2023-11-06,Internet and phone service,REF80419350,73.19,0.0,240726.32
2023-11-09,2023-11-09,Software subscription,REF51269835,144.9,0.0,240581.42
2023-11-11,2023-11-11,Office supplies,REF45729002,11.46,0.0,240569.96
2023-11-12,2023-11-12,Office supplies,REF77944102,45.53,0.0,240524.43
2023-11-15,2023-11-15,Business insurance premium,REF77300832,129.44,0.0,240394.99
2023-11-15,2023-11-15,Project payment - Davidson and Sons,REF20928767,0.0,1129.08,241524.07
2023-11-15,2023-11-15,Payment from Neal-Holden,REF52823110,0.0,1311.11,242835.18
2023-11-15,2023-11-15,Service payment - Peterson Ltd,REF56797576,0.0,1715.73,244550.91
2023-11-21,2023-11-21,Marketing expenses,REF21265908,215.89,0.0,244335.02
2023-11-22,2023-11-22,Office supplies,REF70960075,48.32,0.0,244286.7
2023-11-22,2023-11-22,Equipment purchase,REF66074215,90.75,0.0,244195.95
2023-12-05,2023-12-05,Marketing expenses,REF97887170,154.6,0.0,244041.35
2023-12-06,2023-12-06,Office supplies,REF42033331,30.7,0.0,244010.65
2023-12-08,2023-12-08,Internet and phone service,REF22385831,77.22,0.0,243933.43
2023-12-09,2023-12-09,Software subscription,REF11145911,137.1,0.0,243796.33
2023-12-13,2023-12-13,Equipment purchase,REF46249860,114.15,0.0,243682.18
2023-12-15,2023-12-15,Business insurance premium,REF64784699,106.14,0.0,243576.04
2023-12-15,2023-12-15,Payment from Peterson Ltd,REF60417594,0.0,1366.02,244942.06
2023-12-15,2023-12-15,Payment from Davidson and Sons,REF71825442,0.0,820.24,245762.3
2023-12-15,2023-12-15,Service payment - Neal-Holden,REF52459692,0.0,1240.95,247003.25
2023-12-22,2023-12-22,Office supplies,REF92242062,32.62,0.0,246970.63
2023-12-23,2023-12-23,Business travel,REF69871473,119.88,0.0,246850.75
2023-12-24,2023-12-24,Office supplies,REF29880834,41.18,0.0,246809.57
2023-12-25,2023-12-25,Professional services,REF57242594,169.86,0.0,246639.71
2023-12-30,2023-12-30,Equipment purchase,REF14928978,54.74,0.0,246584.97
2024-01-02,2024-01-02,Office supplies,REF46504876,24.85,0.0,246560.12
2024-01-02,2024-01-02,Business travel,REF87765237,153.55,0.0,246406.57
2024-01-05,2024-01-05,Training/conference,REF17101146,39.77,0.0,246366.8
2024-01-07,2024-01-07,Marketing expenses,REF87880321,161.16,0.0,246205.64
2024-01-09,2024-01-09,Software subscription,REF87310536,107.55,0.0,246098.09
2024-01-13,2024-01-13,Office supplies,REF69451955,42.94,0.0,246055.15
2024-01-15,2024-01-15,Business insurance premium,REF66510510,96.64,0.0,245958.51
2024-01-15,2024-01-15,Payment from Peterson Ltd,REF36986188,0.0,1139.94,247098.45
2024-01-15,2024-01-15,Service payment - Davidson and Sons,REF86824728,0.0,760.91,247859.36
2024-01-15,2024-01-15,Project payment - Neal-Holden,REF94834190,0.0,1044.7,248904.06
2024-01-21,2024-01-21,Training/conference,REF36493448,51.7,0.0,248852.36
2024-01-21,2024-01-21,Internet and phone service,REF41046389,84.09,0.0,248768.27
2024-01-22,2024-01-22,Equipment purchase,REF85965891,98.52,0.0,248669.75
2024-01-22,2024-01-22,Business travel,REF39512148,168.93,0.0,248500.82
2024-01-24,2024-01-24,Office supplies,REF11679739,63.72,0.0,248437.1
2024-02-01,2024-02-01,Equipment purchase,REF93647513,86.56,0.0,248350.54
2024-02-03,2024-02-03,Office supplies,REF58325738,51.39,0.0,248299.15
2024-02-05,2024-02-05,Business travel,REF25432008,111.42,0.0,248187.73
2024-02-09,2024-02-09,Software subscription,REF54952501,142.93,0.0,248044.8
2024-02-11,2024-02-11,Business travel,REF19540132,59.81,0.0,247984.99
2024-02-13,2024-02-13,Office supplies,REF82598943,44.33,0.0,247940.66
2024-02-15,2024-02-15,Service payment - Neal-Holden,REF26319336,0.0,942.42,248883.08
2024-02-15,2024-02-15,Invoice payment - Peterson Ltd,REF52689800,0.0,1481.48,250364.56
2024-02-15,2024-02-15,Business insurance premium,REF62570926,93.78,0.0,250270.78
2024-02-15,2024-02-15,Payment from Davidson and Sons,REF86080290,0.0,742.61,251013.39
2024-02-18,2024-02-18,Equipment purchase,REF73672810,94.13,0.0,250919.26
2024-02-24,2024-02-24,Office supplies,REF93361403,50.75,0.0,250868.51
2024-02-25,2024-02-25,Business travel,REF58706085,155.2,0.0,250713.31
2024-02-29,2024-02-29,Internet and phone service,REF28791733,102.35,0.0,250610.96
2024-03-01,2024-03-01,Office supplies,REF79836774,73.19,0.0,250537.77
2024-03-04,2024-03-04,Marketing expenses,REF91323720,274.37,0.0,250263.4
2024-03-08,2024-03-08,Office supplies,REF57718781,35.63,0.0,250227.77
2024-03-09,2024-03-09,Software subscription,REF27833020,158.12,0.0,250069.65
2024-03-14,2024-03-14,Marketing expenses,REF20777828,277.32,0.0,249792.33
2024-03-15,2024-03-15,Invoice payment - Peterson Ltd,REF34903851,0.0,1934.0,251726.33
2024-03-15,2024-03-15,Payment from Davidson and Sons,REF28396568,0.0,1111.99,252838.32
2024-03-15,2024-03-15,Business insurance premium,REF13257108,133.66,0.0,252704.66
2024-03-15,2024-03-15,Project payment - Neal-Holden,REF39644842,0.0,1163.36,253868.02
2024-03-19,2024-03-19,Professional services,REF38949447,234.3,0.0,253633.72
2024-03-20,2024-03-20,Office supplies,REF68105249,57.49,0.0,253576.23
2024-03-24,2024-03-24,Marketing expenses,REF57284011,192.77,0.0,253383.46
2024-03-25,2024-03-25,Office supplies,REF39869702,74.44,0.0,253309.02
2024-04-01,2024-04-01,Internet and phone service,REF85975462,80.28,0.0,253228.74
2024-04-02,2024-04-02,Marketing expenses,REF46487210,172.17,0.0,253056.57
2024-04-03,2024-04-03,Training/conference,REF15607089,84.35,0.0,252972.22
2024-04-09,2024-04-09,Software subscription,REF51444133,146.4,0.0,252825.82
2024-04-13,2024-04-13,Internet and phone service,REF67622748,49.19,0.0,252776.63
2024-04-15,2024-04-15,Invoice payment - Davidson and Sons,REF93842701,0.0,1114.47,253891.1
2024-04-15,2024-04-15,Service payment - Peterson Ltd,REF86732379,0.0,2038.35,255929.45
2024-04-15,2024-04-15,Business insurance premium,REF46211956,124.53,0.0,255804.92
2024-04-15,2024-04-15,Project payment - Neal-Holden,REF26009845,0.0,1178.08,256983.0
2024-04-25,2024-04-25,Office supplies,REF48731473,34.24,0.0,256948.76
2024-04-29,2024-04-29,Office supplies,REF93224691,53.7,0.0,256895.06
2024-04-30,2024-04-30,Office supplies,REF43672527,56.13,0.0,256838.93
2024-05-01,2024-05-01,Office supplies,REF19623846,62.73,0.0,256776.2
2024-05-08,2024-05-08,Training/conference,REF34869081,62.71,0.0,256713.49
2024-05-09,2024-05-09,Software subscription,REF12239341,130.66,0.0,256582.83
2024-05-15,2024-05-15,Business insurance premium,REF46411449,107.52,0.0,256475.31
2024-05-15,2024-05-15,Equipment purchase,REF27104401,65.33,0.0,256409.98
2024-05-15,2024-05-15,Service payment - Davidson and Sons,REF15022395,0.0,869.13,257279.11
2024-05-15,2024-05-15,Project payment - Peterson Ltd,REF88367618,0.0,1761.91,259041.02
2024-05-25,2024-05-25,Equipment purchase,REF29147813,110.11,0.0,258930.91
2024-05-30,2024-05-30,Office supplies,REF41414276,57.33,0.0,258873.58
2024-06-03,2024-06-03,Business travel,REF55867003,195.59,0.0,258677.99
2024-06-04,2024-06-04,Training/conference,REF77979423,150.66,0.0,258527.33
2024-06-06,2024-06-06,Office supplies,REF70737974,41.17,0.0,258486.16
2024-06-07,2024-06-07,Internet and phone service,REF91047356,64.12,0.0,258422.04
2024-06-09,2024-06-09,Software subscription,REF62041467,139.21,0.0,258282.83
2024-06-15,2024-06-15,Business insurance premium,REF76243041,100.64,0.0,258182.19
2024-06-15,2024-06-15,Payment from Peterson Ltd,REF93069903,0.0,912.42,259094.61
2024-06-15,2024-06-15,Payment from Neal-Holden,REF73353084,0.0,1093.67,260188.28
2024-06-15,2024-06-15,Invoice payment - Davidson and Sons,REF72922492,0.0,967.45,261155.73
2024-06-18,2024-06-18,Training/conference,REF78717811,107.46,0.0,261048.27
2024-06-18,2024-06-18,Marketing expenses,REF75153813,153.88,0.0,260894.39
2024-06-19,2024-06-19,Office supplies,REF89696411,37.78,0.0,260856.61
2024-06-23,2024-06-23,Equipment purchase,REF12940724,50.62,0.0,260805.99
2024-06-25,2024-06-25,Marketing expenses,REF74459369,179.07,0.0,260626.92
2024-06-26,2024-06-26,Business travel,REF39757219,181.06,0.0,260445.86
2024-07-01,2024-07-01,Training/conference,REF98465217,77.36,0.0,260368.5
2024-07-04,2024-07-04,Internet and phone service,REF69660563,71.06,0.0,260297.44
2024-07-07,2024-07-07,Office supplies,REF69818811,45.21,0.0,260252.23
2024-07-09,2024-07-09,Software subscription,REF74941567,119.18,0.0,260133.05
2024-07-15,2024-07-15,Business insurance premium,REF37779290,103.96,0.0,260029.09
2024-07-15,2024-07-15,Service payment - Davidson and Sons,REF53316032,0.0,610.67,260639.76
2024-07-15,2024-07-15,Invoice payment - Neal-Holden,REF76179124,0.0,858.01,261497.77
2024-07-15,2024-07-15,Invoice payment - Peterson Ltd,REF69562129,0.0,1187.1,262684.87
2024-08-02,2024-08-02,Marketing expenses,REF43651605,94.29,0.0,262590.58
2024-08-03,2024-08-03,Office supplies,REF71931684,15.48,0.0,262575.1
2024-08-05,2024-08-05,Equipment purchase,REF44351813,79.4,0.0,262495.7
2024-08-07,2024-08-07,Marketing expenses,REF36923617,128.98,0.0,262366.72
2024-08-08,2024-08-08,Equipment purchase,REF51775002,56.05,0.0,262310.67
2024-08-09,2024-08-09,Software subscription,REF62988708,120.97,0.0,262189.7
2024-08-12,2024-08-12,Business travel,REF18459821,91.98,0.0,262097.72
2024-08-12,2024-08-12,Office supplies,REF52486431,49.67,0.0,262048.05
2024-08-15,2024-08-15,Project payment - Davidson and Sons,REF25732964,0.0,459.55,262507.6
2024-08-15,2024-08-15,Business insurance premium,REF63578931,76.95,0.0,262430.65
2024-08-15,2024-08-15,Invoice payment - Peterson Ltd,REF90202728,0.0,1051.37,263482.02
2024-08-15,2024-08-15,Payment from Neal-Holden,REF92150796,0.0,1206.2,264688.22
2014-08-20,2014-08-20,Professional services,REF25079965,266.11,0.0,3908.23
2014-08-21,2014-08-21,Office supplies,REF53897286,25.86,0.0,3882.37
2014-08-23,2014-08-23,Equipment purchase,REF51255573,83.07,0.0,3799.3
2014-08-26,2014-08-26,Business travel,REF48558570,105.88,0.0,3693.42
2014-08-30,2014-08-30,Internet and phone service,REF56194583,59.46,0.0,3633.96
2014-09-01,2014-09-01,Equipment purchase,REF37651410,107.78,0.0,3526.18
2014-09-09,2014-09-09,Software subscription,REF80147490,148.34,0.0,3377.84
2014-09-10,2014-09-10,Marketing expenses,REF10083653,299.81,0.0,3078.03
2014-09-12,2014-09-12,Professional services,REF64337262,201.25,0.0,2876.78
2014-09-13,2014-09-13,Business travel,REF91214248,139.59,0.0,2737.19
2014-09-15,2014-09-15,"Invoice payment - Moss, James and Edwards",REF84361832,0.0,1458.74,4195.93
2014-09-15,2014-09-15,"Project payment - Crosby, Armstrong and Herrera",REF81638871,0.0,1347.38,5543.31
2014-09-15,2014-09-15,"Service payment - Liu, Buchanan and Meyer",REF13491910,0.0,393.88,5937.19
2014-09-15,2014-09-15,Business insurance premium,REF76939466,134.61,0.0,5802.58
2014-09-16,2014-09-16,Office supplies,REF76031080,60.82,0.0,5741.76
2014-09-24,2014-09-24,Marketing expenses,REF51384033,182.32,0.0,5559.44
2014-09-24,2014-09-24,Training/conference,REF21912971,96.36,0.0,5463.08
2014-10-02,2014-10-02,Office supplies,REF60595428,51.81,0.0,5411.27
2014-10-09,2014-10-09,Professional services,REF24376403,327.58,0.0,5083.69
2014-10-09,2014-10-09,Software subscription,REF68937658,184.05,0.0,4899.64
2014-10-15,2014-10-15,"Service payment - Moss, James and Edwards",REF51878123,0.0,1873.24,6772.88
2014-10-15,2014-10-15,Business insurance premium,REF39856285,141.68,0.0,6631.2
2014-10-15,2014-10-15,"Payment from Crosby, Armstrong and Herrera",REF57069965,0.0,1775.48,8406.68
2014-10-15,2014-10-15,"Payment from Liu, Buchanan and Meyer",REF21437730,0.0,377.57,8784.25
2014-10-16,2014-10-16,Office supplies,REF14698349,47.62,0.0,8736.63
2014-10-18,2014-10-18,Business travel,REF61510570,80.75,0.0,8655.88
2014-10-22,2014-10-22,Business travel,REF61173293,132.83,0.0,8523.05
2014-10-23,2014-10-23,Marketing expenses,REF84401600,245.77,0.0,8277.28
2014-10-26,2014-10-26,Internet and phone service,REF30698935,64.65,0.0,8212.63
2014-11-01,2014-11-01,Training/conference,REF65040910,120.8,0.0,8091.83
2014-11-01,2014-11-01,Internet and phone service,REF14169539,66.36,0.0,8025.47
2014-11-02,2014-11-02,Office supplies,REF23838742,36.63,0.0,7988.84
2014-11-08,2014-11-08,Equipment purchase,REF13358397,117.35,0.0,7871.49
2014-11-09,2014-11-09,Software subscription,REF85262963,148.04,0.0,7723.45
2014-11-14,2014-11-14,Internet and phone service,REF84252600,129.36,0.0,7594.09
2014-11-15,2014-11-15,"Service payment - Moss, James and Edwards",REF46975636,0.0,2126.52,9720.61
2014-11-15,2014-11-15,"Project payment - Liu, Buchanan and Meyer",REF88764793,0.0,359.43,10080.04
2014-11-15,2014-11-15,"Project payment - Crosby, Armstrong and Herrera",REF31895400,0.0,1482.85,11562.89
2014-11-15,2014-11-15,Business insurance premium,REF91436385,140.35,0.0,11422.54
2014-11-16,2014-11-16,Business travel,REF57160471,165.32,0.0,11257.22
2014-11-17,2014-11-17,Office supplies,REF27562343,41.05,0.0,11216.17
2014-11-23,2014-11-23,Office supplies,REF75277523,33.81,0.0,11182.36
2014-11-25,2014-11-25,Business travel,REF94514808,146.97,0.0,11035.39
2014-11-27,2014-11-27,Marketing expenses,REF30660669,332.57,0.0,10702.82
2014-11-28,2014-11-28,Business travel,REF14340296,132.97,0.0,10569.85
2014-12-06,2014-12-06,Business travel,REF85681936,244.69,0.0,10325.16
2014-12-08,2014-12-08,Office supplies,REF10102697,36.43,0.0,10288.73
2014-12-09,2014-12-09,Software subscription,REF63417959,121.02,0.0,10167.71
2014-12-10,2014-12-10,Business travel,REF22364417,138.08,0.0,10029.63
2014-12-15,2014-12-15,Business insurance premium,REF26568541,104.51,0.0,9925.12
2014-12-15,2014-12-15,"Service payment - Liu, Buchanan and Meyer",REF25855505,0.0,290.62,10215.74
2014-12-15,2014-12-15,"Invoice payment - Crosby, Armstrong and Herrera",REF48697232,0.0,1294.29,11510.03
2014-12-15,2014-12-15,"Payment from Moss, James and Edwards",REF89027512,0.0,1484.52,12994.55
2014-12-16,2014-12-16,Equipment purchase,REF90191202,102.73,0.0,12891.82
2014-12-16,2014-12-16,Business travel,REF43573522,51.43,0.0,12840.39
2014-12-17,2014-12-17,Office supplies,REF30582438,24.72,0.0,12815.67
2014-12-17,2014-12-17,Training/conference,REF94146871,24.88,0.0,12790.79
2014-12-20,2014-12-20,Internet and phone service,REF59292006,40.27,0.0,12750.52
2014-12-21,2014-12-21,Office supplies,REF97688576,58.4,0.0,12692.12
2015-01-01,2015-01-01,Equipment purchase,REF23577481,72.77,0.0,12619.35
2015-01-06,2015-01-06,Office supplies,REF10324868,37.87,0.0,12581.48
2015-01-09,2015-01-09,Software subscription,REF91913615,134.67,0.0,12446.81
2015-01-12,2015-01-12,Equipment purchase,REF46234227,37.4,0.0,12409.41
2015-01-13,2015-01-13,Office supplies,REF47851579,16.9,0.0,12392.51
2015-01-15,2015-01-15,"Payment from Moss, James and Edwards",REF65745817,0.0,1191.25,13583.76
2015-01-15,2015-01-15,Business insurance premium,REF68532034,102.58,0.0,13481.18
2015-01-15,2015-01-15,"Project payment - Liu, Buchanan and Meyer",REF77330034,0.0,312.07,13793.25
2015-01-21,2015-01-21,Business travel,REF21030269,93.11,0.0,13700.14
2015-01-22,2015-01-22,Professional services,REF14665178,238.41,0.0,13461.73
2015-01-24,2015-01-24,Marketing expenses,REF36686272,232.4,0.0,13229.33
2015-01-26,2015-01-26,Office supplies,REF26991508,33.93,0.0,13195.4
2015-01-28,2015-01-28,Office supplies,REF14426357,50.61,0.0,13144.79
2015-01-31,2015-01-31,Marketing expenses,REF94901434,110.67,0.0,13034.12
2015-02-09,2015-02-09,Marketing expenses,REF64225318,149.54,0.0,12884.58
2015-02-09,2015-02-09,Software subscription,REF14176770,112.59,0.0,12771.99
2015-02-10,2015-02-10,Equipment purchase,REF58459380,96.39,0.0,12675.6
2015-02-11,2015-02-11,Business travel,REF70772425,172.02,0.0,12503.58
2015-02-12,2015-02-12,Office supplies,REF72746534,47.09,0.0,12456.49
2015-02-15,2015-02-15,"Service payment - Moss, James and Edwards",REF92669516,0.0,1160.97,13617.46
2015-02-15,2015-02-15,"Invoice payment - Liu, Buchanan and Meyer",REF70769695,0.0,365.45,13982.91
2015-02-15,2015-02-15,Business insurance premium,REF13068356,109.11,0.0,13873.8
2015-02-15,2015-02-15,"Service payment - Crosby, Armstrong and Herrera",REF25364425,0.0,1398.99,15272.79
2015-02-18,2015-02-18,Training/conference,REF84750818,99.22,0.0,15173.57
2015-02-24,2015-02-24,Professional services,REF21400374,252.61,0.0,14920.96
2015-03-01,2015-03-01,Professional services,REF66120112,241.64,0.0,14679.32
2015-03-05,2015-03-05,Office supplies,REF34596945,39.42,0.0,14639.9
2015-03-09,2015-03-09,Software subscription,REF92623779,154.54,0.0,14485.36
2015-03-10,2015-03-10,Internet and phone service,REF25080447,55.2,0.0,14430.16
2015-03-11,2015-03-11,Professional services,REF44707138,227.63,0.0,14202.53
2015-03-14,2015-03-14,Marketing expenses,REF97934198,242.85,0.0,13959.68
2015-03-15,2015-03-15,Business insurance premium,REF72953521,126.54,0.0,13833.14
2015-03-15,2015-03-15,"Service payment - Crosby, Armstrong and Herrera",REF61905574,0.0,1670.02,15503.16
2015-03-15,2015-03-15,"Invoice payment - Liu, Buchanan and Meyer",REF45147583,0.0,389.24,15892.4
2015-03-15,2015-03-15,Equipment purchase,REF25936093,162.85,0.0,15729.55
2015-03-19,2015-03-19,Professional services,REF17050522,299.84,0.0,15429.71
2015-03-22,2015-03-22,Office supplies,REF11057067,46.3,0.0,15383.41
2015-03-23,2015-03-23,Office supplies,REF41330113,60.61,0.0,15322.8
2015-03-24,2015-03-24,Professional services,REF20956889,183.93,0.0,15138.87
2015-03-24,2015-03-24,Business travel,REF65097867,237.29,0.0,14901.58
2015-03-26,2015-03-26,Marketing expenses,REF75080357,151.58,0.0,14750.0
2015-04-04,2015-04-04,Office supplies,REF83739590,69.49,0.0,14680.51
2015-04-06,2015-04-06,Office supplies,REF71570785,53.64,0.0,14626.87
2015-04-07,2015-04-07,Equipment purchase,REF33940975,110.14,0.0,14516.73
2015-04-09,2015-04-09,Software subscription,REF89840509,154.48,0.0,14362.25
2015-04-10,2015-04-10,Marketing expenses,REF51453926,185.68,0.0,14176.57
2015-04-15,2015-04-15,Business insurance premium,REF19357730,129.65,0.0,14046.92
2015-04-15,2015-04-15,Business travel,REF54475859,134.35,0.0,13912.57
2015-04-15,2015-04-15,"Project payment - Liu, Buchanan and Meyer",REF19112293,0.0,392.27,14304.84
2015-04-15,2015-04-15,"Invoice payment - Crosby, Armstrong and Herrera",REF35796604,0.0,1616.83,15921.67
2015-04-16,2015-04-16,Office supplies,REF75189018,70.55,0.0,15851.12
2015-04-18,2015-04-18,Office supplies,REF96939821,36.33,0.0,15814.79
2015-04-20,2015-04-20,Marketing expenses,REF35266741,212.35,0.0,15602.44
2015-04-23,2015-04-23,Office supplies,REF28559615,78.04,0.0,15524.4
2015-04-24,2015-04-24,Business travel,REF99607364,164.91,0.0,15359.49
2015-04-26,2015-04-26,Business travel,REF77492048,136.75,0.0,15222.74
2015-04-30,2015-04-30,Internet and phone service,REF40834142,77.48,0.0,15145.26
2015-05-03,2015-05-03,Training/conference,REF47860722,139.02,0.0,15006.24
2015-05-05,2015-05-05,Office supplies,REF98391222,59.16,0.0,14947.08
2015-05-05,2015-05-05,Professional services,REF49062524,263.06,0.0,14684.02
2015-05-06,2015-05-06,Training/conference,REF50908156,80.4,0.0,14603.62
2015-05-09,2015-05-09,Software subscription,REF63972632,154.63,0.0,14448.99
2015-05-15,2015-05-15,"Service payment - Moss, James and Edwards",REF54972592,0.0,1351.69,15800.68
2015-05-15,2015-05-15,Business insurance premium,REF82204856,126.14,0.0,15674.54
2015-05-15,2015-05-15,"Service payment - Crosby, Armstrong and Herrera",REF46901998,0.0,1074.31,16748.85
2015-05-15,2015-05-15,"Invoice payment - Liu, Buchanan and Meyer",REF50585947,0.0,333.39,17082.24
2015-05-16,2015-05-16,Business travel,REF35044127,220.38,0.0,16861.86
2015-05-18,2015-05-18,Equipment purchase,REF96475213,127.95,0.0,16733.91
2015-05-19,2015-05-19,Internet and phone service,REF94368715,34.57,0.0,16699.34
2015-05-20,2015-05-20,Business travel,REF61356298,146.32,0.0,16553.02
2015-05-22,2015-05-22,Professional services,REF78557438,174.59,0.0,16378.43
2015-05-26,2015-05-26,Training/conference,REF19992356,98.06,0.0,16280.37
2015-05-27,2015-05-27,Professional services,REF26856395,179.4,0.0,16100.97
2015-05-29,2015-05-29,Internet and phone service,REF56363513,119.7,0.0,15981.27
2015-06-08,2015-06-08,Equipment purchase,REF20626436,98.89,0.0,15882.38
2015-06-08,2015-06-08,Office supplies,REF68594291,17.51,0.0,15864.87
2015-06-09,2015-06-09,Software subscription,REF87607333,152.89,0.0,15711.98
2015-06-09,2015-06-09,Training/conference,REF32826459,129.77,0.0,15582.21
2015-06-11,2015-06-11,Equipment purchase,REF49201052,127.5,0.0,15454.71
2015-06-15,2015-06-15,"Invoice payment - Moss, James and Edwards",REF74288560,0.0,1079.25,16533.96
2015-06-15,2015-06-15,"Invoice payment - Crosby, Armstrong and Herrera",REF38391027,0.0,825.01,17358.97
2015-06-15,2015-06-15,"Payment from Liu, Buchanan and Meyer",REF87537692,0.0,386.91,17745.88
2015-06-15,2015-06-15,Business insurance premium,REF19554645,117.63,0.0,17628.25
2015-06-16,2015-06-16,Marketing expenses,REF52085043,261.18,0.0,17367.07
2015-06-17,2015-06-17,Business travel,REF65026677,173.13,0.0,17193.94
2015-06-26,2015-06-26,Training/conference,REF11857228,68.66,0.0,17125.28
2015-06-26,2015-06-26,Office supplies,REF93585581,49.72,0.0,17075.56
2015-06-27,2015-06-27,Internet and phone service,REF21541319,48.93,0.0,17026.63
2015-06-29,2015-06-29,Professional services,REF55016381,258.18,0.0,16768.45
2015-06-30,2015-06-30,Business travel,REF59239476,166.09,0.0,16602.36
2015-07-01,2015-07-01,Office supplies,REF79439827,26.7,0.0,16575.66
2015-07-04,2015-07-04,Business travel,REF25818068,119.47,0.0,16456.19
2015-07-05,2015-07-05,Business travel,REF95930112,191.1,0.0,16265.09
2015-07-09,2015-07-09,Software subscription,REF82016458,120.34,0.0,16144.75
2015-07-12,2015-07-12,Office supplies,REF20276435,51.78,0.0,16092.97
2015-07-12,2015-07-12,Business travel,REF48051655,159.93,0.0,15933.04
2015-07-15,2015-07-15,Professional services,REF76437785,270.59,0.0,15662.45
2015-07-15,2015-07-15,"Project payment - Moss, James and Edwards",REF42333115,0.0,1373.47,17035.92
2015-07-15,2015-07-15,Business insurance premium,REF72647760,97.45,0.0,16938.47
2015-07-15,2015-07-15,"Invoice payment - Liu, Buchanan and Meyer",REF12600544,0.0,255.78,17194.25
2015-07-17,2015-07-17,Training/conference,REF59164500,26.38,0.0,17167.87
2015-07-21,2015-07-21,Office supplies,REF77224322,40.92,0.0,17126.95
2015-07-22,2015-07-22,Office supplies,REF43108286,35.68,0.0,17091.27
2015-07-23,2015-07-23,Office supplies,REF19990754,53.16,0.0,17038.11
2015-08-04,2015-08-04,Training/conference,REF54348150,68.22,0.0,16969.89
2015-08-05,2015-08-05,Equipment purchase,REF36680976,101.79,0.0,16868.1
2015-08-09,2015-08-09,Software subscription,REF57681617,91.02,0.0,16777.08
2015-08-14,2015-08-14,Training/conference,REF73991555,23.4,0.0,16753.68
2015-08-15,2015-08-15,"Project payment - Crosby, Armstrong and Herrera",REF71599100,0.0,920.07,17673.75
2015-08-15,2015-08-15,"Invoice payment - Liu, Buchanan and Meyer",REF92184758,0.0,261.15,17934.9
2015-08-15,2015-08-15,"Project payment - Moss, James and Edwards",REF41944454,0.0,1221.44,19156.34
2015-08-15,2015-08-15,Business insurance premium,REF94669486,84.64,0.0,19071.7
2015-08-16,2015-08-16,Business travel,REF83279543,124.08,0.0,18947.62
2015-08-21,2015-08-21,Office supplies,REF75128566,41.84,0.0,18905.78
2015-08-22,2015-08-22,Business travel,REF87549231,112.3,0.0,18793.48
2015-08-25,2015-08-25,Internet and phone service,REF71249203,17.97,0.0,18775.51
2015-08-27,2015-08-27,Office supplies,REF73322306,24.83,0.0,18750.68
2015-08-29,2015-08-29,Internet and phone service,REF61818481,63.15,0.0,18687.53
2015-08-31,2015-08-31,Business travel,REF40593393,111.91,0.0,18575.62
2015-09-02,2015-09-02,Marketing expenses,REF13994070,233.82,0.0,18341.8
2015-09-09,2015-09-09,Software subscription,REF89917554,156.55,0.0,18185.25
2015-09-10,2015-09-10,Training/conference,REF70292475,51.92,0.0,18133.33
2015-09-11,2015-09-11,Office supplies,REF15112509,53.21,0.0,18080.12
2015-09-12,2015-09-12,Training/conference,REF90453017,151.55,0.0,17928.57
2015-09-13,2015-09-13,Training/conference,REF39905052,94.61,0.0,17833.96
2015-09-14,2015-09-14,Equipment purchase,REF66039834,114.14,0.0,17719.82
2015-09-15,2015-09-15,Business insurance premium,REF31239615,125.64,0.0,17594.18
2015-09-15,2015-09-15,Business travel,REF52990961,183.26,0.0,17410.92
2015-09-15,2015-09-15,"Service payment - Liu, Buchanan and Meyer",REF36513568,0.0,426.88,17837.8
2015-09-15,2015-09-15,"Payment from Moss, James and Edwards",REF81154634,0.0,1469.7,19307.5
2015-09-15,2015-09-15,"Invoice payment - Crosby, Armstrong and Herrera",REF34836501,0.0,1481.9,20789.4
2015-09-19,2015-09-19,Training/conference,REF53731315,127.39,0.0,20662.01
2015-09-20,2015-09-20,Business travel,REF25947027,198.4,0.0,20463.61
2015-09-23,2015-09-23,Internet and phone service,REF88554416,95.77,0.0,20367.84
2015-09-24,2015-09-24,Marketing expenses,REF82322957,291.19,0.0,20076.65
2015-09-26,2015-09-26,Office supplies,REF83815849,76.2,0.0,20000.45
2015-10-01,2015-10-01,Training/conference,REF83460862,105.56,0.0,19894.89
2015-10-09,2015-10-09,Software subscription,REF91376197,191.07,0.0,19703.82
2015-10-09,2015-10-09,Business travel,REF11708388,199.82,0.0,19504.0
2015-10-13,2015-10-13,Office supplies,REF99741112,74.78,0.0,19429.22
2015-10-13,2015-10-13,Marketing expenses,REF91170584,215.85,0.0,19213.37
2015-10-14,2015-10-14,Professional services,REF11983672,243.49,0.0,18969.88
2015-10-15,2015-10-15,Business insurance premium,REF62336430,156.95,0.0,18812.93
2015-10-15,2015-10-15,"Invoice payment - Moss, James and Edwards",REF73498946,0.0,1494.98,20307.91
2015-10-15,2015-10-15,"Project payment - Crosby, Armstrong and Herrera",REF38973540,0.0,1797.3,22105.21
2015-10-15,2015-10-15,"Service payment - Liu, Buchanan and Meyer",REF71707172,0.0,393.42,22498.63
2015-10-16,2015-10-16,Marketing expenses,REF88052865,174.71,0.0,22323.92
2015-10-19,2015-10-19,Office supplies,REF57309428,62.25,0.0,22261.67
2015-10-20,2015-10-20,Professional services,REF99019155,227.99,0.0,22033.68
2015-10-24,2015-10-24,Business travel,REF88962687,194.9,0.0,21838.78
2015-11-01,2015-11-01,Office supplies,REF34160719,37.4,0.0,21801.38
2015-11-02,2015-11-02,Training/conference,REF29601873,78.7,0.0,21722.68
2015-11-02,2015-11-02,Equipment purchase,REF87213954,109.01,0.0,21613.67
2015-11-09,2015-11-09,Software subscription,REF82173277,167.02,0.0,21446.65
2015-11-11,2015-11-11,Equipment purchase,REF41762236,112.72,0.0,21333.93
2015-11-15,2015-11-15,"Payment from Crosby, Armstrong and Herrera",REF67572529,0.0,1816.42,23150.35
2015-11-15,2015-11-15,Business insurance premium,REF99581038,133.76,0.0,23016.59
2015-11-16,2015-11-16,Office supplies,REF59684853,52.4,0.0,22964.19
2015-11-18,2015-11-18,Office supplies,REF99350862,27.56,0.0,22936.63
2015-11-19,2015-11-19,Professional services,REF11534131,281.41,0.0,22655.22
2015-11-19,2015-11-19,Office supplies,REF63900204,31.52,0.0,22623.7
2015-11-20,2015-11-20,Office supplies,REF92241120,37.18,0.0,22586.52
2015-11-26,2015-11-26,Professional services,REF11286936,387.87,0.0,22198.65
2015-12-01,2015-12-01,Internet and phone service,REF79201761,5.0,0.0,22193.65
2015-12-03,2015-12-03,Internet and phone service,REF93272463,62.04,0.0,22131.61
2015-12-06,2015-12-06,Equipment purchase,REF84012461,104.83,0.0,22026.78
2015-12-09,2015-12-09,Software subscription,REF20827689,139.95,0.0,21886.83
2015-12-12,2015-12-12,Internet and phone service,REF29782757,60.06,0.0,21826.77
2015-12-13,2015-12-13,Training/conference,REF36793948,92.64,0.0,21734.13
2015-12-15,2015-12-15,Office supplies,REF13016686,39.02,0.0,21695.11
2015-12-15,2015-12-15,"Project payment - Liu, Buchanan and Meyer",REF48784820,0.0,400.88,22095.99
2015-12-15,2015-12-15,"Project payment - Moss, James and Edwards",REF79148221,0.0,1698.06,23794.05
2015-12-15,2015-12-15,Business insurance premium,REF21190102,109.71,0.0,23684.34
2015-12-17,2015-12-17,Internet and phone service,REF15504441,67.26,0.0,23617.08
2015-12-18,2015-12-18,Training/conference,REF24016852,61.37,0.0,23555.71
2015-12-23,2015-12-23,Business travel,REF76476842,137.73,0.0,23417.98
2015-12-24,2015-12-24,Office supplies,REF83785474,35.01,0.0,23382.97
2015-12-26,2015-12-26,Business travel,REF57959464,152.96,0.0,23230.01
2016-01-07,2016-01-07,Marketing expenses,REF31870748,207.9,0.0,23022.11
2016-01-09,2016-01-09,Software subscription,REF21135793,124.74,0.0,22897.37
2016-01-10,2016-01-10,Office supplies,REF11218621,33.89,0.0,22863.48
2016-01-13,2016-01-13,Equipment purchase,REF11698739,44.75,0.0,22818.73
2016-01-15,2016-01-15,"Payment from Moss, James and Edwards",REF37452373,0.0,1157.21,23975.94
2016-01-15,2016-01-15,"Payment from Crosby, Armstrong and Herrera",REF87636310,0.0,1194.33,25170.27
2016-01-15,2016-01-15,Office supplies,REF61559343,11.95,0.0,25158.32
2016-01-15,2016-01-15,"Project payment - Liu, Buchanan and Meyer",REF81763459,0.0,324.65,25482.97
2016-01-15,2016-01-15,Business insurance premium,REF45013047,94.17,0.0,25388.8
2016-01-18,2016-01-18,Office supplies,REF95080775,31.91,0.0,25356.89
2016-01-22,2016-01-22,Office supplies,REF97371681,29.61,0.0,25327.28
2016-01-29,2016-01-29,Equipment purchase,REF32708706,88.71,0.0,25238.57
2016-01-29,2016-01-29,Internet and phone service,REF75449701,47.75,0.0,25190.82
2016-01-31,2016-01-31,Office supplies,REF78000581,33.94,0.0,25156.88
2016-02-01,2016-02-01,Marketing expenses,REF52333984,48.91,0.0,25107.97
2016-02-04,2016-02-04,Equipment purchase,REF26481615,84.81,0.0,25023.16
2016-02-04,2016-02-04,Office supplies,REF27677377,37.96,0.0,24985.2
2016-02-09,2016-02-09,Software subscription,REF63373896,130.65,0.0,24854.55
2016-02-15,2016-02-15,Business insurance premium,REF37827981,114.67,0.0,24739.88
2016-02-15,2016-02-15,"Invoice payment - Moss, James and Edwards",REF50964826,0.0,1349.91,26089.79
2016-02-15,2016-02-15,"Service payment - Crosby, Armstrong and Herrera",REF41178428,0.0,1514.2,27603.99
2016-02-18,2016-02-18,Business travel,REF40117299,132.57,0.0,27471.42
2016-02-20,2016-02-20,Business travel,REF57896582,183.87,0.0,27287.55
2016-02-23,2016-02-23,Office supplies,REF11151597,59.32,0.0,27228.23
2016-02-24,2016-02-24,Equipment purchase,REF56606735,93.4,0.0,27134.83
2016-02-27,2016-02-27,Business travel,REF85226060,122.3,0.0,27012.53
2016-02-27,2016-02-27,Office supplies,REF63125683,50.19,0.0,26962.34
2016-03-07,2016-03-07,Internet and phone service,REF88250887,72.7,0.0,26889.64
2016-03-07,2016-03-07,Office supplies,REF37969635,66.61,0.0,26823.03
2016-03-09,2016-03-09,Software subscription,REF22535074,179.54,0.0,26643.49
2016-03-12,2016-03-12,Office supplies,REF26753234,64.22,0.0,26579.27
2016-03-14,2016-03-14,Professional services,REF95354373,301.02,0.0,26278.25
2016-03-15,2016-03-15,Business insurance premium,REF67594208,122.19,0.0,26156.06
2016-03-15,2016-03-15,Business travel,REF98675150,134.22,0.0,26021.84
2016-03-15,2016-03-15,"Invoice payment - Moss, James and Edwards",REF86933292,0.0,1584.23,27606.07
2016-03-15,2016-03-15,"Project payment - Liu, Buchanan and Meyer",REF63477180,0.0,377.54,27983.61
2016-03-15,2016-03-15,"Invoice payment - Crosby, Armstrong and Herrera",REF63261407,0.0,2001.41,29985.02
2016-03-16,2016-03-16,Equipment purchase,REF42775199,149.85,0.0,29835.17
2016-03-21,2016-03-21,Business travel,REF63946603,167.84,0.0,29667.33
2016-04-03,2016-04-03,Office supplies,REF34221847,58.41,0.0,29608.92
2016-04-08,2016-04-08,Office supplies,REF25679598,59.33,0.0,29549.59
2016-04-09,2016-04-09,Professional services,REF56248210,292.22,0.0,29257.37
2016-04-09,2016-04-09,Software subscription,REF19418710,150.1,0.0,29107.27
2016-04-15,2016-04-15,"Service payment - Moss, James and Edwards",REF64883775,0.0,1374.31,30481.58
2016-04-15,2016-04-15,"Invoice payment - Crosby, Armstrong and Herrera",REF91946797,0.0,1516.88,31998.46
2016-04-15,2016-04-15,Business insurance premium,REF59569672,105.11,0.0,31893.35
2016-04-15,2016-04-15,"Payment from Liu, Buchanan and Meyer",REF53890237,0.0,259.93,32153.28
2016-04-23,2016-04-23,Professional services,REF80786149,86.63,0.0,32066.65
2016-04-23,2016-04-23,Office supplies,REF70461051,55.17,0.0,32011.48
2016-04-26,2016-04-26,Office supplies,REF90908329,40.58,0.0,31970.9
2016-04-26,2016-04-26,Equipment purchase,REF45293980,145.01,0.0,31825.89
2016-04-30,2016-04-30,Professional services,REF96657697,362.56,0.0,31463.33
2016-05-02,2016-05-02,Marketing expenses,REF94921945,156.03,0.0,31307.3
2016-05-09,2016-05-09,Software subscription,REF69634733,173.11,0.0,31134.19
2016-05-09,2016-05-09,Equipment purchase,REF54293225,136.44,0.0,30997.75
2016-05-12,2016-05-12,Equipment purchase,REF96240833,133.54,0.0,30864.21
2016-05-12,2016-05-12,Office supplies,REF88948982,44.22,0.0,30819.99
2016-05-13,2016-05-13,Business travel,REF26977009,160.19,0.0,30659.8
2016-05-15,2016-05-15,"Service payment - Crosby, Armstrong and Herrera",REF76542247,0.0,1280.2,31940.0
2016-05-15,2016-05-15,Business insurance premium,REF21950012,130.8,0.0,31809.2
2016-05-15,2016-05-15,"Payment from Moss, James and Edwards",REF65254387,0.0,1645.32,33454.52
2016-05-15,2016-05-15,"Service payment - Liu, Buchanan and Meyer",REF59682230,0.0,358.41,33812.93
2016-05-16,2016-05-16,Business travel,REF58799592,165.96,0.0,33646.97
2016-06-06,2016-06-06,Training/conference,REF39896061,100.25,0.0,33546.72
2016-06-07,2016-06-07,Internet and phone service,REF35201128,58.96,0.0,33487.76
2016-06-09,2016-06-09,Software subscription,REF35749905,151.76,0.0,33336.0
2016-06-10,2016-06-10,Office supplies,REF76262823,21.14,0.0,33314.86
2016-06-13,2016-06-13,Equipment purchase,REF98543165,29.94,0.0,33284.92
2016-06-15,2016-06-15,"Invoice payment - Moss, James and Edwards",REF35400116,0.0,1568.19,34853.11
2016-06-15,2016-06-15,"Payment from Crosby, Armstrong and Herrera",REF89695695,0.0,1312.16,36165.27
2016-06-15,2016-06-15,"Payment from Liu, Buchanan and Meyer",REF12139638,0.0,203.36,36368.63
2016-06-15,2016-06-15,Business insurance premium,REF63768730,121.2,0.0,36247.43
2016-06-17,2016-06-17,Internet and phone service,REF12979905,94.97,0.0,36152.46
2016-06-17,2016-06-17,Office supplies,REF50541714,21.18,0.0,36131.28
2016-06-17,2016-06-17,Marketing expenses,REF70718533,266.3,0.0,35864.98
2016-06-18,2016-06-18,Professional services,REF95711775,160.75,0.0,35704.23
2016-06-22,2016-06-22,Business travel,REF47785038,111.5,0.0,35592.73
2016-07-01,2016-07-01,Business travel,REF98161712,149.92,0.0,35442.81
2016-07-04,2016-07-04,Professional services,REF70722181,171.23,0.0,35271.58
2016-07-05,2016-07-05,Training/conference,REF49738151,83.18,0.0,35188.4
2016-07-09,2016-07-09,Software subscription,REF53786844,119.11,0.0,35069.29
2016-07-09,2016-07-09,Marketing expenses,REF15931599,137.42,0.0,34931.87
2016-07-13,2016-07-13,Business travel,REF79986702,78.04,0.0,34853.83
2016-07-14,2016-07-14,Professional services,REF52820522,190.55,0.0,34663.28
2016-07-15,2016-07-15,Business insurance premium,REF31785229,98.9,0.0,34564.38
2016-07-15,2016-07-15,"Invoice payment - Crosby, Armstrong and Herrera",REF52399459,0.0,1106.82,35671.2
2016-07-15,2016-07-15,"Service payment - Liu, Buchanan and Meyer",REF75157456,0.0,236.74,35907.94
2016-07-15,2016-07-15,"Service payment - Moss, James and Edwards",REF52496418,0.0,866.31,36774.25
2016-07-16,2016-07-16,Business travel,REF46525624,147.11,0.0,36627.14
2016-07-16,2016-07-16,Office supplies,REF82151123,53.28,0.0,36573.86
2016-07-18,2016-07-18,Office supplies,REF79885592,54.88,0.0,36518.98
2016-07-19,2016-07-19,Office supplies,REF32146960,30.1,0.0,36488.88
2016-08-02,2016-08-02,Internet and phone service,REF61610116,66.68,0.0,36422.2
2016-08-02,2016-08-02,Office supplies,REF33142637,47.18,0.0,36375.02
2016-08-04,2016-08-04,Office supplies,REF70376317,36.16,0.0,36338.86
2016-08-05,2016-08-05,Professional services,REF35135325,108.52,0.0,36230.34
2016-08-07,2016-08-07,Office supplies,REF54209353,27.83,0.0,36202.51
2016-08-09,2016-08-09,Software subscription,REF68953518,91.34,0.0,36111.17
2016-08-09,2016-08-09,Business travel,REF46629945,144.32,0.0,35966.85
2016-08-15,2016-08-15,"Service payment - Crosby, Armstrong and Herrera",REF34468799,0.0,988.8,36955.65
2016-08-15,2016-08-15,"Payment from Moss, James and Edwards",REF72878021,0.0,1272.57,38228.22
2016-08-15,2016-08-15,"Project payment - Liu, Buchanan and Meyer",REF28639777,0.0,198.64,38426.86
2016-08-15,2016-08-15,Business insurance premium,REF82107776,88.61,0.0,38338.25
2016-08-16,2016-08-16,Internet and phone service,REF12657869,48.67,0.0,38289.58
2016-08-17,2016-08-17,Professional services,REF54297475,136.77,0.0,38152.81
2016-08-22,2016-08-22,Business travel,REF30572559,104.19,0.0,38048.62
2016-08-24,2016-08-24,Office supplies,REF74964062,33.88,0.0,38014.74
2016-08-25,2016-08-25,Equipment purchase,REF61815833,87.43,0.0,37927.31
2016-08-25,2016-08-25,Marketing expenses,REF13168352,59.19,0.0,37868.12
2016-08-31,2016-08-31,Internet and phone service,REF51979987,68.35,0.0,37799.77
2016-09-01,2016-09-01,Professional services,REF66279721,182.91,0.0,37616.86
2016-09-05,2016-09-05,Marketing expenses,REF34958231,359.37,0.0,37257.49
2016-09-09,2016-09-09,Office supplies,REF91616372,63.9,0.0,37193.59
2016-09-09,2016-09-09,Software subscription,REF49479740,159.9,0.0,37033.69
2016-09-09,2016-09-09,Professional services,REF57420577,285.8,0.0,36747.89
2016-09-10,2016-09-10,Business travel,REF71980862,107.26,0.0,36640.63
2016-09-15,2016-09-15,"Invoice payment - Liu, Buchanan and Meyer",REF41527140,0.0,412.34,37052.97
2016-09-15,2016-09-15,"Invoice payment - Crosby, Armstrong and Herrera",REF80072505,0.0,1350.12,38403.09
2016-09-15,2016-09-15,Business insurance premium,REF84725629,125.65,0.0,38277.44
2016-09-19,2016-09-19,Office supplies,REF33065992,37.3,0.0,38240.14
2016-09-19,2016-09-19,Training/conference,REF73852625,110.87,0.0,38129.27
2016-09-20,2016-09-20,Marketing expenses,REF12736698,196.46,0.0,37932.81
2016-09-24,2016-09-24,Professional services,REF75496930,197.76,0.0,37735.05
2016-09-28,2016-09-28,Office supplies,REF85226118,60.33,0.0,37674.72
2016-09-30,2016-09-30,Office supplies,REF62553553,106.46,0.0,37568.26
2016-10-04,2016-10-04,Training/conference,REF86999478,74.2,0.0,37494.06
2016-10-09,2016-10-09,Software subscription,REF37509663,148.91,0.0,37345.15
2016-10-09,2016-10-09,Office supplies,REF88831034,38.18,0.0,37306.97
2016-10-11,2016-10-11,Training/conference,REF53184874,169.86,0.0,37137.11
2016-10-14,2016-10-14,Office supplies,REF78351441,101.17,0.0,37035.94
2016-10-15,2016-10-15,"Invoice payment - Moss, James and Edwards",REF77390991,0.0,1633.03,38668.97
2016-10-15,2016-10-15,"Payment from Liu, Buchanan and Meyer",REF49596834,0.0,482.8,39151.77
2016-10-15,2016-10-15,"Project payment - Crosby, Armstrong and Herrera",REF58916311,0.0,2294.65,41446.42
2016-10-15,2016-10-15,Business insurance premium,REF62160271,149.59,0.0,41296.83
2016-10-20,2016-10-20,Business travel,REF53921333,113.6,0.0,41183.23
2016-10-22,2016-10-22,Marketing expenses,REF89124530,292.1,0.0,40891.13
2016-10-29,2016-10-29,Internet and phone service,REF19436782,19.55,0.0,40871.58
2016-10-30,2016-10-30,Equipment purchase,REF69190010,126.61,0.0,40744.97
2016-11-05,2016-11-05,Equipment purchase,REF72020931,109.24,0.0,40635.73
2016-11-09,2016-11-09,Software subscription,REF96998714,217.72,0.0,40418.01
2016-11-15,2016-11-15,"Project payment - Liu, Buchanan and Meyer",REF31134304,0.0,448.72,40866.73
2016-11-15,2016-11-15,Business insurance premium,REF65931493,121.54,0.0,40745.19
2016-11-15,2016-11-15,"Project payment - Crosby, Armstrong and Herrera",REF82253065,0.0,1207.65,41952.84
2016-11-15,2016-11-15,"Service payment - Moss, James and Edwards",REF44205936,0.0,1365.08,43317.92
2016-11-17,2016-11-17,Office supplies,REF70462828,63.58,0.0,43254.34
2016-11-17,2016-11-17,Training/conference,REF81543961,149.35,0.0,43104.99
2016-11-18,2016-11-18,Professional services,REF30170169,139.79,0.0,42965.2
2016-11-20,2016-11-20,Training/conference,REF59080783,102.9,0.0,42862.3
2016-11-24,2016-11-24,Business travel,REF99727503,195.08,0.0,42667.22
2016-11-25,2016-11-25,Office supplies,REF83012951,61.79,0.0,42605.43
2016-12-09,2016-12-09,Software subscription,REF97969549,119.12,0.0,42486.31
2016-12-11,2016-12-11,Office supplies,REF57356367,49.27,0.0,42437.04
2016-12-11,2016-12-11,Equipment purchase,REF95968110,56.13,0.0,42380.91
2016-12-15,2016-12-15,Business insurance premium,REF24444112,111.52,0.0,42269.39
2016-12-15,2016-12-15,"Service payment - Liu, Buchanan and Meyer",REF79341900,0.0,282.54,42551.93
2016-12-15,2016-12-15,"Service payment - Crosby, Armstrong and Herrera",REF76117921,0.0,1244.84,43796.77
2016-12-15,2016-12-15,"Payment from Moss, James and Edwards",REF41519226,0.0,1495.03,45291.8
2016-12-17,2016-12-17,Office supplies,REF46876842,31.69,0.0,45260.11
2016-12-20,2016-12-20,Office supplies,REF61608081,77.7,0.0,45182.41
2016-12-23,2016-12-23,Business travel,REF50054088,56.24,0.0,45126.17
2016-12-23,2016-12-23,Training/conference,REF18072751,121.51,0.0,45004.66
2017-01-06,2017-01-06,Office supplies,REF95517728,29.92,0.0,44974.74
2017-01-07,2017-01-07,Business travel,REF57485161,86.42,0.0,44888.32
2017-01-07,2017-01-07,Office supplies,REF74949938,48.3,0.0,44840.02
2017-01-09,2017-01-09,Software subscription,REF92344243,125.6,0.0,44714.42
2017-01-10,2017-01-10,Marketing expenses,REF79636705,234.71,0.0,44479.71
2017-01-12,2017-01-12,Business travel,REF52280413,128.01,0.0,44351.7
2017-01-15,2017-01-15,"Invoice payment - Liu, Buchanan and Meyer",REF74587299,0.0,284.35,44636.05
2017-01-15,2017-01-15,"Invoice payment - Moss, James and Edwards",REF54250174,0.0,1427.12,46063.17
2017-01-15,2017-01-15,"Project payment - Crosby, Armstrong and Herrera",REF83333156,0.0,1106.28,47169.45
2017-01-15,2017-01-15,Business travel,REF18440129,154.35,0.0,47015.1
2017-01-15,2017-01-15,Business insurance premium,REF15144441,93.81,0.0,46921.29
2017-01-16,2017-01-16,Office supplies,REF53968199,22.98,0.0,46898.31
2017-01-18,2017-01-18,Marketing expenses,REF27849306,230.29,0.0,46668.02
2017-01-23,2017-01-23,Office supplies,REF10099229,44.44,0.0,46623.58
2017-01-25,2017-01-25,Office supplies,REF37514069,49.11,0.0,46574.47
2017-01-25,2017-01-25,Professional services,REF30032157,269.38,0.0,46305.09
2017-01-27,2017-01-27,Equipment purchase,REF32553126,85.57,0.0,46219.52
2017-01-30,2017-01-30,Equipment purchase,REF94078212,102.32,0.0,46117.2
2017-02-02,2017-02-02,Office supplies,REF16928485,41.4,0.0,46075.8
2017-02-04,2017-02-04,Training/conference,REF19092160,88.09,0.0,45987.71
2017-02-05,2017-02-05,Internet and phone service,REF52674976,44.25,0.0,45943.46
2017-02-09,2017-02-09,Software subscription,REF36977270,110.41,0.0,45833.05
2017-02-15,2017-02-15,Business insurance premium,REF84386247,116.12,0.0,45716.93
2017-02-15,2017-02-15,"Invoice payment - Liu, Buchanan and Meyer",REF40299334,0.0,202.6,45919.53
2017-02-15,2017-02-15,"Payment from Crosby, Armstrong and Herrera",REF67712409,0.0,970.01,46889.54
2017-02-15,2017-02-15,"Service payment - Moss, James and Edwards",REF73389486,0.0,1736.19,48625.73
2017-02-16,2017-02-16,Office supplies,REF72388401,47.07,0.0,48578.66
2017-02-19,2017-02-19,Office supplies,REF63085990,48.09,0.0,48530.57
2017-03-09,2017-03-09,Software subscription,REF84063628,143.23,0.0,48387.34
2017-03-13,2017-03-13,Office supplies,REF77805051,56.66,0.0,48330.68
2017-03-14,2017-03-14,Internet and phone service,REF50367496,68.17,0.0,48262.51
2017-03-15,2017-03-15,"Invoice payment - Liu, Buchanan and Meyer",REF18802957,0.0,408.75,48671.26
2017-03-15,2017-03-15,"Project payment - Moss, James and Edwards",REF95987324,0.0,1821.48,50492.74
2017-03-15,2017-03-15,"Service payment - Crosby, Armstrong and Herrera",REF58230769,0.0,1308.42,51801.16
2017-03-15,2017-03-15,Business insurance premium,REF58464426,133.1,0.0,51668.06
2017-03-16,2017-03-16,Internet and phone service,REF34614564,102.46,0.0,51565.6
2017-03-17,2017-03-17,Training/conference,REF62308053,98.86,0.0,51466.74
2017-03-23,2017-03-23,Business travel,REF42773420,166.53,0.0,51300.21
2017-03-24,2017-03-24,Equipment purchase,REF95266732,104.05,0.0,51196.16
2017-03-27,2017-03-27,Business travel,REF24844013,155.6,0.0,51040.56
2017-03-29,2017-03-29,Office supplies,REF35645951,63.24,0.0,50977.32
2017-03-30,2017-03-30,Business travel,REF56280941,93.98,0.0,50883.34
2017-04-02,2017-04-02,Training/conference,REF14708480,78.75,0.0,50804.59
2017-04-04,2017-04-04,Training/conference,REF24068616,122.16,0.0,50682.43
2017-04-04,2017-04-04,Office supplies,REF82832909,56.98,0.0,50625.45
2017-04-08,2017-04-08,Office supplies,REF18742838,50.57,0.0,50574.88
2017-04-09,2017-04-09,Software subscription,REF24065793,171.78,0.0,50403.1
2017-04-11,2017-04-11,Marketing expenses,REF59411825,151.99,0.0,50251.11
2017-04-13,2017-04-13,Training/conference,REF95625011,73.18,0.0,50177.93
2017-04-14,2017-04-14,Equipment purchase,REF65424759,68.47,0.0,50109.46
2017-04-15,2017-04-15,"Payment from Moss, James and Edwards",REF22700951,0.0,1314.1,51423.56
2017-04-15,2017-04-15,Business insurance premium,REF56768249,123.02,0.0,51300.54
2017-04-17,2017-04-17,Office supplies,REF15955623,5.0,0.0,51295.54
2017-05-01,2017-05-01,Office supplies,REF56345588,41.5,0.0,51254.04
2017-05-04,2017-05-04,Equipment purchase,REF77832555,123.33,0.0,51130.71
2017-05-05,2017-05-05,Office supplies,REF94674823,62.86,0.0,51067.85
2017-05-08,2017-05-08,Equipment purchase,REF53227412,108.8,0.0,50959.05
2017-05-09,2017-05-09,Software subscription,REF31607634,169.93,0.0,50789.12
2017-05-12,2017-05-12,Office supplies,REF69893570,38.34,0.0,50750.78
2017-05-12,2017-05-12,Marketing expenses,REF91379584,259.05,0.0,50491.73
2017-05-13,2017-05-13,Equipment purchase,REF49055945,97.83,0.0,50393.9
2017-05-15,2017-05-15,Business insurance premium,REF12493729,121.57,0.0,50272.33
2017-05-15,2017-05-15,"Invoice payment - Moss, James and Edwards",REF47516672,0.0,1410.84,51683.17
2017-05-15,2017-05-15,"Project payment - Liu, Buchanan and Meyer",REF29437711,0.0,352.23,52035.4
2017-05-20,2017-05-20,Internet and phone service,REF99940930,45.91,0.0,51989.49
2017-05-29,2017-05-29,Office supplies,REF41515391,65.75,0.0,51923.74
2017-06-02,2017-06-02,Office supplies,REF56291446,59.5,0.0,51864.24
2017-06-09,2017-06-09,Office supplies,REF74737909,30.4,0.0,51833.84
2017-06-09,2017-06-09,Software subscription,REF95195923,134.84,0.0,51699.0
2017-06-10,2017-06-10,Professional services,REF67581167,216.37,0.0,51482.63
2017-06-12,2017-06-12,Business travel,REF30059441,156.94,0.0,51325.69
2017-06-15,2017-06-15,Business travel,REF55990291,117.51,0.0,51208.18
2017-06-15,2017-06-15,Training/conference,REF75683671,104.0,0.0,51104.18
2017-06-15,2017-06-15,"Project payment - Moss, James and Edwards",REF82014216,0.0,1497.53,52601.71
2017-06-15,2017-06-15,"Invoice payment - Crosby, Armstrong and Herrera",REF95340914,0.0,1579.08,54180.79
2017-06-15,2017-06-15,"Service payment - Liu, Buchanan and Meyer",REF20543842,0.0,294.76,54475.55
2017-06-15,2017-06-15,Business insurance premium,REF55742428,109.14,0.0,54366.41
2017-06-23,2017-06-23,Internet and phone service,REF53522865,78.25,0.0,54288.16
2017-06-27,2017-06-27,Equipment purchase,REF56703896,96.93,0.0,54191.23
2017-06-28,2017-06-28,Internet and phone service,REF31872284,60.44,0.0,54130.79
2017-07-06,2017-07-06,Office supplies,REF95317575,35.21,0.0,54095.58
2017-07-09,2017-07-09,Software subscription,REF22699416,117.86,0.0,53977.72
2017-07-15,2017-07-15,Business insurance premium,REF47593503,93.1,0.0,53884.62
2017-07-15,2017-07-15,"Project payment - Liu, Buchanan and Meyer",REF64086993,0.0,276.4,54161.02
2017-07-15,2017-07-15,"Service payment - Moss, James and Edwards",REF83061347,0.0,1033.63,55194.65
2017-07-15,2017-07-15,"Invoice payment - Crosby, Armstrong and Herrera",REF21592582,0.0,1258.04,56452.69
2017-07-15,2017-07-15,Training/conference,REF13584611,42.17,0.0,56410.52
2017-07-20,2017-07-20,Professional services,REF60744598,199.02,0.0,56211.5
2017-07-21,2017-07-21,Marketing expenses,REF91474747,148.63,0.0,56062.87
2017-07-27,2017-07-27,Business travel,REF14165963,123.24,0.0,55939.63
2017-07-27,2017-07-27,Office supplies,REF29976570,50.45,0.0,55889.18
2017-07-29,2017-07-29,Marketing expenses,REF86537508,158.96,0.0,55730.22
2017-07-31,2017-07-31,Training/conference,REF40640054,72.56,0.0,55657.66
2017-08-01,2017-08-01,Professional services,REF25115447,147.19,0.0,55510.47
2017-08-01,2017-08-01,Office supplies,REF42062815,45.35,0.0,55465.12
2017-08-09,2017-08-09,Software subscription,REF77427334,96.56,0.0,55368.56
2017-08-15,2017-08-15,"Invoice payment - Liu, Buchanan and Meyer",REF16979612,0.0,296.24,55664.8
2017-08-15,2017-08-15,"Service payment - Moss, James and Edwards",REF12678427,0.0,919.44,56584.24
2017-08-15,2017-08-15,Business insurance premium,REF62885020,79.61,0.0,56504.63
2017-08-15,2017-08-15,"Service payment - Crosby, Armstrong and Herrera",REF47497609,0.0,942.16,57446.79
2017-08-21,2017-08-21,Training/conference,REF10280912,53.69,0.0,57393.1
2017-08-21,2017-08-21,Professional services,REF96148255,149.72,0.0,57243.38
2017-08-22,2017-08-22,Office supplies,REF96831970,33.49,0.0,57209.89
2017-08-27,2017-08-27,Office supplies,REF39554210,44.21,0.0,57165.68
2017-08-31,2017-08-31,Internet and phone service,REF99798019,49.61,0.0,57116.07
2017-09-03,2017-09-03,Office supplies,REF76986583,56.09,0.0,57059.98
2017-09-05,2017-09-05,Equipment purchase,REF42183208,82.67,0.0,56977.31
2017-09-08,2017-09-08,Business travel,REF21260967,224.63,0.0,56752.68
2017-09-09,2017-09-09,Office supplies,REF50562436,88.77,0.0,56663.91
2017-09-09,2017-09-09,Software subscription,REF97751247,174.24,0.0,56489.67
2017-09-13,2017-09-13,Training/conference,REF36592581,148.71,0.0,56340.96
2017-09-15,2017-09-15,"Invoice payment - Liu, Buchanan and Meyer",REF60379686,0.0,357.54,56698.5
2017-09-15,2017-09-15,Business insurance premium,REF91352687,140.23,0.0,56558.27
2017-09-15,2017-09-15,"Invoice payment - Moss, James and Edwards",REF85062237,0.0,1917.41,58475.68
2017-09-18,2017-09-18,Professional services,REF88321072,211.27,0.0,58264.41
2017-09-23,2017-09-23,Office supplies,REF55103772,25.2,0.0,58239.21
2017-09-25,2017-09-25,Professional services,REF27353712,374.85,0.0,57864.36
2017-09-26,2017-09-26,Business travel,REF11234955,95.74,0.0,57768.62
2017-09-28,2017-09-28,Office supplies,REF30049885,52.31,0.0,57716.31
2017-09-30,2017-09-30,Training/conference,REF13907905,139.38,0.0,57576.93
2017-10-01,2017-10-01,Office supplies,REF11540782,58.14,0.0,57518.79
2017-10-06,2017-10-06,Professional services,REF30092269,356.25,0.0,57162.54
2017-10-09,2017-10-09,Software subscription,REF16340199,197.93,0.0,56964.61
2017-10-10,2017-10-10,Professional services,REF48984202,244.73,0.0,56719.88
2017-10-11,2017-10-11,Office supplies,REF97958468,64.5,0.0,56655.38
2017-10-13,2017-10-13,Marketing expenses,REF87732916,260.36,0.0,56395.02
2017-10-14,2017-10-14,Marketing expenses,REF46208879,221.78,0.0,56173.24
2017-10-15,2017-10-15,"Invoice payment - Moss, James and Edwards",REF89781747,0.0,2133.73,58306.97
2017-10-15,2017-10-15,"Service payment - Crosby, Armstrong and Herrera",REF40126927,0.0,2250.14,60557.11
2017-10-15,2017-10-15,"Invoice payment - Liu, Buchanan and Meyer",REF24384799,0.0,523.42,61080.53
2017-10-15,2017-10-15,Business insurance premium,REF75999122,140.2,0.0,60940.33
2017-10-16,2017-10-16,Office supplies,REF84916735,82.41,0.0,60857.92
2017-10-18,2017-10-18,Marketing expenses,REF63888976,232.87,0.0,60625.05
2017-10-22,2017-10-22,Office supplies,REF42686908,42.43,0.0,60582.62
2017-10-22,2017-10-22,Internet and phone service,REF52329436,145.82,0.0,60436.8
2017-10-23,2017-10-23,Equipment purchase,REF62890902,146.62,0.0,60290.18
2017-10-24,2017-10-24,Training/conference,REF79365489,129.75,0.0,60160.43
2017-10-24,2017-10-24,Professional services,REF16812701,152.35,0.0,60008.08
2017-10-24,2017-10-24,Office supplies,REF72137918,67.34,0.0,59940.74
2017-10-25,2017-10-25,Business travel,REF67490090,103.15,0.0,59837.59
2017-10-27,2017-10-27,Business travel,REF69867344,211.7,0.0,59625.89
2017-10-28,2017-10-28,Equipment purchase,REF35649023,138.83,0.0,59487.06
2017-10-31,2017-10-31,Business travel,REF75773561,160.34,0.0,59326.72
2017-11-02,2017-11-02,Marketing expenses,REF66682323,238.55,0.0,59088.17
2017-11-04,2017-11-04,Internet and phone service,REF53823174,110.63,0.0,58977.54
2017-11-05,2017-11-05,Marketing expenses,REF47816565,155.77,0.0,58821.77
2017-11-05,2017-11-05,Office supplies,REF25207450,54.07,0.0,58767.7
2017-11-06,2017-11-06,Office supplies,REF67910808,62.94,0.0,58704.76
2017-11-09,2017-11-09,Software subscription,REF47111243,154.28,0.0,58550.48
2017-11-11,2017-11-11,Professional services,REF13200084,253.91,0.0,58296.57
2017-11-14,2017-11-14,Business travel,REF69586073,152.5,0.0,58144.07
2017-11-15,2017-11-15,Office supplies,REF76648277,34.8,0.0,58109.27
2017-11-15,2017-11-15,Business insurance premium,REF76030090,125.73,0.0,57983.54
2017-11-15,2017-11-15,"Service payment - Moss, James and Edwards",REF86416292,0.0,1962.78,59946.32
2017-11-15,2017-11-15,"Invoice payment - Crosby, Armstrong and Herrera",REF21431053,0.0,1548.44,61494.76
2017-11-15,2017-11-15,"Service payment - Liu, Buchanan and Meyer",REF37251535,0.0,356.63,61851.39
2017-11-15,2017-11-15,Internet and phone service,REF12896139,83.86,0.0,61767.53
2017-11-15,2017-11-15,Marketing expenses,REF51001917,216.47,0.0,61551.06
2017-11-25,2017-11-25,Office supplies,REF21415944,46.55,0.0,61504.51
2017-11-26,2017-11-26,Marketing expenses,REF77425922,220.7,0.0,61283.81
2017-11-27,2017-11-27,Office supplies,REF78301816,86.03,0.0,61197.78
2017-11-30,2017-11-30,Training/conference,REF56271146,107.45,0.0,61090.33
2017-12-04,2017-12-04,Office supplies,REF95582162,31.19,0.0,61059.14
2017-12-09,2017-12-09,Software subscription,REF90352022,145.88,0.0,60913.26
2017-12-10,2017-12-10,Training/conference,REF24929357,73.86,0.0,60839.4
2017-12-10,2017-12-10,Business travel,REF90061905,88.41,0.0,60750.99
2017-12-15,2017-12-15,Training/conference,REF77390907,66.05,0.0,60684.94
2017-12-15,2017-12-15,"Payment from Liu, Buchanan and Meyer",REF42075197,0.0,382.83,61067.77
2017-12-15,2017-12-15,"Service payment - Moss, James and Edwards",REF17076813,0.0,1348.13,62415.9
2017-12-15,2017-12-15,Business insurance premium,REF60421013,107.25,0.0,62308.65
2017-12-19,2017-12-19,Office supplies,REF48920268,41.6,0.0,62267.05
2017-12-24,2017-12-24,Internet and phone service,REF69952490,65.85,0.0,62201.2
2018-01-06,2018-01-06,Equipment purchase,REF16191921,84.73,0.0,62116.47
2018-01-08,2018-01-08,Training/conference,REF77353456,100.36,0.0,62016.11
2018-01-09,2018-01-09,Software subscription,REF31105507,121.86,0.0,61894.25
2018-01-11,2018-01-11,Internet and phone service,REF76175174,43.89,0.0,61850.36
2018-01-12,2018-01-12,Business travel,REF59220163,61.69,0.0,61788.67
2018-01-15,2018-01-15,Business insurance premium,REF77980984,94.54,0.0,61694.13
2018-01-15,2018-01-15,"Invoice payment - Crosby, Armstrong and Herrera",REF53370772,0.0,887.68,62581.81
2018-02-04,2018-02-04,Office supplies,REF66856236,57.64,0.0,62524.17
2018-02-08,2018-02-08,Office supplies,REF94550755,43.04,0.0,62481.13
2018-02-09,2018-02-09,Software subscription,REF21769906,130.45,0.0,62350.68
2018-02-10,2018-02-10,Business travel,REF93633037,219.48,0.0,62131.2
2018-02-15,2018-02-15,"Project payment - Moss, James and Edwards",REF54529349,0.0,1268.62,63399.82
2018-02-15,2018-02-15,Professional services,REF41903393,249.1,0.0,63150.72
2018-02-15,2018-02-15,"Invoice payment - Liu, Buchanan and Meyer",REF45934970,0.0,241.02,63391.74
2018-02-15,2018-02-15,"Invoice payment - Crosby, Armstrong and Herrera",REF32257041,0.0,1228.28,64620.02
2018-02-15,2018-02-15,Business insurance premium,REF53889236,111.04,0.0,64508.98
2018-02-25,2018-02-25,Business travel,REF75134667,157.83,0.0,64351.15
2018-02-27,2018-02-27,Office supplies,REF36035639,27.1,0.0,64324.05
2018-03-02,2018-03-02,Internet and phone service,REF68234078,74.06,0.0,64249.99
2018-03-03,2018-03-03,Training/conference,REF24424586,83.12,0.0,64166.87
2018-03-07,2018-03-07,Business travel,REF94388820,153.48,0.0,64013.39
2018-03-08,2018-03-08,Business travel,REF19210795,107.32,0.0,63906.07
2018-03-09,2018-03-09,Software subscription,REF29143594,151.8,0.0,63754.27
2018-03-11,2018-03-11,Equipment purchase,REF16821642,135.93,0.0,63618.34
2018-03-15,2018-03-15,"Invoice payment - Liu, Buchanan and Meyer",REF99544489,0.0,351.17,63969.51
2018-03-15,2018-03-15,"Service payment - Crosby, Armstrong and Herrera",REF64734659,0.0,1723.85,65693.36
2018-03-15,2018-03-15,"Service payment - Moss, James and Edwards",REF91077753,0.0,1809.87,67503.23
2018-03-15,2018-03-15,Business insurance premium,REF88531363,123.64,0.0,67379.59
2018-03-17,2018-03-17,Marketing expenses,REF85969258,136.44,0.0,67243.15
2018-03-17,2018-03-17,Training/conference,REF51416761,148.97,0.0,67094.18
2018-03-19,2018-03-19,Professional services,REF91297303,273.87,0.0,66820.31
2018-03-20,2018-03-20,Office supplies,REF67878840,74.64,0.0,66745.67
2018-03-20,2018-03-20,Professional services,REF15905258,330.21,0.0,66415.46
2018-03-26,2018-03-26,Equipment purchase,REF11249381,114.17,0.0,66301.29
2018-03-28,2018-03-28,Training/conference,REF10300035,137.19,0.0,66164.1
2018-04-09,2018-04-09,Office supplies,REF40693413,36.68,0.0,66127.42
2018-04-09,2018-04-09,Software subscription,REF16658304,160.6,0.0,65966.82
2018-04-12,2018-04-12,Professional services,REF42090918,281.48,0.0,65685.34
2018-04-15,2018-04-15,Business insurance premium,REF20854738,102.66,0.0,65582.68
2018-04-15,2018-04-15,"Payment from Crosby, Armstrong and Herrera",REF40492230,0.0,1500.27,67082.95
2018-04-15,2018-04-15,"Payment from Moss, James and Edwards",REF51216483,0.0,1529.72,68612.67
2018-04-24,2018-04-24,Equipment purchase,REF64672977,67.48,0.0,68545.19
2018-04-27,2018-04-27,Office supplies,REF51641114,47.96,0.0,68497.23
2018-05-01,2018-05-01,Professional services,REF78163438,281.73,0.0,68215.5
2018-05-05,2018-05-05,Office supplies,REF58275254,35.2,0.0,68180.3
2018-05-07,2018-05-07,Internet and phone service,REF31705193,78.07,0.0,68102.23
2018-05-07,2018-05-07,Business travel,REF74047358,212.03,0.0,67890.2
2018-05-09,2018-05-09,Software subscription,REF52576223,165.32,0.0,67724.88
2018-05-15,2018-05-15,Training/conference,REF38710481,148.63,0.0,67576.25
2018-05-15,2018-05-15,Business insurance premium,REF40844608,118.0,0.0,67458.25
2018-05-15,2018-05-15,"Payment from Liu, Buchanan and Meyer",REF68867557,0.0,336.64,67794.89
2018-05-15,2018-05-15,"Project payment - Crosby, Armstrong and Herrera",REF69502234,0.0,1524.75,69319.64
2018-05-15,2018-05-15,"Invoice payment - Moss, James and Edwards",REF11627297,0.0,1786.34,71105.98
2018-05-20,2018-05-20,Internet and phone service,REF60068298,57.65,0.0,71048.33
2018-05-22,2018-05-22,Marketing expenses,REF88882966,189.76,0.0,70858.57
2018-05-22,2018-05-22,Professional services,REF75449543,246.81,0.0,70611.76
2018-05-24,2018-05-24,Office supplies,REF32876656,25.36,0.0,70586.4
2018-05-28,2018-05-28,Office supplies,REF82432879,41.69,0.0,70544.71
2018-05-30,2018-05-30,Equipment purchase,REF84563250,121.61,0.0,70423.1
2018-05-31,2018-05-31,Office supplies,REF52054858,40.79,0.0,70382.31
2018-06-03,2018-06-03,Professional services,REF52943933,303.43,0.0,70078.88
2018-06-03,2018-06-03,Training/conference,REF57279976,107.04,0.0,69971.84
2018-06-07,2018-06-07,Office supplies,REF73503644,46.09,0.0,69925.75
2018-06-07,2018-06-07,Business travel,REF66320633,136.07,0.0,69789.68
2018-06-08,2018-06-08,Training/conference,REF90054916,88.43,0.0,69701.25
2018-06-09,2018-06-09,Software subscription,REF79081999,132.68,0.0,69568.57
2018-06-11,2018-06-11,Equipment purchase,REF52998037,93.79,0.0,69474.78
2018-06-15,2018-06-15,Business insurance premium,REF83927712,108.49,0.0,69366.29
2018-06-15,2018-06-15,"Project payment - Moss, James and Edwards",REF45261551,0.0,1188.0,70554.29
2018-06-15,2018-06-15,"Invoice payment - Crosby, Armstrong and Herrera",REF37562162,0.0,1274.94,71829.23
2018-06-15,2018-06-15,"Payment from Liu, Buchanan and Meyer",REF99567290,0.0,324.53,72153.76
2018-06-16,2018-06-16,Equipment purchase,REF74965758,62.67,0.0,72091.09
2018-06-17,2018-06-17,Equipment purchase,REF72345372,37.85,0.0,72053.24
2018-06-26,2018-06-26,Office supplies,REF15243707,65.21,0.0,71988.03
2018-06-28,2018-06-28,Marketing expenses,REF63003028,189.56,0.0,71798.47
2018-06-30,2018-06-30,Business travel,REF88239357,145.68,0.0,71652.79
2018-07-09,2018-07-09,Software subscription,REF34143166,101.4,0.0,71551.39
2018-07-10,2018-07-10,Office supplies,REF92527191,43.84,0.0,71507.55
2018-07-14,2018-07-14,Internet and phone service,REF51224354,43.35,0.0,71464.2
2018-07-15,2018-07-15,Business insurance premium,REF45887236,86.79,0.0,71377.41
2018-07-15,2018-07-15,"Project payment - Crosby, Armstrong and Herrera",REF68188659,0.0,1116.5,72493.91
2018-07-15,2018-07-15,"Service payment - Liu, Buchanan and Meyer",REF58131410,0.0,296.35,72790.26
2018-07-15,2018-07-15,"Service payment - Moss, James and Edwards",REF26934229,0.0,1526.08,74316.34
2018-07-21,2018-07-21,Training/conference,REF97869483,94.97,0.0,74221.37
2018-07-21,2018-07-21,Equipment purchase,REF32699158,109.58,0.0,74111.79
2018-07-26,2018-07-26,Business travel,REF40436255,72.49,0.0,74039.3
2018-07-26,2018-07-26,Internet and phone service,REF66814944,65.26,0.0,73974.04
2018-07-28,2018-07-28,Equipment purchase,REF56334551,97.69,0.0,73876.35
2018-08-03,2018-08-03,Training/conference,REF73041325,54.2,0.0,73822.15
2018-08-09,2018-08-09,Software subscription,REF77726536,97.06,0.0,73725.09
2018-08-15,2018-08-15,Business insurance premium,REF91036683,87.67,0.0,73637.42
2018-08-15,2018-08-15,"Service payment - Liu, Buchanan and Meyer",REF63780345,0.0,201.88,73839.3
2018-08-15,2018-08-15,"Project payment - Crosby, Armstrong and Herrera",REF84496360,0.0,1298.81,75138.11
2018-08-15,2018-08-15,"Payment from Moss, James and Edwards",REF73835381,0.0,939.06,76077.17
2018-08-18,2018-08-18,Training/conference,REF25968398,79.96,0.0,75997.21
2018-08-18,2018-08-18,Business travel,REF93374913,131.83,0.0,75865.38
2018-08-21,2018-08-21,Office supplies,REF49616295,36.51,0.0,75828.87
2018-08-22,2018-08-22,Internet and phone service,REF80442320,51.81,0.0,75777.06
2018-09-01,2018-09-01,Office supplies,REF92438396,73.45,0.0,75703.61
2018-09-09,2018-09-09,Software subscription,REF62027326,157.8,0.0,75545.81
2018-09-10,2018-09-10,Office supplies,REF61823517,92.87,0.0,75452.94
2018-09-10,2018-09-10,Business travel,REF77406489,81.04,0.0,75371.9
2018-09-10,2018-09-10,Internet and phone service,REF98816749,93.11,0.0,75278.79
2018-09-15,2018-09-15,Business insurance premium,REF78828900,138.38,0.0,75140.41
2018-09-15,2018-09-15,"Project payment - Liu, Buchanan and Meyer",REF79319150,0.0,446.4,75586.81
2018-09-15,2018-09-15,"Payment from Moss, James and Edwards",REF40077690,0.0,1749.66,77336.47
2018-09-15,2018-09-15,"Payment from Crosby, Armstrong and Herrera",REF57117975,0.0,1820.5,79156.97
2018-09-17,2018-09-17,Equipment purchase,REF16174118,90.02,0.0,79066.95
2018-09-18,2018-09-18,Office supplies,REF85466620,63.88,0.0,79003.07
2018-09-24,2018-09-24,Office supplies,REF48834245,42.76,0.0,78960.31
2018-09-25,2018-09-25,Office supplies,REF38299698,32.45,0.0,78927.86
2018-09-27,2018-09-27,Training/conference,REF85997435,75.73,0.0,78852.13
2018-10-01,2018-10-01,Equipment purchase,REF80613061,119.0,0.0,78733.13
2018-10-04,2018-10-04,Equipment purchase,REF63420847,142.58,0.0,78590.55
2018-10-05,2018-10-05,Equipment purchase,REF72965790,94.84,0.0,78495.71
2018-10-09,2018-10-09,Software subscription,REF21085286,195.29,0.0,78300.42
2018-10-10,2018-10-10,Internet and phone service,REF95157082,75.36,0.0,78225.06
2018-10-14,2018-10-14,Equipment purchase,REF47668908,100.94,0.0,78124.12
2018-10-15,2018-10-15,Business insurance premium,REF65407080,149.23,0.0,77974.89
2018-10-15,2018-10-15,"Project payment - Moss, James and Edwards",REF89584568,0.0,2205.64,80180.53
2018-10-15,2018-10-15,"Invoice payment - Liu, Buchanan and Meyer",REF49642328,0.0,447.24,80627.77
2018-10-15,2018-10-15,"Invoice payment - Crosby, Armstrong and Herrera",REF71548502,0.0,1953.62,82581.39
2018-10-17,2018-10-17,Business travel,REF90956486,135.81,0.0,82445.58
2018-10-18,2018-10-18,Office supplies,REF69174620,43.95,0.0,82401.63
2018-10-20,2018-10-20,Internet and phone service,REF27954177,86.24,0.0,82315.39
2018-10-22,2018-10-22,Marketing expenses,REF79572998,193.08,0.0,82122.31
2018-10-22,2018-10-22,Internet and phone service,REF92585829,56.15,0.0,82066.16
2018-10-27,2018-10-27,Internet and phone service,REF69268544,92.19,0.0,81973.97
2018-11-09,2018-11-09,Software subscription,REF85520172,167.66,0.0,81806.31
2018-11-15,2018-11-15,"Invoice payment - Liu, Buchanan and Meyer",REF33889174,0.0,424.25,82230.56
2018-11-15,2018-11-15,"Invoice payment - Crosby, Armstrong and Herrera",REF60488828,0.0,1481.16,83711.72
2018-11-15,2018-11-15,Business insurance premium,REF51356496,134.16,0.0,83577.56
2018-11-15,2018-11-15,Office supplies,REF75683155,43.07,0.0,83534.49
2018-11-15,2018-11-15,"Service payment - Moss, James and Edwards",REF57209246,0.0,1589.41,85123.9
2018-11-17,2018-11-17,Marketing expenses,REF46432242,271.73,0.0,84852.17
2018-11-18,2018-11-18,Marketing expenses,REF29196741,268.45,0.0,84583.72
2018-11-21,2018-11-21,Internet and phone service,REF64139932,77.04,0.0,84506.68
2018-12-04,2018-12-04,Office supplies,REF74103302,57.44,0.0,84449.24
2018-12-07,2018-12-07,Training/conference,REF91270815,129.63,0.0,84319.61
2018-12-09,2018-12-09,Software subscription,REF13186610,126.53,0.0,84193.08
2018-12-15,2018-12-15,Business insurance premium,REF44134553,99.46,0.0,84093.62
2018-12-15,2018-12-15,"Payment from Liu, Buchanan and Meyer",REF19765660,0.0,219.18,84312.8
2018-12-15,2018-12-15,"Project payment - Crosby, Armstrong and Herrera",REF29958949,0.0,1088.65,85401.45
2018-12-15,2018-12-15,"Project payment - Moss, James and Edwards",REF84751604,0.0,1674.15,87075.6
2018-12-19,2018-12-19,Office supplies,REF37117256,58.41,0.0,87017.19
2018-12-20,2018-12-20,Business travel,REF70462932,161.69,0.0,86855.5
2018-12-21,2018-12-21,Internet and phone service,REF99483533,77.82,0.0,86777.68
2018-12-24,2018-12-24,Marketing expenses,REF43765941,219.42,0.0,86558.26
2018-12-26,2018-12-26,Training/conference,REF38965055,113.46,0.0,86444.8
2019-01-04,2019-01-04,Marketing expenses,REF68592447,75.03,0.0,86369.77
2019-01-04,2019-01-04,Business travel,REF85211372,139.75,0.0,86230.02
2019-01-06,2019-01-06,Professional services,REF84463325,206.49,0.0,86023.53
2019-01-09,2019-01-09,Software subscription,REF95111647,120.33,0.0,85903.2
2019-01-13,2019-01-13,Marketing expenses,REF70095687,175.77,0.0,85727.43
2019-01-15,2019-01-15,Business insurance premium,REF47422025,93.3,0.0,85634.13
2019-01-15,2019-01-15,"Service payment - Liu, Buchanan and Meyer",REF11027343,0.0,268.28,85902.41
2019-01-15,2019-01-15,"Payment from Crosby, Armstrong and Herrera",REF13399465,0.0,1093.54,86995.95
2019-01-16,2019-01-16,Office supplies,REF77007164,40.78,0.0,86955.17
2019-01-18,2019-01-18,Marketing expenses,REF54741410,198.4,0.0,86756.77
2019-01-19,2019-01-19,Equipment purchase,REF75618357,57.38,0.0,86699.39
2019-01-21,2019-01-21,Training/conference,REF82104490,93.98,0.0,86605.41
2019-01-21,2019-01-21,Office supplies,REF84591877,60.69,0.0,86544.72
2019-01-23,2019-01-23,Internet and phone service,REF69904038,42.98,0.0,86501.74
2019-01-24,2019-01-24,Office supplies,REF48143013,37.78,0.0,86463.96
2019-01-26,2019-01-26,Business travel,REF30335184,142.17,0.0,86321.79
2019-01-28,2019-01-28,Internet and phone service,REF13514162,63.93,0.0,86257.86
2019-01-31,2019-01-31,Office supplies,REF18409937,6.17,0.0,86251.69
2019-02-01,2019-02-01,Office supplies,REF90107070,34.11,0.0,86217.58
2019-02-01,2019-02-01,Business travel,REF89601276,68.42,0.0,86149.16
2019-02-03,2019-02-03,Professional services,REF74159282,327.73,0.0,85821.43
2019-02-06,2019-02-06,Office supplies,REF49355262,64.89,0.0,85756.54
2019-02-09,2019-02-09,Software subscription,REF85781148,117.04,0.0,85639.5
2019-02-11,2019-02-11,Office supplies,REF83926919,50.23,0.0,85589.27
2019-02-12,2019-02-12,Marketing expenses,REF98396131,154.5,0.0,85434.77
2019-02-15,2019-02-15,"Payment from Moss, James and Edwards",REF24961867,0.0,1566.98,87001.75
2019-02-15,2019-02-15,Business insurance premium,REF85392318,122.35,0.0,86879.4
2019-02-15,2019-02-15,"Service payment - Crosby, Armstrong and Herrera",REF57799424,0.0,882.35,87761.75
2019-02-15,2019-02-15,"Payment from Liu, Buchanan and Meyer",REF93400922,0.0,296.33,88058.08
2019-02-17,2019-02-17,Office supplies,REF31253785,26.32,0.0,88031.76
2019-02-19,2019-02-19,Office supplies,REF58174752,58.03,0.0,87973.73
2019-02-20,2019-02-20,Office supplies,REF28116647,53.59,0.0,87920.14
2019-02-22,2019-02-22,Internet and phone service,REF73901473,53.2,0.0,87866.94
2019-02-25,2019-02-25,Business travel,REF69266743,160.64,0.0,87706.3
2019-02-26,2019-02-26,Professional services,REF36121852,315.57,0.0,87390.73
2019-02-27,2019-02-27,Marketing expenses,REF41114137,213.89,0.0,87176.84
2019-03-02,2019-03-02,Professional services,REF95663580,369.08,0.0,86807.76
2019-03-07,2019-03-07,Professional services,REF12243091,360.81,0.0,86446.95
2019-03-09,2019-03-09,Software subscription,REF83468911,184.59,0.0,86262.36
2019-03-12,2019-03-12,Business travel,REF27118727,164.22,0.0,86098.14
2019-03-15,2019-03-15,"Invoice payment - Moss, James and Edwards",REF84624284,0.0,1692.3,87790.44
2019-03-15,2019-03-15,"Service payment - Liu, Buchanan and Meyer",REF59620044,0.0,374.4,88164.84
2019-03-15,2019-03-15,"Project payment - Crosby, Armstrong and Herrera",REF43008633,0.0,1908.42,90073.26
2019-03-15,2019-03-15,Business insurance premium,REF52519031,131.7,0.0,89941.56
2019-03-17,2019-03-17,Office supplies,REF51248931,35.47,0.0,89906.09
2019-03-23,2019-03-23,Training/conference,REF97699944,69.89,0.0,89836.2
2019-03-23,2019-03-23,Business travel,REF29324093,91.34,0.0,89744.86
2019-03-24,2019-03-24,Office supplies,REF99448826,53.87,0.0,89690.99
2019-03-30,2019-03-30,Marketing expenses,REF71690781,147.03,0.0,89543.96
2019-03-30,2019-03-30,Business travel,REF64420822,156.12,0.0,89387.84
2019-03-31,2019-03-31,Office supplies,REF20377121,91.99,0.0,89295.85
2019-04-01,2019-04-01,Marketing expenses,REF24135303,225.36,0.0,89070.49
2019-04-01,2019-04-01,Office supplies,REF52224258,47.57,0.0,89022.92
2019-04-06,2019-04-06,Equipment purchase,REF80981961,80.77,0.0,88942.15
2019-04-07,2019-04-07,Marketing expenses,REF52109678,220.01,0.0,88722.14
2019-04-07,2019-04-07,Office supplies,REF29430960,44.39,0.0,88677.75
2019-04-08,2019-04-08,Office supplies,REF34608323,45.44,0.0,88632.31
2019-04-09,2019-04-09,Software subscription,REF66843033,148.51,0.0,88483.8
2019-04-14,2019-04-14,Office supplies,REF26078111,56.15,0.0,88427.65
2019-04-15,2019-04-15,"Project payment - Moss, James and Edwards",REF76810000,0.0,1433.78,89861.43
2019-04-15,2019-04-15,Business insurance premium,REF97766537,117.49,0.0,89743.94
2019-04-15,2019-04-15,"Service payment - Liu, Buchanan and Meyer",REF98467418,0.0,513.92,90257.86
2019-04-16,2019-04-16,Office supplies,REF66082297,57.85,0.0,90200.01
2019-04-18,2019-04-18,Business travel,REF16685492,65.65,0.0,90134.36
2019-04-19,2019-04-19,Office supplies,REF89294131,58.76,0.0,90075.6
2019-04-21,2019-04-21,Training/conference,REF51606298,146.24,0.0,89929.36
2019-04-21,2019-04-21,Business travel,REF27903701,117.31,0.0,89812.05
2019-04-23,2019-04-23,Internet and phone service,REF78907329,84.6,0.0,89727.45
2019-04-28,2019-04-28,Business travel,REF29662028,155.93,0.0,89571.52
2019-04-29,2019-04-29,Training/conference,REF31893379,55.27,0.0,89516.25
2019-05-01,2019-05-01,Professional services,REF92088447,253.83,0.0,89262.42
2019-05-03,2019-05-03,Equipment purchase,REF50255940,122.13,0.0,89140.29
2019-05-08,2019-05-08,Office supplies,REF51413676,27.39,0.0,89112.9
2019-05-09,2019-05-09,Software subscription,REF64814145,151.61,0.0,88961.29
2019-05-15,2019-05-15,Business insurance premium,REF49541153,117.42,0.0,88843.87
2019-05-15,2019-05-15,"Invoice payment - Moss, James and Edwards",REF31244963,0.0,1700.57,90544.44
2019-05-15,2019-05-15,"Invoice payment - Liu, Buchanan and Meyer",REF68564214,0.0,435.47,90979.91
2019-05-15,2019-05-15,"Project payment - Crosby, Armstrong and Herrera",REF88162733,0.0,1208.78,92188.69
2019-05-21,2019-05-21,Office supplies,REF36569903,49.81,0.0,92138.88
2019-05-23,2019-05-23,Equipment purchase,REF34492086,84.65,0.0,92054.23
2019-05-24,2019-05-24,Office supplies,REF50040488,46.9,0.0,92007.33
2019-05-25,2019-05-25,Internet and phone service,REF47900097,82.13,0.0,91925.2
2019-05-29,2019-05-29,Business travel,REF92689975,177.01,0.0,91748.19
2019-05-31,2019-05-31,Professional services,REF42475264,149.45,0.0,91598.74
2019-06-08,2019-06-08,Professional services,REF73987420,309.3,0.0,91289.44
2019-06-09,2019-06-09,Software subscription,REF62315063,142.17,0.0,91147.27
2019-06-10,2019-06-10,Training/conference,REF98195736,90.24,0.0,91057.03
2019-06-15,2019-06-15,Equipment purchase,REF20508784,84.29,0.0,90972.74
2019-06-15,2019-06-15,"Service payment - Moss, James and Edwards",REF33488583,0.0,1294.0,92266.74
2019-06-15,2019-06-15,"Payment from Crosby, Armstrong and Herrera",REF32021338,0.0,1295.33,93562.07
2019-06-15,2019-06-15,"Project payment - Liu, Buchanan and Meyer",REF10364199,0.0,334.25,93896.32
2019-06-15,2019-06-15,Business insurance premium,REF53759423,113.89,0.0,93782.43
2019-06-28,2019-06-28,Office supplies,REF65631768,44.51,0.0,93737.92
2019-06-30,2019-06-30,Office supplies,REF61102521,47.0,0.0,93690.92
2019-07-05,2019-07-05,Training/conference,REF14579004,100.25,0.0,93590.67
2019-07-09,2019-07-09,Software subscription,REF46416602,123.73,0.0,93466.94
2019-07-10,2019-07-10,Office supplies,REF41881960,36.79,0.0,93430.15
2019-07-13,2019-07-13,Professional services,REF91484869,296.16,0.0,93133.99
2019-07-15,2019-07-15,Business insurance premium,REF56043747,94.45,0.0,93039.54
2019-07-15,2019-07-15,"Service payment - Liu, Buchanan and Meyer",REF88983149,0.0,261.47,93301.01
2019-07-15,2019-07-15,"Payment from Crosby, Armstrong and Herrera",REF61800171,0.0,1066.33,94367.34
2019-07-18,2019-07-18,Internet and phone service,REF23665941,52.61,0.0,94314.73
2019-07-22,2019-07-22,Office supplies,REF62352722,39.35,0.0,94275.38
2019-07-23,2019-07-23,Office supplies,REF99638217,33.62,0.0,94241.76
2019-07-24,2019-07-24,Office supplies,REF14313059,58.47,0.0,94183.29
2019-07-26,2019-07-26,Marketing expenses,REF74172675,46.99,0.0,94136.3
2019-07-27,2019-07-27,Office supplies,REF13134307,51.5,0.0,94084.8
2019-07-30,2019-07-30,Business travel,REF91711829,71.88,0.0,94012.92
2019-08-03,2019-08-03,Internet and phone service,REF98980018,65.8,0.0,93947.12
2019-08-09,2019-08-09,Software subscription,REF30502506,103.81,0.0,93843.31
2019-08-12,2019-08-12,Professional services,REF22478875,205.78,0.0,93637.53
2019-08-14,2019-08-14,Office supplies,REF48881714,26.88,0.0,93610.65
2019-08-15,2019-08-15,Business insurance premium,REF60503559,79.41,0.0,93531.24
2019-08-15,2019-08-15,"Project payment - Moss, James and Edwards",REF59725456,0.0,1089.76,94621.0
2019-08-15,2019-08-15,"Invoice payment - Liu, Buchanan and Meyer",REF41524376,0.0,281.65,94902.65
2019-08-15,2019-08-15,"Invoice payment - Crosby, Armstrong and Herrera",REF65327622,0.0,1030.57,95933.22
2019-08-18,2019-08-18,Marketing expenses,REF89360853,175.69,0.0,95757.53
2019-08-18,2019-08-18,Office supplies,REF25593985,24.9,0.0,95732.63
2019-08-19,2019-08-19,Business travel,REF87653163,105.43,0.0,95627.2
2019-08-24,2019-08-24,Office supplies,REF32711144,37.54,0.0,95589.66
2019-08-26,2019-08-26,Office supplies,REF73839176,30.79,0.0,95558.87
2019-08-28,2019-08-28,Training/conference,REF97927037,69.97,0.0,95488.9
2019-08-28,2019-08-28,Equipment purchase,REF63547698,104.55,0.0,95384.35
2019-09-09,2019-09-09,Software subscription,REF38357058,160.94,0.0,95223.41
2019-09-13,2019-09-13,Business travel,REF66438016,208.0,0.0,95015.41
2019-09-15,2019-09-15,Business insurance premium,REF35454567,144.32,0.0,94871.09
2019-09-15,2019-09-15,"Project payment - Crosby, Armstrong and Herrera",REF87767757,0.0,1830.97,96702.06
2019-09-15,2019-09-15,"Service payment - Moss, James and Edwards",REF63076861,0.0,1560.74,98262.8
2019-09-15,2019-09-15,"Project payment - Liu, Buchanan and Meyer",REF86007140,0.0,347.55,98610.35
2019-09-16,2019-09-16,Office supplies,REF95495756,70.85,0.0,98539.5
2019-09-19,2019-09-19,Marketing expenses,REF44367936,318.85,0.0,98220.65
2019-09-23,2019-09-23,Professional services,REF39635539,246.71,0.0,97973.94
2019-09-29,2019-09-29,Equipment purchase,REF21787284,77.25,0.0,97896.69
2019-10-01,2019-10-01,Office supplies,REF24743415,34.06,0.0,97862.63
2019-10-01,2019-10-01,Marketing expenses,REF88713799,252.22,0.0,97610.41
2019-10-04,2019-10-04,Office supplies,REF76866705,49.28,0.0,97561.13
2019-10-05,2019-10-05,Office supplies,REF89313997,47.26,0.0,97513.87
2019-10-07,2019-10-07,Office supplies,REF91117340,74.37,0.0,97439.5
2019-10-09,2019-10-09,Software subscription,REF54838471,167.98,0.0,97271.52
2019-10-10,2019-10-10,Training/conference,REF59398158,120.98,0.0,97150.54
2019-10-10,2019-10-10,Office supplies,REF79120853,54.61,0.0,97095.93
2019-10-14,2019-10-14,Business travel,REF14287754,161.63,0.0,96934.3
2019-10-15,2019-10-15,"Payment from Liu, Buchanan and Meyer",REF36384580,0.0,470.93,97405.23
2019-10-15,2019-10-15,Business insurance premium,REF82628507,143.24,0.0,97261.99
2019-10-15,2019-10-15,"Service payment - Crosby, Armstrong and Herrera",REF68309487,0.0,1731.73,98993.72
2019-10-15,2019-10-15,"Invoice payment - Moss, James and Edwards",REF55035101,0.0,1994.19,100987.91
2019-10-17,2019-10-17,Equipment purchase,REF63489970,87.23,0.0,100900.68
2019-10-20,2019-10-20,Office supplies,REF49517569,84.97,0.0,100815.71
2019-10-26,2019-10-26,Marketing expenses,REF91423824,390.16,0.0,100425.55
2019-10-28,2019-10-28,Office supplies,REF45513370,65.82,0.0,100359.73
2019-11-01,2019-11-01,Marketing expenses,REF74904993,185.1,0.0,100174.63
2019-11-03,2019-11-03,Office supplies,REF88210554,35.4,0.0,100139.23
2019-11-03,2019-11-03,Professional services,REF60288560,226.21,0.0,99913.02
2019-11-04,2019-11-04,Business travel,REF76488501,221.2,0.0,99691.82
2019-11-09,2019-11-09,Software subscription,REF23962692,147.03,0.0,99544.79
2019-11-10,2019-11-10,Internet and phone service,REF96495575,32.27,0.0,99512.52
2019-11-12,2019-11-12,Office supplies,REF98166988,66.11,0.0,99446.41
2019-11-14,2019-11-14,Training/conference,REF61414923,143.55,0.0,99302.86
2019-11-15,2019-11-15,Business insurance premium,REF12381904,137.49,0.0,99165.37
2019-11-15,2019-11-15,"Project payment - Moss, James and Edwards",REF75917847,0.0,1879.46,101044.83
2019-11-15,2019-11-15,"Project payment - Crosby, Armstrong and Herrera",REF28348490,0.0,1748.54,102793.37
2019-11-18,2019-11-18,Marketing expenses,REF41121033,209.84,0.0,102583.53
2019-11-22,2019-11-22,Office supplies,REF24751949,45.79,0.0,102537.74
2019-11-24,2019-11-24,Business travel,REF41099362,118.13,0.0,102419.61
2019-11-24,2019-11-24,Office supplies,REF20173430,58.95,0.0,102360.66
2019-11-28,2019-11-28,Professional services,REF76547722,187.01,0.0,102173.65
2019-12-09,2019-12-09,Software subscription,REF23948450,149.86,0.0,102023.79
2019-12-15,2019-12-15,Business insurance premium,REF27885901,113.97,0.0,101909.82
2019-12-15,2019-12-15,"Project payment - Crosby, Armstrong and Herrera",REF26746745,0.0,1380.18,103290.0
2019-12-15,2019-12-15,Marketing expenses,REF67669618,180.34,0.0,103109.66
2019-12-15,2019-12-15,Professional services,REF47323079,218.86,0.0,102890.8
2019-12-15,2019-12-15,"Service payment - Moss, James and Edwards",REF93668398,0.0,1470.14,104360.94
2019-12-18,2019-12-18,Office supplies,REF95251813,23.0,0.0,104337.94
2019-12-24,2019-12-24,Office supplies,REF59623738,24.25,0.0,104313.69
2019-12-27,2019-12-27,Training/conference,REF65832900,41.59,0.0,104272.1
2020-01-02,2020-01-02,Internet and phone service,REF22978863,49.31,0.0,104222.79
2020-01-02,2020-01-02,Office supplies,REF27603068,32.08,0.0,104190.71
2020-01-06,2020-01-06,Internet and phone service,REF60368595,86.28,0.0,104104.43
2020-01-09,2020-01-09,Software subscription,REF86494865,131.97,0.0,103972.46
2020-01-10,2020-01-10,Professional services,REF23998187,123.99,0.0,103848.47
2020-01-15,2020-01-15,Business insurance premium,REF17662693,88.2,0.0,103760.27
2020-01-15,2020-01-15,"Project payment - Liu, Buchanan and Meyer",REF21535898,0.0,262.98,104023.25
2020-01-15,2020-01-15,"Service payment - Moss, James and Edwards",REF28792812,0.0,1076.88,105100.13
2020-01-16,2020-01-16,Office supplies,REF15278073,61.37,0.0,105038.76
2020-01-17,2020-01-17,Office supplies,REF38104793,30.32,0.0,105008.44
2020-01-17,2020-01-17,Business travel,REF99190091,94.84,0.0,104913.6
2020-01-20,2020-01-20,Office supplies,REF28578896,14.94,0.0,104898.66
2020-01-27,2020-01-27,Internet and phone service,REF65762974,34.25,0.0,104864.41
2020-01-28,2020-01-28,Marketing expenses,REF49666819,256.89,0.0,104607.52
2020-02-06,2020-02-06,Training/conference,REF81916835,56.4,0.0,104551.12
2020-02-09,2020-02-09,Software subscription,REF53989050,145.19,0.0,104405.93
2020-02-11,2020-02-11,Professional services,REF11650122,200.65,0.0,104205.28
2020-02-15,2020-02-15,"Project payment - Liu, Buchanan and Meyer",REF55358151,0.0,276.75,104482.03
2020-02-15,2020-02-15,"Payment from Moss, James and Edwards",REF33772069,0.0,1724.58,106206.61
2020-02-15,2020-02-15,Business insurance premium,REF41912535,106.75,0.0,106099.86
2020-02-15,2020-02-15,"Payment from Crosby, Armstrong and Herrera",REF90861742,0.0,1426.7,107526.56
2020-02-16,2020-02-16,Marketing expenses,REF97140152,172.95,0.0,107353.61
2020-02-19,2020-02-19,Equipment purchase,REF86656585,137.07,0.0,107216.54
2020-02-21,2020-02-21,Office supplies,REF39427230,46.61,0.0,107169.93
2020-02-22,2020-02-22,Office supplies,REF42722990,50.03,0.0,107119.9
2020-02-24,2020-02-24,Professional services,REF98540542,212.21,0.0,106907.69
2020-02-28,2020-02-28,Office supplies,REF42691141,43.35,0.0,106864.34
2020-02-29,2020-02-29,Training/conference,REF30204127,109.18,0.0,106755.16
2020-03-06,2020-03-06,Professional services,REF90623398,263.37,0.0,106491.79
2020-03-08,2020-03-08,Office supplies,REF40670931,57.69,0.0,106434.1
2020-03-08,2020-03-08,Training/conference,REF12961293,133.89,0.0,106300.21
2020-03-09,2020-03-09,Software subscription,REF40477195,190.48,0.0,106109.73
2020-03-12,2020-03-12,Business travel,REF53081426,209.64,0.0,105900.09
2020-03-15,2020-03-15,"Invoice payment - Moss, James and Edwards",REF91993486,0.0,1916.29,107816.38
2020-03-15,2020-03-15,"Invoice payment - Crosby, Armstrong and Herrera",REF68145773,0.0,1483.53,109299.91
2020-03-15,2020-03-15,Business insurance premium,REF78465869,129.69,0.0,109170.22
2020-03-15,2020-03-15,"Service payment - Liu, Buchanan and Meyer",REF41868642,0.0,432.12,109602.34
2020-03-23,2020-03-23,Equipment purchase,REF22471060,129.87,0.0,109472.47
2020-03-26,2020-03-26,Marketing expenses,REF76825228,177.42,0.0,109295.05
2020-04-03,2020-04-03,Professional services,REF83414731,254.85,0.0,109040.2
2020-04-04,2020-04-04,Business travel,REF47196594,237.28,0.0,108802.92
2020-04-06,2020-04-06,Training/conference,REF59891893,69.4,0.0,108733.52
2020-04-09,2020-04-09,Software subscription,REF53526578,141.21,0.0,108592.31
2020-04-11,2020-04-11,Internet and phone service,REF35069999,88.73,0.0,108503.58
2020-04-13,2020-04-13,Internet and phone service,REF48929098,106.08,0.0,108397.5
2020-04-15,2020-04-15,Business insurance premium,REF93535883,128.84,0.0,108268.66
2020-04-15,2020-04-15,"Payment from Crosby, Armstrong and Herrera",REF46393248,0.0,1797.69,110066.35
2020-04-15,2020-04-15,"Project payment - Moss, James and Edwards",REF64820520,0.0,1339.96,111406.31
2020-04-15,2020-04-15,"Payment from Liu, Buchanan and Meyer",REF13815967,0.0,407.14,111813.45
2020-04-16,2020-04-16,Office supplies,REF70288817,56.26,0.0,111757.19
2020-04-18,2020-04-18,Office supplies,REF37782292,52.63,0.0,111704.56
2020-04-24,2020-04-24,Office supplies,REF38992475,58.09,0.0,111646.47
2020-04-24,2020-04-24,Professional services,REF27173071,243.68,0.0,111402.79
2020-04-27,2020-04-27,Business travel,REF77890042,129.25,0.0,111273.54
2020-04-28,2020-04-28,Office supplies,REF46971599,35.03,0.0,111238.51
2020-04-30,2020-04-30,Equipment purchase,REF62607187,92.85,0.0,111145.66
2020-05-03,2020-05-03,Business travel,REF84396231,159.83,0.0,110985.83
2020-05-09,2020-05-09,Software subscription,REF89378583,154.11,0.0,110831.72
2020-05-11,2020-05-11,Professional services,REF84088572,185.67,0.0,110646.05
2020-05-15,2020-05-15,"Project payment - Crosby, Armstrong and Herrera",REF61010121,0.0,1288.5,111934.55
2020-05-15,2020-05-15,"Project payment - Liu, Buchanan and Meyer",REF23615098,0.0,390.48,112325.03
2020-05-15,2020-05-15,Marketing expenses,REF41811018,206.06,0.0,112118.97
2020-05-15,2020-05-15,"Invoice payment - Moss, James and Edwards",REF95837085,0.0,1289.04,113408.01
2020-05-15,2020-05-15,Business insurance premium,REF20073486,118.09,0.0,113289.92
2020-05-18,2020-05-18,Office supplies,REF25481806,43.32,0.0,113246.6
2020-05-19,2020-05-19,Professional services,REF92869365,165.27,0.0,113081.33
2020-05-20,2020-05-20,Office supplies,REF55319878,61.73,0.0,113019.6
2020-05-21,2020-05-21,Equipment purchase,REF26107742,99.5,0.0,112920.1
2020-05-24,2020-05-24,Training/conference,REF42596782,68.77,0.0,112851.33
2020-05-24,2020-05-24,Office supplies,REF17272088,62.78,0.0,112788.55
2020-05-24,2020-05-24,Marketing expenses,REF85036587,99.78,0.0,112688.77
2020-05-27,2020-05-27,Training/conference,REF51347618,156.89,0.0,112531.88
2020-05-29,2020-05-29,Equipment purchase,REF13769865,109.05,0.0,112422.83
2020-06-07,2020-06-07,Business travel,REF17302447,169.76,0.0,112253.07
2020-06-07,2020-06-07,Office supplies,REF24346344,51.75,0.0,112201.32
2020-06-09,2020-06-09,Software subscription,REF54255490,148.76,0.0,112052.56
2020-06-12,2020-06-12,Office supplies,REF85095632,49.66,0.0,112002.9
2020-06-13,2020-06-13,Business travel,REF84240330,129.11,0.0,111873.79
2020-06-15,2020-06-15,"Payment from Liu, Buchanan and Meyer",REF39301808,0.0,276.59,112150.38
2020-06-15,2020-06-15,Business insurance premium,REF78493920,106.45,0.0,112043.93
2020-06-15,2020-06-15,"Service payment - Moss, James and Edwards",REF36328687,0.0,1607.2,113651.13
2020-06-15,2020-06-15,"Invoice payment - Crosby, Armstrong and Herrera",REF75926324,0.0,1462.46,115113.59
2020-06-16,2020-06-16,Equipment purchase,REF34481332,153.76,0.0,114959.83
2020-06-18,2020-06-18,Internet and phone service,REF65273321,90.43,0.0,114869.4
2020-06-21,2020-06-21,Marketing expenses,REF85580485,140.11,0.0,114729.29
2020-06-24,2020-06-24,Training/conference,REF81753002,76.94,0.0,114652.35
2020-06-27,2020-06-27,Office supplies,REF13041077,21.22,0.0,114631.13
2020-07-03,2020-07-03,Internet and phone service,REF88360671,75.41,0.0,114555.72
2020-07-03,2020-07-03,Marketing expenses,REF84765234,125.31,0.0,114430.41
2020-07-08,2020-07-08,Office supplies,REF55664581,25.88,0.0,114404.53
2020-07-09,2020-07-09,Software subscription,REF25377684,126.68,0.0,114277.85
2020-07-12,2020-07-12,Business travel,REF53945880,164.09,0.0,114113.76
2020-07-14,2020-07-14,Equipment purchase,REF81022720,77.87,0.0,114035.89
2020-07-15,2020-07-15,Business insurance premium,REF53267013,96.0,0.0,113939.89
2020-07-15,2020-07-15,"Payment from Moss, James and Edwards",REF28613420,0.0,1081.47,115021.36
2020-07-15,2020-07-15,"Service payment - Liu, Buchanan and Meyer",REF88506035,0.0,233.67,115255.03
2020-07-15,2020-07-15,"Invoice payment - Crosby, Armstrong and Herrera",REF88034044,0.0,1457.53,116712.56
2020-07-25,2020-07-25,Equipment purchase,REF74858299,52.86,0.0,116659.7
2020-07-27,2020-07-27,Professional services,REF12741483,283.79,0.0,116375.91
2020-07-28,2020-07-28,Office supplies,REF87407730,40.45,0.0,116335.46
2020-07-30,2020-07-30,Internet and phone service,REF47219446,37.45,0.0,116298.01
2020-08-09,2020-08-09,Software subscription,REF19300497,108.45,0.0,116189.56
2020-08-11,2020-08-11,Office supplies,REF11875648,42.08,0.0,116147.48
2020-08-15,2020-08-15,Business insurance premium,REF94982617,87.43,0.0,116060.05
2020-08-15,2020-08-15,Training/conference,REF49331124,54.54,0.0,116005.51
2020-08-15,2020-08-15,"Payment from Moss, James and Edwards",REF26392101,0.0,984.3,116989.81
2020-08-15,2020-08-15,"Project payment - Liu, Buchanan and Meyer",REF24732472,0.0,220.35,117210.16
2020-08-15,2020-08-15,"Payment from Crosby, Armstrong and Herrera",REF63242435,0.0,974.16,118184.32
2020-08-16,2020-08-16,Business travel,REF99151653,58.14,0.0,118126.18
2020-08-19,2020-08-19,Business travel,REF81804902,78.93,0.0,118047.25
2020-08-20,2020-08-20,Professional services,REF46417729,154.64,0.0,117892.61
2020-08-21,2020-08-21,Office supplies,REF38470574,26.29,0.0,117866.32
2020-08-26,2020-08-26,Office supplies,REF91543963,21.94,0.0,117844.38
2020-08-29,2020-08-29,Office supplies,REF83659960,30.68,0.0,117813.7
2020-09-09,2020-09-09,Software subscription,REF62596416,164.98,0.0,117648.72
2020-09-13,2020-09-13,Professional services,REF70700293,249.43,0.0,117399.29
2020-09-14,2020-09-14,Office supplies,REF40436476,34.91,0.0,117364.38
2020-09-15,2020-09-15,Business insurance premium,REF97099011,136.21,0.0,117228.17
2020-09-15,2020-09-15,"Invoice payment - Liu, Buchanan and Meyer",REF91053887,0.0,350.88,117579.05
2020-09-15,2020-09-15,"Invoice payment - Moss, James and Edwards",REF57528523,0.0,2003.37,119582.42
2020-09-15,2020-09-15,"Service payment - Crosby, Armstrong and Herrera",REF72625608,0.0,1282.78,120865.2
2020-09-23,2020-09-23,Office supplies,REF88920053,60.63,0.0,120804.57
2020-09-23,2020-09-23,Professional services,REF75616931,314.93,0.0,120489.64
2020-09-25,2020-09-25,Marketing expenses,REF85282694,276.13,0.0,120213.51
2020-09-29,2020-09-29,Business travel,REF92444147,233.93,0.0,119979.58
2020-09-30,2020-09-30,Equipment purchase,REF22575469,141.84,0.0,119837.74
2020-10-01,2020-10-01,Business travel,REF14472807,158.67,0.0,119679.07
2020-10-01,2020-10-01,Training/conference,REF68806412,118.91,0.0,119560.16
2020-10-09,2020-10-09,Software subscription,REF98203966,152.53,0.0,119407.63
2020-10-09,2020-10-09,Office supplies,REF19186282,57.79,0.0,119349.84
2020-10-10,2020-10-10,Marketing expenses,REF49374209,255.07,0.0,119094.77
2020-10-13,2020-10-13,Equipment purchase,REF58480841,163.28,0.0,118931.49
2020-10-15,2020-10-15,Training/conference,REF50882364,69.56,0.0,118861.93
2020-10-15,2020-10-15,"Project payment - Liu, Buchanan and Meyer",REF91739101,0.0,448.8,119310.73
2020-10-15,2020-10-15,"Payment from Moss, James and Edwards",REF63002739,0.0,1706.07,121016.8
2020-10-15,2020-10-15,"Payment from Crosby, Armstrong and Herrera",REF94523442,0.0,1657.63,122674.43
2020-10-15,2020-10-15,Business insurance premium,REF27879879,143.23,0.0,122531.2
2020-10-16,2020-10-16,Training/conference,REF32457620,145.93,0.0,122385.27
2020-10-18,2020-10-18,Business travel,REF74203320,244.9,0.0,122140.37
2020-10-19,2020-10-19,Office supplies,REF84983078,42.96,0.0,122097.41
2020-10-21,2020-10-21,Training/conference,REF33750022,65.4,0.0,122032.01
2020-10-23,2020-10-23,Business travel,REF19690696,150.06,0.0,121881.95
2020-10-27,2020-10-27,Business travel,REF75174645,176.71,0.0,121705.24
2020-11-03,2020-11-03,Training/conference,REF85373990,115.23,0.0,121590.01
2020-11-08,2020-11-08,Business travel,REF59079463,230.62,0.0,121359.39
2020-11-09,2020-11-09,Software subscription,REF52085727,181.57,0.0,121177.82
2020-11-11,2020-11-11,Marketing expenses,REF25682984,307.21,0.0,120870.61
2020-11-15,2020-11-15,"Project payment - Moss, James and Edwards",REF25747112,0.0,1605.47,122476.08
2020-11-15,2020-11-15,Internet and phone service,REF90006141,112.77,0.0,122363.31
2020-11-15,2020-11-15,"Service payment - Crosby, Armstrong and Herrera",REF36554122,0.0,1504.41,123867.72
2020-11-15,2020-11-15,Business insurance premium,REF11567958,138.16,0.0,123729.56
2020-11-18,2020-11-18,Business travel,REF98008920,139.18,0.0,123590.38
2020-11-26,2020-11-26,Internet and phone service,REF94539056,85.66,0.0,123504.72
2020-11-27,2020-11-27,Training/conference,REF66406456,148.75,0.0,123355.97
2020-11-28,2020-11-28,Office supplies,REF74348996,65.2,0.0,123290.77
2020-12-01,2020-12-01,Office supplies,REF31509565,38.09,0.0,123252.68
2020-12-03,2020-12-03,Business travel,REF49023757,171.31,0.0,123081.37
2020-12-04,2020-12-04,Equipment purchase,REF20756685,117.01,0.0,122964.36
2020-12-06,2020-12-06,Training/conference,REF55117162,118.62,0.0,122845.74
2020-12-09,2020-12-09,Software subscription,REF23897868,138.76,0.0,122706.98
2020-12-15,2020-12-15,"Service payment - Liu, Buchanan and Meyer",REF93633400,0.0,282.82,122989.8
2020-12-15,2020-12-15,"Payment from Crosby, Armstrong and Herrera",REF39563514,0.0,1295.37,124285.17
2020-12-15,2020-12-15,Business insurance premium,REF31628640,110.17,0.0,124175.0
2020-12-20,2020-12-20,Business travel,REF85252063,172.42,0.0,124002.58
2020-12-24,2020-12-24,Training/conference,REF55954104,89.06,0.0,123913.52
2020-12-27,2020-12-27,Training/conference,REF45787382,61.22,0.0,123852.3
2020-12-28,2020-12-28,Business travel,REF42650419,168.33,0.0,123683.97
2021-01-03,2021-01-03,Office supplies,REF61681331,55.32,0.0,123628.65
2021-01-09,2021-01-09,Software subscription,REF82783616,112.63,0.0,123516.02
2021-01-09,2021-01-09,Office supplies,REF96155891,29.27,0.0,123486.75
2021-01-15,2021-01-15,"Service payment - Moss, James and Edwards",REF26821114,0.0,1583.92,125070.67
2021-01-15,2021-01-15,"Invoice payment - Liu, Buchanan and Meyer",REF37388710,0.0,252.12,125322.79
2021-01-15,2021-01-15,Business insurance premium,REF33890821,92.6,0.0,125230.19
2021-01-15,2021-01-15,"Payment from Crosby, Armstrong and Herrera",REF32272141,0.0,1417.05,126647.24
2021-01-16,2021-01-16,Business travel,REF59955294,121.67,0.0,126525.57
2021-01-21,2021-01-21,Equipment purchase,REF49379390,92.9,0.0,126432.67
2021-01-22,2021-01-22,Internet and phone service,REF19448629,60.68,0.0,126371.99
2021-01-22,2021-01-22,Marketing expenses,REF33463552,213.36,0.0,126158.63
2021-01-25,2021-01-25,Business travel,REF78632880,60.93,0.0,126097.7
2021-01-25,2021-01-25,Professional services,REF54694059,104.71,0.0,125992.99
2021-01-27,2021-01-27,Marketing expenses,REF43722527,170.91,0.0,125822.08
2021-01-30,2021-01-30,Internet and phone service,REF84175209,65.85,0.0,125756.23
2021-02-03,2021-02-03,Office supplies,REF38078350,54.26,0.0,125701.97
2021-02-04,2021-02-04,Office supplies,REF78880240,64.66,0.0,125637.31
2021-02-06,2021-02-06,Office supplies,REF78234491,40.33,0.0,125596.98
2021-02-09,2021-02-09,Software subscription,REF98096970,142.18,0.0,125454.8
2021-02-15,2021-02-15,"Payment from Moss, James and Edwards",REF42702218,0.0,1225.59,126680.39
2021-02-15,2021-02-15,Business insurance premium,REF50480359,111.43,0.0,126568.96
2021-02-15,2021-02-15,"Service payment - Liu, Buchanan and Meyer",REF12630368,0.0,340.3,126909.26
2021-02-15,2021-02-15,"Invoice payment - Crosby, Armstrong and Herrera",REF14560556,0.0,1138.72,128047.98
2021-02-16,2021-02-16,Training/conference,REF32929895,81.05,0.0,127966.93
2021-02-18,2021-02-18,Office supplies,REF56636305,51.54,0.0,127915.39
2021-02-24,2021-02-24,Office supplies,REF53229693,50.03,0.0,127865.36
2021-02-26,2021-02-26,Office supplies,REF68271463,36.49,0.0,127828.87
2021-02-27,2021-02-27,Office supplies,REF22231202,54.91,0.0,127773.96
2021-03-09,2021-03-09,Software subscription,REF65421293,162.89,0.0,127611.07
2021-03-09,2021-03-09,Equipment purchase,REF64892660,107.05,0.0,127504.02
2021-03-10,2021-03-10,Internet and phone service,REF15077391,101.35,0.0,127402.67
2021-03-11,2021-03-11,Office supplies,REF32970319,45.34,0.0,127357.33
2021-03-11,2021-03-11,Professional services,REF29785292,347.31,0.0,127010.02
2021-03-15,2021-03-15,Business insurance premium,REF97061891,117.92,0.0,126892.1
2021-03-15,2021-03-15,"Service payment - Liu, Buchanan and Meyer",REF70454330,0.0,349.08,127241.18
2021-03-15,2021-03-15,"Invoice payment - Moss, James and Edwards",REF11588598,0.0,1402.79,128643.97
2021-03-17,2021-03-17,Training/conference,REF12590990,56.27,0.0,128587.7
2021-03-18,2021-03-18,Business travel,REF31907260,105.97,0.0,128481.73
2021-03-20,2021-03-20,Professional services,REF74154843,205.32,0.0,128276.41
2021-03-23,2021-03-23,Internet and phone service,REF71020598,89.21,0.0,128187.2
2021-04-05,2021-04-05,Training/conference,REF20118118,84.97,0.0,128102.23
2021-04-09,2021-04-09,Software subscription,REF60894167,160.31,0.0,127941.92
2021-04-12,2021-04-12,Equipment purchase,REF24826224,74.71,0.0,127867.21
2021-04-15,2021-04-15,Business insurance premium,REF37748435,116.29,0.0,127750.92
2021-04-15,2021-04-15,"Service payment - Liu, Buchanan and Meyer",REF32443025,0.0,375.56,128126.48
2021-04-15,2021-04-15,"Payment from Moss, James and Edwards",REF11448557,0.0,1220.68,129347.16
2021-04-15,2021-04-15,"Payment from Crosby, Armstrong and Herrera",REF49310602,0.0,1137.86,130485.02
2021-04-18,2021-04-18,Professional services,REF40400989,244.91,0.0,130240.11
2021-04-20,2021-04-20,Training/conference,REF65241529,119.87,0.0,130120.24
2021-04-27,2021-04-27,Office supplies,REF76388881,38.38,0.0,130081.86
2021-04-28,2021-04-28,Internet and phone service,REF33973670,73.49,0.0,130008.37
2021-05-03,2021-05-03,Marketing expenses,REF77613984,157.35,0.0,129851.02
2021-05-05,2021-05-05,Internet and phone service,REF69814076,60.26,0.0,129790.76
2021-05-08,2021-05-08,Training/conference,REF87417511,94.95,0.0,129695.81
2021-05-09,2021-05-09,Software subscription,REF97154176,133.6,0.0,129562.21
2021-05-10,2021-05-10,Business travel,REF61295732,139.06,0.0,129423.15
2021-05-11,2021-05-11,Equipment purchase,REF49637750,37.48,0.0,129385.67
2021-05-15,2021-05-15,Business insurance premium,REF83903587,115.56,0.0,129270.11
2021-05-15,2021-05-15,"Project payment - Crosby, Armstrong and Herrera",REF74768168,0.0,1694.95,130965.06
2021-05-15,2021-05-15,"Service payment - Liu, Buchanan and Meyer",REF67139988,0.0,467.55,131432.61
2021-05-15,2021-05-15,"Payment from Moss, James and Edwards",REF69818755,0.0,1371.61,132804.22
2021-05-16,2021-05-16,Training/conference,REF67592888,97.88,0.0,132706.34
2021-05-20,2021-05-20,Internet and phone service,REF80517104,58.78,0.0,132647.56
2021-05-20,2021-05-20,Marketing expenses,REF55182375,200.4,0.0,132447.16
2021-05-21,2021-05-21,Equipment purchase,REF95193436,60.11,0.0,132387.05
2021-05-26,2021-05-26,Internet and phone service,REF26569986,69.32,0.0,132317.73
2021-05-28,2021-05-28,Internet and phone service,REF97440381,52.18,0.0,132265.55
2021-06-07,2021-06-07,Training/conference,REF29108447,49.7,0.0,132215.85
2021-06-09,2021-06-09,Software subscription,REF82198086,144.11,0.0,132071.74
2021-06-10,2021-06-10,Office supplies,REF84803601,43.05,0.0,132028.69
2021-06-15,2021-06-15,Business insurance premium,REF10443162,107.11,0.0,131921.58
2021-06-15,2021-06-15,"Payment from Moss, James and Edwards",REF76098635,0.0,1133.12,133054.7
2021-06-15,2021-06-15,"Payment from Liu, Buchanan and Meyer",REF96834506,0.0,263.42,133318.12
2021-06-15,2021-06-15,"Invoice payment - Crosby, Armstrong and Herrera",REF77886126,0.0,1321.7,134639.82
2021-06-16,2021-06-16,Business travel,REF76513981,83.58,0.0,134556.24
2021-06-20,2021-06-20,Office supplies,REF79639434,53.81,0.0,134502.43
2021-06-21,2021-06-21,Marketing expenses,REF26790633,75.74,0.0,134426.69
2021-06-28,2021-06-28,Business travel,REF37242452,250.18,0.0,134176.51
2021-07-03,2021-07-03,Equipment purchase,REF22217856,100.18,0.0,134076.33
2021-07-04,2021-07-04,Business travel,REF70611701,147.73,0.0,133928.6
2021-07-05,2021-07-05,Business travel,REF65983384,143.38,0.0,133785.22
2021-07-08,2021-07-08,Business travel,REF33977160,88.64,0.0,133696.58
2021-07-09,2021-07-09,Software subscription,REF21303624,126.97,0.0,133569.61
2021-07-13,2021-07-13,Office supplies,REF60103094,14.72,0.0,133554.89
2021-07-14,2021-07-14,Professional services,REF16022215,272.79,0.0,133282.1
2021-07-15,2021-07-15,"Payment from Moss, James and Edwards",REF51233233,0.0,1323.0,134605.1
2021-07-15,2021-07-15,Business insurance premium,REF72176756,102.73,0.0,134502.37
2021-07-15,2021-07-15,"Service payment - Liu, Buchanan and Meyer",REF67710211,0.0,314.66,134817.03
2021-07-18,2021-07-18,Office supplies,REF69931076,24.0,0.0,134793.03
2021-07-20,2021-07-20,Office supplies,REF57622518,32.14,0.0,134760.89
2021-07-27,2021-07-27,Equipment purchase,REF13865584,86.25,0.0,134674.64
2021-07-27,2021-07-27,Training/conference,REF64008865,93.74,0.0,134580.9
2021-07-29,2021-07-29,Equipment purchase,REF18518340,64.03,0.0,134516.87
2021-08-04,2021-08-04,Training/conference,REF11143880,60.63,0.0,134456.24
2021-08-06,2021-08-06,Marketing expenses,REF82467501,140.63,0.0,134315.61
2021-08-07,2021-08-07,Marketing expenses,REF86471874,138.91,0.0,134176.7
2021-08-08,2021-08-08,Internet and phone service,REF37015541,64.07,0.0,134112.63
2021-08-09,2021-08-09,Software subscription,REF50877473,120.06,0.0,133992.57
2021-08-10,2021-08-10,Equipment purchase,REF24099510,91.47,0.0,133901.1
2021-08-12,2021-08-12,Training/conference,REF31444071,48.25,0.0,133852.85
2021-08-15,2021-08-15,"Invoice payment - Crosby, Armstrong and Herrera",REF82433539,0.0,791.61,134644.46
2021-08-15,2021-08-15,"Service payment - Liu, Buchanan and Meyer",REF83482722,0.0,260.88,134905.34
2021-08-15,2021-08-15,Business insurance premium,REF24449632,85.22,0.0,134820.12
2021-08-15,2021-08-15,"Project payment - Moss, James and Edwards",REF13729117,0.0,974.89,135795.01
2021-08-24,2021-08-24,Office supplies,REF55461705,38.69,0.0,135756.32
2021-08-25,2021-08-25,Professional services,REF23329090,223.35,0.0,135532.97
2021-08-26,2021-08-26,Office supplies,REF16861802,28.49,0.0,135504.48
2021-08-27,2021-08-27,Office supplies,REF97689052,34.29,0.0,135470.19
2021-08-28,2021-08-28,Equipment purchase,REF55167964,74.6,0.0,135395.59
2021-08-30,2021-08-30,Marketing expenses,REF71159749,103.08,0.0,135292.51
2021-08-31,2021-08-31,Office supplies,REF69363458,33.49,0.0,135259.02
2021-09-01,2021-09-01,Office supplies,REF14314152,29.24,0.0,135229.78
2021-09-04,2021-09-04,Office supplies,REF31237969,70.04,0.0,135159.74
2021-09-04,2021-09-04,Equipment purchase,REF32800316,152.43,0.0,135007.31
2021-09-08,2021-09-08,Marketing expenses,REF96230647,178.88,0.0,134828.43
2021-09-08,2021-09-08,Internet and phone service,REF94569045,92.35,0.0,134736.08
2021-09-09,2021-09-09,Software subscription,REF86243268,200.23,0.0,134535.85
2021-09-10,2021-09-10,Marketing expenses,REF39440013,225.2,0.0,134310.65
2021-09-11,2021-09-11,Equipment purchase,REF97524296,39.82,0.0,134270.83
2021-09-13,2021-09-13,Marketing expenses,REF27581408,286.96,0.0,133983.87
2021-09-15,2021-09-15,"Project payment - Crosby, Armstrong and Herrera",REF35976652,0.0,1389.34,135373.21
2021-09-15,2021-09-15,"Project payment - Moss, James and Edwards",REF22003179,0.0,1362.84,136736.05
2021-09-15,2021-09-15,"Project payment - Liu, Buchanan and Meyer",REF87013109,0.0,409.83,137145.88
2021-09-15,2021-09-15,Business insurance premium,REF48215757,128.67,0.0,137017.21
2021-09-16,2021-09-16,Professional services,REF42857054,309.59,0.0,136707.62
2021-09-17,2021-09-17,Internet and phone service,REF76270781,90.31,0.0,136617.31
2021-09-17,2021-09-17,Office supplies,REF70100177,49.89,0.0,136567.42
2021-09-18,2021-09-18,Office supplies,REF13147322,18.02,0.0,136549.4
2021-09-19,2021-09-19,Business travel,REF47554485,189.99,0.0,136359.41
2021-10-04,2021-10-04,Equipment purchase,REF63972859,54.2,0.0,136305.21
2021-10-09,2021-10-09,Software subscription,REF97253961,192.31,0.0,136112.9
2021-10-15,2021-10-15,"Service payment - Crosby, Armstrong and Herrera",REF84129214,0.0,1642.14,137755.04
2021-10-15,2021-10-15,Business insurance premium,REF84013834,159.67,0.0,137595.37
2021-10-15,2021-10-15,"Service payment - Liu, Buchanan and Meyer",REF92512687,0.0,339.05,137934.42
2021-10-15,2021-10-15,Training/conference,REF58732437,86.3,0.0,137848.12
2021-10-23,2021-10-23,Office supplies,REF44104585,78.23,0.0,137769.89
2021-10-23,2021-10-23,Internet and phone service,REF27506906,98.61,0.0,137671.28
2021-10-24,2021-10-24,Office supplies,REF23590374,36.48,0.0,137634.8
2021-10-25,2021-10-25,Office supplies,REF33494333,57.4,0.0,137577.4
2021-10-27,2021-10-27,Business travel,REF68401266,203.27,0.0,137374.13
2021-10-27,2021-10-27,Equipment purchase,REF42993384,78.46,0.0,137295.67
2021-10-30,2021-10-30,Business travel,REF18943290,144.08,0.0,137151.59
2021-10-31,2021-10-31,Marketing expenses,REF31139551,287.43,0.0,136864.16
2021-11-09,2021-11-09,Software subscription,REF48742982,150.13,0.0,136714.03
2021-11-10,2021-11-10,Professional services,REF15730983,517.01,0.0,136197.02
2021-11-11,2021-11-11,Equipment purchase,REF46034451,110.28,0.0,136086.74
2021-11-15,2021-11-15,"Invoice payment - Liu, Buchanan and Meyer",REF89431470,0.0,343.09,136429.83
2021-11-15,2021-11-15,Training/conference,REF12007513,149.28,0.0,136280.55
2021-11-15,2021-11-15,"Payment from Crosby, Armstrong and Herrera",REF77585274,0.0,1343.44,137623.99
2021-11-15,2021-11-15,Business insurance premium,REF77845485,137.25,0.0,137486.74
2021-11-15,2021-11-15,"Project payment - Moss, James and Edwards",REF96738378,0.0,1816.92,139303.66
2021-11-16,2021-11-16,Internet and phone service,REF13686299,85.57,0.0,139218.09
2021-11-27,2021-11-27,Office supplies,REF34550568,65.01,0.0,139153.08
2021-11-28,2021-11-28,Training/conference,REF96430069,117.43,0.0,139035.65
2021-12-03,2021-12-03,Office supplies,REF23300410,37.48,0.0,138998.17
2021-12-04,2021-12-04,Office supplies,REF76372209,51.02,0.0,138947.15
2021-12-09,2021-12-09,Software subscription,REF11558727,127.87,0.0,138819.28
2021-12-12,2021-12-12,Marketing expenses,REF94837926,268.8,0.0,138550.48
2021-12-12,2021-12-12,Training/conference,REF93237615,131.15,0.0,138419.33
2021-12-14,2021-12-14,Office supplies,REF99700165,37.29,0.0,138382.04
2021-12-15,2021-12-15,Business insurance premium,REF55820736,108.53,0.0,138273.51
2021-12-15,2021-12-15,"Project payment - Moss, James and Edwards",REF59606322,0.0,1331.05,139604.56
2021-12-15,2021-12-15,"Invoice payment - Crosby, Armstrong and Herrera",REF75952389,0.0,1133.28,140737.84
2021-12-15,2021-12-15,"Invoice payment - Liu, Buchanan and Meyer",REF99996514,0.0,271.89,141009.73
2021-12-15,2021-12-15,Business travel,REF50327993,140.19,0.0,140869.54
2021-12-18,2021-12-18,Business travel,REF15926272,251.62,0.0,140617.92
2021-12-20,2021-12-20,Equipment purchase,REF74260370,51.47,0.0,140566.45
2021-12-21,2021-12-21,Internet and phone service,REF97291858,86.24,0.0,140480.21
2021-12-23,2021-12-23,Equipment purchase,REF29512416,43.52,0.0,140436.69
2021-12-31,2021-12-31,Professional services,REF79211411,284.42,0.0,140152.27
2022-01-01,2022-01-01,Office supplies,REF96061474,44.19,0.0,140108.08
2022-01-03,2022-01-03,Equipment purchase,REF32630828,98.03,0.0,140010.05
2022-01-04,2022-01-04,Training/conference,REF54785390,36.73,0.0,139973.32
2022-01-09,2022-01-09,Software subscription,REF74937968,116.15,0.0,139857.17
2022-01-09,2022-01-09,Business travel,REF40755154,164.75,0.0,139692.42
2022-01-12,2022-01-12,Business travel,REF36068943,120.97,0.0,139571.45
2022-01-15,2022-01-15,Business insurance premium,REF88926669,99.74,0.0,139471.71
2022-01-15,2022-01-15,Business travel,REF86890370,143.54,0.0,139328.17
2022-01-15,2022-01-15,"Project payment - Liu, Buchanan and Meyer",REF55906041,0.0,302.69,139630.86
2022-01-15,2022-01-15,"Payment from Moss, James and Edwards",REF40974501,0.0,1048.79,140679.65
2022-01-15,2022-01-15,"Payment from Crosby, Armstrong and Herrera",REF86591991,0.0,939.3,141618.95
2022-01-17,2022-01-17,Professional services,REF71524995,149.36,0.0,141469.59
2022-01-18,2022-01-18,Internet and phone service,REF17013841,70.23,0.0,141399.36
2022-01-19,2022-01-19,Office supplies,REF79677395,64.35,0.0,141335.01
2022-01-21,2022-01-21,Office supplies,REF44037962,22.66,0.0,141312.35
2022-01-22,2022-01-22,Office supplies,REF33159187,43.89,0.0,141268.46
2022-01-27,2022-01-27,Office supplies,REF52494283,48.08,0.0,141220.38
2022-01-28,2022-01-28,Office supplies,REF50065840,46.85,0.0,141173.53
2022-01-28,2022-01-28,Business travel,REF87088488,146.43,0.0,141027.1
2022-01-31,2022-01-31,Office supplies,REF13194148,26.24,0.0,141000.86
2022-02-01,2022-02-01,Equipment purchase,REF86267062,69.19,0.0,140931.67
2022-02-02,2022-02-02,Office supplies,REF92391236,34.16,0.0,140897.51
2022-02-04,2022-02-04,Business travel,REF86241353,229.91,0.0,140667.6
2022-02-06,2022-02-06,Professional services,REF58978922,293.77,0.0,140373.83
2022-02-08,2022-02-08,Business travel,REF48974055,68.17,0.0,140305.66
2022-02-09,2022-02-09,Software subscription,REF54197492,139.92,0.0,140165.74
2022-02-09,2022-02-09,Office supplies,REF54017131,75.97,0.0,140089.77
2022-02-14,2022-02-14,Office supplies,REF46852512,63.15,0.0,140026.62
2022-02-15,2022-02-15,Business insurance premium,REF11503185,112.8,0.0,139913.82
2022-02-15,2022-02-15,"Payment from Crosby, Armstrong and Herrera",REF21204444,0.0,1479.57,141393.39
2022-02-15,2022-02-15,"Service payment - Moss, James and Edwards",REF18835310,0.0,1156.58,142549.97
2022-02-18,2022-02-18,Internet and phone service,REF32252284,75.49,0.0,142474.48
2022-02-23,2022-02-23,Internet and phone service,REF60156102,30.28,0.0,142444.2
2022-02-24,2022-02-24,Marketing expenses,REF84835722,188.46,0.0,142255.74
2022-02-27,2022-02-27,Professional services,REF51776888,238.12,0.0,142017.62
2022-03-02,2022-03-02,Office supplies,REF88941626,51.68,0.0,141965.94
2022-03-03,2022-03-03,Office supplies,REF37739291,45.38,0.0,141920.56
2022-03-09,2022-03-09,Software subscription,REF31784135,154.86,0.0,141765.7
2022-03-10,2022-03-10,Office supplies,REF31626054,46.44,0.0,141719.26
2022-03-10,2022-03-10,Business travel,REF96791583,239.07,0.0,141480.19
2022-03-12,2022-03-12,Office supplies,REF13266301,47.2,0.0,141432.99
2022-03-13,2022-03-13,Office supplies,REF83230779,33.19,0.0,141399.8
2022-03-15,2022-03-15,"Project payment - Crosby, Armstrong and Herrera",REF82899188,0.0,2143.5,143543.3
2022-03-15,2022-03-15,Business insurance premium,REF32253469,140.92,0.0,143402.38
2022-03-15,2022-03-15,"Project payment - Moss, James and Edwards",REF57930255,0.0,1461.98,144864.36
2022-03-15,2022-03-15,"Invoice payment - Liu, Buchanan and Meyer",REF68122891,0.0,357.69,145222.05
2022-03-16,2022-03-16,Office supplies,REF32694548,54.33,0.0,145167.72
2022-03-17,2022-03-17,Business travel,REF72671369,166.3,0.0,145001.42
2022-03-19,2022-03-19,Office supplies,REF75212049,52.8,0.0,144948.62
2022-03-21,2022-03-21,Equipment purchase,REF56571283,106.24,0.0,144842.38
2022-03-21,2022-03-21,Business travel,REF47519233,229.22,0.0,144613.16
2022-03-29,2022-03-29,Office supplies,REF44162165,29.49,0.0,144583.67
2022-03-30,2022-03-30,Business travel,REF95693388,211.85,0.0,144371.82
2022-04-03,2022-04-03,Training/conference,REF57725953,65.64,0.0,144306.18
2022-04-04,2022-04-04,Equipment purchase,REF49782315,65.24,0.0,144240.94
2022-04-06,2022-04-06,Internet and phone service,REF93198980,69.95,0.0,144170.99
2022-04-09,2022-04-09,Software subscription,REF21719743,167.92,0.0,144003.07
2022-04-09,2022-04-09,Internet and phone service,REF30431174,81.94,0.0,143921.13
2022-04-09,2022-04-09,Equipment purchase,REF74316739,127.5,0.0,143793.63
2022-04-10,2022-04-10,Training/conference,REF45565505,109.23,0.0,143684.4
2022-04-13,2022-04-13,Equipment purchase,REF75671083,121.57,0.0,143562.83
2022-04-15,2022-04-15,"Project payment - Liu, Buchanan and Meyer",REF47444539,0.0,243.96,143806.79
2022-04-15,2022-04-15,"Project payment - Crosby, Armstrong and Herrera",REF23303177,0.0,1557.6,145364.39
2022-04-15,2022-04-15,Business insurance premium,REF78640887,114.74,0.0,145249.65
2022-04-15,2022-04-15,"Invoice payment - Moss, James and Edwards",REF91861929,0.0,1759.24,147008.89
2022-04-17,2022-04-17,Internet and phone service,REF23647996,47.64,0.0,146961.25
2022-04-19,2022-04-19,Equipment purchase,REF70553423,104.33,0.0,146856.92
2022-04-19,2022-04-19,Internet and phone service,REF56105703,68.43,0.0,146788.49
2022-04-20,2022-04-20,Equipment purchase,REF58766371,151.58,0.0,146636.91
2022-04-21,2022-04-21,Office supplies,REF69389851,33.53,0.0,146603.38
2022-04-25,2022-04-25,Business travel,REF43938527,153.33,0.0,146450.05
2022-04-29,2022-04-29,Business travel,REF19084573,116.91,0.0,146333.14
2022-05-01,2022-05-01,Professional services,REF38032522,108.79,0.0,146224.35
2022-05-07,2022-05-07,Marketing expenses,REF22398391,321.26,0.0,145903.09
2022-05-09,2022-05-09,Software subscription,REF16032813,166.83,0.0,145736.26
2022-05-10,2022-05-10,Internet and phone service,REF33491696,94.57,0.0,145641.69
2022-05-15,2022-05-15,Business insurance premium,REF23671481,120.78,0.0,145520.91
2022-05-15,2022-05-15,"Invoice payment - Moss, James and Edwards",REF12707258,0.0,1910.66,147431.57
2022-05-15,2022-05-15,"Service payment - Liu, Buchanan and Meyer",REF80007818,0.0,348.12,147779.69
2022-05-15,2022-05-15,"Invoice payment - Crosby, Armstrong and Herrera",REF15012968,0.0,1722.64,149502.33
2022-05-17,2022-05-17,Office supplies,REF64205041,66.57,0.0,149435.76
2022-05-29,2022-05-29,Business travel,REF35500238,208.9,0.0,149226.86
2022-05-29,2022-05-29,Office supplies,REF50737440,54.23,0.0,149172.63
2022-05-29,2022-05-29,Training/conference,REF53433991,127.64,0.0,149044.99
2022-05-29,2022-05-29,Equipment purchase,REF95086223,94.43,0.0,148950.56
2022-05-31,2022-05-31,Training/conference,REF90225499,121.26,0.0,148829.3
2022-06-07,2022-06-07,Office supplies,REF82403865,60.99,0.0,148768.31
2022-06-09,2022-06-09,Software subscription,REF98995051,131.8,0.0,148636.51
2022-06-15,2022-06-15,"Service payment - Moss, James and Edwards",REF34010125,0.0,1282.62,149919.13
2022-06-15,2022-06-15,"Invoice payment - Liu, Buchanan and Meyer",REF17247038,0.0,270.27,150189.4
2022-06-15,2022-06-15,"Invoice payment - Crosby, Armstrong and Herrera",REF82908066,0.0,1301.75,151491.15
2022-06-15,2022-06-15,Business insurance premium,REF33822685,107.9,0.0,151383.25
2022-06-15,2022-06-15,Office supplies,REF39791932,61.69,0.0,151321.56
2022-06-17,2022-06-17,Business travel,REF78877555,180.27,0.0,151141.29
2022-06-19,2022-06-19,Office supplies,REF86309423,54.27,0.0,151087.02
2022-06-27,2022-06-27,Office supplies,REF75442131,27.56,0.0,151059.46
2022-07-01,2022-07-01,Office supplies,REF82476161,60.65,0.0,150998.81
2022-07-02,2022-07-02,Equipment purchase,REF45622272,62.0,0.0,150936.81
2022-07-04,2022-07-04,Office supplies,REF97251323,23.78,0.0,150913.03
2022-07-04,2022-07-04,Equipment purchase,REF87850070,58.86,0.0,150854.17
2022-07-05,2022-07-05,Office supplies,REF80757689,27.76,0.0,150826.41
2022-07-06,2022-07-06,Marketing expenses,REF10909535,149.71,0.0,150676.7
2022-07-08,2022-07-08,Business travel,REF98256854,88.4,0.0,150588.3
2022-07-09,2022-07-09,Software subscription,REF81091891,86.91,0.0,150501.39
2022-07-11,2022-07-11,Business travel,REF31911760,58.13,0.0,150443.26
2022-07-14,2022-07-14,Office supplies,REF75265044,34.29,0.0,150408.97
2022-07-14,2022-07-14,Training/conference,REF79852424,64.79,0.0,150344.18
2022-07-15,2022-07-15,"Invoice payment - Moss, James and Edwards",REF83427820,0.0,1321.82,151666.0
2022-07-15,2022-07-15,"Invoice payment - Crosby, Armstrong and Herrera",REF36420921,0.0,1154.29,152820.29
2022-07-15,2022-07-15,Business insurance premium,REF24493166,91.55,0.0,152728.74
2022-07-15,2022-07-15,Office supplies,REF17600026,46.14,0.0,152682.6
2022-07-15,2022-07-15,"Invoice payment - Liu, Buchanan and Meyer",REF24228078,0.0,323.0,153005.6
2022-07-16,2022-07-16,Office supplies,REF18187735,55.17,0.0,152950.43
2022-07-18,2022-07-18,Business travel,REF65657983,170.36,0.0,152780.07
2022-07-19,2022-07-19,Office supplies,REF49664591,16.38,0.0,152763.69
2022-07-24,2022-07-24,Office supplies,REF84777770,29.84,0.0,152733.85
2022-08-07,2022-08-07,Office supplies,REF32958308,54.25,0.0,152679.6
2022-08-09,2022-08-09,Software subscription,REF22248079,114.97,0.0,152564.63
2022-08-11,2022-08-11,Equipment purchase,REF68478609,58.49,0.0,152506.14
2022-08-13,2022-08-13,Training/conference,REF75942734,60.12,0.0,152446.02
2022-08-15,2022-08-15,Business travel,REF82006083,135.45,0.0,152310.57
2022-08-15,2022-08-15,"Service payment - Crosby, Armstrong and Herrera",REF80279213,0.0,905.68,153216.25
2022-08-15,2022-08-15,"Invoice payment - Liu, Buchanan and Meyer",REF53309809,0.0,202.96,153419.21
2022-08-15,2022-08-15,"Service payment - Moss, James and Edwards",REF54797269,0.0,1050.98,154470.19
2022-08-15,2022-08-15,Business insurance premium,REF55598179,86.24,0.0,154383.95
2022-08-17,2022-08-17,Business travel,REF79469579,75.7,0.0,154308.25
2022-08-19,2022-08-19,Office supplies,REF53702185,31.65,0.0,154276.6
2022-08-21,2022-08-21,Office supplies,REF30895202,57.22,0.0,154219.38
2022-08-26,2022-08-26,Office supplies,REF88527307,37.54,0.0,154181.84
2022-08-30,2022-08-30,Equipment purchase,REF13938415,64.81,0.0,154117.03
2022-09-05,2022-09-05,Equipment purchase,REF30884772,87.6,0.0,154029.43
2022-09-09,2022-09-09,Software subscription,REF39693821,143.19,0.0,153886.24
2022-09-12,2022-09-12,Office supplies,REF59159336,58.2,0.0,153828.04
2022-09-15,2022-09-15,Training/conference,REF44817825,101.19,0.0,153726.85
2022-09-15,2022-09-15,"Invoice payment - Moss, James and Edwards",REF97758556,0.0,1400.34,155127.19
2022-09-15,2022-09-15,Business insurance premium,REF13846000,129.39,0.0,154997.8
2022-09-15,2022-09-15,"Payment from Crosby, Armstrong and Herrera",REF33668605,0.0,1518.56,156516.36
2022-09-15,2022-09-15,"Payment from Liu, Buchanan and Meyer",REF30949414,0.0,390.26,156906.62
2022-09-18,2022-09-18,Office supplies,REF39768501,17.29,0.0,156889.33
2022-09-19,2022-09-19,Office supplies,REF58404658,57.04,0.0,156832.29
2022-09-20,2022-09-20,Office supplies,REF76436633,34.62,0.0,156797.67
2022-09-28,2022-09-28,Marketing expenses,REF12641587,159.02,0.0,156638.65
2022-10-06,2022-10-06,Business travel,REF74066906,193.86,0.0,156444.79
2022-10-08,2022-10-08,Office supplies,REF68289110,66.09,0.0,156378.7
2022-10-09,2022-10-09,Software subscription,REF42110260,191.75,0.0,156186.95
2022-10-15,2022-10-15,Business insurance premium,REF78930798,143.34,0.0,156043.61
2022-10-15,2022-10-15,"Project payment - Crosby, Armstrong and Herrera",REF81319423,0.0,1778.1,157821.71
2022-10-15,2022-10-15,"Invoice payment - Liu, Buchanan and Meyer",REF84810566,0.0,346.1,158167.81
2022-10-15,2022-10-15,"Project payment - Moss, James and Edwards",REF72537401,0.0,1496.15,159663.96
2022-10-19,2022-10-19,Internet and phone service,REF96125609,88.54,0.0,159575.42
2022-10-29,2022-10-29,Professional services,REF50806777,228.22,0.0,159347.2
2022-10-30,2022-10-30,Office supplies,REF76930028,38.1,0.0,159309.1
2022-11-07,2022-11-07,Office supplies,REF35160410,59.1,0.0,159250.0
2022-11-09,2022-11-09,Software subscription,REF73231480,151.77,0.0,159098.23
2022-11-10,2022-11-10,Marketing expenses,REF85999955,202.7,0.0,158895.53
2022-11-11,2022-11-11,Office supplies,REF75603615,53.26,0.0,158842.27
2022-11-12,2022-11-12,Marketing expenses,REF18796225,288.95,0.0,158553.32
2022-11-12,2022-11-12,Office supplies,REF10389277,33.22,0.0,158520.1
2022-11-14,2022-11-14,Internet and phone service,REF52842655,87.56,0.0,158432.54
2022-11-15,2022-11-15,"Payment from Moss, James and Edwards",REF50006852,0.0,1832.65,160265.19
2022-11-15,2022-11-15,"Payment from Liu, Buchanan and Meyer",REF16861791,0.0,297.06,160562.25
2022-11-15,2022-11-15,"Payment from Crosby, Armstrong and Herrera",REF44205533,0.0,1681.24,162243.49
2022-11-15,2022-11-15,Business insurance premium,REF88215668,127.17,0.0,162116.32
2022-11-16,2022-11-16,Training/conference,REF43136055,122.56,0.0,161993.76
2022-11-20,2022-11-20,Equipment purchase,REF43787325,114.95,0.0,161878.81
2022-11-22,2022-11-22,Office supplies,REF62547133,64.85,0.0,161813.96
2022-11-22,2022-11-22,Training/conference,REF24193011,66.07,0.0,161747.89
2022-11-25,2022-11-25,Business travel,REF49552680,145.17,0.0,161602.72
2022-11-26,2022-11-26,Training/conference,REF61420936,100.38,0.0,161502.34
2022-11-27,2022-11-27,Training/conference,REF77309195,114.34,0.0,161388.0
2022-11-28,2022-11-28,Professional services,REF62309947,249.59,0.0,161138.41
2022-11-29,2022-11-29,Office supplies,REF61777269,69.09,0.0,161069.32
2022-12-01,2022-12-01,Office supplies,REF24724836,17.22,0.0,161052.1
2022-12-05,2022-12-05,Marketing expenses,REF21345910,202.08,0.0,160850.02
2022-12-06,2022-12-06,Business travel,REF68663877,156.14,0.0,160693.88
2022-12-09,2022-12-09,Software subscription,REF78817532,107.44,0.0,160586.44
2022-12-13,2022-12-13,Office supplies,REF57963643,41.21,0.0,160545.23
2022-12-15,2022-12-15,Business insurance premium,REF61490833,111.4,0.0,160433.83
2022-12-15,2022-12-15,"Project payment - Liu, Buchanan and Meyer",REF40212042,0.0,361.51,160795.34
2022-12-15,2022-12-15,"Service payment - Moss, James and Edwards",REF58438319,0.0,1452.19,162247.53
2022-12-15,2022-12-15,"Service payment - Crosby, Armstrong and Herrera",REF63773954,0.0,1239.39,163486.92
2022-12-16,2022-12-16,Marketing expenses,REF36241602,261.57,0.0,163225.35
2022-12-24,2022-12-24,Professional services,REF76293167,195.3,0.0,163030.05
2022-12-25,2022-12-25,Office supplies,REF49454120,44.86,0.0,162985.19
2022-12-26,2022-12-26,Office supplies,REF38027206,64.81,0.0,162920.38
2022-12-28,2022-12-28,Professional services,REF38015348,231.36,0.0,162689.02
2022-12-29,2022-12-29,Equipment purchase,REF37409896,87.72,0.0,162601.3
2022-12-31,2022-12-31,Office supplies,REF34040346,16.47,0.0,162584.83
2023-01-01,2023-01-01,Business travel,REF71440346,71.46,0.0,162513.37
2023-01-09,2023-01-09,Software subscription,REF61478009,139.69,0.0,162373.68
2023-01-11,2023-01-11,Office supplies,REF66547789,54.19,0.0,162319.49
2023-01-15,2023-01-15,"Payment from Moss, James and Edwards",REF86925357,0.0,1061.03,163380.52
2023-01-15,2023-01-15,"Payment from Crosby, Armstrong and Herrera",REF23077293,0.0,1359.98,164740.5
2023-01-15,2023-01-15,Business insurance premium,REF36886423,104.51,0.0,164635.99
2023-01-21,2023-01-21,Office supplies,REF93643569,75.42,0.0,164560.57
2023-01-21,2023-01-21,Professional services,REF22900537,122.93,0.0,164437.64
2023-01-23,2023-01-23,Business travel,REF80863413,192.08,0.0,164245.56
2023-01-25,2023-01-25,Office supplies,REF29572638,53.6,0.0,164191.96
2023-01-27,2023-01-27,Professional services,REF43521934,138.41,0.0,164053.55
2023-02-06,2023-02-06,Office supplies,REF63494350,52.81,0.0,164000.74
2023-02-09,2023-02-09,Software subscription,REF86534950,146.54,0.0,163854.2
2023-02-12,2023-02-12,Business travel,REF79746040,133.69,0.0,163720.51
2023-02-15,2023-02-15,"Payment from Liu, Buchanan and Meyer",REF69894525,0.0,299.53,164020.04
2023-02-15,2023-02-15,"Service payment - Moss, James and Edwards",REF41330378,0.0,1494.89,165514.93
2023-02-15,2023-02-15,Business insurance premium,REF17278796,96.74,0.0,165418.19
2023-02-15,2023-02-15,"Invoice payment - Crosby, Armstrong and Herrera",REF33609548,0.0,1227.62,166645.81
2023-02-18,2023-02-18,Internet and phone service,REF31765007,41.57,0.0,166604.24
2023-02-21,2023-02-21,Business travel,REF27546199,113.47,0.0,166490.77
2023-02-22,2023-02-22,Business travel,REF48699335,126.13,0.0,166364.64
2023-02-22,2023-02-22,Equipment purchase,REF99333131,96.24,0.0,166268.4
2023-03-03,2023-03-03,Professional services,REF90838200,167.21,0.0,166101.19
2023-03-07,2023-03-07,Equipment purchase,REF59028526,124.64,0.0,165976.55
2023-03-08,2023-03-08,Office supplies,REF71192496,42.49,0.0,165934.06
2023-03-09,2023-03-09,Software subscription,REF69077860,179.81,0.0,165754.25
2023-03-11,2023-03-11,Professional services,REF13967372,386.5,0.0,165367.75
2023-03-12,2023-03-12,Training/conference,REF15452330,130.61,0.0,165237.14
2023-03-13,2023-03-13,Office supplies,REF64937189,50.03,0.0,165187.11
2023-03-15,2023-03-15,"Service payment - Crosby, Armstrong and Herrera",REF81906764,0.0,1575.63,166762.74
2023-03-15,2023-03-15,Business insurance premium,REF66858308,137.4,0.0,166625.34
2023-03-15,2023-03-15,"Invoice payment - Liu, Buchanan and Meyer",REF97945039,0.0,397.2,167022.54
2023-03-15,2023-03-15,"Payment from Moss, James and Edwards",REF90506129,0.0,1784.2,168806.74
2023-03-23,2023-03-23,Professional services,REF60998519,255.47,0.0,168551.27
2023-03-23,2023-03-23,Business travel,REF25467751,231.82,0.0,168319.45
2023-03-30,2023-03-30,Equipment purchase,REF58722582,99.58,0.0,168219.87
2023-04-02,2023-04-02,Training/conference,REF34014861,123.43,0.0,168096.44
2023-04-03,2023-04-03,Training/conference,REF59128608,90.98,0.0,168005.46
2023-04-04,2023-04-04,Office supplies,REF23543483,59.97,0.0,167945.49
2023-04-05,2023-04-05,Office supplies,REF71402874,48.79,0.0,167896.7
2023-04-09,2023-04-09,Software subscription,REF34645749,191.64,0.0,167705.06
2023-04-10,2023-04-10,Business travel,REF93299937,220.37,0.0,167484.69
2023-04-11,2023-04-11,Internet and phone service,REF80696842,126.67,0.0,167358.02
2023-04-12,2023-04-12,Training/conference,REF90445836,134.33,0.0,167223.69
2023-04-15,2023-04-15,"Payment from Moss, James and Edwards",REF60811117,0.0,1875.98,169099.67
2023-04-15,2023-04-15,"Payment from Crosby, Armstrong and Herrera",REF80575681,0.0,1360.09,170459.76
2023-04-15,2023-04-15,Business insurance premium,REF15771797,112.6,0.0,170347.16
2023-04-15,2023-04-15,"Project payment - Liu, Buchanan and Meyer",REF34642160,0.0,303.08,170650.24
2023-04-19,2023-04-19,Marketing expenses,REF93380108,259.94,0.0,170390.3
2023-04-21,2023-04-21,Marketing expenses,REF54249137,153.9,0.0,170236.4
2023-04-22,2023-04-22,Office supplies,REF71340315,73.15,0.0,170163.25
2023-04-23,2023-04-23,Business travel,REF26533024,148.04,0.0,170015.21
2023-04-23,2023-04-23,Office supplies,REF76147803,10.46,0.0,170004.75
2023-05-08,2023-05-08,Office supplies,REF68624671,58.81,0.0,169945.94
2023-05-09,2023-05-09,Software subscription,REF19422824,142.99,0.0,169802.95
2023-05-09,2023-05-09,Marketing expenses,REF30614206,204.5,0.0,169598.45
2023-05-15,2023-05-15,"Invoice payment - Liu, Buchanan and Meyer",REF61229092,0.0,339.83,169938.28
2023-05-15,2023-05-15,"Service payment - Moss, James and Edwards",REF82176515,0.0,1720.13,171658.41
2023-05-15,2023-05-15,Business insurance premium,REF30893055,129.58,0.0,171528.83
2023-05-15,2023-05-15,"Invoice payment - Crosby, Armstrong and Herrera",REF88863831,0.0,1516.39,173045.22
2023-05-26,2023-05-26,Office supplies,REF73723258,60.55,0.0,172984.67
2023-05-28,2023-05-28,Office supplies,REF75946887,57.23,0.0,172927.44
2023-05-28,2023-05-28,Equipment purchase,REF15472717,122.68,0.0,172804.76
2023-06-07,2023-06-07,Equipment purchase,REF48476114,25.71,0.0,172779.05
2023-06-09,2023-06-09,Software subscription,REF21140108,119.23,0.0,172659.82
2023-06-10,2023-06-10,Marketing expenses,REF78204030,175.84,0.0,172483.98
2023-06-15,2023-06-15,Office supplies,REF64287843,42.78,0.0,172441.2
2023-06-15,2023-06-15,"Service payment - Crosby, Armstrong and Herrera",REF56599103,0.0,1330.9,173772.1
2023-06-15,2023-06-15,"Invoice payment - Moss, James and Edwards",REF35561998,0.0,1435.5,175207.6
2023-06-15,2023-06-15,"Payment from Liu, Buchanan and Meyer",REF80497657,0.0,283.96,175491.56
2023-06-15,2023-06-15,Business insurance premium,REF94028543,100.9,0.0,175390.66
2023-06-22,2023-06-22,Business travel,REF40846994,127.8,0.0,175262.86
2023-06-28,2023-06-28,Office supplies,REF19337930,43.39,0.0,175219.47
2023-06-29,2023-06-29,Internet and phone service,REF35569275,71.62,0.0,175147.85
2023-07-01,2023-07-01,Business travel,REF61891805,50.79,0.0,175097.06
2023-07-07,2023-07-07,Training/conference,REF77931438,66.97,0.0,175030.09
2023-07-09,2023-07-09,Software subscription,REF81341165,119.24,0.0,174910.85
2023-07-09,2023-07-09,Office supplies,REF57416589,49.72,0.0,174861.13
2023-07-11,2023-07-11,Professional services,REF24146527,154.73,0.0,174706.4
2023-07-13,2023-07-13,Equipment purchase,REF92760696,58.45,0.0,174647.95
2023-07-14,2023-07-14,Office supplies,REF90149875,39.64,0.0,174608.31
2023-07-15,2023-07-15,Business insurance premium,REF36578466,99.06,0.0,174509.25
2023-07-15,2023-07-15,"Payment from Crosby, Armstrong and Herrera",REF86182632,0.0,1067.5,175576.75
2023-07-15,2023-07-15,"Service payment - Liu, Buchanan and Meyer",REF84128002,0.0,309.95,175886.7
2023-07-15,2023-07-15,"Invoice payment - Moss, James and Edwards",REF83534848,0.0,1124.48,177011.18
2023-07-26,2023-07-26,Office supplies,REF12106117,36.92,0.0,176974.26
2023-07-27,2023-07-27,Office supplies,REF76659630,53.24,0.0,176921.02
2023-08-03,2023-08-03,Office supplies,REF56376316,37.09,0.0,176883.93
2023-08-04,2023-08-04,Internet and phone service,REF50421798,58.41,0.0,176825.52
2023-08-09,2023-08-09,Software subscription,REF87472755,98.5,0.0,176727.02
2023-08-11,2023-08-11,Office supplies,REF23557093,21.44,0.0,176705.58
2023-08-15,2023-08-15,"Invoice payment - Liu, Buchanan and Meyer",REF11664957,0.0,205.28,176910.86
2023-08-15,2023-08-15,Business insurance premium,REF59780461,87.65,0.0,176823.21
2023-08-15,2023-08-15,"Invoice payment - Moss, James and Edwards",REF70768616,0.0,1042.63,177865.84
2023-08-19,2023-08-19,Office supplies,REF55575082,19.66,0.0,177846.18
2023-08-23,2023-08-23,Equipment purchase,REF24877686,56.52,0.0,177789.66
2023-08-24,2023-08-24,Professional services,REF87811414,179.4,0.0,177610.26
2023-08-25,2023-08-25,Internet and phone service,REF16774110,66.44,0.0,177543.82
2023-08-30,2023-08-30,Professional services,REF10849115,135.85,0.0,177407.97
2023-08-30,2023-08-30,Office supplies,REF38388389,41.99,0.0,177365.98
2023-08-31,2023-08-31,Professional services,REF18443226,211.68,0.0,177154.3
2023-08-31,2023-08-31,Training/conference,REF57129435,45.6,0.0,177108.7
2023-09-01,2023-09-01,Marketing expenses,REF42786491,290.4,0.0,176818.3
2023-09-05,2023-09-05,Office supplies,REF49477051,74.67,0.0,176743.63
2023-09-06,2023-09-06,Internet and phone service,REF65885991,122.09,0.0,176621.54
2023-09-09,2023-09-09,Software subscription,REF35513364,183.21,0.0,176438.33
2023-09-10,2023-09-10,Marketing expenses,REF76512175,186.29,0.0,176252.04
2023-09-11,2023-09-11,Business travel,REF66633006,110.16,0.0,176141.88
2023-09-13,2023-09-13,Professional services,REF99941965,140.44,0.0,176001.44
2023-09-14,2023-09-14,Business travel,REF19109013,51.24,0.0,175950.2
2023-09-14,2023-09-14,Internet and phone service,REF94015224,81.43,0.0,175868.77
2023-09-15,2023-09-15,"Invoice payment - Moss, James and Edwards",REF56726159,0.0,1526.14,177394.91
2023-09-15,2023-09-15,"Project payment - Crosby, Armstrong and Herrera",REF96951080,0.0,1351.11,178746.02
2023-09-15,2023-09-15,"Project payment - Liu, Buchanan and Meyer",REF34765078,0.0,388.61,179134.63
2023-09-15,2023-09-15,Business insurance premium,REF44994080,129.61,0.0,179005.02
2023-09-21,2023-09-21,Marketing expenses,REF43081629,206.19,0.0,178798.83
2023-09-25,2023-09-25,Office supplies,REF79988701,49.4,0.0,178749.43
2023-09-29,2023-09-29,Office supplies,REF98523914,72.67,0.0,178676.76
2023-10-04,2023-10-04,Office supplies,REF57177109,57.91,0.0,178618.85
2023-10-05,2023-10-05,Office supplies,REF64255969,14.92,0.0,178603.93
2023-10-07,2023-10-07,Professional services,REF58090775,483.92,0.0,178120.01
2023-10-08,2023-10-08,Office supplies,REF52094249,50.65,0.0,178069.36
2023-10-08,2023-10-08,Internet and phone service,REF17878263,110.89,0.0,177958.47
2023-10-08,2023-10-08,Training/conference,REF51877127,134.31,0.0,177824.16
2023-10-09,2023-10-09,Software subscription,REF33123045,208.78,0.0,177615.38
2023-10-10,2023-10-10,Training/conference,REF81652544,122.88,0.0,177492.5
2023-10-11,2023-10-11,Office supplies,REF90909425,39.96,0.0,177452.54
2023-10-12,2023-10-12,Professional services,REF83584108,271.61,0.0,177180.93
2023-10-14,2023-10-14,Professional services,REF84433356,418.84,0.0,176762.09
2023-10-15,2023-10-15,Business insurance premium,REF70515645,137.54,0.0,176624.55
2023-10-15,2023-10-15,"Payment from Moss, James and Edwards",REF35128378,0.0,2472.4,179096.95
2023-10-15,2023-10-15,"Service payment - Liu, Buchanan and Meyer",REF78986847,0.0,405.25,179502.2
2023-10-15,2023-10-15,"Invoice payment - Crosby, Armstrong and Herrera",REF35344234,0.0,1749.5,181251.7
2023-10-19,2023-10-19,Office supplies,REF45849548,61.97,0.0,181189.73
2023-10-20,2023-10-20,Internet and phone service,REF46424253,121.02,0.0,181068.71
2023-10-21,2023-10-21,Business travel,REF27437558,135.6,0.0,180933.11
2023-10-23,2023-10-23,Office supplies,REF32668041,41.21,0.0,180891.9
2023-10-24,2023-10-24,Office supplies,REF24409262,50.96,0.0,180840.94
2023-10-26,2023-10-26,Marketing expenses,REF64791411,225.1,0.0,180615.84
2023-10-28,2023-10-28,Office supplies,REF58012246,43.0,0.0,180572.84
2023-10-31,2023-10-31,Office supplies,REF86904957,94.13,0.0,180478.71
2023-11-02,2023-11-02,Training/conference,REF13786489,85.37,0.0,180393.34
2023-11-06,2023-11-06,Professional services,REF33788747,171.16,0.0,180222.18
2023-11-07,2023-11-07,Professional services,REF13479727,310.66,0.0,179911.52
2023-11-09,2023-11-09,Software subscription,REF73637742,173.34,0.0,179738.18
2023-11-09,2023-11-09,Internet and phone service,REF27829564,84.47,0.0,179653.71
2023-11-13,2023-11-13,Internet and phone service,REF20600521,80.22,0.0,179573.49
2023-11-15,2023-11-15,Business insurance premium,REF48310490,128.24,0.0,179445.25
2023-11-15,2023-11-15,Internet and phone service,REF76533139,55.0,0.0,179390.25
2023-11-15,2023-11-15,"Service payment - Crosby, Armstrong and Herrera",REF97103003,0.0,1391.57,180781.82
2023-11-15,2023-11-15,"Payment from Moss, James and Edwards",REF28032447,0.0,1630.87,182412.69
2023-11-15,2023-11-15,"Service payment - Liu, Buchanan and Meyer",REF58659351,0.0,364.91,182777.6
2023-11-22,2023-11-22,Business travel,REF41206604,85.89,0.0,182691.71
2023-11-28,2023-11-28,Professional services,REF70034963,356.56,0.0,182335.15
2023-12-01,2023-12-01,Internet and phone service,REF59826300,67.77,0.0,182267.38
2023-12-02,2023-12-02,Business travel,REF37360117,156.04,0.0,182111.34
2023-12-03,2023-12-03,Marketing expenses,REF18053490,142.3,0.0,181969.04
2023-12-04,2023-12-04,Office supplies,REF10730050,63.21,0.0,181905.83
2023-12-09,2023-12-09,Software subscription,REF92074371,126.94,0.0,181778.89
2023-12-10,2023-12-10,Office supplies,REF40821305,35.19,0.0,181743.7
2023-12-15,2023-12-15,Business insurance premium,REF14490726,97.39,0.0,181646.31
2023-12-15,2023-12-15,Marketing expenses,REF22907329,150.34,0.0,181495.97
2023-12-15,2023-12-15,"Payment from Moss, James and Edwards",REF78657322,0.0,1383.92,182879.89
2023-12-15,2023-12-15,"Service payment - Crosby, Armstrong and Herrera",REF44039597,0.0,1741.59,184621.48
2023-12-15,2023-12-15,Internet and phone service,REF19571103,62.43,0.0,184559.05
2023-12-21,2023-12-21,Internet and phone service,REF87311415,87.4,0.0,184471.65
2023-12-23,2023-12-23,Equipment purchase,REF65767944,85.32,0.0,184386.33
2023-12-24,2023-12-24,Internet and phone service,REF60116617,52.44,0.0,184333.89
2023-12-29,2023-12-29,Office supplies,REF64350501,15.16,0.0,184318.73
2023-12-30,2023-12-30,Professional services,REF22131353,244.6,0.0,184074.13
2024-01-02,2024-01-02,Internet and phone service,REF35199481,90.64,0.0,183983.49
2024-01-03,2024-01-03,Marketing expenses,REF21597372,129.72,0.0,183853.77
2024-01-09,2024-01-09,Software subscription,REF83391376,112.76,0.0,183741.01
2024-01-09,2024-01-09,Training/conference,REF31542711,84.07,0.0,183656.94
2024-01-10,2024-01-10,Internet and phone service,REF71476319,74.54,0.0,183582.4
2024-01-11,2024-01-11,Office supplies,REF89465264,43.64,0.0,183538.76
2024-01-11,2024-01-11,Marketing expenses,REF78501439,114.66,0.0,183424.1
2024-01-15,2024-01-15,"Project payment - Liu, Buchanan and Meyer",REF20927625,0.0,223.36,183647.46
2024-01-15,2024-01-15,"Service payment - Moss, James and Edwards",REF22952247,0.0,1040.78,184688.24
2024-01-15,2024-01-15,Business insurance premium,REF58512624,93.7,0.0,184594.54
2024-01-15,2024-01-15,"Payment from Crosby, Armstrong and Herrera",REF68948641,0.0,1219.57,185814.11
2024-01-21,2024-01-21,Professional services,REF48523808,116.45,0.0,185697.66
2024-01-21,2024-01-21,Marketing expenses,REF71531389,108.25,0.0,185589.41
2024-02-03,2024-02-03,Marketing expenses,REF24577064,189.66,0.0,185399.75
2024-02-07,2024-02-07,Professional services,REF28671336,187.81,0.0,185211.94
2024-02-08,2024-02-08,Training/conference,REF19131402,83.24,0.0,185128.7
2024-02-09,2024-02-09,Software subscription,REF83449190,143.91,0.0,184984.79
2024-02-12,2024-02-12,Marketing expenses,REF54009976,258.44,0.0,184726.35
2024-02-14,2024-02-14,Equipment purchase,REF31833342,101.11,0.0,184625.24
2024-02-15,2024-02-15,Business insurance premium,REF63548519,103.83,0.0,184521.41
2024-02-15,2024-02-15,"Payment from Crosby, Armstrong and Herrera",REF22707067,0.0,1004.23,185525.64
2024-02-15,2024-02-15,"Invoice payment - Moss, James and Edwards",REF61532534,0.0,1610.53,187136.17
2024-02-20,2024-02-20,Business travel,REF63703946,88.49,0.0,187047.68
2024-02-20,2024-02-20,Marketing expenses,REF85711615,64.21,0.0,186983.47
2024-02-24,2024-02-24,Training/conference,REF75084262,73.34,0.0,186910.13
2024-02-24,2024-02-24,Business travel,REF36885574,114.07,0.0,186796.06
2024-03-01,2024-03-01,Office supplies,REF35007710,59.2,0.0,186736.86
2024-03-04,2024-03-04,Equipment purchase,REF95322486,131.75,0.0,186605.11
2024-03-09,2024-03-09,Software subscription,REF95201550,168.33,0.0,186436.78
2024-03-14,2024-03-14,Internet and phone service,REF76009488,65.09,0.0,186371.69
2024-03-15,2024-03-15,"Service payment - Crosby, Armstrong and Herrera",REF10481175,0.0,1524.68,187896.37
2024-03-15,2024-03-15,"Payment from Liu, Buchanan and Meyer",REF21274622,0.0,312.45,188208.82
2024-03-15,2024-03-15,"Service payment - Moss, James and Edwards",REF63485161,0.0,1344.47,189553.29
2024-03-15,2024-03-15,Business insurance premium,REF88460585,130.67,0.0,189422.62
2024-03-16,2024-03-16,Internet and phone service,REF62605157,120.67,0.0,189301.95
2024-03-18,2024-03-18,Professional services,REF70554473,480.25,0.0,188821.7
2024-03-18,2024-03-18,Marketing expenses,REF59806829,277.88,0.0,188543.82
2024-03-22,2024-03-22,Equipment purchase,REF24851951,137.12,0.0,188406.7
2024-03-24,2024-03-24,Marketing expenses,REF13617993,274.49,0.0,188132.21
2024-03-28,2024-03-28,Equipment purchase,REF51491910,80.22,0.0,188051.99
2024-04-02,2024-04-02,Equipment purchase,REF57590383,71.49,0.0,187980.5
2024-04-03,2024-04-03,Office supplies,REF56578469,29.96,0.0,187950.54
2024-04-08,2024-04-08,Business travel,REF97403082,181.7,0.0,187768.84
2024-04-09,2024-04-09,Software subscription,REF78390346,157.0,0.0,187611.84
2024-04-13,2024-04-13,Internet and phone service,REF51294618,60.01,0.0,187551.83
2024-04-14,2024-04-14,Office supplies,REF63705795,47.73,0.0,187504.1
2024-04-15,2024-04-15,"Payment from Liu, Buchanan and Meyer",REF38836170,0.0,312.59,187816.69
2024-04-15,2024-04-15,Business insurance premium,REF82160888,125.34,0.0,187691.35
2024-04-15,2024-04-15,Marketing expenses,REF68832363,183.89,0.0,187507.46
2024-04-15,2024-04-15,"Payment from Crosby, Armstrong and Herrera",REF13999219,0.0,1643.91,189151.37
2024-04-15,2024-04-15,"Service payment - Moss, James and Edwards",REF72363515,0.0,1660.35,190811.72
2024-04-19,2024-04-19,Internet and phone service,REF90865447,96.79,0.0,190714.93
2024-04-19,2024-04-19,Business travel,REF90832945,149.72,0.0,190565.21
2024-04-20,2024-04-20,Office supplies,REF69965398,50.97,0.0,190514.24
2024-04-25,2024-04-25,Equipment purchase,REF87732930,134.54,0.0,190379.7
2024-04-27,2024-04-27,Office supplies,REF23030495,56.74,0.0,190322.96
2024-05-01,2024-05-01,Marketing expenses,REF98568389,170.96,0.0,190152.0
2024-05-03,2024-05-03,Marketing expenses,REF47379455,133.86,0.0,190018.14
2024-05-04,2024-05-04,Office supplies,REF45490180,80.95,0.0,189937.19
2024-05-06,2024-05-06,Business travel,REF24422801,167.92,0.0,189769.27
2024-05-09,2024-05-09,Software subscription,REF19733081,157.24,0.0,189612.03
2024-05-09,2024-05-09,Office supplies,REF26824281,49.19,0.0,189562.84
2024-05-12,2024-05-12,Training/conference,REF17175206,111.19,0.0,189451.65
2024-05-15,2024-05-15,Professional services,REF83563471,300.57,0.0,189151.08
2024-05-15,2024-05-15,"Invoice payment - Moss, James and Edwards",REF56572222,0.0,1972.61,191123.69
2024-05-15,2024-05-15,Business insurance premium,REF28440564,111.16,0.0,191012.53
2024-05-15,2024-05-15,"Service payment - Crosby, Armstrong and Herrera",REF20222393,0.0,1665.42,192677.95
2024-05-15,2024-05-15,"Invoice payment - Liu, Buchanan and Meyer",REF91065704,0.0,401.55,193079.5
2024-05-17,2024-05-17,Business travel,REF25860190,82.87,0.0,192996.63
2024-05-19,2024-05-19,Marketing expenses,REF21295055,157.68,0.0,192838.95
2024-05-20,2024-05-20,Training/conference,REF46935940,137.38,0.0,192701.57
2024-05-23,2024-05-23,Internet and phone service,REF82562107,64.02,0.0,192637.55
2024-05-28,2024-05-28,Office supplies,REF95580873,62.35,0.0,192575.2
2024-05-30,2024-05-30,Equipment purchase,REF27973953,70.46,0.0,192504.74
2024-06-06,2024-06-06,Marketing expenses,REF25425371,160.01,0.0,192344.73
2024-06-09,2024-06-09,Software subscription,REF14770418,140.39,0.0,192204.34
2024-06-15,2024-06-15,Business insurance premium,REF97825007,106.14,0.0,192098.2
2024-06-15,2024-06-15,"Project payment - Crosby, Armstrong and Herrera",REF84449431,0.0,1245.15,193343.35
2024-06-15,2024-06-15,"Service payment - Moss, James and Edwards",REF76813501,0.0,1294.76,194638.11
2024-06-15,2024-06-15,"Invoice payment - Liu, Buchanan and Meyer",REF67991671,0.0,385.78,195023.89
2024-06-22,2024-06-22,Office supplies,REF29606310,28.21,0.0,194995.68
2024-07-02,2024-07-02,Business travel,REF80043445,139.84,0.0,194855.84
2024-07-03,2024-07-03,Internet and phone service,REF97417611,50.01,0.0,194805.83
2024-07-09,2024-07-09,Software subscription,REF92312658,105.43,0.0,194700.4
2024-07-09,2024-07-09,Internet and phone service,REF30875433,87.49,0.0,194612.91
2024-07-10,2024-07-10,Office supplies,REF93449014,53.36,0.0,194559.55
2024-07-11,2024-07-11,Training/conference,REF86930029,76.84,0.0,194482.71
2024-07-13,2024-07-13,Equipment purchase,REF89348882,99.38,0.0,194383.33
2024-07-15,2024-07-15,Business insurance premium,REF45141401,81.58,0.0,194301.75
2024-07-15,2024-07-15,"Payment from Moss, James and Edwards",REF60075299,0.0,1438.89,195740.64
2024-07-15,2024-07-15,"Payment from Crosby, Armstrong and Herrera",REF90832395,0.0,1106.39,196847.03
2024-07-15,2024-07-15,"Project payment - Liu, Buchanan and Meyer",REF36998881,0.0,329.8,197176.83
2024-07-29,2024-07-29,Office supplies,REF36321481,35.76,0.0,197141.07
2024-08-04,2024-08-04,Office supplies,REF84445337,21.81,0.0,197119.26
2024-08-04,2024-08-04,Equipment purchase,REF28481011,116.14,0.0,197003.12
2024-08-06,2024-08-06,Professional services,REF28004329,110.73,0.0,196892.39
2024-08-07,2024-08-07,Professional services,REF17396729,277.53,0.0,196614.86
2024-08-07,2024-08-07,Office supplies,REF44944464,42.14,0.0,196572.72
2024-08-08,2024-08-08,Office supplies,REF85314706,22.73,0.0,196549.99
2024-08-09,2024-08-09,Software subscription,REF57926944,89.53,0.0,196460.46
2024-08-09,2024-08-09,Office supplies,REF29017250,49.31,0.0,196411.15
2024-08-15,2024-08-15,"Service payment - Crosby, Armstrong and Herrera",REF89592693,0.0,803.11,197214.26
2024-08-15,2024-08-15,"Service payment - Moss, James and Edwards",REF23435322,0.0,1124.59,198338.85
2024-08-15,2024-08-15,"Service payment - Liu, Buchanan and Meyer",REF70285135,0.0,210.69,198549.54
2024-08-15,2024-08-15,Business insurance premium,REF67338879,88.17,0.0,198461.37
2015-08-20,2015-08-20,Internet and phone service,REF27898458,81.87,0.0,7452.66
2015-08-22,2015-08-22,Internet and phone service,REF50683333,68.86,0.0,7383.8
2015-08-23,2015-08-23,Professional services,REF20113011,11.89,0.0,7371.91
2015-08-23,2015-08-23,Marketing expenses,REF24931888,170.1,0.0,7201.81
2015-08-30,2015-08-30,Business travel,REF19251220,125.73,0.0,7076.08
2015-08-31,2015-08-31,Office supplies,REF74901935,50.31,0.0,7025.77
2015-09-02,2015-09-02,Office supplies,REF93107108,24.31,0.0,7001.46
2015-09-03,2015-09-03,Office supplies,REF22269489,77.03,0.0,6924.43
2015-09-07,2015-09-07,Office supplies,REF26966144,76.65,0.0,6847.78
2015-09-08,2015-09-08,Business travel,REF10970208,237.76,0.0,6610.02
2015-09-09,2015-09-09,Software subscription,REF50513877,179.23,0.0,6430.79
2015-09-15,2015-09-15,Business insurance premium,REF77023757,134.92,0.0,6295.87
2015-09-15,2015-09-15,Invoice payment - Medina and Sons,REF22720609,0.0,2557.31,8853.18
2015-09-15,2015-09-15,Payment from Cunningham-Barton,REF39689368,0.0,1649.85,10503.03
2015-09-15,2015-09-15,Payment from Dunn-Wilson,REF26386987,0.0,1210.68,11713.71
2015-09-19,2015-09-19,Business travel,REF71088598,105.27,0.0,11608.44
2015-09-21,2015-09-21,Office supplies,REF64165861,31.53,0.0,11576.91
2015-09-23,2015-09-23,Office supplies,REF44763547,42.72,0.0,11534.19
2015-10-03,2015-10-03,Internet and phone service,REF72747584,119.1,0.0,11415.09
2015-10-04,2015-10-04,Internet and phone service,REF32058247,116.84,0.0,11298.25
2015-10-06,2015-10-06,Office supplies,REF41788504,73.43,0.0,11224.82
2015-10-09,2015-10-09,Software subscription,REF36736934,189.35,0.0,11035.47
2015-10-13,2015-10-13,Marketing expenses,REF90685287,316.51,0.0,10718.96
2015-10-15,2015-10-15,Service payment - Cunningham-Barton,REF71159720,0.0,1758.8,12477.76
2015-10-15,2015-10-15,Invoice payment - Medina and Sons,REF47920314,0.0,3027.11,15504.87
2015-10-15,2015-10-15,Business insurance premium,REF22445207,155.75,0.0,15349.12
2015-10-15,2015-10-15,Payment from Dunn-Wilson,REF57770797,0.0,1497.78,16846.9
2015-10-16,2015-10-16,Office supplies,REF81964468,88.28,0.0,16758.62
2015-10-24,2015-10-24,Office supplies,REF29821910,84.66,0.0,16673.96
2015-10-24,2015-10-24,Business travel,REF91150123,198.6,0.0,16475.36
2015-10-31,2015-10-31,Business travel,REF74081661,196.5,0.0,16278.86
2015-11-04,2015-11-04,Business travel,REF39903675,109.23,0.0,16169.63
2015-11-05,2015-11-05,Office supplies,REF10433296,73.71,0.0,16095.92
2015-11-06,2015-11-06,Marketing expenses,REF61153552,180.68,0.0,15915.24
2015-11-07,2015-11-07,Professional services,REF28552388,258.38,0.0,15656.86
2015-11-08,2015-11-08,Office supplies,REF36111365,68.75,0.0,15588.11
2015-11-09,2015-11-09,Professional services,REF36543717,375.49,0.0,15212.62
2015-11-09,2015-11-09,Software subscription,REF66775552,157.55,0.0,15055.07
2015-11-10,2015-11-10,Office supplies,REF84852393,73.21,0.0,14981.86
2015-11-11,2015-11-11,Business travel,REF10755002,156.94,0.0,14824.92
2015-11-15,2015-11-15,Business insurance premium,REF95190661,137.36,0.0,14687.56
2015-11-15,2015-11-15,Service payment - Medina and Sons,REF11707816,0.0,2212.38,16899.94
2015-11-15,2015-11-15,Payment from Dunn-Wilson,REF33927541,0.0,1154.56,18054.5
2015-11-15,2015-11-15,Invoice payment - Cunningham-Barton,REF50572071,0.0,1567.74,19622.24
2015-11-22,2015-11-22,Equipment purchase,REF90690277,105.12,0.0,19517.12
2015-11-22,2015-11-22,Marketing expenses,REF46622799,235.15,0.0,19281.97
2015-11-22,2015-11-22,Professional services,REF61832090,232.79,0.0,19049.18
2015-11-23,2015-11-23,Office supplies,REF99757180,48.49,0.0,19000.69
2015-11-27,2015-11-27,Business travel,REF36153789,160.5,0.0,18840.19
2015-12-02,2015-12-02,Equipment purchase,REF72765650,85.01,0.0,18755.18
2015-12-04,2015-12-04,Training/conference,REF82166611,143.62,0.0,18611.56
2015-12-09,2015-12-09,Software subscription,REF70182601,153.11,0.0,18458.45
2015-12-15,2015-12-15,Business insurance premium,REF90696284,110.66,0.0,18347.79
2015-12-15,2015-12-15,Project payment - Cunningham-Barton,REF21673401,0.0,1274.1,19621.89
2015-12-15,2015-12-15,Payment from Medina and Sons,REF61475775,0.0,1346.55,20968.44
2015-12-15,2015-12-15,Service payment - Dunn-Wilson,REF16118841,0.0,972.73,21941.17
2015-12-17,2015-12-17,Business travel,REF65587249,108.4,0.0,21832.77
2015-12-23,2015-12-23,Professional services,REF39487529,303.59,0.0,21529.18
2015-12-25,2015-12-25,Training/conference,REF41083065,118.57,0.0,21410.61
2015-12-25,2015-12-25,Equipment purchase,REF90953728,66.19,0.0,21344.42
2016-01-01,2016-01-01,Marketing expenses,REF20729130,197.48,0.0,21146.94
2016-01-02,2016-01-02,Training/conference,REF55014595,63.84,0.0,21083.1
2016-01-05,2016-01-05,Training/conference,REF54307270,121.14,0.0,20961.96
2016-01-07,2016-01-07,Business travel,REF79135042,156.88,0.0,20805.08
2016-01-09,2016-01-09,Software subscription,REF40868124,129.01,0.0,20676.07
2016-01-15,2016-01-15,Business travel,REF76037869,133.18,0.0,20542.89
2016-01-15,2016-01-15,Project payment - Cunningham-Barton,REF20216028,0.0,1004.06,21546.95
2016-01-15,2016-01-15,Invoice payment - Dunn-Wilson,REF20942217,0.0,774.57,22321.52
2016-01-15,2016-01-15,Business insurance premium,REF65803491,96.59,0.0,22224.93
2016-01-19,2016-01-19,Marketing expenses,REF10863201,120.65,0.0,22104.28
2016-01-20,2016-01-20,Professional services,REF66234898,217.76,0.0,21886.52
2016-01-22,2016-01-22,Business travel,REF67862861,94.3,0.0,21792.22
2016-01-26,2016-01-26,Office supplies,REF46573930,55.6,0.0,21736.62
2016-01-26,2016-01-26,Equipment purchase,REF25975724,45.71,0.0,21690.91
2016-01-29,2016-01-29,Professional services,REF89960490,170.04,0.0,21520.87
2016-02-01,2016-02-01,Office supplies,REF56502609,42.79,0.0,21478.08
2016-02-02,2016-02-02,Office supplies,REF22555442,70.52,0.0,21407.56
2016-02-07,2016-02-07,Business travel,REF11565404,189.89,0.0,21217.67
2016-02-08,2016-02-08,Marketing expenses,REF37447425,226.23,0.0,20991.44
2016-02-09,2016-02-09,Software subscription,REF30417477,135.57,0.0,20855.87
2016-02-11,2016-02-11,Office supplies,REF11624837,5.29,0.0,20850.58
2016-02-14,2016-02-14,Business travel,REF47946937,135.45,0.0,20715.13
2016-02-14,2016-02-14,Internet and phone service,REF98219706,51.57,0.0,20663.56
2016-02-15,2016-02-15,Business insurance premium,REF10421723,113.23,0.0,20550.33
2016-02-15,2016-02-15,Invoice payment - Cunningham-Barton,REF83909168,0.0,1632.45,22182.78
2016-02-15,2016-02-15,Project payment - Dunn-Wilson,REF33503115,0.0,1028.43,23211.21
2016-02-15,2016-02-15,Project payment - Medina and Sons,REF28203706,0.0,1871.46,25082.67
2016-02-15,2016-02-15,Business travel,REF31900308,86.26,0.0,24996.41
2016-02-17,2016-02-17,Internet and phone service,REF17863700,110.02,0.0,24886.39
2016-02-19,2016-02-19,Business travel,REF39102737,193.53,0.0,24692.86
2016-02-21,2016-02-21,Office supplies,REF20589609,53.36,0.0,24639.5
2016-02-23,2016-02-23,Internet and phone service,REF77229827,77.31,0.0,24562.19
2016-02-24,2016-02-24,Office supplies,REF71497256,45.21,0.0,24516.98
2016-02-25,2016-02-25,Office supplies,REF46078099,20.31,0.0,24496.67
2016-03-04,2016-03-04,Office supplies,REF97536844,65.09,0.0,24431.58
2016-03-08,2016-03-08,Training/conference,REF70732947,150.41,0.0,24281.17
2016-03-09,2016-03-09,Software subscription,REF78238987,173.64,0.0,24107.53
2016-03-11,2016-03-11,Marketing expenses,REF35743358,249.23,0.0,23858.3
2016-03-15,2016-03-15,Project payment - Dunn-Wilson,REF74292242,0.0,844.13,24702.43
2016-03-15,2016-03-15,Marketing expenses,REF24663320,187.81,0.0,24514.62
2016-03-15,2016-03-15,Project payment - Medina and Sons,REF50804049,0.0,1871.48,26386.1
2016-03-15,2016-03-15,Business insurance premium,REF35126390,133.58,0.0,26252.52
2016-03-15,2016-03-15,Service payment - Cunningham-Barton,REF84949383,0.0,1564.44,27816.96
2016-03-20,2016-03-20,Office supplies,REF92959747,55.51,0.0,27761.45
2016-03-22,2016-03-22,Business travel,REF41903502,238.57,0.0,27522.88
2016-03-23,2016-03-23,Office supplies,REF97413694,44.81,0.0,27478.07
2016-03-26,2016-03-26,Office supplies,REF96824644,27.53,0.0,27450.54
2016-03-31,2016-03-31,Equipment purchase,REF22509659,199.41,0.0,27251.13
2016-04-01,2016-04-01,Office supplies,REF99235187,46.11,0.0,27205.02
2016-04-09,2016-04-09,Software subscription,REF70362238,135.7,0.0,27069.32
2016-04-14,2016-04-14,Professional services,REF84400627,164.06,0.0,26905.26
2016-04-15,2016-04-15,Service payment - Dunn-Wilson,REF87344780,0.0,1590.15,28495.41
2016-04-15,2016-04-15,Invoice payment - Medina and Sons,REF64597289,0.0,1643.64,30139.05
2016-04-15,2016-04-15,Business insurance premium,REF92170976,118.25,0.0,30020.8
2016-04-15,2016-04-15,Service payment - Cunningham-Barton,REF88657198,0.0,1522.96,31543.76
2016-04-16,2016-04-16,Internet and phone service,REF44363403,53.18,0.0,31490.58
2016-04-16,2016-04-16,Office supplies,REF30722045,76.56,0.0,31414.02
2016-04-26,2016-04-26,Business travel,REF73334398,163.93,0.0,31250.09
2016-04-29,2016-04-29,Office supplies,REF37428945,46.86,0.0,31203.23
2016-04-30,2016-04-30,Internet and phone service,REF55013722,89.48,0.0,31113.75
2016-05-01,2016-05-01,Internet and phone service,REF26258472,41.1,0.0,31072.65
2016-05-02,2016-05-02,Internet and phone service,REF14825783,47.67,0.0,31024.98
2016-05-05,2016-05-05,Training/conference,REF99587633,69.75,0.0,30955.23
2016-05-09,2016-05-09,Software subscription,REF22468692,151.76,0.0,30803.47
2016-05-11,2016-05-11,Professional services,REF70613494,199.61,0.0,30603.86
2016-05-15,2016-05-15,Payment from Medina and Sons,REF56875749,0.0,1565.78,32169.64
2016-05-15,2016-05-15,Payment from Cunningham-Barton,REF21160095,0.0,1357.27,33526.91
2016-05-15,2016-05-15,Business insurance premium,REF59029556,129.43,0.0,33397.48
2016-05-17,2016-05-17,Office supplies,REF34923183,50.15,0.0,33347.33
2016-05-19,2016-05-19,Office supplies,REF58700869,58.36,0.0,33288.97
2016-05-24,2016-05-24,Internet and phone service,REF97940359,70.56,0.0,33218.41
2016-05-25,2016-05-25,Office supplies,REF24886256,31.72,0.0,33186.69
2016-05-26,2016-05-26,Business travel,REF55625045,144.18,0.0,33042.51
2016-05-27,2016-05-27,Training/conference,REF11233801,83.19,0.0,32959.32
2016-06-02,2016-06-02,Internet and phone service,REF65853313,125.01,0.0,32834.31
2016-06-08,2016-06-08,Business travel,REF59196917,151.11,0.0,32683.2
2016-06-09,2016-06-09,Software subscription,REF51379701,121.43,0.0,32561.77
2016-06-15,2016-06-15,Business insurance premium,REF14768954,110.41,0.0,32451.36
2016-06-15,2016-06-15,Office supplies,REF38160620,38.94,0.0,32412.42
2016-06-15,2016-06-15,Service payment - Medina and Sons,REF41744706,0.0,1481.11,33893.53
2016-06-15,2016-06-15,Service payment - Dunn-Wilson,REF60007642,0.0,1368.08,35261.61
2016-06-24,2016-06-24,Office supplies,REF53554285,22.42,0.0,35239.19
2016-06-27,2016-06-27,Equipment purchase,REF39324013,119.41,0.0,35119.78
2016-06-28,2016-06-28,Training/conference,REF68986004,113.05,0.0,35006.73
2016-06-28,2016-06-28,Business travel,REF85507229,130.27,0.0,34876.46
2016-07-01,2016-07-01,Internet and phone service,REF78271741,78.95,0.0,34797.51
2016-07-04,2016-07-04,Business travel,REF78101194,125.03,0.0,34672.48
2016-07-08,2016-07-08,Professional services,REF14843562,206.1,0.0,34466.38
2016-07-09,2016-07-09,Software subscription,REF85127071,125.8,0.0,34340.58
2016-07-10,2016-07-10,Internet and phone service,REF75479707,34.77,0.0,34305.81
2016-07-12,2016-07-12,Marketing expenses,REF13477381,160.42,0.0,34145.39
2016-07-15,2016-07-15,Business insurance premium,REF31145891,101.34,0.0,34044.05
2016-07-15,2016-07-15,Project payment - Cunningham-Barton,REF45636743,0.0,1224.87,35268.92
2016-07-15,2016-07-15,Invoice payment - Dunn-Wilson,REF23345791,0.0,965.74,36234.66
2016-07-17,2016-07-17,Office supplies,REF31690592,41.68,0.0,36192.98
2016-07-18,2016-07-18,Office supplies,REF57186690,53.62,0.0,36139.36
2016-07-19,2016-07-19,Office supplies,REF84119483,34.07,0.0,36105.29
2016-07-23,2016-07-23,Equipment purchase,REF63504210,132.3,0.0,35972.99
2016-07-26,2016-07-26,Business travel,REF47839994,141.46,0.0,35831.53
2016-07-27,2016-07-27,Training/conference,REF63334225,44.51,0.0,35787.02
2016-07-28,2016-07-28,Equipment purchase,REF11685277,45.09,0.0,35741.93
2016-08-09,2016-08-09,Software subscription,REF18028779,101.76,0.0,35640.17
2016-08-15,2016-08-15,Business insurance premium,REF93853333,84.24,0.0,35555.93
2016-08-15,2016-08-15,Invoice payment - Medina and Sons,REF37602866,0.0,1226.5,36782.43
2016-08-15,2016-08-15,Service payment - Dunn-Wilson,REF74742092,0.0,916.48,37698.91
2016-08-17,2016-08-17,Office supplies,REF60087503,27.62,0.0,37671.29
2016-08-18,2016-08-18,Office supplies,REF27671310,21.41,0.0,37649.88
2016-08-19,2016-08-19,Marketing expenses,REF41359964,125.96,0.0,37523.92
2016-08-20,2016-08-20,Business travel,REF56248889,111.25,0.0,37412.67
2016-08-28,2016-08-28,Professional services,REF26682518,112.74,0.0,37299.93
2016-09-06,2016-09-06,Office supplies,REF73713697,76.83,0.0,37223.1
2016-09-09,2016-09-09,Software subscription,REF98235417,175.14,0.0,37047.96
2016-09-11,2016-09-11,Equipment purchase,REF58887470,32.37,0.0,37015.59
2016-09-12,2016-09-12,Professional services,REF59868500,294.68,0.0,36720.91
2016-09-14,2016-09-14,Professional services,REF65543339,203.05,0.0,36517.86
2016-09-15,2016-09-15,Business insurance premium,REF66034548,141.45,0.0,36376.41
2016-09-15,2016-09-15,Business travel,REF76042886,201.08,0.0,36175.33
2016-09-15,2016-09-15,Invoice payment - Cunningham-Barton,REF67130995,0.0,1582.01,37757.34
2016-09-15,2016-09-15,Invoice payment - Dunn-Wilson,REF99045870,0.0,1677.55,39434.89
2016-09-17,2016-09-17,Office supplies,REF20746536,54.63,0.0,39380.26
2016-10-02,2016-10-02,Internet and phone service,REF74467451,99.05,0.0,39281.21
2016-10-03,2016-10-03,Professional services,REF27642427,375.1,0.0,38906.11
2016-10-06,2016-10-06,Internet and phone service,REF31029333,88.9,0.0,38817.21
2016-10-09,2016-10-09,Software subscription,REF61056367,163.78,0.0,38653.43
2016-10-13,2016-10-13,Office supplies,REF52366840,76.77,0.0,38576.66
2016-10-14,2016-10-14,Training/conference,REF26445860,206.0,0.0,38370.66
2016-10-14,2016-10-14,Equipment purchase,REF92502027,78.18,0.0,38292.48
2016-10-15,2016-10-15,Project payment - Cunningham-Barton,REF54325833,0.0,1726.81,40019.29
2016-10-15,2016-10-15,Business insurance premium,REF21325672,155.64,0.0,39863.65
2016-10-15,2016-10-15,Project payment - Medina and Sons,REF55364797,0.0,2227.22,42090.87
2016-10-15,2016-10-15,Invoice payment - Dunn-Wilson,REF86765060,0.0,1511.9,43602.77
2016-10-22,2016-10-22,Business travel,REF21606070,241.04,0.0,43361.73
2016-10-23,2016-10-23,Business travel,REF91403743,130.0,0.0,43231.73
2016-10-27,2016-10-27,Office supplies,REF65151560,53.85,0.0,43177.88
2016-10-28,2016-10-28,Business travel,REF73466316,109.05,0.0,43068.83
2016-10-30,2016-10-30,Training/conference,REF32422386,201.58,0.0,42867.25
2016-11-01,2016-11-01,Office supplies,REF63680559,40.33,0.0,42826.92
2016-11-09,2016-11-09,Software subscription,REF19012960,172.57,0.0,42654.35
2016-11-11,2016-11-11,Training/conference,REF92751843,94.29,0.0,42560.06
2016-11-14,2016-11-14,Business travel,REF53011539,206.53,0.0,42353.53
2016-11-15,2016-11-15,Payment from Dunn-Wilson,REF15895413,0.0,1474.2,43827.73
2016-11-15,2016-11-15,Project payment - Medina and Sons,REF49804129,0.0,2010.88,45838.61
2016-11-15,2016-11-15,Project payment - Cunningham-Barton,REF75784201,0.0,1303.42,47142.03
2016-11-15,2016-11-15,Business insurance premium,REF21627603,137.05,0.0,47004.98
2016-11-15,2016-11-15,Business travel,REF57704755,245.12,0.0,46759.86
2016-11-18,2016-11-18,Office supplies,REF85826279,75.59,0.0,46684.27
2016-11-22,2016-11-22,Office supplies,REF38901135,51.01,0.0,46633.26
2016-11-25,2016-11-25,Office supplies,REF19817515,48.48,0.0,46584.78
2016-11-27,2016-11-27,Office supplies,REF60526038,44.84,0.0,46539.94
2016-11-29,2016-11-29,Training/conference,REF80710684,136.44,0.0,46403.5
2016-11-30,2016-11-30,Office supplies,REF86794998,31.43,0.0,46372.07
2016-12-04,2016-12-04,Business travel,REF41921733,176.84,0.0,46195.23
2016-12-08,2016-12-08,Office supplies,REF93870060,24.22,0.0,46171.01
2016-12-09,2016-12-09,Software subscription,REF21544226,134.25,0.0,46036.76
2016-12-15,2016-12-15,Service payment - Cunningham-Barton,REF35481606,0.0,1227.0,47263.76
2016-12-15,2016-12-15,Business travel,REF52560652,195.46,0.0,47068.3
2016-12-15,2016-12-15,Service payment - Dunn-Wilson,REF79331224,0.0,1034.36,48102.66
2016-12-15,2016-12-15,Project payment - Medina and Sons,REF75353787,0.0,1499.44,49602.1
2016-12-15,2016-12-15,Business insurance premium,REF78055039,106.18,0.0,49495.92
2016-12-16,2016-12-16,Marketing expenses,REF55361833,204.39,0.0,49291.53
2016-12-22,2016-12-22,Training/conference,REF35609742,105.71,0.0,49185.82
2016-12-25,2016-12-25,Professional services,REF44142677,215.85,0.0,48969.97
2016-12-26,2016-12-26,Training/conference,REF52538716,78.02,0.0,48891.95
2016-12-26,2016-12-26,Equipment purchase,REF38113035,117.07,0.0,48774.88
2016-12-28,2016-12-28,Marketing expenses,REF35366659,143.66,0.0,48631.22
2016-12-29,2016-12-29,Business travel,REF44350409,135.02,0.0,48496.2
2017-01-04,2017-01-04,Office supplies,REF69984357,54.37,0.0,48441.83
2017-01-06,2017-01-06,Professional services,REF90402982,208.85,0.0,48232.98
2017-01-09,2017-01-09,Software subscription,REF86747996,114.55,0.0,48118.43
2017-01-11,2017-01-11,Equipment purchase,REF55732546,104.2,0.0,48014.23
2017-01-15,2017-01-15,Business insurance premium,REF57660087,90.56,0.0,47923.67
2017-01-15,2017-01-15,Invoice payment - Medina and Sons,REF19516598,0.0,1569.06,49492.73
2017-01-15,2017-01-15,Invoice payment - Cunningham-Barton,REF86236539,0.0,1013.16,50505.89
2017-01-16,2017-01-16,Office supplies,REF52279099,53.95,0.0,50451.94
2017-01-19,2017-01-19,Marketing expenses,REF32829374,208.33,0.0,50243.61
2017-01-22,2017-01-22,Internet and phone service,REF40350975,57.72,0.0,50185.89
2017-01-23,2017-01-23,Equipment purchase,REF95506012,104.61,0.0,50081.28
2017-01-25,2017-01-25,Marketing expenses,REF53507847,113.0,0.0,49968.28
2017-01-26,2017-01-26,Office supplies,REF49462603,58.51,0.0,49909.77
2017-01-31,2017-01-31,Office supplies,REF19190036,28.83,0.0,49880.94
2017-02-01,2017-02-01,Training/conference,REF46100054,98.38,0.0,49782.56
2017-02-04,2017-02-04,Marketing expenses,REF73181387,108.11,0.0,49674.45
2017-02-06,2017-02-06,Business travel,REF50329987,109.26,0.0,49565.19
2017-02-07,2017-02-07,Equipment purchase,REF77528083,133.55,0.0,49431.64
2017-02-08,2017-02-08,Professional services,REF49158755,222.68,0.0,49208.96
2017-02-09,2017-02-09,Software subscription,REF35170284,139.71,0.0,49069.25
2017-02-14,2017-02-14,Internet and phone service,REF78776108,16.2,0.0,49053.05
2017-02-14,2017-02-14,Equipment purchase,REF16241819,123.17,0.0,48929.88
2017-02-15,2017-02-15,Service payment - Cunningham-Barton,REF49745429,0.0,1216.64,50146.52
2017-02-15,2017-02-15,Invoice payment - Dunn-Wilson,REF43820142,0.0,1115.78,51262.3
2017-02-15,2017-02-15,Business insurance premium,REF38692394,105.89,0.0,51156.41
2017-02-27,2017-02-27,Training/conference,REF91459571,84.46,0.0,51071.95
2017-03-01,2017-03-01,Office supplies,REF62594459,45.47,0.0,51026.48
2017-03-05,2017-03-05,Business travel,REF98566862,212.84,0.0,50813.64
2017-03-07,2017-03-07,Business travel,REF53045269,119.46,0.0,50694.18
2017-03-07,2017-03-07,Office supplies,REF86537594,50.15,0.0,50644.03
2017-03-08,2017-03-08,Office supplies,REF66966453,71.27,0.0,50572.76
2017-03-09,2017-03-09,Software subscription,REF88635686,177.46,0.0,50395.3
2017-03-15,2017-03-15,Project payment - Medina and Sons,REF50193967,0.0,2057.07,52452.37
2017-03-15,2017-03-15,Business insurance premium,REF40178183,126.26,0.0,52326.11
2017-03-20,2017-03-20,Professional services,REF67622770,166.11,0.0,52160.0
2017-03-21,2017-03-21,Professional services,REF93735890,197.52,0.0,51962.48
2017-03-23,2017-03-23,Equipment purchase,REF77482537,50.12,0.0,51912.36
2017-03-28,2017-03-28,Office supplies,REF47587100,43.81,0.0,51868.55
2017-03-29,2017-03-29,Office supplies,REF44213902,23.75,0.0,51844.8
2017-04-09,2017-04-09,Software subscription,REF29209297,162.25,0.0,51682.55
2017-04-11,2017-04-11,Office supplies,REF77585106,65.78,0.0,51616.77
2017-04-11,2017-04-11,Marketing expenses,REF66134261,196.06,0.0,51420.71
2017-04-12,2017-04-12,Training/conference,REF91343007,117.43,0.0,51303.28
2017-04-15,2017-04-15,Payment from Dunn-Wilson,REF24274113,0.0,1108.55,52411.83
2017-04-15,2017-04-15,Invoice payment - Medina and Sons,REF97348089,0.0,2071.53,54483.36
2017-04-15,2017-04-15,Invoice payment - Cunningham-Barton,REF96741237,0.0,1009.99,55493.35
2017-04-15,2017-04-15,Business insurance premium,REF40302123,120.0,0.0,55373.35
2017-04-29,2017-04-29,Office supplies,REF28294160,41.21,0.0,55332.14
2017-04-30,2017-04-30,Equipment purchase,REF98986832,106.83,0.0,55225.31
2017-05-03,2017-05-03,Training/conference,REF96502386,89.21,0.0,55136.1
2017-05-05,2017-05-05,Office supplies,REF82347881,28.29,0.0,55107.81
2017-05-06,2017-05-06,Office supplies,REF93274799,71.03,0.0,55036.78
2017-05-06,2017-05-06,Equipment purchase,REF39839848,12.85,0.0,55023.93
2017-05-09,2017-05-09,Software subscription,REF63624008,204.6,0.0,54819.33
2017-05-10,2017-05-10,Professional services,REF30356476,386.33,0.0,54433.0
2017-05-15,2017-05-15,Business insurance premium,REF23395164,125.04,0.0,54307.96
2017-05-15,2017-05-15,Payment from Medina and Sons,REF99741689,0.0,2482.73,56790.69
2017-05-15,2017-05-15,Payment from Cunningham-Barton,REF65720651,0.0,1669.87,58460.56
2017-05-15,2017-05-15,Payment from Dunn-Wilson,REF65936432,0.0,1506.82,59967.38
2017-05-17,2017-05-17,Internet and phone service,REF35021619,83.99,0.0,59883.39
2017-05-19,2017-05-19,Business travel,REF97361079,47.28,0.0,59836.11
2017-05-27,2017-05-27,Marketing expenses,REF21137259,301.59,0.0,59534.52
2017-05-31,2017-05-31,Office supplies,REF13445694,46.04,0.0,59488.48
2017-06-04,2017-06-04,Internet and phone service,REF50803841,91.35,0.0,59397.13
2017-06-06,2017-06-06,Internet and phone service,REF17570215,69.37,0.0,59327.76
2017-06-09,2017-06-09,Software subscription,REF78170901,137.08,0.0,59190.68
2017-06-12,2017-06-12,Office supplies,REF41086359,65.32,0.0,59125.36
2017-06-14,2017-06-14,Internet and phone service,REF34176636,78.7,0.0,59046.66
2017-06-15,2017-06-15,Business insurance premium,REF63165332,108.47,0.0,58938.19
2017-06-15,2017-06-15,Payment from Cunningham-Barton,REF80624353,0.0,1469.66,60407.85
2017-06-15,2017-06-15,Payment from Dunn-Wilson,REF26751909,0.0,662.55,61070.4
2017-06-15,2017-06-15,Service payment - Medina and Sons,REF47757273,0.0,1419.93,62490.33
2017-06-18,2017-06-18,Business travel,REF51013993,195.1,0.0,62295.23
2017-06-21,2017-06-21,Business travel,REF33213217,225.24,0.0,62069.99
2017-06-25,2017-06-25,Office supplies,REF44568280,33.79,0.0,62036.2
2017-06-26,2017-06-26,Business travel,REF17129793,134.17,0.0,61902.03
2017-06-30,2017-06-30,Marketing expenses,REF53611958,67.39,0.0,61834.64
2017-07-08,2017-07-08,Office supplies,REF75498557,48.19,0.0,61786.45
2017-07-09,2017-07-09,Software subscription,REF20948502,124.81,0.0,61661.64
2017-07-12,2017-07-12,Business travel,REF90314006,49.24,0.0,61612.4
2017-07-15,2017-07-15,Business insurance premium,REF63408562,93.04,0.0,61519.36
2017-07-15,2017-07-15,Project payment - Cunningham-Barton,REF30040963,0.0,961.28,62480.64
2017-07-15,2017-07-15,Invoice payment - Medina and Sons,REF91497094,0.0,1505.26,63985.9
2017-07-15,2017-07-15,Service payment - Dunn-Wilson,REF43366816,0.0,787.24,64773.14
2017-07-16,2017-07-16,Training/conference,REF98947806,30.31,0.0,64742.83
2017-07-19,2017-07-19,Business travel,REF57981248,165.21,0.0,64577.62
2017-07-20,2017-07-20,Internet and phone service,REF66936527,76.47,0.0,64501.15
2017-07-27,2017-07-27,Internet and phone service,REF94326478,47.18,0.0,64453.97
2017-07-27,2017-07-27,Business travel,REF63036215,107.07,0.0,64346.9
2017-07-30,2017-07-30,Training/conference,REF55672257,96.46,0.0,64250.44
2017-07-31,2017-07-31,Office supplies,REF48448035,42.57,0.0,64207.87
2017-08-01,2017-08-01,Training/conference,REF91881784,68.72,0.0,64139.15
2017-08-01,2017-08-01,Business travel,REF11742802,117.48,0.0,64021.67
2017-08-03,2017-08-03,Business travel,REF44110955,109.36,0.0,63912.31
2017-08-04,2017-08-04,Business travel,REF61611034,109.44,0.0,63802.87
2017-08-05,2017-08-05,Training/conference,REF13160556,69.18,0.0,63733.69
2017-08-08,2017-08-08,Office supplies,REF48214435,20.99,0.0,63712.7
2017-08-09,2017-08-09,Software subscription,REF36759701,101.22,0.0,63611.48
2017-08-11,2017-08-11,Equipment purchase,REF66185997,32.34,0.0,63579.14
2017-08-12,2017-08-12,Training/conference,REF82279694,60.48,0.0,63518.66
2017-08-15,2017-08-15,Project payment - Dunn-Wilson,REF31791413,0.0,1163.21,64681.87
2017-08-15,2017-08-15,Payment from Medina and Sons,REF39716128,0.0,1169.24,65851.11
2017-08-15,2017-08-15,Project payment - Cunningham-Barton,REF70667854,0.0,977.01,66828.12
2017-08-15,2017-08-15,Business insurance premium,REF48418272,80.21,0.0,66747.91
2017-08-17,2017-08-17,Office supplies,REF34159852,44.14,0.0,66703.77
2017-08-19,2017-08-19,Business travel,REF63854110,110.16,0.0,66593.61
2017-08-20,2017-08-20,Office supplies,REF12129872,5.0,0.0,66588.61
2017-08-24,2017-08-24,Office supplies,REF67882107,23.98,0.0,66564.63
2017-08-29,2017-08-29,Office supplies,REF68128662,31.43,0.0,66533.2
2017-09-02,2017-09-02,Internet and phone service,REF63317878,77.17,0.0,66456.03
2017-09-05,2017-09-05,Equipment purchase,REF29183296,101.08,0.0,66354.95
2017-09-07,2017-09-07,Professional services,REF11464807,317.64,0.0,66037.31
2017-09-08,2017-09-08,Professional services,REF63505962,236.52,0.0,65800.79
2017-09-09,2017-09-09,Software subscription,REF58610387,176.84,0.0,65623.95
2017-09-12,2017-09-12,Business travel,REF23692337,122.28,0.0,65501.67
2017-09-13,2017-09-13,Business travel,REF10683488,131.18,0.0,65370.49
2017-09-15,2017-09-15,Internet and phone service,REF74975660,104.79,0.0,65265.7
2017-09-15,2017-09-15,Payment from Medina and Sons,REF64138351,0.0,1860.76,67126.46
2017-09-15,2017-09-15,Service payment - Dunn-Wilson,REF25485199,0.0,1756.31,68882.77
2017-09-15,2017-09-15,Service payment - Cunningham-Barton,REF10168458,0.0,1469.6,70352.37
2017-09-15,2017-09-15,Business insurance premium,REF28054093,139.21,0.0,70213.16
2017-09-18,2017-09-18,Office supplies,REF14960184,39.71,0.0,70173.45
2017-09-20,2017-09-20,Office supplies,REF63756979,47.39,0.0,70126.06
2017-09-22,2017-09-22,Office supplies,REF95625619,49.88,0.0,70076.18
2017-09-25,2017-09-25,Training/conference,REF20752949,69.65,0.0,70006.53
2017-09-26,2017-09-26,Office supplies,REF80330988,32.74,0.0,69973.79
2017-09-29,2017-09-29,Equipment purchase,REF95593206,167.83,0.0,69805.96
2017-09-30,2017-09-30,Office supplies,REF83663682,67.28,0.0,69738.68
2017-10-02,2017-10-02,Professional services,REF63882417,285.46,0.0,69453.22
2017-10-05,2017-10-05,Office supplies,REF29299541,58.96,0.0,69394.26
2017-10-08,2017-10-08,Marketing expenses,REF37222051,150.62,0.0,69243.64
2017-10-09,2017-10-09,Software subscription,REF81199711,177.28,0.0,69066.36
2017-10-15,2017-10-15,Payment from Dunn-Wilson,REF82097881,0.0,1424.9,70491.26
2017-10-15,2017-10-15,Business insurance premium,REF33127981,144.56,0.0,70346.7
2017-10-19,2017-10-19,Office supplies,REF96919002,80.83,0.0,70265.87
2017-10-20,2017-10-20,Business travel,REF14325042,243.34,0.0,70022.53
2017-10-24,2017-10-24,Professional services,REF17813749,269.48,0.0,69753.05
2017-10-26,2017-10-26,Office supplies,REF56394331,22.97,0.0,69730.08
2017-10-29,2017-10-29,Marketing expenses,REF35521865,263.97,0.0,69466.11
2017-11-06,2017-11-06,Office supplies,REF17400960,52.23,0.0,69413.88
2017-11-06,2017-11-06,Professional services,REF85159574,249.65,0.0,69164.23
2017-11-08,2017-11-08,Training/conference,REF78243335,177.51,0.0,68986.72
2017-11-09,2017-11-09,Software subscription,REF26560490,144.89,0.0,68841.83
2017-11-12,2017-11-12,Professional services,REF48502740,118.83,0.0,68723.0
2017-11-15,2017-11-15,Business insurance premium,REF84664776,127.56,0.0,68595.44
2017-11-15,2017-11-15,Payment from Dunn-Wilson,REF53749326,0.0,1478.12,70073.56
2017-11-15,2017-11-15,Payment from Cunningham-Barton,REF62640947,0.0,1444.72,71518.28
2017-11-15,2017-11-15,Project payment - Medina and Sons,REF61090982,0.0,1847.88,73366.16
2017-11-19,2017-11-19,Office supplies,REF18855100,29.74,0.0,73336.42
2017-11-24,2017-11-24,Marketing expenses,REF71011429,123.45,0.0,73212.97
2017-11-24,2017-11-24,Equipment purchase,REF61010407,141.33,0.0,73071.64
2017-11-26,2017-11-26,Business travel,REF30342994,190.93,0.0,72880.71
2017-12-03,2017-12-03,Equipment purchase,REF94788155,92.92,0.0,72787.79
2017-12-06,2017-12-06,Office supplies,REF60402130,64.77,0.0,72723.02
2017-12-08,2017-12-08,Office supplies,REF85244417,44.43,0.0,72678.59
2017-12-09,2017-12-09,Software subscription,REF74855304,161.21,0.0,72517.38
2017-12-11,2017-12-11,Office supplies,REF35313361,45.02,0.0,72472.36
2017-12-11,2017-12-11,Professional services,REF62630789,308.27,0.0,72164.09
2017-12-13,2017-12-13,Internet and phone service,REF20316143,67.79,0.0,72096.3
2017-12-14,2017-12-14,Office supplies,REF28739497,21.42,0.0,72074.88
2017-12-14,2017-12-14,Training/conference,REF11711762,78.96,0.0,71995.92
2017-12-15,2017-12-15,Project payment - Cunningham-Barton,REF71717934,0.0,966.13,72962.05
2017-12-15,2017-12-15,Invoice payment - Dunn-Wilson,REF87496572,0.0,1118.74,74080.79
2017-12-15,2017-12-15,Business insurance premium,REF81501220,106.4,0.0,73974.39
2017-12-15,2017-12-15,Project payment - Medina and Sons,REF85759208,0.0,1817.98,75792.37
2017-12-21,2017-12-21,Office supplies,REF86481812,62.72,0.0,75729.65
2017-12-22,2017-12-22,Training/conference,REF91950689,54.1,0.0,75675.55
2017-12-28,2017-12-28,Business travel,REF15528814,173.59,0.0,75501.96
2017-12-29,2017-12-29,Training/conference,REF59345132,117.86,0.0,75384.1
2017-12-31,2017-12-31,Internet and phone service,REF85664615,79.1,0.0,75305.0
2018-01-06,2018-01-06,Training/conference,REF95135676,66.4,0.0,75238.6
2018-01-07,2018-01-07,Business travel,REF48668610,66.83,0.0,75171.77
2018-01-09,2018-01-09,Software subscription,REF71516745,116.56,0.0,75055.21
2018-01-15,2018-01-15,Business insurance premium,REF35127710,93.39,0.0,74961.82
2018-01-15,2018-01-15,Invoice payment - Cunningham-Barton,REF13399635,0.0,876.01,75837.83
2018-01-15,2018-01-15,Project payment - Dunn-Wilson,REF41546818,0.0,1023.1,76860.93
2018-01-18,2018-01-18,Business travel,REF61952385,95.11,0.0,76765.82
2018-01-20,2018-01-20,Business travel,REF85951407,77.54,0.0,76688.28
2018-01-20,2018-01-20,Marketing expenses,REF99485043,139.96,0.0,76548.32
2018-01-21,2018-01-21,Office supplies,REF12933339,44.61,0.0,76503.71
2018-02-01,2018-02-01,Equipment purchase,REF54933941,18.9,0.0,76484.81
2018-02-09,2018-02-09,Software subscription,REF76876309,131.33,0.0,76353.48
2018-02-15,2018-02-15,Business insurance premium,REF92584726,109.7,0.0,76243.78
2018-02-15,2018-02-15,Service payment - Cunningham-Barton,REF48408521,0.0,1382.69,77626.47
2018-02-15,2018-02-15,Payment from Dunn-Wilson,REF43070055,0.0,1156.44,78782.91
2018-02-15,2018-02-15,Internet and phone service,REF91382317,37.95,0.0,78744.96
2018-02-21,2018-02-21,Office supplies,REF40179598,82.04,0.0,78662.92
2018-02-23,2018-02-23,Business travel,REF55802450,145.84,0.0,78517.08
2018-03-02,2018-03-02,Professional services,REF80201873,20.61,0.0,78496.47
2018-03-03,2018-03-03,Office supplies,REF52097676,60.64,0.0,78435.83
2018-03-04,2018-03-04,Professional services,REF51593802,248.34,0.0,78187.49
2018-03-05,2018-03-05,Training/conference,REF77262176,126.09,0.0,78061.4
2018-03-06,2018-03-06,Training/conference,REF88285526,139.27,0.0,77922.13
2018-03-09,2018-03-09,Software subscription,REF71258404,193.12,0.0,77729.01
2018-03-15,2018-03-15,Business insurance premium,REF94970555,119.72,0.0,77609.29
2018-03-15,2018-03-15,Project payment - Dunn-Wilson,REF57587828,0.0,1269.81,78879.1
2018-03-15,2018-03-15,Project payment - Cunningham-Barton,REF84205768,0.0,1502.48,80381.58
2018-03-15,2018-03-15,Payment from Medina and Sons,REF52813571,0.0,1830.63,82212.21
2018-03-16,2018-03-16,Office supplies,REF73327477,61.54,0.0,82150.67
2018-03-18,2018-03-18,Training/conference,REF49295066,98.28,0.0,82052.39
2018-03-18,2018-03-18,Office supplies,REF95672766,62.42,0.0,81989.97
2018-03-20,2018-03-20,Internet and phone service,REF32272944,69.04,0.0,81920.93
2018-03-21,2018-03-21,Training/conference,REF12026953,146.36,0.0,81774.57
2018-03-22,2018-03-22,Office supplies,REF91616741,63.37,0.0,81711.2
2018-03-23,2018-03-23,Business travel,REF60760269,148.8,0.0,81562.4
2018-03-25,2018-03-25,Office supplies,REF50099449,47.27,0.0,81515.13
2018-03-28,2018-03-28,Training/conference,REF44378606,108.42,0.0,81406.71
2018-03-29,2018-03-29,Office supplies,REF68243544,59.98,0.0,81346.73
2018-04-01,2018-04-01,Office supplies,REF45084556,43.17,0.0,81303.56
2018-04-04,2018-04-04,Professional services,REF14339468,338.33,0.0,80965.23
2018-04-05,2018-04-05,Business travel,REF73948088,107.25,0.0,80857.98
2018-04-06,2018-04-06,Office supplies,REF99628069,56.35,0.0,80801.63
2018-04-09,2018-04-09,Software subscription,REF18928782,164.73,0.0,80636.9
2018-04-15,2018-04-15,Invoice payment - Medina and Sons,REF66614035,0.0,1677.97,82314.87
2018-04-15,2018-04-15,Business insurance premium,REF86035313,129.42,0.0,82185.45
2018-04-15,2018-04-15,Professional services,REF83955274,184.28,0.0,82001.17
2018-04-15,2018-04-15,Service payment - Dunn-Wilson,REF30438168,0.0,1304.74,83305.91
2018-04-15,2018-04-15,Invoice payment - Cunningham-Barton,REF17098975,0.0,1183.93,84489.84
2018-04-20,2018-04-20,Office supplies,REF80915429,61.42,0.0,84428.42
2018-04-21,2018-04-21,Internet and phone service,REF67446750,53.38,0.0,84375.04
2018-04-23,2018-04-23,Marketing expenses,REF64372403,176.22,0.0,84198.82
2018-04-24,2018-04-24,Office supplies,REF48963746,42.06,0.0,84156.76
2018-04-24,2018-04-24,Internet and phone service,REF52525488,107.97,0.0,84048.79
2018-04-25,2018-04-25,Business travel,REF99717083,180.62,0.0,83868.17
2018-04-26,2018-04-26,Internet and phone service,REF27156590,74.0,0.0,83794.17
2018-04-27,2018-04-27,Office supplies,REF69416864,53.51,0.0,83740.66
2018-04-29,2018-04-29,Professional services,REF38436033,175.73,0.0,83564.93
2018-04-30,2018-04-30,Office supplies,REF58351311,56.11,0.0,83508.82
2018-05-09,2018-05-09,Software subscription,REF99929311,157.81,0.0,83351.01
2018-05-10,2018-05-10,Business travel,REF91216531,168.08,0.0,83182.93
2018-05-11,2018-05-11,Internet and phone service,REF13128253,36.96,0.0,83145.97
2018-05-15,2018-05-15,Project payment - Dunn-Wilson,REF12336703,0.0,1227.87,84373.84
2018-05-15,2018-05-15,Business insurance premium,REF89033435,124.98,0.0,84248.86
2018-05-15,2018-05-15,Service payment - Medina and Sons,REF95565571,0.0,1614.9,85863.76
2018-05-15,2018-05-15,Payment from Cunningham-Barton,REF15850242,0.0,1058.89,86922.65
2018-05-21,2018-05-21,Office supplies,REF57720684,55.71,0.0,86866.94
2018-05-27,2018-05-27,Office supplies,REF74712024,41.89,0.0,86825.05
2018-05-28,2018-05-28,Business travel,REF41396618,108.72,0.0,86716.33
2018-05-30,2018-05-30,Office supplies,REF70347412,59.64,0.0,86656.69
2018-06-02,2018-06-02,Office supplies,REF45447492,54.05,0.0,86602.64
2018-06-04,2018-06-04,Training/conference,REF76515941,64.87,0.0,86537.77
2018-06-09,2018-06-09,Software subscription,REF76205608,147.7,0.0,86390.07
2018-06-09,2018-06-09,Office supplies,REF95369513,44.81,0.0,86345.26
2018-06-10,2018-06-10,Office supplies,REF34626585,32.46,0.0,86312.8
2018-06-15,2018-06-15,Business insurance premium,REF15346526,101.12,0.0,86211.68
2018-06-15,2018-06-15,Service payment - Cunningham-Barton,REF67651287,0.0,1010.61,87222.29
2018-06-15,2018-06-15,Invoice payment - Dunn-Wilson,REF93144787,0.0,847.47,88069.76
2018-06-15,2018-06-15,Marketing expenses,REF60668699,235.84,0.0,87833.92
2018-06-15,2018-06-15,Service payment - Medina and Sons,REF42889305,0.0,1499.56,89333.48
2018-06-27,2018-06-27,Training/conference,REF26950508,83.29,0.0,89250.19
2018-06-28,2018-06-28,Training/conference,REF20515878,116.44,0.0,89133.75
2018-06-29,2018-06-29,Training/conference,REF57704475,95.32,0.0,89038.43
2018-07-02,2018-07-02,Office supplies,REF45844671,33.9,0.0,89004.53
2018-07-06,2018-07-06,Training/conference,REF77971218,74.26,0.0,88930.27
2018-07-08,2018-07-08,Equipment purchase,REF53918336,70.45,0.0,88859.82
2018-07-09,2018-07-09,Software subscription,REF36446026,126.48,0.0,88733.34
2018-07-12,2018-07-12,Office supplies,REF22466331,37.86,0.0,88695.48
2018-07-13,2018-07-13,Equipment purchase,REF31574971,92.02,0.0,88603.46
2018-07-14,2018-07-14,Office supplies,REF10318473,25.42,0.0,88578.04
2018-07-15,2018-07-15,Project payment - Cunningham-Barton,REF75603605,0.0,1113.67,89691.71
2018-07-15,2018-07-15,Professional services,REF56818046,245.45,0.0,89446.26
2018-07-15,2018-07-15,Business insurance premium,REF91174043,91.71,0.0,89354.55
2018-07-15,2018-07-15,Invoice payment - Medina and Sons,REF18322917,0.0,1088.05,90442.6
2018-07-15,2018-07-15,Service payment - Dunn-Wilson,REF23462715,0.0,885.59,91328.19
2018-07-20,2018-07-20,Business travel,REF58671931,64.96,0.0,91263.23
2018-07-23,2018-07-23,Business travel,REF46325199,132.95,0.0,91130.28
2018-07-23,2018-07-23,Marketing expenses,REF34645502,104.96,0.0,91025.32
2018-07-25,2018-07-25,Professional services,REF52516862,269.07,0.0,90756.25
2018-07-28,2018-07-28,Office supplies,REF41424094,56.02,0.0,90700.23
2018-07-29,2018-07-29,Office supplies,REF40494927,35.27,0.0,90664.96
2018-07-29,2018-07-29,Internet and phone service,REF31088919,50.68,0.0,90614.28
2018-08-02,2018-08-02,Professional services,REF70749526,89.43,0.0,90524.85
2018-08-02,2018-08-02,Marketing expenses,REF78118992,145.76,0.0,90379.09
2018-08-04,2018-08-04,Office supplies,REF12861889,41.22,0.0,90337.87
2018-08-09,2018-08-09,Software subscription,REF96443098,118.3,0.0,90219.57
2018-08-15,2018-08-15,Business insurance premium,REF43909149,84.85,0.0,90134.72
2018-08-15,2018-08-15,Invoice payment - Medina and Sons,REF38054661,0.0,1296.78,91431.5
2018-08-15,2018-08-15,Payment from Dunn-Wilson,REF40026214,0.0,786.69,92218.19
2018-08-15,2018-08-15,Professional services,REF23313689,153.58,0.0,92064.61
2018-08-20,2018-08-20,Professional services,REF92021228,180.09,0.0,91884.52
2018-08-23,2018-08-23,Marketing expenses,REF63488276,129.99,0.0,91754.53
2018-08-24,2018-08-24,Office supplies,REF11798154,27.56,0.0,91726.97
2018-08-25,2018-08-25,Business travel,REF91198675,119.39,0.0,91607.58
2018-08-29,2018-08-29,Office supplies,REF68771783,45.01,0.0,91562.57
2018-09-01,2018-09-01,Marketing expenses,REF58078948,292.15,0.0,91270.42
2018-09-05,2018-09-05,Office supplies,REF38526922,119.21,0.0,91151.21
2018-09-05,2018-09-05,Training/conference,REF48778034,108.18,0.0,91043.03
2018-09-06,2018-09-06,Marketing expenses,REF57399439,202.58,0.0,90840.45
2018-09-08,2018-09-08,Office supplies,REF55350703,50.87,0.0,90789.58
2018-09-09,2018-09-09,Software subscription,REF75698786,177.82,0.0,90611.76
2018-09-10,2018-09-10,Training/conference,REF84880394,176.6,0.0,90435.16
2018-09-12,2018-09-12,Internet and phone service,REF93686057,71.52,0.0,90363.64
2018-09-15,2018-09-15,Business insurance premium,REF62070724,128.1,0.0,90235.54
2018-09-15,2018-09-15,Service payment - Medina and Sons,REF43740552,0.0,1849.41,92084.95
2018-09-15,2018-09-15,Service payment - Cunningham-Barton,REF60779292,0.0,1398.74,93483.69
2018-09-15,2018-09-15,Invoice payment - Dunn-Wilson,REF81043818,0.0,1513.61,94997.3
2018-09-16,2018-09-16,Internet and phone service,REF16980098,88.09,0.0,94909.21
2018-09-17,2018-09-17,Business travel,REF86552782,79.35,0.0,94829.86
2018-09-19,2018-09-19,Business travel,REF32580963,197.54,0.0,94632.32
2018-09-20,2018-09-20,Office supplies,REF71150451,47.13,0.0,94585.19
2018-09-25,2018-09-25,Training/conference,REF71260315,94.58,0.0,94490.61
2018-10-01,2018-10-01,Internet and phone service,REF18887062,100.5,0.0,94390.11
2018-10-01,2018-10-01,Office supplies,REF69083644,78.91,0.0,94311.2
2018-10-05,2018-10-05,Training/conference,REF92624133,89.28,0.0,94221.92
2018-10-09,2018-10-09,Software subscription,REF81359783,164.29,0.0,94057.63
2018-10-12,2018-10-12,Professional services,REF97757901,200.94,0.0,93856.69
2018-10-15,2018-10-15,Payment from Dunn-Wilson,REF56073896,0.0,1693.1,95549.79
2018-10-15,2018-10-15,Business insurance premium,REF65740832,126.99,0.0,95422.8
2018-10-15,2018-10-15,Project payment - Medina and Sons,REF99828660,0.0,1910.76,97333.56
2018-10-15,2018-10-15,Payment from Cunningham-Barton,REF52172236,0.0,1197.62,98531.18
2018-10-18,2018-10-18,Internet and phone service,REF58285213,69.32,0.0,98461.86
2018-10-21,2018-10-21,Professional services,REF77114058,201.16,0.0,98260.7
2018-10-31,2018-10-31,Office supplies,REF40564255,44.15,0.0,98216.55
2018-11-05,2018-11-05,Internet and phone service,REF58293978,68.85,0.0,98147.7
2018-11-06,2018-11-06,Office supplies,REF19526546,43.32,0.0,98104.38
2018-11-09,2018-11-09,Software subscription,REF51851509,159.26,0.0,97945.12
2018-11-09,2018-11-09,Marketing expenses,REF83073711,260.86,0.0,97684.26
2018-11-10,2018-11-10,Internet and phone service,REF26510918,83.61,0.0,97600.65
2018-11-15,2018-11-15,Invoice payment - Dunn-Wilson,REF50765294,0.0,1224.51,98825.16
2018-11-15,2018-11-15,Business insurance premium,REF82117292,139.05,0.0,98686.11
2018-11-15,2018-11-15,Project payment - Medina and Sons,REF19739896,0.0,2073.4,100759.51
2018-11-15,2018-11-15,Payment from Cunningham-Barton,REF11323525,0.0,1541.47,102300.98
2018-11-18,2018-11-18,Professional services,REF76579574,243.18,0.0,102057.8
2018-11-19,2018-11-19,Training/conference,REF18656808,110.09,0.0,101947.71
2018-11-21,2018-11-21,Professional services,REF10952330,263.84,0.0,101683.87
2018-11-21,2018-11-21,Office supplies,REF51664102,66.45,0.0,101617.42
2018-11-23,2018-11-23,Office supplies,REF52432278,47.96,0.0,101569.46
2018-11-25,2018-11-25,Training/conference,REF69585150,67.1,0.0,101502.36
2018-11-26,2018-11-26,Marketing expenses,REF98099635,310.94,0.0,101191.42
2018-11-27,2018-11-27,Training/conference,REF70587146,146.88,0.0,101044.54
2018-11-28,2018-11-28,Office supplies,REF58642604,34.41,0.0,101010.13
2018-11-29,2018-11-29,Marketing expenses,REF77324952,240.42,0.0,100769.71
2018-12-08,2018-12-08,Business travel,REF34299029,148.99,0.0,100620.72
2018-12-09,2018-12-09,Software subscription,REF88244144,128.76,0.0,100491.96
2018-12-13,2018-12-13,Equipment purchase,REF45856121,102.44,0.0,100389.52
2018-12-15,2018-12-15,Project payment - Cunningham-Barton,REF79367543,0.0,1139.91,101529.43
2018-12-15,2018-12-15,Office supplies,REF28771842,5.0,0.0,101524.43
2018-12-15,2018-12-15,Payment from Dunn-Wilson,REF68684617,0.0,1190.19,102714.62
2018-12-15,2018-12-15,Service payment - Medina and Sons,REF37168103,0.0,1941.47,104656.09
2018-12-15,2018-12-15,Business insurance premium,REF54414047,108.66,0.0,104547.43
2018-12-20,2018-12-20,Office supplies,REF53748531,43.81,0.0,104503.62
2018-12-21,2018-12-21,Office supplies,REF66452729,55.67,0.0,104447.95
2018-12-22,2018-12-22,Professional services,REF21575971,90.34,0.0,104357.61
2018-12-30,2018-12-30,Business travel,REF36881469,113.5,0.0,104244.11
2019-01-01,2019-01-01,Business travel,REF27468677,144.09,0.0,104100.02
2019-01-04,2019-01-04,Office supplies,REF82326868,26.23,0.0,104073.79
2019-01-09,2019-01-09,Software subscription,REF40147289,144.18,0.0,103929.61
2019-01-09,2019-01-09,Internet and phone service,REF14305482,58.74,0.0,103870.87
2019-01-11,2019-01-11,Business travel,REF36816212,170.06,0.0,103700.81
2019-01-15,2019-01-15,Payment from Dunn-Wilson,REF89174246,0.0,1080.38,104781.19
2019-01-15,2019-01-15,Project payment - Medina and Sons,REF59429013,0.0,1233.9,106015.09
2019-01-15,2019-01-15,Project payment - Cunningham-Barton,REF45659405,0.0,1118.67,107133.76
2019-01-15,2019-01-15,Business insurance premium,REF83999660,95.23,0.0,107038.53
2019-01-25,2019-01-25,Professional services,REF47745663,122.65,0.0,106915.88
2019-02-03,2019-02-03,Professional services,REF99999465,202.04,0.0,106713.84
2019-02-06,2019-02-06,Internet and phone service,REF33992996,77.87,0.0,106635.97
2019-02-09,2019-02-09,Software subscription,REF58931804,138.78,0.0,106497.19
2019-02-15,2019-02-15,Business insurance premium,REF52614788,108.28,0.0,106388.91
2019-02-15,2019-02-15,Payment from Dunn-Wilson,REF95377982,0.0,1186.75,107575.66
2019-02-15,2019-02-15,Invoice payment - Medina and Sons,REF20277561,0.0,1480.24,109055.9
2019-02-15,2019-02-15,Service payment - Cunningham-Barton,REF77725571,0.0,1239.94,110295.84
2019-02-16,2019-02-16,Training/conference,REF61373985,47.85,0.0,110247.99
2019-02-19,2019-02-19,Business travel,REF88080275,108.34,0.0,110139.65
2019-02-19,2019-02-19,Equipment purchase,REF31919031,97.86,0.0,110041.79
2019-02-20,2019-02-20,Professional services,REF16804977,242.78,0.0,109799.01
2019-02-21,2019-02-21,Business travel,REF24294736,146.08,0.0,109652.93
2019-02-21,2019-02-21,Equipment purchase,REF43565656,128.94,0.0,109523.99
2019-02-24,2019-02-24,Professional services,REF63202779,286.5,0.0,109237.49
2019-02-25,2019-02-25,Office supplies,REF55546668,17.25,0.0,109220.24
2019-02-27,2019-02-27,Office supplies,REF29679856,44.73,0.0,109175.51
2019-02-27,2019-02-27,Marketing expenses,REF33609639,179.45,0.0,108996.06
2019-03-09,2019-03-09,Software subscription,REF86314934,163.75,0.0,108832.31
2019-03-11,2019-03-11,Training/conference,REF84600371,111.49,0.0,108720.82
2019-03-15,2019-03-15,Invoice payment - Medina and Sons,REF11865976,0.0,2164.68,110885.5
2019-03-15,2019-03-15,Business travel,REF86620302,116.66,0.0,110768.84
2019-03-15,2019-03-15,Business insurance premium,REF26488706,129.29,0.0,110639.55
2019-03-18,2019-03-18,Business travel,REF72239614,124.98,0.0,110514.57
2019-03-19,2019-03-19,Marketing expenses,REF99230055,361.02,0.0,110153.55
2019-03-20,2019-03-20,Internet and phone service,REF12458887,43.18,0.0,110110.37
2019-03-21,2019-03-21,Office supplies,REF17476331,68.39,0.0,110041.98
2019-03-22,2019-03-22,Training/conference,REF29783617,59.11,0.0,109982.87
2019-03-23,2019-03-23,Business travel,REF40610128,121.46,0.0,109861.41
2019-03-26,2019-03-26,Office supplies,REF30336304,63.89,0.0,109797.52
2019-03-29,2019-03-29,Office supplies,REF59450472,71.88,0.0,109725.64
2019-03-31,2019-03-31,Office supplies,REF18330453,56.42,0.0,109669.22
2019-04-05,2019-04-05,Training/conference,REF83881665,129.94,0.0,109539.28
2019-04-09,2019-04-09,Software subscription,REF66188822,148.18,0.0,109391.1
2019-04-10,2019-04-10,Business travel,REF17830315,151.3,0.0,109239.8
2019-04-12,2019-04-12,Office supplies,REF66574692,58.26,0.0,109181.54
2019-04-15,2019-04-15,Project payment - Cunningham-Barton,REF67045462,0.0,1119.72,110301.26
2019-04-15,2019-04-15,Payment from Medina and Sons,REF35305463,0.0,1911.27,112212.53
2019-04-15,2019-04-15,Payment from Dunn-Wilson,REF24256429,0.0,1191.34,113403.87
2019-04-15,2019-04-15,Business insurance premium,REF51674900,113.97,0.0,113289.9
2019-04-17,2019-04-17,Equipment purchase,REF18590972,100.35,0.0,113189.55
2019-04-23,2019-04-23,Business travel,REF30708041,158.55,0.0,113031.0
2019-04-26,2019-04-26,Professional services,REF18813459,265.14,0.0,112765.86
2019-04-26,2019-04-26,Marketing expenses,REF11570328,253.24,0.0,112512.62
2019-04-28,2019-04-28,Office supplies,REF59687547,50.65,0.0,112461.97
2019-05-07,2019-05-07,Business travel,REF45005602,99.35,0.0,112362.62
2019-05-07,2019-05-07,Equipment purchase,REF45520004,103.09,0.0,112259.53
2019-05-09,2019-05-09,Software subscription,REF94157064,141.97,0.0,112117.56
2019-05-09,2019-05-09,Office supplies,REF94674533,66.04,0.0,112051.52
2019-05-09,2019-05-09,Training/conference,REF86077857,149.66,0.0,111901.86
2019-05-11,2019-05-11,Office supplies,REF45069579,37.93,0.0,111863.93
2019-05-14,2019-05-14,Equipment purchase,REF19247018,77.76,0.0,111786.17
2019-05-14,2019-05-14,Professional services,REF31405009,221.39,0.0,111564.78
2019-05-15,2019-05-15,Business insurance premium,REF46431445,112.35,0.0,111452.43
2019-05-15,2019-05-15,Payment from Dunn-Wilson,REF70344284,0.0,1229.76,112682.19
2019-05-15,2019-05-15,Service payment - Cunningham-Barton,REF52406977,0.0,1225.61,113907.8
2019-05-22,2019-05-22,Business travel,REF63833013,99.69,0.0,113808.11
2019-05-22,2019-05-22,Professional services,REF11480665,210.12,0.0,113597.99
2019-05-23,2019-05-23,Business travel,REF82471720,181.87,0.0,113416.12
2019-05-24,2019-05-24,Marketing expenses,REF56637115,105.94,0.0,113310.18
2019-05-25,2019-05-25,Office supplies,REF82489412,39.6,0.0,113270.58
2019-06-01,2019-06-01,Marketing expenses,REF17769916,216.49,0.0,113054.09
2019-06-01,2019-06-01,Business travel,REF70422731,206.56,0.0,112847.53
2019-06-07,2019-06-07,Office supplies,REF57051180,48.47,0.0,112799.06
2019-06-09,2019-06-09,Software subscription,REF83367116,134.25,0.0,112664.81
2019-06-11,2019-06-11,Marketing expenses,REF62757912,186.16,0.0,112478.65
2019-06-13,2019-06-13,Office supplies,REF69999401,48.12,0.0,112430.53
2019-06-15,2019-06-15,Business insurance premium,REF57237086,102.44,0.0,112328.09
2019-06-15,2019-06-15,Invoice payment - Medina and Sons,REF54859977,0.0,1221.39,113549.48
2019-06-15,2019-06-15,Invoice payment - Cunningham-Barton,REF50305817,0.0,1373.06,114922.54
2019-06-15,2019-06-15,Invoice payment - Dunn-Wilson,REF13084789,0.0,1275.17,116197.71
2019-06-16,2019-06-16,Professional services,REF94536588,121.48,0.0,116076.23
2019-06-21,2019-06-21,Professional services,REF45729309,275.27,0.0,115800.96
2019-06-23,2019-06-23,Office supplies,REF64889292,63.01,0.0,115737.95
2019-07-06,2019-07-06,Business travel,REF31393806,138.65,0.0,115599.3
2019-07-07,2019-07-07,Office supplies,REF96461091,21.13,0.0,115578.17
2019-07-09,2019-07-09,Software subscription,REF81796916,126.14,0.0,115452.03
2019-07-13,2019-07-13,Business travel,REF37031345,134.83,0.0,115317.2
2019-07-15,2019-07-15,Business insurance premium,REF88380931,95.93,0.0,115221.27
2019-07-15,2019-07-15,Invoice payment - Cunningham-Barton,REF10174821,0.0,1050.88,116272.15
2019-07-15,2019-07-15,Project payment - Dunn-Wilson,REF61111676,0.0,791.5,117063.65
2019-07-15,2019-07-15,Project payment - Medina and Sons,REF70746116,0.0,1249.6,118313.25
2019-07-20,2019-07-20,Marketing expenses,REF48231243,171.6,0.0,118141.65
2019-07-20,2019-07-20,Office supplies,REF86180834,47.59,0.0,118094.06
2019-07-26,2019-07-26,Business travel,REF15787225,110.33,0.0,117983.73
2019-07-26,2019-07-26,Professional services,REF21082959,220.18,0.0,117763.55
2019-07-28,2019-07-28,Marketing expenses,REF10691991,180.91,0.0,117582.64
2019-07-30,2019-07-30,Marketing expenses,REF32682466,67.27,0.0,117515.37
2019-07-31,2019-07-31,Office supplies,REF79750269,56.81,0.0,117458.56
2019-07-31,2019-07-31,Training/conference,REF81277101,91.37,0.0,117367.19
2019-08-03,2019-08-03,Equipment purchase,REF22615938,73.1,0.0,117294.09
2019-08-04,2019-08-04,Office supplies,REF64524455,31.15,0.0,117262.94
2019-08-04,2019-08-04,Internet and phone service,REF60118148,42.38,0.0,117220.56
2019-08-09,2019-08-09,Software subscription,REF12516232,95.41,0.0,117125.15
2019-08-09,2019-08-09,Office supplies,REF27324504,37.23,0.0,117087.92
2019-08-11,2019-08-11,Office supplies,REF55656626,38.6,0.0,117049.32
2019-08-14,2019-08-14,Internet and phone service,REF29860947,65.37,0.0,116983.95
2019-08-15,2019-08-15,Business insurance premium,REF71873882,88.09,0.0,116895.86
2019-08-15,2019-08-15,Business travel,REF93829364,74.92,0.0,116820.94
2019-08-15,2019-08-15,Service payment - Medina and Sons,REF21442188,0.0,1295.38,118116.32
2019-08-15,2019-08-15,Payment from Cunningham-Barton,REF91549207,0.0,1030.59,119146.91
2019-08-15,2019-08-15,Payment from Dunn-Wilson,REF18513751,0.0,1098.39,120245.3
2019-08-18,2019-08-18,Marketing expenses,REF34449039,58.61,0.0,120186.69
2019-08-22,2019-08-22,Marketing expenses,REF21823542,99.12,0.0,120087.57
2019-08-29,2019-08-29,Office supplies,REF94497308,31.72,0.0,120055.85
2019-08-30,2019-08-30,Internet and phone service,REF36892580,19.83,0.0,120036.02
2019-08-30,2019-08-30,Office supplies,REF69145223,19.16,0.0,120016.86
2019-09-02,2019-09-02,Internet and phone service,REF75509446,100.46,0.0,119916.4
2019-09-07,2019-09-07,Equipment purchase,REF34177536,74.45,0.0,119841.95
2019-09-07,2019-09-07,Marketing expenses,REF64594415,184.86,0.0,119657.09
2019-09-08,2019-09-08,Business travel,REF92657055,130.8,0.0,119526.29
2019-09-09,2019-09-09,Software subscription,REF56743067,179.02,0.0,119347.27
2019-09-11,2019-09-11,Internet and phone service,REF17895978,96.14,0.0,119251.13
2019-09-13,2019-09-13,Professional services,REF77401630,309.21,0.0,118941.92
2019-09-15,2019-09-15,Office supplies,REF59930517,64.02,0.0,118877.9
2019-09-15,2019-09-15,Payment from Cunningham-Barton,REF43046042,0.0,1823.1,120701.0
2019-09-15,2019-09-15,Payment from Medina and Sons,REF87736192,0.0,1992.3,122693.3
2019-09-15,2019-09-15,Invoice payment - Dunn-Wilson,REF12102935,0.0,1277.93,123971.23
2019-09-15,2019-09-15,Business insurance premium,REF37566882,144.38,0.0,123826.85
2019-09-19,2019-09-19,Internet and phone service,REF37745320,121.17,0.0,123705.68
2019-09-19,2019-09-19,Training/conference,REF35282629,94.11,0.0,123611.57
2019-09-24,2019-09-24,Office supplies,REF69021857,37.71,0.0,123573.86
2019-09-24,2019-09-24,Business travel,REF13569979,177.74,0.0,123396.12
2019-09-28,2019-09-28,Marketing expenses,REF81853489,267.1,0.0,123129.02
2019-09-29,2019-09-29,Training/conference,REF76937688,58.43,0.0,123070.59
2019-10-06,2019-10-06,Office supplies,REF83937543,59.54,0.0,123011.05
2019-10-09,2019-10-09,Software subscription,REF19815937,194.31,0.0,122816.74
2019-10-09,2019-10-09,Office supplies,REF69518727,60.0,0.0,122756.74
2019-10-14,2019-10-14,Equipment purchase,REF78761966,63.37,0.0,122693.37
2019-10-15,2019-10-15,Payment from Cunningham-Barton,REF94605317,0.0,1797.64,124491.01
2019-10-15,2019-10-15,Payment from Medina and Sons,REF41989692,0.0,2087.77,126578.78
2019-10-15,2019-10-15,Business travel,REF87525079,189.35,0.0,126389.43
2019-10-15,2019-10-15,Invoice payment - Dunn-Wilson,REF12894394,0.0,1577.53,127966.96
2019-10-15,2019-10-15,Business insurance premium,REF56206738,141.58,0.0,127825.38
2019-10-16,2019-10-16,Business travel,REF90496338,176.74,0.0,127648.64
2019-10-21,2019-10-21,Office supplies,REF75900938,50.72,0.0,127597.92
2019-10-26,2019-10-26,Office supplies,REF85212853,103.86,0.0,127494.06
2019-10-31,2019-10-31,Business travel,REF86488033,291.52,0.0,127202.54
2019-11-05,2019-11-05,Professional services,REF76711118,362.6,0.0,126839.94
2019-11-06,2019-11-06,Office supplies,REF16610036,43.82,0.0,126796.12
2019-11-06,2019-11-06,Internet and phone service,REF28172599,90.15,0.0,126705.97
2019-11-09,2019-11-09,Software subscription,REF17807988,178.1,0.0,126527.87
2019-11-13,2019-11-13,Professional services,REF96066796,296.02,0.0,126231.85
2019-11-15,2019-11-15,Service payment - Cunningham-Barton,REF24591344,0.0,1662.04,127893.89
2019-11-15,2019-11-15,Invoice payment - Dunn-Wilson,REF10100759,0.0,1723.28,129617.17
2019-11-15,2019-11-15,Payment from Medina and Sons,REF27730316,0.0,2210.75,131827.92
2019-11-15,2019-11-15,Business insurance premium,REF49496883,138.81,0.0,131689.11
2019-11-19,2019-11-19,Training/conference,REF53463497,74.15,0.0,131614.96
2019-11-22,2019-11-22,Internet and phone service,REF10263608,73.87,0.0,131541.09
2019-11-25,2019-11-25,Training/conference,REF13515590,70.95,0.0,131470.14
2019-11-26,2019-11-26,Office supplies,REF54445315,60.87,0.0,131409.27
2019-11-27,2019-11-27,Equipment purchase,REF45825730,94.0,0.0,131315.27
2019-11-29,2019-11-29,Training/conference,REF30718750,85.83,0.0,131229.44
2019-12-02,2019-12-02,Office supplies,REF86277604,40.77,0.0,131188.67
2019-12-05,2019-12-05,Professional services,REF74673994,149.02,0.0,131039.65
2019-12-05,2019-12-05,Office supplies,REF66624601,5.01,0.0,131034.64
2019-12-09,2019-12-09,Software subscription,REF35364078,131.57,0.0,130903.07
2019-12-15,2019-12-15,Invoice payment - Cunningham-Barton,REF12442701,0.0,1208.74,132111.81
2019-12-15,2019-12-15,Payment from Medina and Sons,REF50193639,0.0,1836.05,133947.86
2019-12-15,2019-12-15,Service payment - Dunn-Wilson,REF11711902,0.0,1185.5,135133.36
2019-12-15,2019-12-15,Business insurance premium,REF69999491,101.37,0.0,135031.99
2019-12-21,2019-12-21,Office supplies,REF49576244,51.19,0.0,134980.8
2019-12-22,2019-12-22,Office supplies,REF88376986,16.61,0.0,134964.19
2019-12-27,2019-12-27,Training/conference,REF15246890,97.86,0.0,134866.33
2020-01-04,2020-01-04,Professional services,REF58650210,227.76,0.0,134638.57
2020-01-09,2020-01-09,Software subscription,REF71515758,118.03,0.0,134520.54
2020-01-12,2020-01-12,Marketing expenses,REF47978972,110.03,0.0,134410.51
2020-01-15,2020-01-15,Invoice payment - Medina and Sons,REF93636495,0.0,1434.4,135844.91
2020-01-15,2020-01-15,Invoice payment - Dunn-Wilson,REF42166633,0.0,935.43,136780.34
2020-01-15,2020-01-15,Business insurance premium,REF98892831,102.34,0.0,136678.0
2020-01-17,2020-01-17,Equipment purchase,REF92738425,76.76,0.0,136601.24
2020-01-27,2020-01-27,Training/conference,REF42586029,70.45,0.0,136530.79
2020-01-30,2020-01-30,Office supplies,REF56813668,38.71,0.0,136492.08
2020-02-02,2020-02-02,Professional services,REF81599130,174.45,0.0,136317.63
2020-02-09,2020-02-09,Training/conference,REF73468699,63.76,0.0,136253.87
2020-02-09,2020-02-09,Office supplies,REF59957565,32.18,0.0,136221.69
2020-02-09,2020-02-09,Software subscription,REF14486584,141.84,0.0,136079.85
2020-02-15,2020-02-15,Service payment - Medina and Sons,REF84963198,0.0,1690.89,137770.74
2020-02-15,2020-02-15,Project payment - Dunn-Wilson,REF83052447,0.0,1074.27,138845.01
2020-02-15,2020-02-15,Payment from Cunningham-Barton,REF24072339,0.0,1194.55,140039.56
2020-02-15,2020-02-15,Business insurance premium,REF54456000,112.85,0.0,139926.71
2020-02-19,2020-02-19,Office supplies,REF94235891,28.78,0.0,139897.93
2020-02-20,2020-02-20,Professional services,REF98532093,89.93,0.0,139808.0
2020-02-21,2020-02-21,Business travel,REF72123810,176.09,0.0,139631.91
2020-02-24,2020-02-24,Office supplies,REF31267880,37.89,0.0,139594.02
2020-02-28,2020-02-28,Marketing expenses,REF24642076,279.7,0.0,139314.32
2020-03-02,2020-03-02,Equipment purchase,REF42460703,80.42,0.0,139233.9
2020-03-05,2020-03-05,Business travel,REF80791863,160.43,0.0,139073.47
2020-03-06,2020-03-06,Business travel,REF40541923,124.24,0.0,138949.23
2020-03-09,2020-03-09,Software subscription,REF20455396,157.54,0.0,138791.69
2020-03-11,2020-03-11,Office supplies,REF85962301,26.76,0.0,138764.93
2020-03-11,2020-03-11,Equipment purchase,REF51987240,115.14,0.0,138649.79
2020-03-12,2020-03-12,Training/conference,REF19629211,42.28,0.0,138607.51
2020-03-13,2020-03-13,Office supplies,REF38083439,61.41,0.0,138546.1
2020-03-14,2020-03-14,Office supplies,REF97477187,60.58,0.0,138485.52
2020-03-15,2020-03-15,Business insurance premium,REF76659967,121.92,0.0,138363.6
2020-03-15,2020-03-15,Equipment purchase,REF45704094,116.68,0.0,138246.92
2020-03-15,2020-03-15,Payment from Dunn-Wilson,REF25965726,0.0,1259.01,139505.93
2020-03-19,2020-03-19,Equipment purchase,REF77355059,154.07,0.0,139351.86
2020-03-23,2020-03-23,Internet and phone service,REF73430019,105.7,0.0,139246.16
2020-03-27,2020-03-27,Equipment purchase,REF65395014,139.21,0.0,139106.95
2020-04-01,2020-04-01,Office supplies,REF16117378,22.03,0.0,139084.92
2020-04-07,2020-04-07,Business travel,REF53330908,87.13,0.0,138997.79
2020-04-08,2020-04-08,Office supplies,REF42041235,65.51,0.0,138932.28
2020-04-09,2020-04-09,Software subscription,REF51318383,155.6,0.0,138776.68
2020-04-10,2020-04-10,Training/conference,REF50421694,79.38,0.0,138697.3
2020-04-11,2020-04-11,Office supplies,REF62925094,37.74,0.0,138659.56
2020-04-11,2020-04-11,Business travel,REF38076890,85.45,0.0,138574.11
2020-04-12,2020-04-12,Office supplies,REF52744629,49.99,0.0,138524.12
2020-04-14,2020-04-14,Business travel,REF62296844,128.28,0.0,138395.84
2020-04-15,2020-04-15,Business insurance premium,REF76612192,119.09,0.0,138276.75
2020-04-15,2020-04-15,Project payment - Medina and Sons,REF43103576,0.0,1860.7,140137.45
2020-04-15,2020-04-15,Payment from Cunningham-Barton,REF72508398,0.0,1463.53,141600.98
2020-04-15,2020-04-15,Invoice payment - Dunn-Wilson,REF27598764,0.0,1496.2,143097.18
2020-04-16,2020-04-16,Office supplies,REF57836752,47.6,0.0,143049.58
2020-04-27,2020-04-27,Marketing expenses,REF39617812,270.58,0.0,142779.0
2020-04-28,2020-04-28,Professional services,REF23858623,322.63,0.0,142456.37
2020-04-29,2020-04-29,Marketing expenses,REF68429840,205.76,0.0,142250.61
2020-05-01,2020-05-01,Business travel,REF96974244,123.52,0.0,142127.09
2020-05-03,2020-05-03,Marketing expenses,REF51920694,177.41,0.0,141949.68
2020-05-03,2020-05-03,Business travel,REF81215050,94.65,0.0,141855.03
2020-05-04,2020-05-04,Office supplies,REF50667867,48.34,0.0,141806.69
2020-05-09,2020-05-09,Software subscription,REF57895284,138.69,0.0,141668.0
2020-05-10,2020-05-10,Marketing expenses,REF26374331,145.89,0.0,141522.11
2020-05-15,2020-05-15,Business insurance premium,REF73068313,127.76,0.0,141394.35
2020-05-15,2020-05-15,Payment from Dunn-Wilson,REF12135945,0.0,1305.44,142699.79
2020-05-15,2020-05-15,Project payment - Medina and Sons,REF11382284,0.0,1822.04,144521.83
2020-05-15,2020-05-15,Payment from Cunningham-Barton,REF63004180,0.0,1565.99,146087.82
2020-05-15,2020-05-15,Office supplies,REF35792525,53.29,0.0,146034.53
2020-05-16,2020-05-16,Office supplies,REF96861317,50.03,0.0,145984.5
2020-05-19,2020-05-19,Equipment purchase,REF72673243,134.73,0.0,145849.77
2020-05-22,2020-05-22,Marketing expenses,REF44096046,186.34,0.0,145663.43
2020-05-27,2020-05-27,Internet and phone service,REF84045886,88.98,0.0,145574.45
2020-05-28,2020-05-28,Training/conference,REF85440893,95.81,0.0,145478.64
2020-05-31,2020-05-31,Business travel,REF68465218,175.28,0.0,145303.36
2020-06-02,2020-06-02,Marketing expenses,REF22573897,110.68,0.0,145192.68
2020-06-02,2020-06-02,Office supplies,REF39031111,32.01,0.0,145160.67
2020-06-04,2020-06-04,Business travel,REF31232303,115.69,0.0,145044.98
2020-06-09,2020-06-09,Software subscription,REF93462186,130.26,0.0,144914.72
2020-06-15,2020-06-15,Service payment - Cunningham-Barton,REF10682079,0.0,1302.36,146217.08
2020-06-15,2020-06-15,Business insurance premium,REF89296493,109.77,0.0,146107.31
2020-06-15,2020-06-15,Project payment - Dunn-Wilson,REF52195982,0.0,872.22,146979.53
2020-06-15,2020-06-15,Payment from Medina and Sons,REF25516241,0.0,1534.34,148513.87
2020-06-22,2020-06-22,Business travel,REF46025558,164.97,0.0,148348.9
2020-06-22,2020-06-22,Professional services,REF27760823,118.45,0.0,148230.45
2020-06-22,2020-06-22,Internet and phone service,REF36637985,62.14,0.0,148168.31
2020-06-24,2020-06-24,Business travel,REF73277123,31.36,0.0,148136.95
2020-06-25,2020-06-25,Training/conference,REF48063122,42.24,0.0,148094.71
2020-07-09,2020-07-09,Software subscription,REF66541808,120.17,0.0,147974.54
2020-07-09,2020-07-09,Business travel,REF46098563,177.09,0.0,147797.45
2020-07-14,2020-07-14,Internet and phone service,REF62485555,85.64,0.0,147711.81
2020-07-15,2020-07-15,Payment from Medina and Sons,REF15822417,0.0,1599.36,149311.17
2020-07-15,2020-07-15,Project payment - Dunn-Wilson,REF45598123,0.0,964.1,150275.27
2020-07-15,2020-07-15,Service payment - Cunningham-Barton,REF48451294,0.0,939.83,151215.1
2020-07-15,2020-07-15,Business insurance premium,REF70575918,90.24,0.0,151124.86
2020-07-21,2020-07-21,Office supplies,REF71434519,36.57,0.0,151088.29
2020-07-24,2020-07-24,Training/conference,REF46574822,78.39,0.0,151009.9
2020-07-26,2020-07-26,Business travel,REF41554147,113.27,0.0,150896.63
2020-08-02,2020-08-02,Office supplies,REF93085830,42.82,0.0,150853.81
2020-08-09,2020-08-09,Software subscription,REF18090721,113.45,0.0,150740.36
2020-08-13,2020-08-13,Business travel,REF21031514,90.42,0.0,150649.94
2020-08-15,2020-08-15,Project payment - Dunn-Wilson,REF22112393,0.0,910.97,151560.91
2020-08-15,2020-08-15,Business insurance premium,REF95305541,86.18,0.0,151474.73
2020-08-15,2020-08-15,Project payment - Medina and Sons,REF36534926,0.0,1299.58,152774.31
2020-08-15,2020-08-15,Internet and phone service,REF21440964,32.87,0.0,152741.44
2020-08-15,2020-08-15,Project payment - Cunningham-Barton,REF83347689,0.0,961.79,153703.23
2020-08-16,2020-08-16,Training/conference,REF80383335,66.61,0.0,153636.62
2020-08-17,2020-08-17,Marketing expenses,REF25072055,160.32,0.0,153476.3
2020-08-18,2020-08-18,Office supplies,REF99104072,23.63,0.0,153452.67
2020-08-21,2020-08-21,Office supplies,REF67753546,45.65,0.0,153407.02
2020-08-24,2020-08-24,Internet and phone service,REF67667175,53.52,0.0,153353.5
2020-08-24,2020-08-24,Office supplies,REF69623641,34.33,0.0,153319.17
2020-08-24,2020-08-24,Training/conference,REF38633471,96.34,0.0,153222.83
2020-08-24,2020-08-24,Business travel,REF80993620,146.24,0.0,153076.59
2020-08-31,2020-08-31,Internet and phone service,REF65100145,37.39,0.0,153039.2
2020-08-31,2020-08-31,Equipment purchase,REF33442654,74.51,0.0,152964.69
2020-08-31,2020-08-31,Marketing expenses,REF95818794,166.01,0.0,152798.68
2020-09-03,2020-09-03,Marketing expenses,REF91252662,185.05,0.0,152613.63
2020-09-04,2020-09-04,Professional services,REF59401907,272.88,0.0,152340.75
2020-09-06,2020-09-06,Marketing expenses,REF56986315,286.45,0.0,152054.3
2020-09-06,2020-09-06,Equipment purchase,REF22622276,79.95,0.0,151974.35
2020-09-08,2020-09-08,Office supplies,REF50298035,26.41,0.0,151947.94
2020-09-09,2020-09-09,Software subscription,REF84936696,175.94,0.0,151772.0
2020-09-13,2020-09-13,Training/conference,REF88787303,105.18,0.0,151666.82
2020-09-13,2020-09-13,Office supplies,REF39417936,71.96,0.0,151594.86
2020-09-14,2020-09-14,Office supplies,REF14843595,47.56,0.0,151547.3
2020-09-15,2020-09-15,Invoice payment - Dunn-Wilson,REF50632235,0.0,1467.59,153014.89
2020-09-15,2020-09-15,Invoice payment - Medina and Sons,REF47381470,0.0,2278.91,155293.8
2020-09-15,2020-09-15,Business insurance premium,REF47190283,115.28,0.0,155178.52
2020-09-15,2020-09-15,Service payment - Cunningham-Barton,REF82488845,0.0,1038.8,156217.32
2020-09-19,2020-09-19,Internet and phone service,REF20446691,89.19,0.0,156128.13
2020-09-20,2020-09-20,Business travel,REF13670334,265.27,0.0,155862.86
2020-09-22,2020-09-22,Marketing expenses,REF13745023,262.32,0.0,155600.54
2020-09-24,2020-09-24,Office supplies,REF59062833,73.87,0.0,155526.67
2020-09-26,2020-09-26,Business travel,REF73163989,162.42,0.0,155364.25
2020-09-30,2020-09-30,Office supplies,REF95692421,45.42,0.0,155318.83
2020-10-03,2020-10-03,Office supplies,REF95102782,91.78,0.0,155227.05
2020-10-07,2020-10-07,Business travel,REF71136077,148.28,0.0,155078.77
2020-10-08,2020-10-08,Business travel,REF60119779,206.69,0.0,154872.08
2020-10-08,2020-10-08,Professional services,REF19946335,287.18,0.0,154584.9
2020-10-09,2020-10-09,Software subscription,REF51809959,188.78,0.0,154396.12
2020-10-15,2020-10-15,Business insurance premium,REF87127188,144.89,0.0,154251.23
2020-10-15,2020-10-15,Payment from Cunningham-Barton,REF25288434,0.0,1838.23,156089.46
2020-10-15,2020-10-15,Payment from Dunn-Wilson,REF10819664,0.0,1258.78,157348.24
2020-10-15,2020-10-15,Service payment - Medina and Sons,REF10679211,0.0,1647.72,158995.96
2020-10-16,2020-10-16,Equipment purchase,REF55753705,93.46,0.0,158902.5
2020-10-17,2020-10-17,Professional services,REF26368226,467.07,0.0,158435.43
2020-10-17,2020-10-17,Office supplies,REF55417611,75.86,0.0,158359.57
2020-10-24,2020-10-24,Equipment purchase,REF68721255,82.68,0.0,158276.89
2020-10-26,2020-10-26,Business travel,REF65755496,161.44,0.0,158115.45
2020-10-27,2020-10-27,Business travel,REF76744352,152.26,0.0,157963.19
2020-11-01,2020-11-01,Office supplies,REF69343345,62.36,0.0,157900.83
2020-11-05,2020-11-05,Professional services,REF31138832,311.18,0.0,157589.65
2020-11-06,2020-11-06,Internet and phone service,REF62957736,110.65,0.0,157479.0
2020-11-09,2020-11-09,Software subscription,REF87758086,192.21,0.0,157286.79
2020-11-10,2020-11-10,Office supplies,REF33107488,64.15,0.0,157222.64
2020-11-10,2020-11-10,Professional services,REF50459074,143.05,0.0,157079.59
2020-11-12,2020-11-12,Marketing expenses,REF98878372,286.33,0.0,156793.26
2020-11-15,2020-11-15,Business insurance premium,REF10787725,137.91,0.0,156655.35
2020-11-15,2020-11-15,Invoice payment - Cunningham-Barton,REF58538382,0.0,1499.89,158155.24
2020-11-15,2020-11-15,Project payment - Medina and Sons,REF15986128,0.0,2057.5,160212.74
2020-11-15,2020-11-15,Payment from Dunn-Wilson,REF16472728,0.0,943.4,161156.14
2020-11-22,2020-11-22,Office supplies,REF56933976,52.39,0.0,161103.75
2020-11-25,2020-11-25,Office supplies,REF64770876,45.37,0.0,161058.38
2020-11-30,2020-11-30,Training/conference,REF28637964,122.05,0.0,160936.33
2020-12-04,2020-12-04,Business travel,REF96657873,77.75,0.0,160858.58
2020-12-06,2020-12-06,Internet and phone service,REF13662053,81.72,0.0,160776.86
2020-12-09,2020-12-09,Software subscription,REF96213164,140.71,0.0,160636.15
2020-12-13,2020-12-13,Office supplies,REF49761563,24.53,0.0,160611.62
2020-12-14,2020-12-14,Office supplies,REF17757619,28.81,0.0,160582.81
2020-12-15,2020-12-15,Service payment - Medina and Sons,REF51980212,0.0,1682.9,162265.71
2020-12-15,2020-12-15,Service payment - Cunningham-Barton,REF59453768,0.0,1182.76,163448.47
2020-12-15,2020-12-15,Payment from Dunn-Wilson,REF30079796,0.0,1159.43,164607.9
2020-12-15,2020-12-15,Business insurance premium,REF77071393,106.33,0.0,164501.57
2020-12-21,2020-12-21,Office supplies,REF24192932,20.65,0.0,164480.92
2020-12-22,2020-12-22,Marketing expenses,REF83648592,182.71,0.0,164298.21
2020-12-23,2020-12-23,Internet and phone service,REF63698308,33.1,0.0,164265.11
2020-12-24,2020-12-24,Training/conference,REF37624426,95.62,0.0,164169.49
2020-12-26,2020-12-26,Office supplies,REF74448009,42.66,0.0,164126.83
2020-12-29,2020-12-29,Office supplies,REF11505501,57.32,0.0,164069.51
2021-01-05,2021-01-05,Internet and phone service,REF35237886,43.71,0.0,164025.8
2021-01-07,2021-01-07,Training/conference,REF85138031,70.33,0.0,163955.47
2021-01-09,2021-01-09,Software subscription,REF69035652,113.8,0.0,163841.67
2021-01-15,2021-01-15,Office supplies,REF53464691,57.87,0.0,163783.8
2021-01-15,2021-01-15,Business insurance premium,REF48701952,94.38,0.0,163689.42
2021-01-15,2021-01-15,Project payment - Dunn-Wilson,REF26900827,0.0,1138.8,164828.22
2021-01-15,2021-01-15,Project payment - Cunningham-Barton,REF26457616,0.0,1189.92,166018.14
2021-01-15,2021-01-15,Service payment - Medina and Sons,REF86381058,0.0,1264.36,167282.5
2021-01-17,2021-01-17,Office supplies,REF90425364,38.8,0.0,167243.7
2021-01-21,2021-01-21,Business travel,REF94812330,155.46,0.0,167088.24
2021-01-31,2021-01-31,Professional services,REF55188294,183.82,0.0,166904.42
2021-02-02,2021-02-02,Office supplies,REF91492980,51.14,0.0,166853.28
2021-02-03,2021-02-03,Office supplies,REF70340698,49.08,0.0,166804.2
2021-02-05,2021-02-05,Office supplies,REF61529500,33.96,0.0,166770.24
2021-02-05,2021-02-05,Marketing expenses,REF97831597,104.51,0.0,166665.73
2021-02-07,2021-02-07,Office supplies,REF90234504,64.1,0.0,166601.63
2021-02-09,2021-02-09,Software subscription,REF94639227,118.05,0.0,166483.58
2021-02-11,2021-02-11,Office supplies,REF30839423,38.72,0.0,166444.86
2021-02-15,2021-02-15,Business insurance premium,REF80352360,108.02,0.0,166336.84
2021-02-15,2021-02-15,Marketing expenses,REF88625197,192.63,0.0,166144.21
2021-02-19,2021-02-19,Equipment purchase,REF86061421,73.91,0.0,166070.3
2021-02-20,2021-02-20,Marketing expenses,REF51054165,254.4,0.0,165815.9
2021-02-21,2021-02-21,Equipment purchase,REF60163741,68.69,0.0,165747.21
2021-02-25,2021-02-25,Office supplies,REF99327585,55.88,0.0,165691.33
2021-03-02,2021-03-02,Office supplies,REF44550264,41.56,0.0,165649.77
2021-03-08,2021-03-08,Office supplies,REF90375839,34.97,0.0,165614.8
2021-03-09,2021-03-09,Software subscription,REF31062986,138.15,0.0,165476.65
2021-03-11,2021-03-11,Internet and phone service,REF33482879,57.76,0.0,165418.89
2021-03-15,2021-03-15,Payment from Cunningham-Barton,REF56931650,0.0,1494.98,166913.87
2021-03-15,2021-03-15,Business insurance premium,REF48290236,137.0,0.0,166776.87
2021-03-15,2021-03-15,Project payment - Medina and Sons,REF68733721,0.0,2017.73,168794.6
2021-03-15,2021-03-15,Service payment - Dunn-Wilson,REF43790519,0.0,1297.23,170091.83
2021-03-15,2021-03-15,Business travel,REF14113007,215.18,0.0,169876.65
2021-03-21,2021-03-21,Business travel,REF95310892,228.93,0.0,169647.72
2021-03-26,2021-03-26,Office supplies,REF20115177,50.62,0.0,169597.1
2021-04-06,2021-04-06,Marketing expenses,REF81523546,282.22,0.0,169314.88
2021-04-08,2021-04-08,Internet and phone service,REF48277941,90.77,0.0,169224.11
2021-04-09,2021-04-09,Software subscription,REF59698218,129.66,0.0,169094.45
2021-04-12,2021-04-12,Office supplies,REF27096287,57.01,0.0,169037.44
2021-04-14,2021-04-14,Office supplies,REF83563621,43.45,0.0,168993.99
2021-04-15,2021-04-15,Service payment - Medina and Sons,REF36423462,0.0,1539.35,170533.34
2021-04-15,2021-04-15,Service payment - Dunn-Wilson,REF85347768,0.0,1359.81,171893.15
2021-04-15,2021-04-15,Project payment - Cunningham-Barton,REF98801085,0.0,825.66,172718.81
2021-04-15,2021-04-15,Business insurance premium,REF46144501,122.12,0.0,172596.69
2021-04-20,2021-04-20,Professional services,REF78848438,232.39,0.0,172364.3
2021-04-20,2021-04-20,Business travel,REF54554339,245.21,0.0,172119.09
2021-04-23,2021-04-23,Office supplies,REF41675921,44.84,0.0,172074.25
2021-05-05,2021-05-05,Equipment purchase,REF44990254,101.75,0.0,171972.5
2021-05-09,2021-05-09,Software subscription,REF57993937,130.9,0.0,171841.6
2021-05-11,2021-05-11,Internet and phone service,REF36729561,97.4,0.0,171744.2
2021-05-12,2021-05-12,Office supplies,REF58652550,50.1,0.0,171694.1
2021-05-15,2021-05-15,Business insurance premium,REF61144851,116.65,0.0,171577.45
2021-05-15,2021-05-15,Service payment - Dunn-Wilson,REF22973854,0.0,1240.36,172817.81
2021-05-15,2021-05-15,Service payment - Medina and Sons,REF24393634,0.0,2149.7,174967.51
2021-05-15,2021-05-15,Payment from Cunningham-Barton,REF45329772,0.0,1358.23,176325.74
2021-05-18,2021-05-18,Marketing expenses,REF82081342,151.63,0.0,176174.11
2021-05-22,2021-05-22,Business travel,REF42283748,83.61,0.0,176090.5
2021-05-23,2021-05-23,Marketing expenses,REF63811571,156.5,0.0,175934.0
2021-05-26,2021-05-26,Internet and phone service,REF81621946,69.98,0.0,175864.02
2021-05-31,2021-05-31,Training/conference,REF50402003,61.65,0.0,175802.37
2021-06-01,2021-06-01,Office supplies,REF14993353,27.73,0.0,175774.64
2021-06-04,2021-06-04,Marketing expenses,REF33071530,168.98,0.0,175605.66
2021-06-04,2021-06-04,Professional services,REF12140313,464.4,0.0,175141.26
2021-06-06,2021-06-06,Office supplies,REF89804695,33.81,0.0,175107.45
2021-06-06,2021-06-06,Training/conference,REF93937891,85.83,0.0,175021.62
2021-06-07,2021-06-07,Office supplies,REF47772480,62.19,0.0,174959.43
2021-06-09,2021-06-09,Software subscription,REF16031553,147.24,0.0,174812.19
2021-06-10,2021-06-10,Internet and phone service,REF38554662,76.57,0.0,174735.62
2021-06-11,2021-06-11,Office supplies,REF38788958,71.62,0.0,174664.0
2021-06-13,2021-06-13,Office supplies,REF20919124,20.14,0.0,174643.86
2021-06-14,2021-06-14,Internet and phone service,REF56598066,118.45,0.0,174525.41
2021-06-15,2021-06-15,Project payment - Cunningham-Barton,REF26839060,0.0,1296.91,175822.32
2021-06-15,2021-06-15,Business insurance premium,REF61787063,102.9,0.0,175719.42
2021-06-15,2021-06-15,Service payment - Medina and Sons,REF25871086,0.0,1516.16,177235.58
2021-06-15,2021-06-15,Invoice payment - Dunn-Wilson,REF66747254,0.0,712.87,177948.45
2021-06-16,2021-06-16,Office supplies,REF33137435,48.26,0.0,177900.19
2021-06-18,2021-06-18,Training/conference,REF77313399,65.33,0.0,177834.86
2021-06-22,2021-06-22,Business travel,REF66453023,148.61,0.0,177686.25
2021-06-24,2021-06-24,Office supplies,REF86124837,60.93,0.0,177625.32
2021-06-30,2021-06-30,Marketing expenses,REF84196068,81.71,0.0,177543.61
2021-07-03,2021-07-03,Equipment purchase,REF39556237,111.95,0.0,177431.66
2021-07-05,2021-07-05,Office supplies,REF15671082,30.16,0.0,177401.5
2021-07-09,2021-07-09,Software subscription,REF89952632,116.83,0.0,177284.67
2021-07-11,2021-07-11,Marketing expenses,REF53639655,133.36,0.0,177151.31
2021-07-15,2021-07-15,Invoice payment - Dunn-Wilson,REF83381843,0.0,973.19,178124.5
2021-07-15,2021-07-15,Invoice payment - Medina and Sons,REF38598896,0.0,1099.3,179223.8
2021-07-15,2021-07-15,Payment from Cunningham-Barton,REF18345787,0.0,1076.36,180300.16
2021-07-15,2021-07-15,Business insurance premium,REF73725628,93.38,0.0,180206.78
2021-07-15,2021-07-15,Office supplies,REF96150410,22.01,0.0,180184.77
2021-07-20,2021-07-20,Business travel,REF60233745,173.81,0.0,180010.96
2021-07-21,2021-07-21,Office supplies,REF89288226,35.23,0.0,179975.73
2021-07-22,2021-07-22,Office supplies,REF11191156,39.1,0.0,179936.63
2021-07-23,2021-07-23,Office supplies,REF43892866,19.91,0.0,179916.72
2021-07-26,2021-07-26,Marketing expenses,REF77296121,138.85,0.0,179777.87
2021-07-28,2021-07-28,Office supplies,REF60924034,41.62,0.0,179736.25
2021-08-02,2021-08-02,Office supplies,REF87195844,20.53,0.0,179715.72
2021-08-05,2021-08-05,Office supplies,REF71387015,54.96,0.0,179660.76
2021-08-09,2021-08-09,Marketing expenses,REF30959138,71.61,0.0,179589.15
2021-08-09,2021-08-09,Software subscription,REF44858832,113.52,0.0,179475.63
2021-08-13,2021-08-13,Equipment purchase,REF57321763,83.38,0.0,179392.25
2021-08-13,2021-08-13,Professional services,REF66647398,110.96,0.0,179281.29
2021-08-15,2021-08-15,Business insurance premium,REF15393330,84.34,0.0,179196.95
2021-08-15,2021-08-15,Service payment - Dunn-Wilson,REF58149507,0.0,789.09,179986.04
2021-08-15,2021-08-15,Invoice payment - Medina and Sons,REF68011322,0.0,1285.46,181271.5
2021-08-15,2021-08-15,Project payment - Cunningham-Barton,REF99837121,0.0,656.41,181927.91
2021-08-19,2021-08-19,Business travel,REF21293128,166.41,0.0,181761.5
2021-08-20,2021-08-20,Internet and phone service,REF92161870,75.99,0.0,181685.51
2021-08-21,2021-08-21,Office supplies,REF13056885,5.0,0.0,181680.51
2021-08-22,2021-08-22,Professional services,REF60210663,53.38,0.0,181627.13
2021-08-27,2021-08-27,Office supplies,REF48589640,56.62,0.0,181570.51
2021-08-30,2021-08-30,Business travel,REF40983087,140.35,0.0,181430.16
2021-08-31,2021-08-31,Business travel,REF85141261,102.51,0.0,181327.65
2021-09-04,2021-09-04,Marketing expenses,REF70447980,160.82,0.0,181166.83
2021-09-08,2021-09-08,Office supplies,REF97753252,43.81,0.0,181123.02
2021-09-09,2021-09-09,Software subscription,REF72634298,181.66,0.0,180941.36
2021-09-14,2021-09-14,Internet and phone service,REF17297849,84.01,0.0,180857.35
2021-09-15,2021-09-15,Project payment - Dunn-Wilson,REF71862301,0.0,1529.06,182386.41
2021-09-15,2021-09-15,Business insurance premium,REF19245111,127.97,0.0,182258.44
2021-09-15,2021-09-15,Invoice payment - Medina and Sons,REF46077832,0.0,2148.37,184406.81
2021-09-15,2021-09-15,Payment from Cunningham-Barton,REF55572108,0.0,1032.25,185439.06
2021-09-18,2021-09-18,Equipment purchase,REF22582536,89.73,0.0,185349.33
2021-09-19,2021-09-19,Professional services,REF77048056,323.76,0.0,185025.57
2021-09-21,2021-09-21,Professional services,REF31290598,417.11,0.0,184608.46
2021-09-26,2021-09-26,Business travel,REF35929440,73.31,0.0,184535.15
2021-09-28,2021-09-28,Office supplies,REF81508264,56.9,0.0,184478.25
2021-09-30,2021-09-30,Business travel,REF35040119,182.86,0.0,184295.39
2021-10-04,2021-10-04,Professional services,REF68709800,69.06,0.0,184226.33
2021-10-05,2021-10-05,Marketing expenses,REF18040321,281.0,0.0,183945.33
2021-10-06,2021-10-06,Business travel,REF11844019,178.54,0.0,183766.79
2021-10-08,2021-10-08,Training/conference,REF31112253,127.43,0.0,183639.36
2021-10-09,2021-10-09,Software subscription,REF93196941,202.78,0.0,183436.58
2021-10-15,2021-10-15,Payment from Dunn-Wilson,REF88353176,0.0,1631.32,185067.9
2021-10-15,2021-10-15,Project payment - Medina and Sons,REF95395388,0.0,2250.84,187318.74
2021-10-15,2021-10-15,Office supplies,REF30944009,58.8,0.0,187259.94
2021-10-15,2021-10-15,Marketing expenses,REF40562441,313.02,0.0,186946.92
2021-10-15,2021-10-15,Project payment - Cunningham-Barton,REF30586046,0.0,1644.69,188591.61
2021-10-15,2021-10-15,Business insurance premium,REF34525301,151.71,0.0,188439.9
2021-10-17,2021-10-17,Office supplies,REF23865180,33.5,0.0,188406.4
2021-10-21,2021-10-21,Equipment purchase,REF84146039,64.24,0.0,188342.16
2021-10-22,2021-10-22,Office supplies,REF63852106,49.7,0.0,188292.46
2021-10-23,2021-10-23,Office supplies,REF32632519,86.65,0.0,188205.81
2021-10-24,2021-10-24,Office supplies,REF43621295,53.83,0.0,188151.98
2021-10-27,2021-10-27,Business travel,REF82832186,85.23,0.0,188066.75
2021-10-28,2021-10-28,Equipment purchase,REF52698169,152.55,0.0,187914.2
2021-10-31,2021-10-31,Internet and phone service,REF88065785,186.47,0.0,187727.73
2021-11-02,2021-11-02,Professional services,REF46434037,164.71,0.0,187563.02
2021-11-04,2021-11-04,Business travel,REF10663721,285.54,0.0,187277.48
2021-11-05,2021-11-05,Business travel,REF57851341,86.51,0.0,187190.97
2021-11-06,2021-11-06,Marketing expenses,REF19042600,223.12,0.0,186967.85
2021-11-09,2021-11-09,Software subscription,REF43005677,159.22,0.0,186808.63
2021-11-09,2021-11-09,Marketing expenses,REF80754328,206.75,0.0,186601.88
2021-11-15,2021-11-15,Project payment - Cunningham-Barton,REF70263054,0.0,1439.46,188041.34
2021-11-15,2021-11-15,Business travel,REF75176540,121.77,0.0,187919.57
2021-11-15,2021-11-15,Payment from Dunn-Wilson,REF97691216,0.0,1344.55,189264.12
2021-11-15,2021-11-15,Service payment - Medina and Sons,REF32362040,0.0,1847.19,191111.31
2021-11-15,2021-11-15,Business insurance premium,REF63047980,129.32,0.0,190981.99
2021-11-17,2021-11-17,Office supplies,REF29759771,64.38,0.0,190917.61
2021-11-19,2021-11-19,Office supplies,REF53241850,59.78,0.0,190857.83
2021-11-23,2021-11-23,Business travel,REF76245845,227.56,0.0,190630.27
2021-11-25,2021-11-25,Office supplies,REF84814082,92.87,0.0,190537.4
2021-12-01,2021-12-01,Training/conference,REF51728860,111.97,0.0,190425.43
2021-12-03,2021-12-03,Office supplies,REF35083472,31.84,0.0,190393.59
2021-12-09,2021-12-09,Professional services,REF53656653,299.71,0.0,190093.88
2021-12-09,2021-12-09,Software subscription,REF81283539,127.86,0.0,189966.02
2021-12-10,2021-12-10,Marketing expenses,REF15996655,198.22,0.0,189767.8
2021-12-14,2021-12-14,Business travel,REF67026057,118.74,0.0,189649.06
2021-12-15,2021-12-15,Invoice payment - Cunningham-Barton,REF39594129,0.0,1307.1,190956.16
2021-12-15,2021-12-15,Invoice payment - Medina and Sons,REF85976364,0.0,1388.15,192344.31
2021-12-15,2021-12-15,Invoice payment - Dunn-Wilson,REF59200265,0.0,1033.19,193377.5
2021-12-15,2021-12-15,Business insurance premium,REF94921775,104.34,0.0,193273.16
2021-12-22,2021-12-22,Office supplies,REF68393740,41.76,0.0,193231.4
2021-12-27,2021-12-27,Professional services,REF49761036,267.29,0.0,192964.11
2021-12-30,2021-12-30,Training/conference,REF52492670,86.95,0.0,192877.16
2021-12-30,2021-12-30,Business travel,REF38158926,154.17,0.0,192722.99
2022-01-06,2022-01-06,Business travel,REF70907883,156.59,0.0,192566.4
2022-01-07,2022-01-07,Office supplies,REF64130529,25.49,0.0,192540.91
2022-01-08,2022-01-08,Office supplies,REF53131365,44.18,0.0,192496.73
2022-01-09,2022-01-09,Software subscription,REF50120874,136.77,0.0,192359.96
2022-01-11,2022-01-11,Marketing expenses,REF71503852,158.44,0.0,192201.52
