transaction_date,value_date,description,reference,debit,credit,balance
2022-08-18,2022-08-18,Project payment - Customer_0039,REF53941066,0.0,167.41,4250.27
2022-08-18,2022-08-18,Project payment - Customer_0004,REF30517855,0.0,52.99,4303.26
2022-08-18,2022-08-18,Service payment - Customer_0027,REF87825272,0.0,80.83,4384.09
2022-08-18,2022-08-18,Payment from Customer_0089,REF73252836,0.0,131.63,4515.72
2022-08-18,2022-08-18,Invoice payment - Customer_0080,REF20313357,0.0,46.37,4562.09
2022-08-18,2022-08-18,Invoice payment - Customer_0055,REF77965701,0.0,45.4,4607.49
2022-08-18,2022-08-18,Project payment - Customer_0048,REF41813930,0.0,112.82,4720.31
2022-08-18,2022-08-18,Service payment - Customer_0062,REF25752789,0.0,57.63,4777.94
2022-08-18,2022-08-18,Project payment - Customer_0040,REF77007476,0.0,44.28,4822.22
2022-08-19,2022-08-19,Invoice payment - Customer_0005,REF95272597,0.0,34.29,4856.51
2022-08-19,2022-08-19,Project payment - Customer_0039,REF50385949,0.0,90.82,4947.33
2022-08-19,2022-08-19,Service payment - Customer_0076,REF14638709,0.0,10.94,4958.27
2022-08-19,2022-08-19,Project payment - Customer_0023,REF17554142,0.0,127.46,5085.73
2022-08-19,2022-08-19,Payment from Customer_0078,REF58862775,0.0,155.21,5240.94
2022-08-19,2022-08-19,Payment from Customer_0080,REF52020282,0.0,45.02,5285.96
2022-08-20,2022-08-20,Project payment - Customer_0004,REF77503074,0.0,54.9,5340.86
2022-08-20,2022-08-20,Invoice payment - Customer_0073,REF43957999,0.0,86.34,5427.2
2022-08-20,2022-08-20,Service payment - Customer_0040,REF39218627,0.0,40.53,5467.73
2022-08-20,2022-08-20,Payment from Customer_0062,REF73468979,0.0,69.67,5537.4
2022-08-20,2022-08-20,Payment from Customer_0067,REF53981498,0.0,108.66,5646.06
2022-08-20,2022-08-20,Project payment - Customer_0095,REF71278606,0.0,81.95,5728.01
2022-08-20,2022-08-20,Service payment - Customer_0039,REF63205172,0.0,137.85,5865.86
2022-08-20,2022-08-20,Service payment - Customer_0006,REF13922141,0.0,88.19,5954.05
2022-08-20,2022-08-20,Service payment - Customer_0057,REF17908920,0.0,121.68,6075.73
2022-08-20,2022-08-20,Payment from Customer_0022,REF73468157,0.0,73.52,6149.25
2022-08-21,2022-08-21,Payment from Customer_0035,REF67851168,0.0,120.45,6269.7
2022-08-21,2022-08-21,Service payment - Customer_0026,REF28495946,0.0,104.73,6374.43
2022-08-21,2022-08-21,Payment from Customer_0054,REF47549345,0.0,77.28,6451.71
2022-08-21,2022-08-21,Service payment - Customer_0048,REF60207883,0.0,108.73,6560.44
2022-08-21,2022-08-21,Project payment - Customer_0070,REF46125856,0.0,71.64,6632.08
2022-08-21,2022-08-21,Service payment - Customer_0082,REF59774835,0.0,166.94,6799.02
2022-08-21,2022-08-21,Invoice payment - Customer_0072,REF46060310,0.0,149.63,6948.65
2022-08-21,2022-08-21,Payment from Customer_0025,REF18785755,0.0,117.7,7066.35
2022-08-21,2022-08-21,Service payment - Customer_0090,REF22810093,0.0,93.92,7160.27
2022-08-21,2022-08-21,Payment from Customer_0091,REF68034614,0.0,130.19,7290.46
2022-08-21,2022-08-21,Service payment - Customer_0001,REF36728165,0.0,54.12,7344.58
2022-08-22,2022-08-22,Invoice payment - Customer_0049,REF97763983,0.0,99.41,7443.99
2022-08-22,2022-08-22,Project payment - Customer_0073,REF71809382,0.0,122.66,7566.65
2022-08-22,2022-08-22,Project payment - Customer_0078,REF67263263,0.0,120.26,7686.91
2022-08-22,2022-08-22,Payment from Customer_0062,REF74169470,0.0,75.04,7761.95
2022-08-22,2022-08-22,Invoice payment - Customer_0075,REF98125399,0.0,138.45,7900.4
2022-08-22,2022-08-22,Invoice payment - Customer_0085,REF37505353,0.0,106.51,8006.91
2022-08-22,2022-08-22,Service payment - Customer_0005,REF40167747,0.0,30.04,8036.95
2022-08-22,2022-08-22,Service payment - Customer_0011,REF10897324,0.0,74.53,8111.48
2022-08-22,2022-08-22,Invoice payment - Customer_0089,REF95708110,0.0,122.47,8233.95
2022-08-22,2022-08-22,Utility bill payment,REF64294783,139.34,0.0,8094.61
2022-08-23,2022-08-23,Service payment - Customer_0089,REF67685263,0.0,151.39,8246.0
2022-08-23,2022-08-23,Invoice payment - Customer_0044,REF67270183,0.0,34.43,8280.43
2022-08-23,2022-08-23,Service payment - Customer_0028,REF82890743,0.0,74.59,8355.02
2022-08-23,2022-08-23,Invoice payment - Customer_0059,REF48119552,0.0,71.0,8426.02
2022-08-23,2022-08-23,Project payment - Customer_0083,REF94860724,0.0,77.53,8503.55
2022-08-23,2022-08-23,Payment from Customer_0099,REF76108681,0.0,33.47,8537.02
2022-08-23,2022-08-23,Project payment - Customer_0033,REF96837621,0.0,65.06,8602.08
2022-08-23,2022-08-23,Service payment - Customer_0048,REF79968727,0.0,124.52,8726.6
2022-08-23,2022-08-23,Invoice payment - Customer_0084,REF43562373,0.0,73.82,8800.42
2022-08-24,2022-08-24,Service payment - Customer_0041,REF82039148,0.0,131.42,8931.84
2022-08-24,2022-08-24,Payment from Customer_0060,REF57191148,0.0,55.78,8987.62
2022-08-24,2022-08-24,Payment from Customer_0084,REF98602130,0.0,81.99,9069.61
2022-08-24,2022-08-24,Service payment - Customer_0012,REF53997932,0.0,86.81,9156.42
2022-08-24,2022-08-24,Project payment - Customer_0058,REF13468746,0.0,25.98,9182.4
2022-08-24,2022-08-24,Packaging Shipping expense,REF54422644,156.27,0.0,9026.13
2022-08-24,2022-08-24,Payment from Customer_0016,REF52224464,0.0,30.97,9057.1
2022-08-24,2022-08-24,Service payment - Customer_0093,REF59540659,0.0,94.78,9151.88
2022-08-24,2022-08-24,Project payment - Customer_0053,REF76977524,0.0,100.91,9252.79
2022-08-24,2022-08-24,Payment from Customer_0047,REF84898446,0.0,103.74,9356.53
2022-08-24,2022-08-24,Service payment - Customer_0045,REF30741581,0.0,110.41,9466.94
2022-08-24,2022-08-24,Service payment - Customer_0006,REF97222187,0.0,69.33,9536.27
2022-08-25,2022-08-25,Service payment - Customer_0006,REF90325749,0.0,107.16,9643.43
2022-08-25,2022-08-25,Project payment - Customer_0062,REF14852212,0.0,62.55,9705.98
2022-08-25,2022-08-25,Service payment - Customer_0035,REF48051111,0.0,97.53,9803.51
2022-08-25,2022-08-25,Invoice payment - Customer_0036,REF19637093,0.0,64.6,9868.11
2022-08-25,2022-08-25,Invoice payment - Customer_0022,REF12235015,0.0,70.73,9938.84
2022-08-25,2022-08-25,Project payment - Customer_0027,REF26142509,0.0,117.32,10056.16
2022-08-25,2022-08-25,Service payment - Customer_0061,REF61430703,0.0,127.61,10183.77
2022-08-26,2022-08-26,Service payment - Customer_0047,REF65547205,0.0,126.78,10310.55
2022-08-26,2022-08-26,Employee payroll,REF69066262,2493.09,0.0,7817.46
2022-08-26,2022-08-26,Service payment - Customer_0091,REF58642883,0.0,130.28,7947.74
2022-08-26,2022-08-26,Service payment - Customer_0035,REF68488544,0.0,128.97,8076.71
2022-08-26,2022-08-26,Service payment - Customer_0042,REF98422183,0.0,91.03,8167.74
2022-08-26,2022-08-26,Project payment - Customer_0069,REF27681714,0.0,56.16,8223.9
2022-08-27,2022-08-27,Project payment - Customer_0042,REF40861300,0.0,81.32,8305.22
2022-08-27,2022-08-27,Project payment - Customer_0035,REF15193477,0.0,99.31,8404.53
2022-08-27,2022-08-27,Invoice payment - Customer_0094,REF13065377,0.0,113.85,8518.38
2022-08-27,2022-08-27,Payment from Customer_0083,REF78178245,0.0,67.17,8585.55
2022-08-27,2022-08-27,Invoice payment - Customer_0078,REF53387731,0.0,123.96,8709.51
2022-08-27,2022-08-27,Project payment - Customer_0011,REF11384128,0.0,100.0,8809.51
2022-08-27,2022-08-27,Service payment - Customer_0032,REF30937462,0.0,78.1,8887.61
2022-08-27,2022-08-27,Service payment - Customer_0041,REF67448114,0.0,137.21,9024.82
2022-08-28,2022-08-28,Payment from Customer_0037,REF78670790,0.0,150.2,9175.02
2022-08-28,2022-08-28,Service payment - Customer_0007,REF56284905,0.0,145.6,9320.62
2022-08-28,2022-08-28,Service payment - Customer_0055,REF47493169,0.0,62.82,9383.44
2022-08-28,2022-08-28,Payment from Customer_0095,REF15219852,0.0,55.73,9439.17
2022-08-28,2022-08-28,Payment from Customer_0083,REF86596708,0.0,77.14,9516.31
2022-08-28,2022-08-28,Service payment - Customer_0087,REF64712638,0.0,108.9,9625.21
2022-08-28,2022-08-28,Service payment - Customer_0004,REF68201797,0.0,67.25,9692.46
2022-08-28,2022-08-28,Project payment - Customer_0063,REF69702334,0.0,85.47,9777.93
2022-08-28,2022-08-28,Inventory purchase,REF15053942,4009.34,0.0,5768.59
2022-08-28,2022-08-28,Invoice payment - Customer_0003,REF65256545,0.0,81.19,5849.78
2022-08-28,2022-08-28,Service payment - Customer_0001,REF65251817,0.0,53.62,5903.4
2022-08-29,2022-08-29,Service payment - Customer_0081,REF83478065,0.0,87.34,5990.74
2022-08-29,2022-08-29,Invoice payment - Customer_0050,REF76036721,0.0,129.1,6119.84
2022-08-29,2022-08-29,Payment from Customer_0041,REF20784963,0.0,117.79,6237.63
2022-08-29,2022-08-29,Service payment - Customer_0051,REF44708172,0.0,62.06,6299.69
2022-08-29,2022-08-29,Payment from Customer_0088,REF99980982,0.0,125.03,6424.72
2022-08-29,2022-08-29,Payment from Customer_0070,REF47540723,0.0,58.37,6483.09
2022-08-29,2022-08-29,Invoice payment - Customer_0017,REF88705533,0.0,79.23,6562.32
2022-08-29,2022-08-29,Project payment - Customer_0044,REF71131723,0.0,29.8,6592.12
2022-08-29,2022-08-29,Project payment - Customer_0046,REF98980151,0.0,122.99,6715.11
2022-08-29,2022-08-29,Invoice payment - Customer_0075,REF70961438,0.0,134.86,6849.97
2022-08-29,2022-08-29,Service payment - Customer_0021,REF36123091,0.0,67.74,6917.71
2022-08-30,2022-08-30,Payment from Customer_0067,REF46727241,0.0,110.91,7028.62
2022-08-30,2022-08-30,Service payment - Customer_0078,REF56070884,0.0,112.55,7141.17
2022-08-30,2022-08-30,Project payment - Customer_0037,REF47236922,0.0,99.56,7240.73
2022-08-30,2022-08-30,Invoice payment - Customer_0043,REF18213553,0.0,105.87,7346.6
2022-08-30,2022-08-30,Service payment - Customer_0083,REF98340651,0.0,64.9,7411.5
2022-08-30,2022-08-30,Project payment - Customer_0084,REF73036884,0.0,97.03,7508.53
2022-08-30,2022-08-30,Service payment - Customer_0052,REF28974511,0.0,42.58,7551.11
2022-08-30,2022-08-30,Service payment - Customer_0045,REF55363946,0.0,69.29,7620.4
2022-08-30,2022-08-30,Invoice payment - Customer_0001,REF86679707,0.0,96.1,7716.5
2022-08-30,2022-08-30,Project payment - Customer_0009,REF23649814,0.0,81.92,7798.42
2022-08-30,2022-08-30,Project payment - Customer_0080,REF45204416,0.0,31.09,7829.51
2022-08-30,2022-08-30,Invoice payment - Customer_0068,REF50334088,0.0,53.17,7882.68
2022-08-30,2022-08-30,Project payment - Customer_0053,REF46014565,0.0,137.98,8020.66
2022-08-31,2022-08-31,Service payment - Customer_0083,REF41169960,0.0,74.44,8095.1
2022-08-31,2022-08-31,Payment from Customer_0085,REF79876658,0.0,118.22,8213.32
2022-08-31,2022-08-31,Service payment - Customer_0009,REF24475926,0.0,70.23,8283.55
2022-08-31,2022-08-31,Project payment - Customer_0023,REF94516381,0.0,90.79,8374.34
2022-08-31,2022-08-31,Project payment - Customer_0005,REF35676223,0.0,31.0,8405.34
2022-08-31,2022-08-31,Invoice payment - Customer_0087,REF50961473,0.0,87.79,8493.13
2022-08-31,2022-08-31,Invoice payment - Customer_0014,REF35378147,0.0,95.66,8588.79
2022-09-01,2022-09-01,Project payment - Customer_0098,REF36049403,0.0,62.8,8651.59
2022-09-01,2022-09-01,Payment from Customer_0085,REF86328673,0.0,122.29,8773.88
2022-09-01,2022-09-01,Service payment - Customer_0072,REF96122240,0.0,129.17,8903.05
2022-09-01,2022-09-01,Payment from Customer_0084,REF97780687,0.0,87.94,8990.99
2022-09-01,2022-09-01,Payment from Customer_0075,REF67637892,0.0,114.32,9105.31
2022-09-01,2022-09-01,Service payment - Customer_0021,REF13613695,0.0,70.95,9176.26
2022-09-01,2022-09-01,Monthly office rent,REF37261936,1230.3,0.0,7945.96
2022-09-01,2022-09-01,Invoice payment - Customer_0047,REF76805846,0.0,106.56,8052.52
2022-09-01,2022-09-01,Project payment - Customer_0074,REF81982862,0.0,52.57,8105.09
2022-09-02,2022-09-02,Invoice payment - Customer_0078,REF14828786,0.0,100.68,8205.77
2022-09-02,2022-09-02,Invoice payment - Customer_0071,REF48368921,0.0,46.8,8252.57
2022-09-02,2022-09-02,Service payment - Customer_0000,REF69359609,0.0,39.67,8292.24
2022-09-02,2022-09-02,Invoice payment - Customer_0084,REF87502083,0.0,96.29,8388.53
2022-09-02,2022-09-02,Payment from Customer_0099,REF58988359,0.0,44.36,8432.89
2022-09-02,2022-09-02,Service payment - Customer_0035,REF69128046,0.0,158.77,8591.66
2022-09-02,2022-09-02,Project payment - Customer_0083,REF50647097,0.0,74.54,8666.2
2022-09-02,2022-09-02,Invoice payment - Customer_0053,REF12779298,0.0,109.89,8776.09
2022-09-02,2022-09-02,Invoice payment - Customer_0023,REF81910254,0.0,87.67,8863.76
2022-09-02,2022-09-02,Payment from Customer_0010,REF90163307,0.0,76.57,8940.33
2022-09-02,2022-09-02,Invoice payment - Customer_0004,REF13936430,0.0,54.82,8995.15
2022-09-03,2022-09-03,Professional Services expense,REF58639050,176.49,0.0,8818.66
2022-09-03,2022-09-03,Payment from Customer_0059,REF11489766,0.0,60.05,8878.71
2022-09-03,2022-09-03,Invoice payment - Customer_0094,REF35941763,0.0,84.64,8963.35
2022-09-03,2022-09-03,Invoice payment - Customer_0021,REF64556559,0.0,81.99,9045.34
2022-09-03,2022-09-03,Service payment - Customer_0099,REF56019995,0.0,53.73,9099.07
2022-09-03,2022-09-03,Project payment - Customer_0041,REF55890427,0.0,163.32,9262.39
2022-09-03,2022-09-03,Service payment - Customer_0037,REF25692077,0.0,150.26,9412.65
2022-09-03,2022-09-03,Project payment - Customer_0086,REF42033793,0.0,88.21,9500.86
2022-09-03,2022-09-03,Invoice payment - Customer_0091,REF85218468,0.0,139.53,9640.39
2022-09-03,2022-09-03,Invoice payment - Customer_0080,REF16773535,0.0,38.75,9679.14
2022-09-03,2022-09-03,Service payment - Customer_0066,REF23221118,0.0,66.05,9745.19
2022-09-04,2022-09-04,Service payment - Customer_0004,REF24114762,0.0,51.76,9796.95
2022-09-04,2022-09-04,Service payment - Customer_0005,REF85387284,0.0,31.02,9827.97
2022-09-04,2022-09-04,Service payment - Customer_0026,REF14908174,0.0,100.73,9928.7
2022-09-04,2022-09-04,Payment from Customer_0034,REF42496207,0.0,99.16,10027.86
2022-09-04,2022-09-04,Service payment - Customer_0071,REF13225279,0.0,43.44,10071.3
2022-09-04,2022-09-04,Payment from Customer_0024,REF99381109,0.0,77.94,10149.24
2022-09-04,2022-09-04,Payment from Customer_0044,REF13207842,0.0,29.99,10179.23
2022-09-04,2022-09-04,Invoice payment - Customer_0066,REF93074546,0.0,56.16,10235.39
2022-09-04,2022-09-04,Invoice payment - Customer_0090,REF50407303,0.0,113.27,10348.66
2022-09-04,2022-09-04,Payment from Customer_0046,REF37380656,0.0,125.45,10474.11
2022-09-04,2022-09-04,Project payment - Customer_0015,REF62997869,0.0,125.41,10599.52
2022-09-04,2022-09-04,Service payment - Customer_0072,REF71244488,0.0,113.19,10712.71
2022-09-05,2022-09-05,Project payment - Customer_0019,REF29429573,0.0,79.29,10792.0
2022-09-05,2022-09-05,Service payment - Customer_0037,REF91038284,0.0,160.34,10952.34
2022-09-05,2022-09-05,Project payment - Customer_0012,REF92637954,0.0,85.27,11037.61
2022-09-05,2022-09-05,Project payment - Customer_0004,REF87357294,0.0,69.96,11107.57
2022-09-05,2022-09-05,Project payment - Customer_0036,REF20341731,0.0,57.71,11165.28
2022-09-05,2022-09-05,Payment from Customer_0088,REF14936264,0.0,97.78,11263.06
2022-09-06,2022-09-06,Payment from Customer_0020,REF53060061,0.0,95.88,11358.94
2022-09-06,2022-09-06,Payment from Customer_0076,REF62415710,0.0,10.0,11368.94
2022-09-06,2022-09-06,Payment from Customer_0085,REF26320985,0.0,104.45,11473.39
2022-09-06,2022-09-06,Payment from Customer_0015,REF56407204,0.0,79.7,11553.09
2022-09-06,2022-09-06,Invoice payment - Customer_0094,REF83993534,0.0,96.13,11649.22
2022-09-06,2022-09-06,Service payment - Customer_0091,REF52264905,0.0,133.42,11782.64
2022-09-06,2022-09-06,Invoice payment - Customer_0059,REF16345202,0.0,80.34,11862.98
2022-09-06,2022-09-06,Invoice payment - Customer_0069,REF90363305,0.0,71.52,11934.5
2022-09-07,2022-09-07,Payment from Customer_0035,REF92175018,0.0,98.65,12033.15
2022-09-07,2022-09-07,Service payment - Customer_0094,REF19265968,0.0,82.08,12115.23
2022-09-07,2022-09-07,Payment from Customer_0061,REF20601080,0.0,131.43,12246.66
2022-09-07,2022-09-07,Invoice payment - Customer_0091,REF21990110,0.0,141.74,12388.4
2022-09-07,2022-09-07,Service payment - Customer_0095,REF59123160,0.0,116.21,12504.61
2022-09-07,2022-09-07,Project payment - Customer_0056,REF21412158,0.0,27.61,12532.22
2022-09-07,2022-09-07,Project payment - Customer_0002,REF16017437,0.0,79.68,12611.9
2022-09-07,2022-09-07,Service payment - Customer_0018,REF31849784,0.0,85.74,12697.64
2022-09-07,2022-09-07,Project payment - Customer_0082,REF96173659,0.0,117.01,12814.65
2022-09-08,2022-09-08,Service payment - Customer_0057,REF97142670,0.0,117.99,12932.64
2022-09-08,2022-09-08,Service payment - Customer_0066,REF54856169,0.0,61.46,12994.1
2022-09-08,2022-09-08,Invoice payment - Customer_0091,REF47082227,0.0,102.54,13096.64
2022-09-08,2022-09-08,Service payment - Customer_0054,REF55956013,0.0,73.52,13170.16
2022-09-08,2022-09-08,Service payment - Customer_0053,REF87188112,0.0,72.25,13242.41
2022-09-08,2022-09-08,Project payment - Customer_0010,REF98807550,0.0,107.3,13349.71
2022-09-08,2022-09-08,Project payment - Customer_0060,REF88214677,0.0,86.93,13436.64
2022-09-08,2022-09-08,Project payment - Customer_0007,REF42091637,0.0,153.74,13590.38
2022-09-08,2022-09-08,Payment from Customer_0028,REF16348403,0.0,98.14,13688.52
2022-09-08,2022-09-08,Payment from Customer_0078,REF65507444,0.0,149.5,13838.02
2022-09-08,2022-09-08,Payment from Customer_0071,REF59540459,0.0,38.9,13876.92
2022-09-09,2022-09-09,Payment from Customer_0026,REF70787863,0.0,97.89,13974.81
2022-09-09,2022-09-09,Project payment - Customer_0080,REF27626203,0.0,24.34,13999.15
2022-09-09,2022-09-09,Payment from Customer_0042,REF93547114,0.0,108.13,14107.28
2022-09-09,2022-09-09,Service payment - Customer_0060,REF84160672,0.0,79.1,14186.38
2022-09-09,2022-09-09,Invoice payment - Customer_0087,REF33197722,0.0,78.9,14265.28
2022-09-09,2022-09-09,Payment from Customer_0064,REF92848317,0.0,32.39,14297.67
2022-09-09,2022-09-09,Project payment - Customer_0095,REF63583637,0.0,83.95,14381.62
2022-09-09,2022-09-09,Invoice payment - Customer_0067,REF59548700,0.0,115.12,14496.74
2022-09-09,2022-09-09,Invoice payment - Customer_0070,REF10801959,0.0,61.05,14557.79
2022-09-09,2022-09-09,Payment from Customer_0093,REF18829739,0.0,89.12,14646.91
2022-09-10,2022-09-10,Payment from Customer_0093,REF44954852,0.0,137.17,14784.08
2022-09-10,2022-09-10,Project payment - Customer_0082,REF91395257,0.0,174.17,14958.25
2022-09-10,2022-09-10,Invoice payment - Customer_0053,REF80045168,0.0,122.26,15080.51
2022-09-10,2022-09-10,Project payment - Customer_0003,REF32455238,0.0,82.08,15162.59
2022-09-10,2022-09-10,Payment from Customer_0006,REF10238676,0.0,60.06,15222.65
2022-09-10,2022-09-10,Project payment - Customer_0066,REF10209606,0.0,61.4,15284.05
2022-09-10,2022-09-10,Invoice payment - Customer_0088,REF98507418,0.0,104.17,15388.22
2022-09-10,2022-09-10,Marketing expenses,REF64477115,297.42,0.0,15090.8
2022-09-11,2022-09-11,Payment from Customer_0066,REF59012465,0.0,46.17,15136.97
2022-09-11,2022-09-11,Payment from Customer_0000,REF47815962,0.0,45.58,15182.55
2022-09-11,2022-09-11,Project payment - Customer_0005,REF42455272,0.0,33.75,15216.3
2022-09-11,2022-09-11,Invoice payment - Customer_0089,REF66375526,0.0,108.07,15324.37
2022-09-11,2022-09-11,Service payment - Customer_0083,REF62204111,0.0,60.91,15385.28
2022-09-11,2022-09-11,Inventory purchase,REF11863704,3515.25,0.0,11870.03
2022-09-11,2022-09-11,Project payment - Customer_0026,REF43875901,0.0,88.4,11958.43
2022-09-11,2022-09-11,Service payment - Customer_0043,REF36062661,0.0,127.14,12085.57
2022-09-11,2022-09-11,Project payment - Customer_0003,REF31024097,0.0,76.25,12161.82
2022-09-11,2022-09-11,Payment from Customer_0029,REF36602267,0.0,72.52,12234.34
2022-09-11,2022-09-11,Payment from Customer_0053,REF67260172,0.0,136.78,12371.12
2022-09-12,2022-09-12,Payment from Customer_0000,REF32712636,0.0,45.74,12416.86
2022-09-12,2022-09-12,Invoice payment - Customer_0048,REF31736747,0.0,69.83,12486.69
2022-09-12,2022-09-12,Project payment - Customer_0017,REF67857064,0.0,74.84,12561.53
2022-09-12,2022-09-12,Invoice payment - Customer_0038,REF84829073,0.0,55.2,12616.73
2022-09-12,2022-09-12,Payment from Customer_0057,REF22779497,0.0,109.95,12726.68
2022-09-12,2022-09-12,Payment from Customer_0027,REF31797503,0.0,66.77,12793.45
2022-09-12,2022-09-12,Invoice payment - Customer_0069,REF92568542,0.0,64.07,12857.52
2022-09-12,2022-09-12,Service payment - Customer_0006,REF58804729,0.0,76.46,12933.98
2022-09-13,2022-09-13,Payment from Customer_0053,REF73716633,0.0,163.35,13097.33
2022-09-13,2022-09-13,Project payment - Customer_0092,REF57093328,0.0,63.24,13160.57
2022-09-13,2022-09-13,Payment from Customer_0094,REF66930236,0.0,59.23,13219.8
2022-09-13,2022-09-13,Invoice payment - Customer_0067,REF84359960,0.0,91.57,13311.37
2022-09-14,2022-09-14,Payment from Customer_0073,REF43065171,0.0,145.53,13456.9
2022-09-14,2022-09-14,Service payment - Customer_0070,REF20978982,0.0,54.47,13511.37
2022-09-14,2022-09-14,Invoice payment - Customer_0075,REF90838301,0.0,116.78,13628.15
2022-09-14,2022-09-14,Project payment - Customer_0080,REF80608324,0.0,42.56,13670.71
2022-09-14,2022-09-14,Invoice payment - Customer_0090,REF62012506,0.0,74.9,13745.61
2022-09-14,2022-09-14,Service payment - Customer_0067,REF72819592,0.0,113.21,13858.82
2022-09-14,2022-09-14,Service payment - Customer_0077,REF17441962,0.0,79.09,13937.91
2022-09-14,2022-09-14,Invoice payment - Customer_0044,REF55692550,0.0,35.29,13973.2
2022-09-14,2022-09-14,Service payment - Customer_0095,REF14246875,0.0,79.08,14052.28
2022-09-14,2022-09-14,Project payment - Customer_0082,REF48292212,0.0,154.94,14207.22
2022-09-14,2022-09-14,Service payment - Customer_0091,REF28783722,0.0,114.64,14321.86
2022-09-14,2022-09-14,Project payment - Customer_0079,REF23973654,0.0,88.81,14410.67
2022-09-14,2022-09-14,Invoice payment - Customer_0092,REF65953390,0.0,55.47,14466.14
2022-09-14,2022-09-14,Payment from Customer_0040,REF33264990,0.0,36.85,14502.99
2022-09-14,2022-09-14,Payment from Customer_0042,REF99287659,0.0,61.66,14564.65
2022-09-14,2022-09-14,Payment from Customer_0098,REF41779131,0.0,77.43,14642.08
2022-09-14,2022-09-14,Invoice payment - Customer_0058,REF87756642,0.0,32.8,14674.88
2022-09-15,2022-09-15,Payment from Customer_0097,REF70082399,0.0,58.92,14733.8
2022-09-15,2022-09-15,Project payment - Customer_0098,REF51521524,0.0,87.67,14821.47
2022-09-15,2022-09-15,Service payment - Customer_0069,REF87315014,0.0,79.11,14900.58
2022-09-15,2022-09-15,Payment from Customer_0018,REF21943752,0.0,91.8,14992.38
2022-09-15,2022-09-15,Project payment - Customer_0056,REF93786541,0.0,35.88,15028.26
2022-09-15,2022-09-15,Project payment - Customer_0009,REF34966383,0.0,66.43,15094.69
2022-09-15,2022-09-15,Business insurance premium,REF97916399,163.41,0.0,14931.28
2022-09-16,2022-09-16,Project payment - Customer_0036,REF99796959,0.0,50.38,14981.66
2022-09-16,2022-09-16,Invoice payment - Customer_0008,REF87879609,0.0,114.41,15096.07
2022-09-16,2022-09-16,Payment from Customer_0055,REF66793052,0.0,58.58,15154.65
2022-09-16,2022-09-16,Service payment - Customer_0089,REF14682756,0.0,110.6,15265.25
2022-09-16,2022-09-16,Project payment - Customer_0044,REF22922112,0.0,32.82,15298.07
2022-09-16,2022-09-16,Service payment - Customer_0039,REF60735396,0.0,143.93,15442.0
2022-09-16,2022-09-16,Invoice payment - Customer_0031,REF21566094,0.0,101.42,15543.42
2022-09-16,2022-09-16,Service payment - Customer_0061,REF43980276,0.0,144.85,15688.27
2022-09-16,2022-09-16,Service payment - Customer_0080,REF29788291,0.0,41.27,15729.54
2022-09-16,2022-09-16,Service payment - Customer_0097,REF51837521,0.0,64.8,15794.34
2022-09-16,2022-09-16,Invoice payment - Customer_0084,REF43267079,0.0,64.16,15858.5
2022-09-16,2022-09-16,Project payment - Customer_0003,REF77797935,0.0,65.27,15923.77
2022-09-16,2022-09-16,Invoice payment - Customer_0065,REF55717440,0.0,42.23,15966.0
2022-09-16,2022-09-16,Invoice payment - Customer_0059,REF63246788,0.0,67.92,16033.92
2022-09-17,2022-09-17,Service payment - Customer_0059,REF67964792,0.0,85.92,16119.84
2022-09-17,2022-09-17,Payment from Customer_0026,REF25737550,0.0,121.57,16241.41
2022-09-17,2022-09-17,Service payment - Customer_0028,REF87175442,0.0,99.92,16341.33
2022-09-18,2022-09-18,Payment from Customer_0030,REF51267810,0.0,47.42,16388.75
2022-09-18,2022-09-18,Project payment - Customer_0036,REF67534116,0.0,69.43,16458.18
2022-09-18,2022-09-18,Project payment - Customer_0079,REF87572608,0.0,96.88,16555.06
2022-09-18,2022-09-18,Service payment - Customer_0002,REF74957543,0.0,83.02,16638.08
2022-09-18,2022-09-18,Payment from Customer_0003,REF23246586,0.0,100.71,16738.79
2022-09-18,2022-09-18,Service payment - Customer_0045,REF12820798,0.0,92.24,16831.03
2022-09-18,2022-09-18,Project payment - Customer_0041,REF34230749,0.0,155.92,16986.95
2022-09-18,2022-09-18,Payment from Customer_0056,REF95143218,0.0,42.27,17029.22
2022-09-18,2022-09-18,Payment from Customer_0048,REF59198875,0.0,105.21,17134.43
2022-09-18,2022-09-18,Invoice payment - Customer_0049,REF75398551,0.0,75.91,17210.34
2022-09-18,2022-09-18,Service payment - Customer_0001,REF10446347,0.0,60.33,17270.67
2022-09-18,2022-09-18,Invoice payment - Customer_0072,REF81912054,0.0,139.51,17410.18
2022-09-18,2022-09-18,Project payment - Customer_0070,REF97853963,0.0,49.21,17459.39
2022-09-19,2022-09-19,Invoice payment - Customer_0071,REF34414710,0.0,30.55,17489.94
2022-09-19,2022-09-19,Project payment - Customer_0096,REF60453766,0.0,84.49,17574.43
2022-09-19,2022-09-19,Project payment - Customer_0045,REF29281680,0.0,102.44,17676.87
2022-09-19,2022-09-19,Invoice payment - Customer_0095,REF85218469,0.0,64.65,17741.52
2022-09-19,2022-09-19,Project payment - Customer_0026,REF14032313,0.0,87.24,17828.76
2022-09-19,2022-09-19,Payment from Customer_0008,REF34512333,0.0,91.75,17920.51
2022-09-19,2022-09-19,Project payment - Customer_0068,REF23368270,0.0,51.22,17971.73
2022-09-19,2022-09-19,Invoice payment - Customer_0082,REF76331448,0.0,159.42,18131.15
2022-09-19,2022-09-19,Invoice payment - Customer_0049,REF83874810,0.0,66.52,18197.67
2022-09-20,2022-09-20,Invoice payment - Customer_0032,REF45281603,0.0,75.14,18272.81
2022-09-20,2022-09-20,Service payment - Customer_0065,REF47172819,0.0,61.41,18334.22
2022-09-20,2022-09-20,Invoice payment - Customer_0022,REF78937366,0.0,81.17,18415.39
2022-09-20,2022-09-20,Service payment - Customer_0053,REF16879101,0.0,126.75,18542.14
2022-09-20,2022-09-20,Project payment - Customer_0095,REF53770527,0.0,73.18,18615.32
2022-09-20,2022-09-20,Project payment - Customer_0037,REF10503715,0.0,149.78,18765.1
2022-09-20,2022-09-20,Payment from Customer_0017,REF60326440,0.0,83.78,18848.88
2022-09-20,2022-09-20,Project payment - Customer_0047,REF42199438,0.0,120.38,18969.26
2022-09-20,2022-09-20,Invoice payment - Customer_0012,REF28648553,0.0,73.07,19042.33
2022-09-20,2022-09-20,Project payment - Customer_0093,REF80859963,0.0,120.22,19162.55
2022-09-20,2022-09-20,Invoice payment - Customer_0018,REF24597244,0.0,84.23,19246.78
2022-09-21,2022-09-21,Invoice payment - Customer_0065,REF83306231,0.0,50.3,19297.08
2022-09-21,2022-09-21,Payment from Customer_0090,REF89937021,0.0,122.08,19419.16
2022-09-21,2022-09-21,Project payment - Customer_0097,REF75034811,0.0,60.64,19479.8
2022-09-21,2022-09-21,Invoice payment - Customer_0042,REF17971413,0.0,109.02,19588.82
2022-09-21,2022-09-21,Service payment - Customer_0049,REF64208040,0.0,74.96,19663.78
2022-09-21,2022-09-21,Invoice payment - Customer_0024,REF19967765,0.0,89.99,19753.77
2022-09-21,2022-09-21,Service payment - Customer_0038,REF59942074,0.0,54.39,19808.16
2022-09-21,2022-09-21,Invoice payment - Customer_0092,REF94788824,0.0,72.82,19880.98
2022-09-21,2022-09-21,Service payment - Customer_0061,REF39936668,0.0,116.43,19997.41
2022-09-21,2022-09-21,Service payment - Customer_0021,REF11401615,0.0,91.3,20088.71
2022-09-22,2022-09-22,Invoice payment - Customer_0054,REF94358899,0.0,93.4,20182.11
2022-09-22,2022-09-22,Service payment - Customer_0037,REF86812295,0.0,122.06,20304.17
2022-09-22,2022-09-22,Payment from Customer_0084,REF83352218,0.0,80.01,20384.18
2022-09-22,2022-09-22,Project payment - Customer_0066,REF19645517,0.0,49.66,20433.84
2022-09-22,2022-09-22,Project payment - Customer_0056,REF60546584,0.0,24.69,20458.53
2022-09-22,2022-09-22,Service payment - Customer_0058,REF11280839,0.0,67.99,20526.52
2022-09-22,2022-09-22,Invoice payment - Customer_0055,REF66646269,0.0,82.4,20608.92
2022-09-22,2022-09-22,Payment from Customer_0003,REF67344487,0.0,88.52,20697.44
2022-09-22,2022-09-22,Invoice payment - Customer_0045,REF33309995,0.0,71.84,20769.28
2022-09-22,2022-09-22,Utility bill payment,REF74350119,158.14,0.0,20611.14
2022-09-22,2022-09-22,Invoice payment - Customer_0020,REF39612526,0.0,105.28,20716.42
2022-09-22,2022-09-22,Payment from Customer_0077,REF36236921,0.0,92.29,20808.71
2022-09-23,2022-09-23,Invoice payment - Customer_0026,REF97831652,0.0,90.72,20899.43
2022-09-23,2022-09-23,Payment from Customer_0008,REF50438505,0.0,119.76,21019.19
2022-09-23,2022-09-23,Project payment - Customer_0069,REF59187976,0.0,76.46,21095.65
2022-09-23,2022-09-23,Payment from Customer_0080,REF55761448,0.0,35.49,21131.14
2022-09-23,2022-09-23,Payment from Customer_0034,REF25315541,0.0,84.03,21215.17
2022-09-23,2022-09-23,Service payment - Customer_0048,REF55306279,0.0,68.41,21283.58
2022-09-23,2022-09-23,Invoice payment - Customer_0035,REF31807566,0.0,131.8,21415.38
2022-09-24,2022-09-24,Project payment - Customer_0071,REF59344689,0.0,40.44,21455.82
2022-09-24,2022-09-24,Payment from Customer_0046,REF28201208,0.0,142.95,21598.77
2022-09-24,2022-09-24,Service payment - Customer_0083,REF60798015,0.0,66.52,21665.29
2022-09-24,2022-09-24,Service payment - Customer_0044,REF50415765,0.0,33.0,21698.29
2022-09-24,2022-09-24,Service payment - Customer_0021,REF46034515,0.0,72.41,21770.7
2022-09-24,2022-09-24,Service payment - Customer_0072,REF66459164,0.0,116.91,21887.61
2022-09-24,2022-09-24,Payment from Customer_0036,REF84880321,0.0,53.55,21941.16
2022-09-25,2022-09-25,Project payment - Customer_0072,REF92131838,0.0,155.58,22096.74
2022-09-25,2022-09-25,Invoice payment - Customer_0057,REF77169071,0.0,122.06,22218.8
2022-09-25,2022-09-25,Payment from Customer_0086,REF51009172,0.0,77.99,22296.79
2022-09-25,2022-09-25,Invoice payment - Customer_0063,REF55366083,0.0,84.62,22381.41
2022-09-25,2022-09-25,Service payment - Customer_0033,REF25086878,0.0,76.05,22457.46
2022-09-25,2022-09-25,Project payment - Customer_0091,REF63396328,0.0,110.25,22567.71
2022-09-25,2022-09-25,Invoice payment - Customer_0002,REF27772033,0.0,64.51,22632.22
2022-09-26,2022-09-26,Project payment - Customer_0062,REF15122416,0.0,93.31,22725.53
2022-09-26,2022-09-26,Project payment - Customer_0025,REF62271843,0.0,97.59,22823.12
2022-09-26,2022-09-26,Payment from Customer_0035,REF21704600,0.0,140.18,22963.3
2022-09-26,2022-09-26,Payment from Customer_0068,REF84456866,0.0,54.94,23018.24
2022-09-26,2022-09-26,Service payment - Customer_0045,REF92547535,0.0,105.68,23123.92
2022-09-26,2022-09-26,Service payment - Customer_0099,REF39993303,0.0,44.97,23168.89
2022-09-26,2022-09-26,Payment from Customer_0033,REF87704146,0.0,73.18,23242.07
2022-09-26,2022-09-26,Project payment - Customer_0041,REF29417596,0.0,135.64,23377.71
2022-09-26,2022-09-26,Invoice payment - Customer_0090,REF63933074,0.0,80.85,23458.56
2022-09-26,2022-09-26,Project payment - Customer_0030,REF28207440,0.0,50.2,23508.76
2022-09-26,2022-09-26,Payment from Customer_0051,REF67453610,0.0,70.74,23579.5
2022-09-27,2022-09-27,Inventory purchase,REF86923537,4226.89,0.0,19352.61
2022-09-27,2022-09-27,Invoice payment - Customer_0033,REF54467856,0.0,76.84,19429.45
2022-09-27,2022-09-27,Project payment - Customer_0081,REF66404698,0.0,70.32,19499.77
2022-09-27,2022-09-27,Payment from Customer_0054,REF24732067,0.0,79.89,19579.66
2022-09-27,2022-09-27,Project payment - Customer_0042,REF96878888,0.0,87.95,19667.61
2022-09-27,2022-09-27,Service payment - Customer_0078,REF27567735,0.0,111.91,19779.52
2022-09-27,2022-09-27,Invoice payment - Customer_0025,REF54417577,0.0,108.59,19888.11
2022-09-27,2022-09-27,Payment from Customer_0051,REF72564492,0.0,81.81,19969.92
2022-09-27,2022-09-27,Invoice payment - Customer_0037,REF25347145,0.0,157.58,20127.5
2022-09-27,2022-09-27,Invoice payment - Customer_0059,REF38225458,0.0,75.4,20202.9
2022-09-27,2022-09-27,Invoice payment - Customer_0060,REF47665097,0.0,89.15,20292.05
2022-09-27,2022-09-27,Payment from Customer_0001,REF25784884,0.0,64.55,20356.6
2022-09-27,2022-09-27,Service payment - Customer_0027,REF18545055,0.0,98.58,20455.18
2022-09-27,2022-09-27,Service payment - Customer_0052,REF38454983,0.0,44.0,20499.18
2022-09-27,2022-09-27,Project payment - Customer_0007,REF72782917,0.0,136.81,20635.99
2022-09-28,2022-09-28,Service payment - Customer_0050,REF42043435,0.0,126.6,20762.59
2022-09-28,2022-09-28,Project payment - Customer_0080,REF50710563,0.0,38.34,20800.93
2022-09-28,2022-09-28,Packaging Shipping expense,REF19235493,274.97,0.0,20525.96
2022-09-28,2022-09-28,Invoice payment - Customer_0039,REF84333383,0.0,140.1,20666.06
2022-09-28,2022-09-28,Service payment - Customer_0026,REF43717264,0.0,103.68,20769.74
2022-09-28,2022-09-28,Invoice payment - Customer_0033,REF20232796,0.0,70.53,20840.27
2022-09-28,2022-09-28,Project payment - Customer_0004,REF83185898,0.0,59.77,20900.04
2022-09-28,2022-09-28,Inventory purchase,REF13555371,1811.47,0.0,19088.57
2022-09-29,2022-09-29,Invoice payment - Customer_0067,REF31339199,0.0,123.91,19212.48
2022-09-29,2022-09-29,Project payment - Customer_0053,REF74000067,0.0,130.2,19342.68
2022-09-29,2022-09-29,Payment from Customer_0054,REF64695636,0.0,73.27,19415.95
2022-09-29,2022-09-29,Payment from Customer_0084,REF33118461,0.0,67.24,19483.19
2022-09-29,2022-09-29,Invoice payment - Customer_0040,REF64013049,0.0,27.1,19510.29
2022-09-30,2022-09-30,Service payment - Customer_0001,REF90728046,0.0,71.48,19581.77
2022-09-30,2022-09-30,Service payment - Customer_0087,REF57491362,0.0,94.25,19676.02
2022-09-30,2022-09-30,Invoice payment - Customer_0081,REF83708157,0.0,76.49,19752.51
2022-09-30,2022-09-30,Project payment - Customer_0033,REF59188003,0.0,71.38,19823.89
2022-09-30,2022-09-30,Service payment - Customer_0077,REF69461552,0.0,108.2,19932.09
2022-09-30,2022-09-30,Service payment - Customer_0061,REF44745581,0.0,129.68,20061.77
2022-09-30,2022-09-30,Project payment - Customer_0006,REF11842411,0.0,91.87,20153.64
2022-09-30,2022-09-30,Project payment - Customer_0055,REF42514376,0.0,71.5,20225.14
2022-10-01,2022-10-01,Project payment - Customer_0063,REF58239871,0.0,70.15,20295.29
2022-10-01,2022-10-01,Monthly office rent,REF95147750,1324.84,0.0,18970.45
2022-10-01,2022-10-01,Invoice payment - Customer_0005,REF79924965,0.0,37.24,19007.69
2022-10-01,2022-10-01,Project payment - Customer_0023,REF59356522,0.0,149.88,19157.57
2022-10-01,2022-10-01,Payment from Customer_0027,REF83611798,0.0,92.38,19249.95
2022-10-01,2022-10-01,Project payment - Customer_0004,REF17416367,0.0,57.69,19307.64
2022-10-01,2022-10-01,Service payment - Customer_0079,REF90052497,0.0,100.32,19407.96
2022-10-01,2022-10-01,Project payment - Customer_0084,REF60258338,0.0,75.49,19483.45
2022-10-01,2022-10-01,Invoice payment - Customer_0007,REF42082682,0.0,147.47,19630.92
2022-10-02,2022-10-02,Invoice payment - Customer_0088,REF84374405,0.0,141.41,19772.33
2022-10-02,2022-10-02,Invoice payment - Customer_0034,REF39224883,0.0,81.29,19853.62
2022-10-02,2022-10-02,Payment from Customer_0075,REF76769997,0.0,120.59,19974.21
2022-10-02,2022-10-02,Service payment - Customer_0082,REF75657732,0.0,161.98,20136.19
2022-10-02,2022-10-02,Invoice payment - Customer_0009,REF87876913,0.0,91.67,20227.86
2022-10-02,2022-10-02,Payment from Customer_0010,REF39538576,0.0,100.92,20328.78
2022-10-02,2022-10-02,Payment from Customer_0037,REF97035623,0.0,145.36,20474.14
2022-10-03,2022-10-03,Inventory purchase,REF82850039,4033.15,0.0,16440.99
2022-10-03,2022-10-03,Service payment - Customer_0045,REF10568552,0.0,97.98,16538.97
2022-10-03,2022-10-03,Payment from Customer_0082,REF72463214,0.0,157.56,16696.53
2022-10-03,2022-10-03,Project payment - Customer_0038,REF69873712,0.0,56.28,16752.81
2022-10-03,2022-10-03,Service payment - Customer_0098,REF33893741,0.0,72.37,16825.18
2022-10-03,2022-10-03,Invoice payment - Customer_0076,REF61849522,0.0,10.0,16835.18
2022-10-03,2022-10-03,Project payment - Customer_0093,REF74576702,0.0,117.82,16953.0
2022-10-03,2022-10-03,Project payment - Customer_0027,REF92975295,0.0,86.81,17039.81
2022-10-03,2022-10-03,Invoice payment - Customer_0005,REF45878211,0.0,33.73,17073.54
2022-10-03,2022-10-03,Project payment - Customer_0008,REF19371274,0.0,123.23,17196.77
2022-10-03,2022-10-03,Service payment - Customer_0086,REF92713740,0.0,86.85,17283.62
2022-10-03,2022-10-03,Project payment - Customer_0040,REF44800168,0.0,49.63,17333.25
2022-10-03,2022-10-03,Project payment - Customer_0072,REF85616076,0.0,140.09,17473.34
2022-10-03,2022-10-03,Project payment - Customer_0091,REF39363842,0.0,150.36,17623.7
2022-10-03,2022-10-03,Service payment - Customer_0030,REF49408602,0.0,40.39,17664.09
2022-10-04,2022-10-04,Invoice payment - Customer_0016,REF89509736,0.0,25.72,17689.81
2022-10-04,2022-10-04,Payment from Customer_0065,REF28522809,0.0,80.18,17769.99
2022-10-04,2022-10-04,Payment from Customer_0032,REF67302188,0.0,66.56,17836.55
2022-10-04,2022-10-04,Payment from Customer_0038,REF56644292,0.0,63.61,17900.16
2022-10-04,2022-10-04,Service payment - Customer_0048,REF75159524,0.0,114.45,18014.61
2022-10-04,2022-10-04,Invoice payment - Customer_0014,REF35855322,0.0,98.75,18113.36
2022-10-04,2022-10-04,Project payment - Customer_0084,REF44593353,0.0,92.7,18206.06
2022-10-04,2022-10-04,Payment from Customer_0097,REF22068377,0.0,71.95,18278.01
2022-10-04,2022-10-04,Project payment - Customer_0053,REF45462628,0.0,142.69,18420.7
2022-10-05,2022-10-05,Payment from Customer_0017,REF42495403,0.0,94.09,18514.79
2022-10-05,2022-10-05,Payment from Customer_0083,REF42743933,0.0,68.4,18583.19
2022-10-05,2022-10-05,Service payment - Customer_0082,REF82383902,0.0,127.7,18710.89
2022-10-05,2022-10-05,Service payment - Customer_0096,REF47377245,0.0,106.18,18817.07
2022-10-05,2022-10-05,Project payment - Customer_0087,REF31500540,0.0,88.42,18905.49
2022-10-05,2022-10-05,Payment from Customer_0090,REF20047808,0.0,78.99,18984.48
2022-10-05,2022-10-05,Invoice payment - Customer_0049,REF63310878,0.0,90.04,19074.52
2022-10-05,2022-10-05,Invoice payment - Customer_0012,REF64868592,0.0,84.27,19158.79
2022-10-05,2022-10-05,Invoice payment - Customer_0000,REF62059491,0.0,48.64,19207.43
2022-10-05,2022-10-05,Invoice payment - Customer_0021,REF94515910,0.0,78.08,19285.51
2022-10-05,2022-10-05,Service payment - Customer_0016,REF49751194,0.0,30.08,19315.59
2022-10-06,2022-10-06,Payment from Customer_0016,REF44759783,0.0,38.25,19353.84
2022-10-06,2022-10-06,Payment from Customer_0037,REF69526172,0.0,141.05,19494.89
2022-10-06,2022-10-06,Payment from Customer_0069,REF50391458,0.0,80.94,19575.83
2022-10-06,2022-10-06,Service payment - Customer_0045,REF30757909,0.0,87.91,19663.74
2022-10-06,2022-10-06,Employee payroll,REF14739505,2859.02,0.0,16804.72
2022-10-06,2022-10-06,Service payment - Customer_0059,REF17493422,0.0,98.41,16903.13
2022-10-07,2022-10-07,Payment from Customer_0018,REF36498246,0.0,112.36,17015.49
2022-10-07,2022-10-07,Payment from Customer_0009,REF90526099,0.0,90.41,17105.9
2022-10-07,2022-10-07,Project payment - Customer_0067,REF21844845,0.0,129.5,17235.4
2022-10-07,2022-10-07,Service payment - Customer_0094,REF73946403,0.0,102.58,17337.98
2022-10-08,2022-10-08,Service payment - Customer_0068,REF77767530,0.0,62.34,17400.32
2022-10-08,2022-10-08,Invoice payment - Customer_0066,REF42762332,0.0,69.16,17469.48
2022-10-08,2022-10-08,Project payment - Customer_0069,REF79404329,0.0,78.79,17548.27
2022-10-08,2022-10-08,Invoice payment - Customer_0095,REF29949728,0.0,107.77,17656.04
2022-10-08,2022-10-08,Payment from Customer_0065,REF76235831,0.0,48.79,17704.83
2022-10-08,2022-10-08,Project payment - Customer_0061,REF37183106,0.0,133.12,17837.95
2022-10-08,2022-10-08,Payment from Customer_0080,REF68582945,0.0,40.44,17878.39
2022-10-08,2022-10-08,Invoice payment - Customer_0094,REF70244399,0.0,86.89,17965.28
2022-10-08,2022-10-08,Payment from Customer_0007,REF95233629,0.0,155.99,18121.27
2022-10-09,2022-10-09,Invoice payment - Customer_0061,REF95921599,0.0,96.68,18217.95
2022-10-09,2022-10-09,Payment from Customer_0092,REF89156511,0.0,71.75,18289.7
2022-10-09,2022-10-09,Invoice payment - Customer_0021,REF73020657,0.0,96.23,18385.93
2022-10-09,2022-10-09,Payment from Customer_0012,REF94994572,0.0,78.12,18464.05
2022-10-09,2022-10-09,Invoice payment - Customer_0017,REF74999349,0.0,71.74,18535.79
2022-10-09,2022-10-09,Project payment - Customer_0010,REF34090969,0.0,134.66,18670.45
2022-10-09,2022-10-09,Project payment - Customer_0006,REF72384586,0.0,90.35,18760.8
2022-10-10,2022-10-10,Payment from Customer_0063,REF63630641,0.0,64.1,18824.9
2022-10-10,2022-10-10,Service payment - Customer_0022,REF49160637,0.0,59.03,18883.93
2022-10-10,2022-10-10,Service payment - Customer_0014,REF50447057,0.0,98.09,18982.02
2022-10-10,2022-10-10,Service payment - Customer_0082,REF95880504,0.0,130.82,19112.84
2022-10-10,2022-10-10,Invoice payment - Customer_0021,REF14448160,0.0,90.81,19203.65
2022-10-10,2022-10-10,Project payment - Customer_0043,REF37776885,0.0,132.18,19335.83
2022-10-10,2022-10-10,Project payment - Customer_0036,REF89345658,0.0,72.02,19407.85
2022-10-11,2022-10-11,Payment from Customer_0063,REF93970813,0.0,79.82,19487.67
2022-10-11,2022-10-11,Inventory purchase,REF54046861,3662.57,0.0,15825.1
2022-10-11,2022-10-11,Service payment - Customer_0083,REF85981371,0.0,52.45,15877.55
2022-10-11,2022-10-11,Payment from Customer_0081,REF82988008,0.0,94.93,15972.48
2022-10-11,2022-10-11,Invoice payment - Customer_0049,REF82644202,0.0,121.4,16093.88
2022-10-11,2022-10-11,Payment from Customer_0037,REF38567024,0.0,187.98,16281.86
2022-10-11,2022-10-11,Invoice payment - Customer_0029,REF35884686,0.0,93.14,16375.0
2022-10-11,2022-10-11,Payment from Customer_0072,REF30781228,0.0,116.34,16491.34
2022-10-12,2022-10-12,Invoice payment - Customer_0021,REF37311520,0.0,69.02,16560.36
2022-10-12,2022-10-12,Service payment - Customer_0020,REF68651893,0.0,103.34,16663.7
2022-10-12,2022-10-12,Invoice payment - Customer_0084,REF16427610,0.0,66.58,16730.28
2022-10-12,2022-10-12,Project payment - Customer_0014,REF89291754,0.0,115.87,16846.15
2022-10-12,2022-10-12,Invoice payment - Customer_0061,REF65851711,0.0,94.59,16940.74
2022-10-12,2022-10-12,Invoice payment - Customer_0037,REF40362938,0.0,134.08,17074.82
2022-10-12,2022-10-12,Invoice payment - Customer_0059,REF75722184,0.0,97.81,17172.63
2022-10-12,2022-10-12,Service payment - Customer_0035,REF89105860,0.0,125.7,17298.33
2022-10-13,2022-10-13,Payment from Customer_0091,REF31658419,0.0,168.76,17467.09
2022-10-13,2022-10-13,Invoice payment - Customer_0038,REF87313301,0.0,65.99,17533.08
2022-10-13,2022-10-13,Invoice payment - Customer_0081,REF41710386,0.0,102.34,17635.42
2022-10-13,2022-10-13,Payment from Customer_0064,REF85289029,0.0,45.36,17680.78
2022-10-13,2022-10-13,Service payment - Customer_0046,REF72481886,0.0,117.36,17798.14
2022-10-13,2022-10-13,Invoice payment - Customer_0066,REF22105656,0.0,55.4,17853.54
2022-10-13,2022-10-13,Project payment - Customer_0095,REF81336435,0.0,93.85,17947.39
2022-10-13,2022-10-13,Project payment - Customer_0043,REF49087777,0.0,165.6,18112.99
2022-10-13,2022-10-13,Project payment - Customer_0032,REF43236279,0.0,64.08,18177.07
2022-10-13,2022-10-13,Project payment - Customer_0035,REF61234778,0.0,122.29,18299.36
2022-10-14,2022-10-14,Project payment - Customer_0071,REF32061259,0.0,36.52,18335.88
2022-10-14,2022-10-14,Project payment - Customer_0083,REF29119499,0.0,84.07,18419.95
2022-10-14,2022-10-14,Service payment - Customer_0031,REF93860912,0.0,92.03,18511.98
2022-10-14,2022-10-14,Payment from Customer_0076,REF37528205,0.0,10.0,18521.98
2022-10-14,2022-10-14,Invoice payment - Customer_0064,REF26897033,0.0,41.36,18563.34
2022-10-14,2022-10-14,Invoice payment - Customer_0015,REF11186787,0.0,151.85,18715.19
2022-10-14,2022-10-14,Service payment - Customer_0001,REF49104022,0.0,70.95,18786.14
2022-10-14,2022-10-14,Service payment - Customer_0094,REF91628444,0.0,101.21,18887.35
2022-10-15,2022-10-15,Project payment - Customer_0003,REF39052693,0.0,82.08,18969.43
2022-10-15,2022-10-15,Service payment - Customer_0013,REF13262131,0.0,75.43,19044.86
2022-10-15,2022-10-15,Service payment - Customer_0078,REF13670640,0.0,107.6,19152.46
2022-10-15,2022-10-15,Payment from Customer_0048,REF14435250,0.0,93.57,19246.03
2022-10-15,2022-10-15,Service payment - Customer_0057,REF44215822,0.0,126.3,19372.33
2022-10-15,2022-10-15,Service payment - Customer_0022,REF62791483,0.0,91.25,19463.58
2022-10-15,2022-10-15,Invoice payment - Customer_0053,REF15915396,0.0,159.47,19623.05
2022-10-15,2022-10-15,Invoice payment - Customer_0044,REF76150867,0.0,42.53,19665.58
2022-10-15,2022-10-15,Invoice payment - Customer_0029,REF12482019,0.0,86.0,19751.58
2022-10-15,2022-10-15,Project payment - Customer_0063,REF92799710,0.0,88.69,19840.27
2022-10-15,2022-10-15,Inventory purchase,REF95013973,3850.88,0.0,15989.39
2022-10-15,2022-10-15,Service payment - Customer_0058,REF67890836,0.0,45.59,16034.98
2022-10-15,2022-10-15,Service payment - Customer_0039,REF96961703,0.0,172.74,16207.72
2022-10-15,2022-10-15,Project payment - Customer_0083,REF63691052,0.0,72.2,16279.92
2022-10-15,2022-10-15,Invoice payment - Customer_0092,REF35681912,0.0,73.31,16353.23
2022-10-15,2022-10-15,Invoice payment - Customer_0055,REF93043078,0.0,68.37,16421.6
2022-10-15,2022-10-15,Business insurance premium,REF83233936,201.48,0.0,16220.12
2022-10-16,2022-10-16,Payment from Customer_0069,REF97378112,0.0,99.88,16320.0
2022-10-16,2022-10-16,Service payment - Customer_0099,REF71164454,0.0,57.84,16377.84
2022-10-16,2022-10-16,Invoice payment - Customer_0064,REF63812417,0.0,41.85,16419.69
2022-10-16,2022-10-16,Project payment - Customer_0081,REF98407499,0.0,105.22,16524.91
2022-10-16,2022-10-16,Payment from Customer_0042,REF11766069,0.0,105.2,16630.11
2022-10-16,2022-10-16,Invoice payment - Customer_0098,REF40066339,0.0,79.45,16709.56
2022-10-16,2022-10-16,Project payment - Customer_0035,REF27389048,0.0,107.22,16816.78
2022-10-17,2022-10-17,Invoice payment - Customer_0019,REF79418523,0.0,107.06,16923.84
2022-10-17,2022-10-17,Service payment - Customer_0084,REF62259698,0.0,77.74,17001.58
2022-10-17,2022-10-17,Project payment - Customer_0037,REF91902707,0.0,141.65,17143.23
2022-10-17,2022-10-17,Invoice payment - Customer_0006,REF58632398,0.0,89.72,17232.95
2022-10-17,2022-10-17,Project payment - Customer_0022,REF75619321,0.0,61.66,17294.61
2022-10-17,2022-10-17,Project payment - Customer_0023,REF37258779,0.0,113.77,17408.38
2022-10-17,2022-10-17,Project payment - Customer_0030,REF96750444,0.0,44.83,17453.21
2022-10-17,2022-10-17,Project payment - Customer_0068,REF74720032,0.0,60.07,17513.28
2022-10-17,2022-10-17,Payment from Customer_0050,REF27977583,0.0,130.81,17644.09
2022-10-18,2022-10-18,Payment from Customer_0075,REF40896163,0.0,108.89,17752.98
2022-10-18,2022-10-18,Invoice payment - Customer_0079,REF73640340,0.0,104.58,17857.56
2022-10-18,2022-10-18,Payment from Customer_0088,REF87150539,0.0,144.84,18002.4
2022-10-18,2022-10-18,Payment from Customer_0055,REF56936164,0.0,78.11,18080.51
2022-10-18,2022-10-18,Invoice payment - Customer_0008,REF65651127,0.0,115.67,18196.18
2022-10-18,2022-10-18,Project payment - Customer_0091,REF91842800,0.0,124.76,18320.94
2022-10-18,2022-10-18,Service payment - Customer_0093,REF94726601,0.0,141.15,18462.09
2022-10-18,2022-10-18,Invoice payment - Customer_0006,REF50370492,0.0,104.96,18567.05
2022-10-18,2022-10-18,Payment from Customer_0005,REF80444888,0.0,36.85,18603.9
2022-10-18,2022-10-18,Invoice payment - Customer_0039,REF10349303,0.0,136.92,18740.82
2022-10-18,2022-10-18,Service payment - Customer_0084,REF35916738,0.0,67.87,18808.69
2022-10-18,2022-10-18,Payment from Customer_0035,REF34224258,0.0,142.69,18951.38
2022-10-18,2022-10-18,Invoice payment - Customer_0081,REF42300336,0.0,87.53,19038.91
2022-10-18,2022-10-18,Project payment - Customer_0023,REF89657239,0.0,103.28,19142.19
2022-10-18,2022-10-18,Service payment - Customer_0085,REF66196195,0.0,134.53,19276.72
2022-10-19,2022-10-19,Inventory purchase,REF55929755,3674.6,0.0,15602.12
2022-10-19,2022-10-19,Invoice payment - Customer_0038,REF81152137,0.0,55.9,15658.02
2022-10-19,2022-10-19,Payment from Customer_0020,REF76799105,0.0,128.39,15786.41
2022-10-19,2022-10-19,Project payment - Customer_0056,REF48909582,0.0,33.52,15819.93
2022-10-19,2022-10-19,Payment from Customer_0036,REF78554978,0.0,66.44,15886.37
2022-10-19,2022-10-19,Service payment - Customer_0074,REF43875350,0.0,60.37,15946.74
2022-10-19,2022-10-19,Service payment - Customer_0002,REF91466994,0.0,113.72,16060.46
2022-10-19,2022-10-19,Payment from Customer_0023,REF67182474,0.0,110.31,16170.77
2022-10-19,2022-10-19,Project payment - Customer_0088,REF54524993,0.0,131.98,16302.75
2022-10-19,2022-10-19,Service payment - Customer_0069,REF74235263,0.0,73.98,16376.73
2022-10-19,2022-10-19,Invoice payment - Customer_0070,REF38786227,0.0,62.97,16439.7
2022-10-20,2022-10-20,Invoice payment - Customer_0005,REF50092324,0.0,35.64,16475.34
2022-10-20,2022-10-20,Project payment - Customer_0007,REF38546699,0.0,154.84,16630.18
2022-10-20,2022-10-20,Project payment - Customer_0056,REF65253308,0.0,34.28,16664.46
2022-10-20,2022-10-20,Service payment - Customer_0086,REF56531299,0.0,91.03,16755.49
2022-10-20,2022-10-20,Invoice payment - Customer_0042,REF68154387,0.0,64.23,16819.72
2022-10-20,2022-10-20,Invoice payment - Customer_0023,REF47132035,0.0,91.87,16911.59
2022-10-20,2022-10-20,Service payment - Customer_0070,REF74188517,0.0,65.35,16976.94
2022-10-20,2022-10-20,Project payment - Customer_0054,REF70262062,0.0,81.9,17058.84
2022-10-20,2022-10-20,Service payment - Customer_0028,REF25111686,0.0,106.84,17165.68
2022-10-21,2022-10-21,Service payment - Customer_0043,REF43452739,0.0,154.38,17320.06
2022-10-21,2022-10-21,Project payment - Customer_0032,REF23436339,0.0,89.35,17409.41
2022-10-21,2022-10-21,Payment from Customer_0084,REF13507011,0.0,86.23,17495.64
2022-10-21,2022-10-21,Project payment - Customer_0094,REF69101692,0.0,89.61,17585.25
2022-10-21,2022-10-21,Invoice payment - Customer_0042,REF48866534,0.0,116.17,17701.42
2022-10-21,2022-10-21,Service payment - Customer_0057,REF57336664,0.0,144.89,17846.31
2022-10-21,2022-10-21,Service payment - Customer_0015,REF54862218,0.0,143.1,17989.41
2022-10-22,2022-10-22,Project payment - Customer_0028,REF20372171,0.0,118.37,18107.78
2022-10-22,2022-10-22,Utility bill payment,REF43357868,168.79,0.0,17938.99
2022-10-22,2022-10-22,Project payment - Customer_0050,REF81041207,0.0,126.36,18065.35
2022-10-22,2022-10-22,Project payment - Customer_0066,REF18094162,0.0,44.07,18109.42
2022-10-22,2022-10-22,Invoice payment - Customer_0069,REF33322269,0.0,79.83,18189.25
2022-10-22,2022-10-22,Payment from Customer_0030,REF80843767,0.0,51.34,18240.59
2022-10-22,2022-10-22,Invoice payment - Customer_0014,REF37911813,0.0,112.06,18352.65
2022-10-22,2022-10-22,Invoice payment - Customer_0055,REF30014905,0.0,71.78,18424.43
2022-10-22,2022-10-22,Project payment - Customer_0020,REF69383579,0.0,114.9,18539.33
2022-10-22,2022-10-22,Service payment - Customer_0063,REF36817057,0.0,58.77,18598.1
2022-10-22,2022-10-22,Service payment - Customer_0012,REF99810739,0.0,88.18,18686.28
2022-10-23,2022-10-23,Project payment - Customer_0059,REF86242006,0.0,76.35,18762.63
2022-10-23,2022-10-23,Invoice payment - Customer_0031,REF10111950,0.0,117.4,18880.03
2022-10-23,2022-10-23,Project payment - Customer_0002,REF97187297,0.0,77.75,18957.78
2022-10-23,2022-10-23,Project payment - Customer_0056,REF55122220,0.0,37.6,18995.38
2022-10-23,2022-10-23,Payment from Customer_0006,REF16562788,0.0,75.76,19071.14
2022-10-23,2022-10-23,Service payment - Customer_0038,REF50951539,0.0,55.74,19126.88
2022-10-23,2022-10-23,Project payment - Customer_0096,REF48472501,0.0,81.3,19208.18
2022-10-24,2022-10-24,Project payment - Customer_0021,REF53489105,0.0,74.51,19282.69
2022-10-24,2022-10-24,Payment from Customer_0031,REF94450139,0.0,107.28,19389.97
2022-10-24,2022-10-24,Payment from Customer_0009,REF11079285,0.0,86.17,19476.14
2022-10-24,2022-10-24,Payment from Customer_0063,REF17271904,0.0,87.26,19563.4
2022-10-24,2022-10-24,Invoice payment - Customer_0052,REF37205477,0.0,47.15,19610.55
2022-10-24,2022-10-24,Service payment - Customer_0013,REF28203695,0.0,73.34,19683.89
2022-10-24,2022-10-24,Service payment - Customer_0023,REF99799523,0.0,119.33,19803.22
2022-10-24,2022-10-24,Project payment - Customer_0035,REF42990472,0.0,117.18,19920.4
2022-10-24,2022-10-24,Project payment - Customer_0017,REF36222690,0.0,94.71,20015.11
2022-10-24,2022-10-24,Payment from Customer_0050,REF82588849,0.0,171.74,20186.85
2022-10-24,2022-10-24,Project payment - Customer_0045,REF81797714,0.0,97.88,20284.73
2022-10-25,2022-10-25,Payment from Customer_0073,REF82997296,0.0,99.7,20384.43
2022-10-25,2022-10-25,Project payment - Customer_0052,REF31792526,0.0,43.62,20428.05
2022-10-25,2022-10-25,Project payment - Customer_0090,REF43035758,0.0,94.37,20522.42
2022-10-25,2022-10-25,Payment from Customer_0022,REF24185331,0.0,107.14,20629.56
2022-10-25,2022-10-25,Invoice payment - Customer_0070,REF22180638,0.0,63.61,20693.17
2022-10-25,2022-10-25,Invoice payment - Customer_0069,REF90036462,0.0,92.48,20785.65
2022-10-25,2022-10-25,Service payment - Customer_0076,REF91007286,0.0,10.91,20796.56
2022-10-25,2022-10-25,Service payment - Customer_0008,REF44764924,0.0,114.0,20910.56
2022-10-25,2022-10-25,Project payment - Customer_0007,REF66048187,0.0,126.44,21037.0
2022-10-26,2022-10-26,Service payment - Customer_0059,REF32942818,0.0,62.77,21099.77
2022-10-26,2022-10-26,Service payment - Customer_0002,REF43510648,0.0,79.51,21179.28
2022-10-26,2022-10-26,Service payment - Customer_0046,REF85448289,0.0,120.29,21299.57
2022-10-26,2022-10-26,Project payment - Customer_0023,REF60486403,0.0,121.14,21420.71
2022-10-26,2022-10-26,Project payment - Customer_0028,REF92188733,0.0,123.17,21543.88
2022-10-26,2022-10-26,Invoice payment - Customer_0042,REF41381905,0.0,115.39,21659.27
2022-10-26,2022-10-26,Service payment - Customer_0054,REF74145828,0.0,87.96,21747.23
2022-10-26,2022-10-26,Payment from Customer_0063,REF71429911,0.0,77.07,21824.3
2022-10-26,2022-10-26,Payment from Customer_0075,REF43255420,0.0,106.94,21931.24
2022-10-26,2022-10-26,Service payment - Customer_0093,REF88105475,0.0,123.92,22055.16
2022-10-26,2022-10-26,Project payment - Customer_0060,REF39634502,0.0,114.72,22169.88
2022-10-27,2022-10-27,Invoice payment - Customer_0024,REF13693328,0.0,99.01,22268.89
2022-10-27,2022-10-27,Invoice payment - Customer_0073,REF13297852,0.0,132.92,22401.81
2022-10-27,2022-10-27,Service payment - Customer_0071,REF63816125,0.0,54.59,22456.4
2022-10-27,2022-10-27,Invoice payment - Customer_0079,REF28529238,0.0,113.77,22570.17
2022-10-27,2022-10-27,Project payment - Customer_0017,REF95037522,0.0,47.19,22617.36
2022-10-27,2022-10-27,Service payment - Customer_0086,REF65738763,0.0,88.28,22705.64
2022-10-27,2022-10-27,Project payment - Customer_0037,REF20214603,0.0,152.26,22857.9
2022-10-27,2022-10-27,Project payment - Customer_0009,REF97751100,0.0,81.93,22939.83
2022-10-27,2022-10-27,Project payment - Customer_0095,REF57782867,0.0,100.32,23040.15
2022-10-27,2022-10-27,Service payment - Customer_0056,REF86322626,0.0,41.25,23081.4
2022-10-28,2022-10-28,Service payment - Customer_0008,REF36819236,0.0,100.59,23181.99
2022-10-28,2022-10-28,Invoice payment - Customer_0020,REF30905928,0.0,140.05,23322.04
2022-10-28,2022-10-28,Project payment - Customer_0032,REF27878462,0.0,85.19,23407.23
2022-10-28,2022-10-28,Payment from Customer_0047,REF48878120,0.0,96.88,23504.11
2022-10-28,2022-10-28,Payment from Customer_0054,REF67925707,0.0,94.9,23599.01
2022-10-28,2022-10-28,Invoice payment - Customer_0004,REF24419130,0.0,57.36,23656.37
2022-10-28,2022-10-28,Invoice payment - Customer_0042,REF86987122,0.0,81.19,23737.56
2022-10-28,2022-10-28,Service payment - Customer_0036,REF67162949,0.0,59.59,23797.15
2022-10-28,2022-10-28,Invoice payment - Customer_0079,REF43648522,0.0,107.62,23904.77
2022-10-29,2022-10-29,Invoice payment - Customer_0026,REF39247312,0.0,109.62,24014.39
2022-10-29,2022-10-29,Service payment - Customer_0082,REF71086285,0.0,155.18,24169.57
2022-10-29,2022-10-29,Project payment - Customer_0013,REF66355377,0.0,79.12,24248.69
2022-10-29,2022-10-29,Project payment - Customer_0060,REF97595765,0.0,79.72,24328.41
2022-10-29,2022-10-29,Invoice payment - Customer_0097,REF68201172,0.0,57.27,24385.68
2022-10-29,2022-10-29,Service payment - Customer_0076,REF35746235,0.0,11.4,24397.08
2022-10-29,2022-10-29,Service payment - Customer_0054,REF36661041,0.0,58.82,24455.9
2022-10-29,2022-10-29,Project payment - Customer_0055,REF52163761,0.0,91.0,24546.9
2022-10-29,2022-10-29,Payment from Customer_0001,REF37872011,0.0,35.39,24582.29
2022-10-29,2022-10-29,Project payment - Customer_0023,REF31451916,0.0,98.87,24681.16
2022-10-29,2022-10-29,Payment from Customer_0045,REF35809835,0.0,104.25,24785.41
2022-10-29,2022-10-29,Payment from Customer_0053,REF63911142,0.0,144.67,24930.08
2022-10-30,2022-10-30,Project payment - Customer_0029,REF29716006,0.0,104.9,25034.98
2022-10-30,2022-10-30,Project payment - Customer_0035,REF39019763,0.0,127.3,25162.28
2022-10-30,2022-10-30,Payment from Customer_0040,REF81598130,0.0,44.93,25207.21
2022-10-30,2022-10-30,Payment from Customer_0051,REF77746306,0.0,70.53,25277.74
2022-10-30,2022-10-30,Invoice payment - Customer_0042,REF53971502,0.0,93.46,25371.2
2022-10-31,2022-10-31,Invoice payment - Customer_0060,REF94991063,0.0,104.88,25476.08
2022-10-31,2022-10-31,Invoice payment - Customer_0086,REF50954349,0.0,90.11,25566.19
2022-10-31,2022-10-31,Payment from Customer_0037,REF78254782,0.0,150.81,25717.0
2022-10-31,2022-10-31,Invoice payment - Customer_0013,REF33962864,0.0,75.55,25792.55
2022-10-31,2022-10-31,Project payment - Customer_0042,REF66399318,0.0,76.96,25869.51
2022-10-31,2022-10-31,Service payment - Customer_0000,REF21631199,0.0,36.38,25905.89
2022-10-31,2022-10-31,Project payment - Customer_0017,REF25051836,0.0,87.15,25993.04
2022-10-31,2022-10-31,Project payment - Customer_0063,REF43333400,0.0,82.14,26075.18
2022-10-31,2022-10-31,Invoice payment - Customer_0062,REF48581083,0.0,71.56,26146.74
2022-10-31,2022-10-31,Invoice payment - Customer_0004,REF43968069,0.0,56.69,26203.43
2022-10-31,2022-10-31,Invoice payment - Customer_0043,REF43097905,0.0,156.46,26359.89
2022-10-31,2022-10-31,Payment from Customer_0099,REF83862272,0.0,61.57,26421.46
2022-11-01,2022-11-01,Project payment - Customer_0021,REF65418139,0.0,123.48,26544.94
2022-11-01,2022-11-01,Service payment - Customer_0033,REF86111978,0.0,83.72,26628.66
2022-11-01,2022-11-01,Invoice payment - Customer_0089,REF41089210,0.0,187.59,26816.25
2022-11-01,2022-11-01,Monthly office rent,REF96080454,1603.39,0.0,25212.86
2022-11-01,2022-11-01,Service payment - Customer_0034,REF90373738,0.0,132.55,25345.41
2022-11-01,2022-11-01,Invoice payment - Customer_0005,REF32553669,0.0,50.22,25395.63
2022-11-01,2022-11-01,Service payment - Customer_0002,REF98367807,0.0,105.11,25500.74
2022-11-01,2022-11-01,Invoice payment - Customer_0060,REF68353126,0.0,139.77,25640.51
2022-11-01,2022-11-01,Project payment - Customer_0054,REF34833958,0.0,110.84,25751.35
2022-11-01,2022-11-01,Project payment - Customer_0043,REF30895931,0.0,141.12,25892.47
2022-11-01,2022-11-01,Service payment - Customer_0098,REF41698865,0.0,108.87,26001.34
2022-11-02,2022-11-02,Marketing expenses,REF48057316,216.08,0.0,25785.26
2022-11-02,2022-11-02,Service payment - Customer_0023,REF25180157,0.0,167.97,25953.23
2022-11-02,2022-11-02,Service payment - Customer_0063,REF75332276,0.0,101.04,26054.27
2022-11-02,2022-11-02,Invoice payment - Customer_0080,REF45001028,0.0,38.71,26092.98
2022-11-02,2022-11-02,Invoice payment - Customer_0026,REF32527638,0.0,184.08,26277.06
2022-11-02,2022-11-02,Invoice payment - Customer_0007,REF21162383,0.0,227.34,26504.4
2022-11-02,2022-11-02,Service payment - Customer_0060,REF47810744,0.0,93.93,26598.33
2022-11-02,2022-11-02,Payment from Customer_0001,REF97251405,0.0,99.05,26697.38
2022-11-02,2022-11-02,Project payment - Customer_0078,REF65881303,0.0,150.5,26847.88
2022-11-02,2022-11-02,Payment from Customer_0079,REF66594911,0.0,137.91,26985.79
2022-11-02,2022-11-02,Invoice payment - Customer_0088,REF66461924,0.0,190.16,27175.95
2022-11-02,2022-11-02,Payment from Customer_0012,REF70473253,0.0,105.49,27281.44
2022-11-02,2022-11-02,Payment from Customer_0070,REF95541121,0.0,82.35,27363.79
2022-11-03,2022-11-03,Project payment - Customer_0021,REF63881617,0.0,87.1,27450.89
2022-11-03,2022-11-03,Service payment - Customer_0086,REF82058027,0.0,129.47,27580.36
2022-11-03,2022-11-03,Service payment - Customer_0033,REF19204334,0.0,68.07,27648.43
2022-11-03,2022-11-03,Service payment - Customer_0072,REF60514346,0.0,200.92,27849.35
2022-11-03,2022-11-03,Project payment - Customer_0029,REF30993888,0.0,102.96,27952.31
2022-11-03,2022-11-03,Payment from Customer_0016,REF20505387,0.0,46.11,27998.42
2022-11-03,2022-11-03,Project payment - Customer_0098,REF59812170,0.0,131.2,28129.62
2022-11-03,2022-11-03,Project payment - Customer_0062,REF12873107,0.0,88.27,28217.89
2022-11-03,2022-11-03,Invoice payment - Customer_0063,REF32597275,0.0,111.19,28329.08
2022-11-03,2022-11-03,Project payment - Customer_0094,REF40716130,0.0,120.5,28449.58
2022-11-03,2022-11-03,Service payment - Customer_0067,REF45554032,0.0,212.67,28662.25
2022-11-03,2022-11-03,Payment from Customer_0044,REF70057758,0.0,51.37,28713.62
2022-11-04,2022-11-04,Service payment - Customer_0030,REF83758199,0.0,60.19,28773.81
2022-11-04,2022-11-04,Payment from Customer_0015,REF29782057,0.0,174.31,28948.12
2022-11-04,2022-11-04,Project payment - Customer_0018,REF81909262,0.0,86.47,29034.59
2022-11-04,2022-11-04,Invoice payment - Customer_0002,REF74948158,0.0,142.54,29177.13
2022-11-04,2022-11-04,Invoice payment - Customer_0043,REF24572013,0.0,205.19,29382.32
2022-11-04,2022-11-04,Service payment - Customer_0090,REF41000598,0.0,132.32,29514.64
2022-11-04,2022-11-04,Project payment - Customer_0079,REF98270772,0.0,79.29,29593.93
2022-11-04,2022-11-04,Service payment - Customer_0013,REF76688758,0.0,112.12,29706.05
2022-11-05,2022-11-05,Project payment - Customer_0040,REF27487046,0.0,49.04,29755.09
2022-11-05,2022-11-05,Payment from Customer_0012,REF51482594,0.0,96.77,29851.86
2022-11-05,2022-11-05,Project payment - Customer_0010,REF82320648,0.0,138.81,29990.67
2022-11-05,2022-11-05,Invoice payment - Customer_0047,REF85965903,0.0,108.05,30098.72
2022-11-05,2022-11-05,Service payment - Customer_0067,REF32209699,0.0,192.02,30290.74
2022-11-05,2022-11-05,Payment from Customer_0097,REF50800722,0.0,112.15,30402.89
2022-11-05,2022-11-05,Payment from Customer_0014,REF40552654,0.0,103.75,30506.64
2022-11-06,2022-11-06,Invoice payment - Customer_0024,REF52693429,0.0,146.5,30653.14
2022-11-06,2022-11-06,Service payment - Customer_0086,REF16903219,0.0,108.31,30761.45
2022-11-06,2022-11-06,Payment from Customer_0078,REF43871356,0.0,215.64,30977.09
2022-11-06,2022-11-06,Invoice payment - Customer_0068,REF77688651,0.0,67.07,31044.16
2022-11-06,2022-11-06,Invoice payment - Customer_0039,REF84952185,0.0,245.21,31289.37
2022-11-06,2022-11-06,Service payment - Customer_0063,REF46496450,0.0,78.21,31367.58
2022-11-06,2022-11-06,Payment from Customer_0018,REF34455917,0.0,103.3,31470.88
2022-11-06,2022-11-06,Payment from Customer_0077,REF76028378,0.0,169.98,31640.86
2022-11-06,2022-11-06,Invoice payment - Customer_0073,REF65008675,0.0,191.38,31832.24
2022-11-06,2022-11-06,Project payment - Customer_0022,REF43229802,0.0,81.1,31913.34
2022-11-06,2022-11-06,Invoice payment - Customer_0005,REF71348104,0.0,49.3,31962.64
2022-11-06,2022-11-06,Payment from Customer_0030,REF49210557,0.0,45.98,32008.62
2022-11-07,2022-11-07,Payment from Customer_0070,REF88180546,0.0,80.07,32088.69
2022-11-07,2022-11-07,Invoice payment - Customer_0013,REF66468724,0.0,111.0,32199.69
2022-11-07,2022-11-07,Payment from Customer_0036,REF10701536,0.0,74.36,32274.05
2022-11-07,2022-11-07,Service payment - Customer_0044,REF18295176,0.0,48.77,32322.82
2022-11-07,2022-11-07,Project payment - Customer_0080,REF60313800,0.0,49.77,32372.59
2022-11-07,2022-11-07,Service payment - Customer_0028,REF10880043,0.0,111.79,32484.38
2022-11-07,2022-11-07,Service payment - Customer_0067,REF16162189,0.0,246.2,32730.58
2022-11-07,2022-11-07,Invoice payment - Customer_0014,REF20749746,0.0,127.16,32857.74
2022-11-07,2022-11-07,Invoice payment - Customer_0075,REF76572258,0.0,162.99,33020.73
2022-11-07,2022-11-07,Payment from Customer_0059,REF40563012,0.0,88.4,33109.13
2022-11-07,2022-11-07,Project payment - Customer_0000,REF32356476,0.0,64.22,33173.35
2022-11-07,2022-11-07,Service payment - Customer_0031,REF62135391,0.0,128.73,33302.08
2022-11-07,2022-11-07,Payment from Customer_0064,REF97656825,0.0,47.45,33349.53
2022-11-07,2022-11-07,Service payment - Customer_0030,REF64796422,0.0,49.0,33398.53
2022-11-07,2022-11-07,Service payment - Customer_0096,REF69615841,0.0,151.15,33549.68
2022-11-08,2022-11-08,Service payment - Customer_0048,REF11767909,0.0,159.29,33708.97
2022-11-08,2022-11-08,Project payment - Customer_0074,REF58666770,0.0,91.2,33800.17
2022-11-08,2022-11-08,Invoice payment - Customer_0004,REF32488220,0.0,70.28,33870.45
2022-11-08,2022-11-08,Project payment - Customer_0014,REF78247924,0.0,148.87,34019.32
2022-11-08,2022-11-08,Payment from Customer_0093,REF70040924,0.0,136.44,34155.76
2022-11-08,2022-11-08,Project payment - Customer_0094,REF29617481,0.0,150.27,34306.03
2022-11-08,2022-11-08,Service payment - Customer_0024,REF20290520,0.0,148.55,34454.58
2022-11-08,2022-11-08,Payment from Customer_0002,REF20362937,0.0,116.24,34570.82
2022-11-09,2022-11-09,Invoice payment - Customer_0030,REF26053240,0.0,72.45,34643.27
2022-11-09,2022-11-09,Service payment - Customer_0058,REF18296027,0.0,75.58,34718.85
2022-11-09,2022-11-09,Service payment - Customer_0009,REF78701850,0.0,97.68,34816.53
2022-11-09,2022-11-09,Project payment - Customer_0080,REF79341707,0.0,58.35,34874.88
2022-11-09,2022-11-09,Project payment - Customer_0069,REF58316721,0.0,107.46,34982.34
2022-11-09,2022-11-09,Invoice payment - Customer_0017,REF47537137,0.0,88.96,35071.3
2022-11-09,2022-11-09,Project payment - Customer_0010,REF54389876,0.0,147.29,35218.59
2022-11-09,2022-11-09,Invoice payment - Customer_0038,REF76022732,0.0,72.59,35291.18
2022-11-09,2022-11-09,Invoice payment - Customer_0033,REF73849200,0.0,102.05,35393.23
2022-11-10,2022-11-10,Invoice payment - Customer_0079,REF54968946,0.0,146.91,35540.14
2022-11-10,2022-11-10,Project payment - Customer_0047,REF25411884,0.0,170.38,35710.52
2022-11-10,2022-11-10,Project payment - Customer_0060,REF98657963,0.0,136.18,35846.7
2022-11-10,2022-11-10,Service payment - Customer_0016,REF59537609,0.0,54.7,35901.4
2022-11-10,2022-11-10,Invoice payment - Customer_0091,REF42299178,0.0,175.28,36076.68
2022-11-10,2022-11-10,Service payment - Customer_0009,REF85280337,0.0,83.92,36160.6
2022-11-10,2022-11-10,Invoice payment - Customer_0044,REF55458936,0.0,48.32,36208.92
2022-11-10,2022-11-10,Service payment - Customer_0028,REF29633161,0.0,111.29,36320.21
2022-11-10,2022-11-10,Service payment - Customer_0014,REF78364231,0.0,171.46,36491.67
2022-11-11,2022-11-11,Project payment - Customer_0056,REF68382993,0.0,38.54,36530.21
2022-11-11,2022-11-11,Invoice payment - Customer_0015,REF77918330,0.0,191.84,36722.05
2022-11-11,2022-11-11,Invoice payment - Customer_0095,REF19787708,0.0,93.4,36815.45
2022-11-11,2022-11-11,Service payment - Customer_0003,REF83833627,0.0,86.43,36901.88
2022-11-11,2022-11-11,Payment from Customer_0063,REF87041120,0.0,94.03,36995.91
2022-11-11,2022-11-11,Payment from Customer_0009,REF32713530,0.0,128.36,37124.27
2022-11-11,2022-11-11,Invoice payment - Customer_0019,REF38461599,0.0,103.85,37228.12
2022-11-11,2022-11-11,Project payment - Customer_0092,REF92687701,0.0,89.64,37317.76
2022-11-11,2022-11-11,Inventory purchase,REF80145820,2748.25,0.0,34569.51
2022-11-12,2022-11-12,Inventory purchase,REF47822995,3811.73,0.0,30757.78
2022-11-12,2022-11-12,Project payment - Customer_0027,REF52160227,0.0,119.39,30877.17
2022-11-12,2022-11-12,Payment from Customer_0080,REF59333118,0.0,51.68,30928.85
2022-11-12,2022-11-12,Service payment - Customer_0058,REF86506393,0.0,69.21,30998.06
2022-11-12,2022-11-12,Invoice payment - Customer_0044,REF50301351,0.0,53.5,31051.56
2022-11-12,2022-11-12,Invoice payment - Customer_0073,REF96926849,0.0,164.61,31216.17
2022-11-12,2022-11-12,Invoice payment - Customer_0062,REF19874384,0.0,104.62,31320.79
2022-11-12,2022-11-12,Invoice payment - Customer_0015,REF63263913,0.0,167.37,31488.16
2022-11-12,2022-11-12,Invoice payment - Customer_0024,REF58687583,0.0,136.34,31624.5
2022-11-12,2022-11-12,Payment from Customer_0052,REF30815287,0.0,75.2,31699.7
2022-11-12,2022-11-12,Payment from Customer_0078,REF97037169,0.0,134.14,31833.84
2022-11-12,2022-11-12,Service payment - Customer_0029,REF85996118,0.0,100.3,31934.14
2022-11-12,2022-11-12,Project payment - Customer_0028,REF30676820,0.0,123.63,32057.77
2022-11-13,2022-11-13,Project payment - Customer_0079,REF58445286,0.0,127.33,32185.1
2022-11-13,2022-11-13,Service payment - Customer_0008,REF94883131,0.0,188.57,32373.67
2022-11-13,2022-11-13,Service payment - Customer_0051,REF71868283,0.0,115.04,32488.71
2022-11-13,2022-11-13,Payment from Customer_0046,REF92318449,0.0,156.61,32645.32
2022-11-13,2022-11-13,Payment from Customer_0013,REF97966959,0.0,105.5,32750.82
2022-11-13,2022-11-13,Project payment - Customer_0078,REF14843652,0.0,160.44,32911.26
2022-11-13,2022-11-13,Payment from Customer_0000,REF59641078,0.0,55.77,32967.03
2022-11-13,2022-11-13,Service payment - Customer_0070,REF72330896,0.0,91.88,33058.91
2022-11-13,2022-11-13,Invoice payment - Customer_0050,REF30762590,0.0,238.01,33296.92
2022-11-13,2022-11-13,Invoice payment - Customer_0069,REF63161346,0.0,119.6,33416.52
2022-11-13,2022-11-13,Invoice payment - Customer_0041,REF62155418,0.0,181.33,33597.85
2022-11-13,2022-11-13,Invoice payment - Customer_0015,REF41559616,0.0,153.48,33751.33
2022-11-14,2022-11-14,Payment from Customer_0008,REF73580088,0.0,151.46,33902.79
2022-11-14,2022-11-14,Payment from Customer_0098,REF86199219,0.0,97.88,34000.67
2022-11-14,2022-11-14,Service payment - Customer_0045,REF71702183,0.0,121.21,34121.88
2022-11-14,2022-11-14,Project payment - Customer_0034,REF34432053,0.0,90.38,34212.26
2022-11-14,2022-11-14,Project payment - Customer_0066,REF79177120,0.0,70.84,34283.1
2022-11-14,2022-11-14,Service payment - Customer_0061,REF48418010,0.0,164.84,34447.94
2022-11-14,2022-11-14,Payment from Customer_0046,REF98115136,0.0,192.85,34640.79
2022-11-14,2022-11-14,Service payment - Customer_0031,REF88768586,0.0,155.86,34796.65
2022-11-15,2022-11-15,Invoice payment - Customer_0057,REF83003720,0.0,158.32,34954.97
2022-11-15,2022-11-15,Business insurance premium,REF52813354,247.46,0.0,34707.51
2022-11-15,2022-11-15,Invoice payment - Customer_0019,REF39654150,0.0,151.75,34859.26
2022-11-15,2022-11-15,Service payment - Customer_0015,REF18509121,0.0,169.61,35028.87
2022-11-15,2022-11-15,Invoice payment - Customer_0085,REF14062926,0.0,159.9,35188.77
2022-11-15,2022-11-15,Payment from Customer_0008,REF48745219,0.0,150.53,35339.3
2022-11-15,2022-11-15,Invoice payment - Customer_0055,REF58228801,0.0,105.82,35445.12
2022-11-15,2022-11-15,Payment from Customer_0074,REF65111820,0.0,70.16,35515.28
2022-11-15,2022-11-15,Service payment - Customer_0077,REF49498115,0.0,135.86,35651.14
2022-11-16,2022-11-16,Service payment - Customer_0005,REF74945614,0.0,45.29,35696.43
2022-11-16,2022-11-16,Service payment - Customer_0074,REF40662789,0.0,55.99,35752.42
2022-11-16,2022-11-16,Project payment - Customer_0056,REF31446762,0.0,57.62,35810.04
2022-11-16,2022-11-16,Invoice payment - Customer_0029,REF64133621,0.0,77.71,35887.75
2022-11-16,2022-11-16,Project payment - Customer_0061,REF75471293,0.0,147.3,36035.05
2022-11-16,2022-11-16,Service payment - Customer_0014,REF17277295,0.0,130.48,36165.53
2022-11-16,2022-11-16,Payment from Customer_0006,REF16613296,0.0,148.5,36314.03
2022-11-16,2022-11-16,Invoice payment - Customer_0079,REF65915272,0.0,109.96,36423.99
2022-11-16,2022-11-16,Invoice payment - Customer_0071,REF80785047,0.0,58.28,36482.27
2022-11-17,2022-11-17,Project payment - Customer_0059,REF69493912,0.0,72.31,36554.58
2022-11-17,2022-11-17,Payment from Customer_0024,REF45035701,0.0,124.87,36679.45
2022-11-17,2022-11-17,Payment from Customer_0036,REF30450832,0.0,91.66,36771.11
2022-11-17,2022-11-17,Project payment - Customer_0082,REF11902356,0.0,225.96,36997.07
2022-11-17,2022-11-17,Payment from Customer_0048,REF19314418,0.0,148.94,37146.01
2022-11-17,2022-11-17,Payment from Customer_0051,REF39422653,0.0,100.23,37246.24
2022-11-17,2022-11-17,Invoice payment - Customer_0002,REF71939669,0.0,121.22,37367.46
2022-11-17,2022-11-17,Payment from Customer_0044,REF31774998,0.0,60.93,37428.39
2022-11-17,2022-11-17,Project payment - Customer_0054,REF47529318,0.0,133.38,37561.77
2022-11-17,2022-11-17,Project payment - Customer_0033,REF61359517,0.0,96.76,37658.53
2022-11-17,2022-11-17,Service payment - Customer_0011,REF32739587,0.0,130.64,37789.17
2022-11-17,2022-11-17,Invoice payment - Customer_0060,REF87243555,0.0,142.18,37931.35
2022-11-17,2022-11-17,Payment from Customer_0056,REF98600722,0.0,45.06,37976.41
2022-11-18,2022-11-18,Service payment - Customer_0058,REF91986252,0.0,63.95,38040.36
2022-11-18,2022-11-18,Service payment - Customer_0069,REF53207976,0.0,118.89,38159.25
2022-11-18,2022-11-18,Inventory purchase,REF71232643,2994.47,0.0,35164.78
2022-11-18,2022-11-18,Pos Systems expense,REF79608663,62.64,0.0,35102.14
2022-11-18,2022-11-18,Project payment - Customer_0088,REF45802418,0.0,170.04,35272.18
2022-11-18,2022-11-18,Payment from Customer_0000,REF81014708,0.0,60.94,35333.12
2022-11-18,2022-11-18,Service payment - Customer_0011,REF71813356,0.0,159.93,35493.05
2022-11-18,2022-11-18,Project payment - Customer_0082,REF51788264,0.0,223.81,35716.86
2022-11-18,2022-11-18,Invoice payment - Customer_0056,REF22152216,0.0,35.02,35751.88
2022-11-18,2022-11-18,Invoice payment - Customer_0025,REF91847834,0.0,168.27,35920.15
2022-11-18,2022-11-18,Project payment - Customer_0084,REF91822823,0.0,108.58,36028.73
2022-11-18,2022-11-18,Invoice payment - Customer_0010,REF43157823,0.0,126.35,36155.08
2022-11-18,2022-11-18,Service payment - Customer_0043,REF70166390,0.0,152.16,36307.24
2022-11-18,2022-11-18,Project payment - Customer_0072,REF36284481,0.0,164.93,36472.17
2022-11-18,2022-11-18,Payment from Customer_0006,REF59882198,0.0,93.74,36565.91
2022-11-19,2022-11-19,Project payment - Customer_0098,REF38107226,0.0,99.13,36665.04
2022-11-19,2022-11-19,Project payment - Customer_0039,REF19297442,0.0,198.42,36863.46
2022-11-19,2022-11-19,Service payment - Customer_0014,REF48369321,0.0,110.49,36973.95
2022-11-19,2022-11-19,Project payment - Customer_0012,REF47661383,0.0,114.63,37088.58
2022-11-19,2022-11-19,Invoice payment - Customer_0034,REF15408500,0.0,110.69,37199.27
2022-11-20,2022-11-20,Payment from Customer_0086,REF12106500,0.0,126.03,37325.3
2022-11-20,2022-11-20,Invoice payment - Customer_0065,REF43156217,0.0,75.79,37401.09
2022-11-20,2022-11-20,Project payment - Customer_0084,REF58035241,0.0,88.64,37489.73
2022-11-20,2022-11-20,Payment from Customer_0060,REF84710304,0.0,108.21,37597.94
2022-11-20,2022-11-20,Service payment - Customer_0046,REF16425033,0.0,202.42,37800.36
2022-11-20,2022-11-20,Service payment - Customer_0035,REF49346546,0.0,152.81,37953.17
2022-11-20,2022-11-20,Invoice payment - Customer_0076,REF88104691,0.0,10.0,37963.17
2022-11-20,2022-11-20,Service payment - Customer_0097,REF94382812,0.0,94.75,38057.92
2022-11-21,2022-11-21,Payment from Customer_0008,REF14863646,0.0,138.88,38196.8
2022-11-21,2022-11-21,Invoice payment - Customer_0014,REF95400491,0.0,122.88,38319.68
2022-11-21,2022-11-21,Project payment - Customer_0029,REF59585944,0.0,119.54,38439.22
2022-11-21,2022-11-21,Professional Services expense,REF81574962,154.38,0.0,38284.84
2022-11-21,2022-11-21,Payment from Customer_0006,REF67779265,0.0,135.78,38420.62
2022-11-21,2022-11-21,Project payment - Customer_0013,REF34773463,0.0,114.71,38535.33
2022-11-21,2022-11-21,Service payment - Customer_0036,REF77303828,0.0,83.81,38619.14
2022-11-21,2022-11-21,Invoice payment - Customer_0063,REF97778985,0.0,112.66,38731.8
2022-11-22,2022-11-22,Professional Services expense,REF79452019,204.42,0.0,38527.38
2022-11-22,2022-11-22,Invoice payment - Customer_0027,REF35438960,0.0,122.8,38650.18
2022-11-22,2022-11-22,Project payment - Customer_0043,REF43056840,0.0,183.72,38833.9
2022-11-22,2022-11-22,Service payment - Customer_0076,REF92605701,0.0,13.97,38847.87
2022-11-22,2022-11-22,Utility bill payment,REF35031701,212.36,0.0,38635.51
2022-11-22,2022-11-22,Project payment - Customer_0082,REF44888061,0.0,184.79,38820.3
2022-11-22,2022-11-22,Service payment - Customer_0067,REF23511152,0.0,135.0,38955.3
2022-11-22,2022-11-22,Invoice payment - Customer_0008,REF26575760,0.0,160.38,39115.68
2022-11-22,2022-11-22,Service payment - Customer_0039,REF50057669,0.0,176.64,39292.32
2022-11-22,2022-11-22,Invoice payment - Customer_0070,REF56295556,0.0,63.86,39356.18
2022-11-22,2022-11-22,Invoice payment - Customer_0025,REF32406190,0.0,176.07,39532.25
2022-11-22,2022-11-22,Payment from Customer_0053,REF39294144,0.0,169.03,39701.28
2022-11-23,2022-11-23,Payment from Customer_0091,REF59522907,0.0,249.73,39951.01
2022-11-23,2022-11-23,Project payment - Customer_0048,REF74366595,0.0,118.2,40069.21
2022-11-23,2022-11-23,Payment from Customer_0094,REF95555517,0.0,92.22,40161.43
2022-11-23,2022-11-23,Payment from Customer_0002,REF20518487,0.0,109.78,40271.21
2022-11-23,2022-11-23,Inventory purchase,REF34717784,5282.54,0.0,34988.67
2022-11-23,2022-11-23,Payment from Customer_0096,REF78815711,0.0,102.62,35091.29
2022-11-23,2022-11-23,Service payment - Customer_0043,REF92991363,0.0,210.07,35301.36
2022-11-23,2022-11-23,Payment from Customer_0098,REF21194520,0.0,97.72,35399.08
2022-11-23,2022-11-23,Project payment - Customer_0036,REF83766403,0.0,72.57,35471.65
2022-11-23,2022-11-23,Service payment - Customer_0054,REF18780864,0.0,105.15,35576.8
2022-11-24,2022-11-24,Inventory purchase,REF43315465,3928.27,0.0,31648.53
2022-11-24,2022-11-24,Payment from Customer_0066,REF12378064,0.0,89.31,31737.84
2022-11-24,2022-11-24,Service payment - Customer_0015,REF94862948,0.0,208.36,31946.2
2022-11-24,2022-11-24,Project payment - Customer_0043,REF96930949,0.0,173.12,32119.32
2022-11-24,2022-11-24,Service payment - Customer_0098,REF55352469,0.0,118.13,32237.45
2022-11-24,2022-11-24,Invoice payment - Customer_0089,REF13843311,0.0,181.76,32419.21
2022-11-24,2022-11-24,Service payment - Customer_0019,REF39140356,0.0,161.41,32580.62
2022-11-24,2022-11-24,Service payment - Customer_0093,REF48874886,0.0,146.7,32727.32
2022-11-24,2022-11-24,Project payment - Customer_0075,REF34778084,0.0,185.58,32912.9
2022-11-24,2022-11-24,Payment from Customer_0027,REF90124616,0.0,113.14,33026.04
2022-11-24,2022-11-24,Invoice payment - Customer_0046,REF11511689,0.0,181.92,33207.96
2022-11-25,2022-11-25,Service payment - Customer_0016,REF67466393,0.0,41.85,33249.81
2022-11-25,2022-11-25,Invoice payment - Customer_0009,REF96891922,0.0,120.12,33369.93
2022-11-25,2022-11-25,Project payment - Customer_0017,REF31112060,0.0,133.17,33503.1
2022-11-26,2022-11-26,Project payment - Customer_0068,REF97234716,0.0,64.7,33567.8
2022-11-26,2022-11-26,Payment from Customer_0046,REF54126821,0.0,150.87,33718.67
2022-11-26,2022-11-26,Service payment - Customer_0073,REF49560461,0.0,164.36,33883.03
2022-11-26,2022-11-26,Project payment - Customer_0017,REF77183015,0.0,84.85,33967.88
2022-11-26,2022-11-26,Service payment - Customer_0069,REF59165878,0.0,88.39,34056.27
2022-11-26,2022-11-26,Payment from Customer_0050,REF70826797,0.0,243.13,34299.4
2022-11-26,2022-11-26,Service payment - Customer_0076,REF14140414,0.0,15.64,34315.04
2022-11-26,2022-11-26,Payment from Customer_0020,REF58951278,0.0,158.16,34473.2
2022-11-26,2022-11-26,Payment from Customer_0010,REF34582722,0.0,138.29,34611.49
2022-11-27,2022-11-27,Project payment - Customer_0035,REF83202294,0.0,178.36,34789.85
2022-11-27,2022-11-27,Payment from Customer_0042,REF49894089,0.0,114.65,34904.5
2022-11-27,2022-11-27,Project payment - Customer_0044,REF17383862,0.0,46.7,34951.2
2022-11-27,2022-11-27,Service payment - Customer_0070,REF66237298,0.0,58.47,35009.67
2022-11-27,2022-11-27,Payment from Customer_0047,REF49892235,0.0,146.97,35156.64
2022-11-27,2022-11-27,Invoice payment - Customer_0019,REF17189312,0.0,123.77,35280.41
2022-11-27,2022-11-27,Project payment - Customer_0096,REF57950370,0.0,148.9,35429.31
2022-11-27,2022-11-27,Service payment - Customer_0014,REF49990367,0.0,147.09,35576.4
2022-11-28,2022-11-28,Payment from Customer_0017,REF16554873,0.0,106.16,35682.56
2022-11-28,2022-11-28,Payment from Customer_0065,REF55975097,0.0,76.82,35759.38
2022-11-28,2022-11-28,Payment from Customer_0092,REF75751555,0.0,85.17,35844.55
2022-11-28,2022-11-28,Service payment - Customer_0071,REF38964196,0.0,65.84,35910.39
2022-11-29,2022-11-29,Project payment - Customer_0047,REF65097409,0.0,176.94,36087.33
2022-11-29,2022-11-29,Invoice payment - Customer_0091,REF28718688,0.0,183.63,36270.96
2022-11-29,2022-11-29,Service payment - Customer_0058,REF82755573,0.0,66.69,36337.65
2022-11-29,2022-11-29,Invoice payment - Customer_0006,REF88756052,0.0,105.77,36443.42
2022-11-29,2022-11-29,Payment from Customer_0019,REF57383393,0.0,142.77,36586.19
2022-11-29,2022-11-29,Payment from Customer_0096,REF86208852,0.0,161.05,36747.24
2022-11-29,2022-11-29,Project payment - Customer_0075,REF82694894,0.0,209.82,36957.06
2022-11-30,2022-11-30,Payment from Customer_0020,REF38363418,0.0,107.94,37065.0
2022-11-30,2022-11-30,Payment from Customer_0002,REF52124590,0.0,81.93,37146.93
2022-11-30,2022-11-30,Payment from Customer_0018,REF67799360,0.0,105.43,37252.36
2022-11-30,2022-11-30,Service payment - Customer_0013,REF33512398,0.0,120.58,37372.94
2022-11-30,2022-11-30,Payment from Customer_0021,REF57857502,0.0,94.83,37467.77
2022-11-30,2022-11-30,Project payment - Customer_0060,REF34945620,0.0,126.63,37594.4
2022-11-30,2022-11-30,Packaging Shipping expense,REF82163974,247.08,0.0,37347.32
2022-11-30,2022-11-30,Service payment - Customer_0056,REF63115324,0.0,41.86,37389.18
2022-11-30,2022-11-30,Payment from Customer_0055,REF59087789,0.0,97.16,37486.34
2022-11-30,2022-11-30,Service payment - Customer_0047,REF22788764,0.0,171.77,37658.11
2022-11-30,2022-11-30,Invoice payment - Customer_0079,REF23045528,0.0,102.14,37760.25
2022-11-30,2022-11-30,Invoice payment - Customer_0048,REF19770624,0.0,170.7,37930.95
2022-12-01,2022-12-01,Invoice payment - Customer_0092,REF18782922,0.0,93.26,38024.21
2022-12-01,2022-12-01,Invoice payment - Customer_0015,REF44499426,0.0,135.17,38159.38
2022-12-01,2022-12-01,Project payment - Customer_0004,REF48478374,0.0,116.07,38275.45
2022-12-01,2022-12-01,Invoice payment - Customer_0051,REF98771753,0.0,88.55,38364.0
2022-12-01,2022-12-01,Project payment - Customer_0084,REF13244668,0.0,156.43,38520.43
2022-12-01,2022-12-01,Payment from Customer_0009,REF94994458,0.0,134.44,38654.87
2022-12-01,2022-12-01,Service payment - Customer_0059,REF36226353,0.0,116.19,38771.06
2022-12-01,2022-12-01,Monthly office rent,REF23030847,1948.94,0.0,36822.12
2022-12-01,2022-12-01,Service payment - Customer_0069,REF11556184,0.0,144.67,36966.79
2022-12-01,2022-12-01,Project payment - Customer_0021,REF17925320,0.0,96.21,37063.0
2022-12-02,2022-12-02,Service payment - Customer_0071,REF16398169,0.0,83.31,37146.31
2022-12-02,2022-12-02,Payment from Customer_0047,REF91160620,0.0,152.95,37299.26
2022-12-02,2022-12-02,Service payment - Customer_0060,REF78972275,0.0,170.7,37469.96
2022-12-02,2022-12-02,Invoice payment - Customer_0076,REF40892917,0.0,15.25,37485.21
2022-12-02,2022-12-02,Service payment - Customer_0015,REF49298756,0.0,168.51,37653.72
2022-12-02,2022-12-02,Payment from Customer_0011,REF89287067,0.0,150.78,37804.5
2022-12-02,2022-12-02,Payment from Customer_0044,REF65947034,0.0,72.26,37876.76
2022-12-02,2022-12-02,Service payment - Customer_0095,REF86067018,0.0,153.14,38029.9
2022-12-02,2022-12-02,Project payment - Customer_0091,REF71076825,0.0,257.08,38286.98
2022-12-03,2022-12-03,Service payment - Customer_0078,REF52504802,0.0,184.64,38471.62
2022-12-03,2022-12-03,Invoice payment - Customer_0027,REF46715599,0.0,158.76,38630.38
2022-12-03,2022-12-03,Payment from Customer_0074,REF87211513,0.0,64.42,38694.8
2022-12-03,2022-12-03,Service payment - Customer_0007,REF82189398,0.0,289.98,38984.78
2022-12-03,2022-12-03,Service payment - Customer_0063,REF35683537,0.0,105.87,39090.65
2022-12-03,2022-12-03,Project payment - Customer_0032,REF30669203,0.0,97.8,39188.45
2022-12-03,2022-12-03,Service payment - Customer_0029,REF78052045,0.0,94.21,39282.66
2022-12-03,2022-12-03,Service payment - Customer_0050,REF55238895,0.0,233.9,39516.56
2022-12-03,2022-12-03,Inventory purchase,REF17395842,6309.71,0.0,33206.85
2022-12-04,2022-12-04,Service payment - Customer_0020,REF47567896,0.0,203.04,33409.89
2022-12-04,2022-12-04,Professional Services expense,REF49214406,422.14,0.0,32987.75
2022-12-04,2022-12-04,Service payment - Customer_0069,REF80671684,0.0,91.11,33078.86
2022-12-04,2022-12-04,Invoice payment - Customer_0077,REF22646009,0.0,175.27,33254.13
2022-12-04,2022-12-04,Project payment - Customer_0064,REF54175158,0.0,66.53,33320.66
2022-12-04,2022-12-04,Service payment - Customer_0058,REF93784136,0.0,72.76,33393.42
2022-12-04,2022-12-04,Payment from Customer_0026,REF50274212,0.0,153.35,33546.77
2022-12-04,2022-12-04,Payment from Customer_0004,REF26692955,0.0,88.33,33635.1
2022-12-04,2022-12-04,Payment from Customer_0071,REF25353392,0.0,60.14,33695.24
2022-12-04,2022-12-04,Invoice payment - Customer_0008,REF13405308,0.0,195.84,33891.08
2022-12-04,2022-12-04,Project payment - Customer_0057,REF14852056,0.0,221.56,34112.64
2022-12-04,2022-12-04,Service payment - Customer_0043,REF83474589,0.0,212.35,34324.99
2022-12-05,2022-12-05,Project payment - Customer_0035,REF41239700,0.0,204.15,34529.14
2022-12-05,2022-12-05,Invoice payment - Customer_0046,REF92711198,0.0,221.58,34750.72
2022-12-05,2022-12-05,Payment from Customer_0067,REF96505292,0.0,178.31,34929.03
2022-12-05,2022-12-05,Service payment - Customer_0037,REF96272451,0.0,233.18,35162.21
2022-12-05,2022-12-05,Payment from Customer_0013,REF99548604,0.0,122.04,35284.25
2022-12-05,2022-12-05,Payment from Customer_0017,REF82881692,0.0,90.63,35374.88
2022-12-05,2022-12-05,Project payment - Customer_0038,REF29425424,0.0,95.22,35470.1
2022-12-05,2022-12-05,Payment from Customer_0076,REF55159782,0.0,17.96,35488.06
2022-12-05,2022-12-05,Marketing expenses,REF10019737,387.69,0.0,35100.37
2022-12-05,2022-12-05,Service payment - Customer_0098,REF48789752,0.0,115.94,35216.31
2022-12-05,2022-12-05,Invoice payment - Customer_0010,REF74669386,0.0,145.76,35362.07
2022-12-05,2022-12-05,Service payment - Customer_0091,REF43077924,0.0,217.79,35579.86
2022-12-05,2022-12-05,Invoice payment - Customer_0099,REF10481014,0.0,92.58,35672.44
2022-12-06,2022-12-06,Project payment - Customer_0047,REF32831740,0.0,171.23,35843.67
2022-12-06,2022-12-06,Invoice payment - Customer_0033,REF63040460,0.0,122.01,35965.68
2022-12-06,2022-12-06,Project payment - Customer_0013,REF61313480,0.0,149.64,36115.32
2022-12-06,2022-12-06,Marketing expenses,REF58487402,394.71,0.0,35720.61
2022-12-06,2022-12-06,Invoice payment - Customer_0027,REF37650691,0.0,132.24,35852.85
2022-12-06,2022-12-06,Project payment - Customer_0049,REF94421229,0.0,146.5,35999.35
2022-12-06,2022-12-06,Payment from Customer_0007,REF94731986,0.0,224.66,36224.01
2022-12-06,2022-12-06,Payment from Customer_0041,REF57839030,0.0,172.08,36396.09
2022-12-06,2022-12-06,Invoice payment - Customer_0052,REF69346230,0.0,70.66,36466.75
2022-12-06,2022-12-06,Project payment - Customer_0073,REF77089915,0.0,216.6,36683.35
2022-12-06,2022-12-06,Invoice payment - Customer_0088,REF35862146,0.0,139.24,36822.59
2022-12-06,2022-12-06,Invoice payment - Customer_0063,REF14050334,0.0,87.58,36910.17
2022-12-07,2022-12-07,Invoice payment - Customer_0010,REF62956427,0.0,136.18,37046.35
2022-12-07,2022-12-07,Project payment - Customer_0023,REF51532088,0.0,199.63,37245.98
2022-12-07,2022-12-07,Employee payroll,REF65182110,4218.66,0.0,33027.32
2022-12-07,2022-12-07,Payment from Customer_0024,REF80114730,0.0,155.9,33183.22
2022-12-07,2022-12-07,Service payment - Customer_0074,REF52528749,0.0,86.17,33269.39
2022-12-07,2022-12-07,Invoice payment - Customer_0036,REF43819980,0.0,72.15,33341.54
2022-12-07,2022-12-07,Project payment - Customer_0045,REF81211653,0.0,170.63,33512.17
2022-12-07,2022-12-07,Service payment - Customer_0096,REF47962776,0.0,159.75,33671.92
2022-12-07,2022-12-07,Payment from Customer_0065,REF31065663,0.0,98.63,33770.55
2022-12-07,2022-12-07,Marketing expenses,REF18826702,531.62,0.0,33238.93
2022-12-07,2022-12-07,Service payment - Customer_0006,REF48392517,0.0,128.94,33367.87
2022-12-07,2022-12-07,Payment from Customer_0070,REF35927029,0.0,85.94,33453.81
2022-12-08,2022-12-08,Payment from Customer_0062,REF57798581,0.0,96.09,33549.9
2022-12-08,2022-12-08,Project payment - Customer_0098,REF32148122,0.0,136.75,33686.65
2022-12-08,2022-12-08,Payment from Customer_0028,REF65588463,0.0,126.28,33812.93
2022-12-08,2022-12-08,Project payment - Customer_0075,REF41393861,0.0,205.46,34018.39
2022-12-08,2022-12-08,Payment from Customer_0095,REF20672746,0.0,152.09,34170.48
2022-12-08,2022-12-08,Payment from Customer_0059,REF70472751,0.0,120.49,34290.97
2022-12-08,2022-12-08,Project payment - Customer_0064,REF56246579,0.0,64.61,34355.58
2022-12-08,2022-12-08,Invoice payment - Customer_0002,REF67189477,0.0,152.19,34507.77
2022-12-08,2022-12-08,Payment from Customer_0001,REF22867291,0.0,110.98,34618.75
2022-12-09,2022-12-09,Project payment - Customer_0096,REF22903991,0.0,128.87,34747.62
2022-12-09,2022-12-09,Invoice payment - Customer_0038,REF56901612,0.0,112.21,34859.83
2022-12-09,2022-12-09,Project payment - Customer_0046,REF86367373,0.0,222.2,35082.03
2022-12-09,2022-12-09,Invoice payment - Customer_0058,REF27818675,0.0,69.91,35151.94
2022-12-09,2022-12-09,Invoice payment - Customer_0086,REF96002542,0.0,118.52,35270.46
2022-12-09,2022-12-09,Inventory purchase,REF69783230,9162.9,0.0,26107.56
2022-12-09,2022-12-09,Payment from Customer_0007,REF60020881,0.0,197.79,26305.35
2022-12-10,2022-12-10,Project payment - Customer_0041,REF15467835,0.0,197.29,26502.64
2022-12-10,2022-12-10,Service payment - Customer_0070,REF60799002,0.0,84.74,26587.38
2022-12-10,2022-12-10,Project payment - Customer_0033,REF69315600,0.0,130.2,26717.58
2022-12-10,2022-12-10,Project payment - Customer_0003,REF51561304,0.0,91.6,26809.18
2022-12-10,2022-12-10,Project payment - Customer_0078,REF28704647,0.0,185.34,26994.52
2022-12-10,2022-12-10,Invoice payment - Customer_0065,REF71976952,0.0,95.2,27089.72
2022-12-10,2022-12-10,Invoice payment - Customer_0051,REF10405472,0.0,131.72,27221.44
2022-12-10,2022-12-10,Payment from Customer_0042,REF95239234,0.0,153.43,27374.87
2022-12-10,2022-12-10,Invoice payment - Customer_0073,REF10636551,0.0,189.42,27564.29
2022-12-10,2022-12-10,Invoice payment - Customer_0063,REF48482570,0.0,110.26,27674.55
2022-12-10,2022-12-10,Payment from Customer_0019,REF47139026,0.0,157.32,27831.87
2022-12-10,2022-12-10,Service payment - Customer_0045,REF15467646,0.0,169.48,28001.35
2022-12-10,2022-12-10,Project payment - Customer_0062,REF64604021,0.0,63.17,28064.52
2022-12-11,2022-12-11,Inventory purchase,REF83552317,6081.94,0.0,21982.58
2022-12-11,2022-12-11,Service payment - Customer_0002,REF49120037,0.0,145.35,22127.93
2022-12-11,2022-12-11,Invoice payment - Customer_0054,REF56525008,0.0,127.34,22255.27
2022-12-11,2022-12-11,Invoice payment - Customer_0037,REF88135354,0.0,195.15,22450.42
2022-12-11,2022-12-11,Service payment - Customer_0024,REF87125907,0.0,157.93,22608.35
2022-12-11,2022-12-11,Service payment - Customer_0083,REF58622835,0.0,108.89,22717.24
2022-12-11,2022-12-11,Invoice payment - Customer_0064,REF35460086,0.0,64.49,22781.73
2022-12-11,2022-12-11,Service payment - Customer_0036,REF27954087,0.0,98.7,22880.43
2022-12-12,2022-12-12,Employee payroll,REF87129497,4033.95,0.0,18846.48
2022-12-12,2022-12-12,Invoice payment - Customer_0039,REF75559484,0.0,165.87,19012.35
2022-12-12,2022-12-12,Payment from Customer_0010,REF19128960,0.0,146.11,19158.46
2022-12-12,2022-12-12,Payment from Customer_0071,REF68937920,0.0,79.2,19237.66
2022-12-12,2022-12-12,Service payment - Customer_0087,REF63946903,0.0,113.41,19351.07
2022-12-12,2022-12-12,Project payment - Customer_0042,REF94769740,0.0,141.14,19492.21
2022-12-12,2022-12-12,Service payment - Customer_0082,REF41571769,0.0,218.68,19710.89
2022-12-12,2022-12-12,Service payment - Customer_0072,REF44442175,0.0,206.65,19917.54
2022-12-12,2022-12-12,Invoice payment - Customer_0041,REF87591016,0.0,253.12,20170.66
2022-12-12,2022-12-12,Project payment - Customer_0019,REF81014832,0.0,140.38,20311.04
2022-12-13,2022-12-13,Payment from Customer_0056,REF84260092,0.0,60.82,20371.86
2022-12-13,2022-12-13,Project payment - Customer_0009,REF56710210,0.0,114.98,20486.84
2022-12-13,2022-12-13,Project payment - Customer_0062,REF32689177,0.0,97.17,20584.01
2022-12-13,2022-12-13,Project payment - Customer_0092,REF14881079,0.0,108.71,20692.72
2022-12-13,2022-12-13,Invoice payment - Customer_0017,REF35109456,0.0,107.93,20800.65
2022-12-13,2022-12-13,Service payment - Customer_0091,REF79206952,0.0,245.06,21045.71
2022-12-13,2022-12-13,Payment from Customer_0074,REF31411490,0.0,80.09,21125.8
2022-12-13,2022-12-13,Payment from Customer_0089,REF54234641,0.0,247.24,21373.04
2022-12-13,2022-12-13,Service payment - Customer_0011,REF84383580,0.0,179.71,21552.75
2022-12-13,2022-12-13,Payment from Customer_0045,REF39956224,0.0,130.52,21683.27
2022-12-13,2022-12-13,Payment from Customer_0036,REF94036217,0.0,101.83,21785.1
2022-12-13,2022-12-13,Payment from Customer_0078,REF73554935,0.0,160.9,21946.0
2022-12-13,2022-12-13,Invoice payment - Customer_0008,REF61415868,0.0,164.6,22110.6
2022-12-13,2022-12-13,Payment from Customer_0068,REF69652878,0.0,76.73,22187.33
2022-12-13,2022-12-13,Project payment - Customer_0076,REF66700824,0.0,17.4,22204.73
2022-12-14,2022-12-14,Invoice payment - Customer_0096,REF93258084,0.0,143.24,22347.97
2022-12-14,2022-12-14,Payment from Customer_0035,REF49468565,0.0,211.02,22558.99
2022-12-14,2022-12-14,Service payment - Customer_0062,REF78542018,0.0,113.6,22672.59
2022-12-14,2022-12-14,Project payment - Customer_0073,REF55297450,0.0,207.77,22880.36
2022-12-14,2022-12-14,Invoice payment - Customer_0063,REF38494027,0.0,117.51,22997.87
2022-12-14,2022-12-14,Service payment - Customer_0087,REF64028521,0.0,161.88,23159.75
2022-12-14,2022-12-14,Project payment - Customer_0030,REF70443766,0.0,67.48,23227.23
2022-12-14,2022-12-14,Payment from Customer_0054,REF97722805,0.0,142.74,23369.97
2022-12-14,2022-12-14,Service payment - Customer_0043,REF48232790,0.0,183.83,23553.8
2022-12-14,2022-12-14,Project payment - Customer_0045,REF41495571,0.0,140.45,23694.25
2022-12-14,2022-12-14,Invoice payment - Customer_0011,REF17576227,0.0,183.42,23877.67
2022-12-15,2022-12-15,Payment from Customer_0052,REF71942369,0.0,64.12,23941.79
2022-12-15,2022-12-15,Project payment - Customer_0022,REF29584357,0.0,104.69,24046.48
2022-12-15,2022-12-15,Invoice payment - Customer_0050,REF82275413,0.0,261.79,24308.27
2022-12-15,2022-12-15,Inventory purchase,REF49589922,6930.3,0.0,17377.97
2022-12-15,2022-12-15,Service payment - Customer_0093,REF52661938,0.0,132.78,17510.75
2022-12-15,2022-12-15,Project payment - Customer_0059,REF64247355,0.0,128.37,17639.12
2022-12-15,2022-12-15,Payment from Customer_0011,REF33860825,0.0,174.97,17814.09
2022-12-15,2022-12-15,Service payment - Customer_0073,REF63737075,0.0,158.99,17973.08
2022-12-15,2022-12-15,Service payment - Customer_0070,REF59118407,0.0,93.31,18066.39
2022-12-15,2022-12-15,Project payment - Customer_0092,REF97719874,0.0,94.62,18161.01
2022-12-15,2022-12-15,Payment from Customer_0094,REF97142323,0.0,139.09,18300.1
2022-12-15,2022-12-15,Business insurance premium,REF42409813,315.57,0.0,17984.53
2022-12-15,2022-12-15,Service payment - Customer_0018,REF97411084,0.0,118.36,18102.89
2022-12-15,2022-12-15,Project payment - Customer_0069,REF42808440,0.0,172.74,18275.63
2022-12-15,2022-12-15,Service payment - Customer_0040,REF93822332,0.0,38.74,18314.37
2022-12-15,2022-12-15,Invoice payment - Customer_0033,REF35084271,0.0,140.48,18454.85
2022-12-15,2022-12-15,Service payment - Customer_0044,REF12469208,0.0,56.53,18511.38
2022-12-16,2022-12-16,Service payment - Customer_0014,REF23056981,0.0,109.43,18620.81
2022-12-16,2022-12-16,Payment from Customer_0072,REF51539451,0.0,174.1,18794.91
2022-12-16,2022-12-16,Service payment - Customer_0040,REF73714231,0.0,57.7,18852.61
2022-12-16,2022-12-16,Invoice payment - Customer_0022,REF69233304,0.0,118.9,18971.51
2022-12-16,2022-12-16,Project payment - Customer_0059,REF81499357,0.0,106.19,19077.7
2022-12-16,2022-12-16,Invoice payment - Customer_0002,REF67040061,0.0,142.18,19219.88
2022-12-16,2022-12-16,Invoice payment - Customer_0041,REF43958654,0.0,250.69,19470.57
2022-12-16,2022-12-16,Service payment - Customer_0066,REF18601349,0.0,104.22,19574.79
2022-12-16,2022-12-16,Service payment - Customer_0001,REF81762624,0.0,118.11,19692.9
2022-12-16,2022-12-16,Project payment - Customer_0028,REF77224802,0.0,128.89,19821.79
2022-12-16,2022-12-16,Project payment - Customer_0004,REF69908235,0.0,80.49,19902.28
2022-12-17,2022-12-17,Pos Systems expense,REF34363851,91.67,0.0,19810.61
2022-12-17,2022-12-17,Payment from Customer_0031,REF58256886,0.0,135.98,19946.59
2022-12-17,2022-12-17,Payment from Customer_0061,REF18781565,0.0,197.07,20143.66
2022-12-17,2022-12-17,Invoice payment - Customer_0036,REF85356027,0.0,79.8,20223.46
2022-12-17,2022-12-17,Payment from Customer_0017,REF42885590,0.0,116.57,20340.03
2022-12-18,2022-12-18,Payment from Customer_0039,REF44785200,0.0,199.42,20539.45
2022-12-18,2022-12-18,Payment from Customer_0090,REF26373658,0.0,153.07,20692.52
2022-12-18,2022-12-18,Service payment - Customer_0077,REF25678036,0.0,155.33,20847.85
2022-12-18,2022-12-18,Invoice payment - Customer_0094,REF51501904,0.0,137.62,20985.47
2022-12-18,2022-12-18,Service payment - Customer_0064,REF50764450,0.0,52.62,21038.09
2022-12-18,2022-12-18,Service payment - Customer_0025,REF64210736,0.0,189.2,21227.29
2022-12-18,2022-12-18,Service payment - Customer_0095,REF22504306,0.0,136.99,21364.28
2022-12-19,2022-12-19,Invoice payment - Customer_0031,REF59645995,0.0,165.75,21530.03
2022-12-19,2022-12-19,Project payment - Customer_0050,REF24641963,0.0,278.49,21808.52
2022-12-19,2022-12-19,Invoice payment - Customer_0021,REF10368181,0.0,108.65,21917.17
2022-12-19,2022-12-19,Invoice payment - Customer_0078,REF59443780,0.0,205.94,22123.11
2022-12-19,2022-12-19,Payment from Customer_0073,REF56636323,0.0,182.43,22305.54
2022-12-19,2022-12-19,Invoice payment - Customer_0033,REF44665039,0.0,122.19,22427.73
2022-12-19,2022-12-19,Project payment - Customer_0094,REF70312146,0.0,119.85,22547.58
2022-12-20,2022-12-20,Service payment - Customer_0044,REF94741854,0.0,61.48,22609.06
2022-12-20,2022-12-20,Project payment - Customer_0039,REF37133572,0.0,171.98,22781.04
2022-12-20,2022-12-20,Invoice payment - Customer_0006,REF83149679,0.0,150.98,22932.02
2022-12-20,2022-12-20,Project payment - Customer_0004,REF66071814,0.0,95.22,23027.24
2022-12-20,2022-12-20,Project payment - Customer_0067,REF35597172,0.0,229.74,23256.98
2022-12-20,2022-12-20,Service payment - Customer_0052,REF83153715,0.0,59.45,23316.43
2022-12-20,2022-12-20,Invoice payment - Customer_0027,REF57220288,0.0,157.01,23473.44
2022-12-20,2022-12-20,Invoice payment - Customer_0011,REF73778462,0.0,160.97,23634.41
2022-12-20,2022-12-20,Payment from Customer_0026,REF49295634,0.0,191.42,23825.83
2022-12-20,2022-12-20,Payment from Customer_0001,REF16417704,0.0,116.66,23942.49
2022-12-21,2022-12-21,Invoice payment - Customer_0013,REF36398170,0.0,122.43,24064.92
2022-12-21,2022-12-21,Invoice payment - Customer_0032,REF93836080,0.0,113.21,24178.13
2022-12-21,2022-12-21,Project payment - Customer_0069,REF74750231,0.0,131.52,24309.65
2022-12-21,2022-12-21,Project payment - Customer_0070,REF80177812,0.0,99.3,24408.95
2022-12-21,2022-12-21,Invoice payment - Customer_0067,REF74187243,0.0,223.9,24632.85
2022-12-21,2022-12-21,Payment from Customer_0089,REF93855843,0.0,181.56,24814.41
2022-12-21,2022-12-21,Invoice payment - Customer_0095,REF15816398,0.0,134.06,24948.47
2022-12-21,2022-12-21,Invoice payment - Customer_0087,REF69297734,0.0,102.51,25050.98
2022-12-21,2022-12-21,Service payment - Customer_0051,REF99034907,0.0,132.63,25183.61
2022-12-21,2022-12-21,Payment from Customer_0026,REF52170621,0.0,164.43,25348.04
2022-12-22,2022-12-22,Project payment - Customer_0088,REF27735286,0.0,177.66,25525.7
2022-12-22,2022-12-22,Service payment - Customer_0075,REF24414509,0.0,176.51,25702.21
2022-12-22,2022-12-22,Project payment - Customer_0041,REF77192969,0.0,202.54,25904.75
2022-12-22,2022-12-22,Inventory purchase,REF82052828,7687.9,0.0,18216.85
2022-12-22,2022-12-22,Payment from Customer_0025,REF76943163,0.0,163.41,18380.26
2022-12-22,2022-12-22,Invoice payment - Customer_0020,REF83717975,0.0,173.16,18553.42
2022-12-22,2022-12-22,Project payment - Customer_0066,REF77908176,0.0,94.58,18648.0
2022-12-22,2022-12-22,Utility bill payment,REF57181669,204.31,0.0,18443.69
2022-12-23,2022-12-23,Project payment - Customer_0066,REF42716543,0.0,87.23,18530.92
2022-12-23,2022-12-23,Project payment - Customer_0099,REF83356654,0.0,69.24,18600.16
2022-12-23,2022-12-23,Invoice payment - Customer_0093,REF52634387,0.0,232.63,18832.79
2022-12-23,2022-12-23,Service payment - Customer_0077,REF40103395,0.0,147.25,18980.04
2022-12-23,2022-12-23,Payment from Customer_0069,REF24483889,0.0,119.0,19099.04
2022-12-23,2022-12-23,Invoice payment - Customer_0089,REF55598945,0.0,224.06,19323.1
2022-12-23,2022-12-23,Service payment - Customer_0084,REF92369926,0.0,132.66,19455.76
2022-12-23,2022-12-23,Service payment - Customer_0080,REF76367282,0.0,78.03,19533.79
2022-12-23,2022-12-23,Payment from Customer_0055,REF24964318,0.0,78.11,19611.9
2022-12-23,2022-12-23,Invoice payment - Customer_0054,REF82160597,0.0,145.52,19757.42
2022-12-23,2022-12-23,Payment from Customer_0024,REF11124717,0.0,160.14,19917.56
2022-12-24,2022-12-24,Marketing expenses,REF88824965,538.32,0.0,19379.24
2022-12-24,2022-12-24,Payment from Customer_0083,REF48731660,0.0,105.33,19484.57
2022-12-24,2022-12-24,Project payment - Customer_0077,REF57487426,0.0,108.94,19593.51
2022-12-24,2022-12-24,Service payment - Customer_0081,REF24577490,0.0,143.76,19737.27
2022-12-24,2022-12-24,Invoice payment - Customer_0044,REF90216582,0.0,68.09,19805.36
2022-12-24,2022-12-24,Invoice payment - Customer_0080,REF55173684,0.0,52.01,19857.37
2022-12-24,2022-12-24,Service payment - Customer_0072,REF91509209,0.0,208.56,20065.93
2022-12-24,2022-12-24,Payment from Customer_0000,REF27404409,0.0,73.73,20139.66
2022-12-24,2022-12-24,Payment from Customer_0060,REF16724234,0.0,139.09,20278.75
2022-12-24,2022-12-24,Payment from Customer_0027,REF64990979,0.0,132.53,20411.28
2022-12-25,2022-12-25,Service payment - Customer_0033,REF96015937,0.0,95.56,20506.84
2022-12-25,2022-12-25,Project payment - Customer_0024,REF17704682,0.0,166.46,20673.3
2022-12-25,2022-12-25,Service payment - Customer_0056,REF48218424,0.0,53.24,20726.54
2022-12-25,2022-12-25,Project payment - Customer_0012,REF15928347,0.0,106.72,20833.26
2022-12-25,2022-12-25,Project payment - Customer_0099,REF79876090,0.0,53.19,20886.45
2022-12-25,2022-12-25,Project payment - Customer_0013,REF77411037,0.0,100.47,20986.92
2022-12-25,2022-12-25,Project payment - Customer_0044,REF50450165,0.0,58.72,21045.64
2022-12-26,2022-12-26,Project payment - Customer_0083,REF59456946,0.0,95.93,21141.57
2022-12-26,2022-12-26,Project payment - Customer_0007,REF75778886,0.0,272.03,21413.6
2022-12-26,2022-12-26,Invoice payment - Customer_0044,REF76608155,0.0,44.36,21457.96
2022-12-26,2022-12-26,Packaging Shipping expense,REF55480320,473.27,0.0,20984.69
2022-12-26,2022-12-26,Payment from Customer_0049,REF80769430,0.0,128.91,21113.6
2022-12-26,2022-12-26,Invoice payment - Customer_0078,REF16461769,0.0,198.68,21312.28
2022-12-26,2022-12-26,Project payment - Customer_0068,REF78384148,0.0,56.03,21368.31
2022-12-26,2022-12-26,Payment from Customer_0088,REF98386137,0.0,137.36,21505.67
2022-12-26,2022-12-26,Payment from Customer_0008,REF36475917,0.0,171.94,21677.61
2022-12-26,2022-12-26,Invoice payment - Customer_0032,REF90841304,0.0,87.95,21765.56
2022-12-26,2022-12-26,Payment from Customer_0073,REF45016490,0.0,187.55,21953.11
2022-12-26,2022-12-26,Invoice payment - Customer_0023,REF90003247,0.0,167.96,22121.07
2022-12-27,2022-12-27,Invoice payment - Customer_0035,REF46240664,0.0,259.65,22380.72
2022-12-27,2022-12-27,Project payment - Customer_0040,REF13630062,0.0,53.9,22434.62
2022-12-27,2022-12-27,Payment from Customer_0001,REF87044982,0.0,121.96,22556.58
2022-12-27,2022-12-27,Packaging Shipping expense,REF17051611,318.6,0.0,22237.98
2022-12-27,2022-12-27,Invoice payment - Customer_0070,REF96219763,0.0,76.18,22314.16
2022-12-27,2022-12-27,Service payment - Customer_0059,REF89876301,0.0,110.79,22424.95
2022-12-27,2022-12-27,Invoice payment - Customer_0028,REF98238656,0.0,172.8,22597.75
2022-12-27,2022-12-27,Payment from Customer_0027,REF88687879,0.0,111.7,22709.45
2022-12-27,2022-12-27,Payment from Customer_0058,REF89768611,0.0,73.34,22782.79
2022-12-28,2022-12-28,Service payment - Customer_0092,REF81919567,0.0,129.68,22912.47
2022-12-28,2022-12-28,Invoice payment - Customer_0032,REF35819510,0.0,110.39,23022.86
2022-12-28,2022-12-28,Project payment - Customer_0030,REF12248263,0.0,87.74,23110.6
2022-12-28,2022-12-28,Project payment - Customer_0040,REF65841907,0.0,53.12,23163.72
2022-12-28,2022-12-28,Payment from Customer_0089,REF46656631,0.0,309.4,23473.12
2022-12-28,2022-12-28,Service payment - Customer_0049,REF57638422,0.0,158.13,23631.25
2022-12-29,2022-12-29,Service payment - Customer_0062,REF22661182,0.0,76.87,23708.12
2022-12-29,2022-12-29,Service payment - Customer_0050,REF50193885,0.0,236.54,23944.66
2022-12-29,2022-12-29,Project payment - Customer_0065,REF46006358,0.0,87.16,24031.82
2022-12-29,2022-12-29,Project payment - Customer_0011,REF18343291,0.0,140.8,24172.62
2022-12-29,2022-12-29,Invoice payment - Customer_0044,REF45721997,0.0,70.08,24242.7
2022-12-29,2022-12-29,Payment from Customer_0047,REF93396376,0.0,177.08,24419.78
2022-12-29,2022-12-29,Payment from Customer_0022,REF96122188,0.0,115.4,24535.18
2022-12-29,2022-12-29,Invoice payment - Customer_0029,REF17739556,0.0,172.23,24707.41
2022-12-29,2022-12-29,Project payment - Customer_0028,REF72554958,0.0,112.81,24820.22
2022-12-29,2022-12-29,Service payment - Customer_0052,REF35839948,0.0,68.9,24889.12
2022-12-29,2022-12-29,Service payment - Customer_0035,REF48382191,0.0,147.8,25036.92
2022-12-29,2022-12-29,Service payment - Customer_0071,REF51069757,0.0,51.87,25088.79
2022-12-29,2022-12-29,Service payment - Customer_0018,REF57989383,0.0,92.25,25181.04
2022-12-30,2022-12-30,Service payment - Customer_0012,REF81405005,0.0,91.19,25272.23
2022-12-30,2022-12-30,Service payment - Customer_0088,REF31238367,0.0,156.69,25428.92
2022-12-30,2022-12-30,Invoice payment - Customer_0032,REF73872611,0.0,136.87,25565.79
2022-12-30,2022-12-30,Invoice payment - Customer_0056,REF77459854,0.0,35.3,25601.09
2022-12-30,2022-12-30,Service payment - Customer_0030,REF43149930,0.0,69.09,25670.18
2022-12-30,2022-12-30,Project payment - Customer_0078,REF20031678,0.0,197.93,25868.11
2022-12-30,2022-12-30,Project payment - Customer_0021,REF66475372,0.0,97.1,25965.21
2022-12-30,2022-12-30,Invoice payment - Customer_0013,REF99501886,0.0,110.27,26075.48
2022-12-30,2022-12-30,Project payment - Customer_0097,REF58497786,0.0,117.85,26193.33
2022-12-30,2022-12-30,Service payment - Customer_0093,REF88048922,0.0,210.62,26403.95
2022-12-30,2022-12-30,Project payment - Customer_0065,REF58719177,0.0,55.25,26459.2
2022-12-30,2022-12-30,Invoice payment - Customer_0091,REF26257487,0.0,242.07,26701.27
2022-12-30,2022-12-30,Project payment - Customer_0049,REF31665111,0.0,113.13,26814.4
2022-12-30,2022-12-30,Invoice payment - Customer_0074,REF99631457,0.0,101.71,26916.11
2022-12-30,2022-12-30,Packaging Shipping expense,REF72945233,314.14,0.0,26601.97
2022-12-31,2022-12-31,Service payment - Customer_0075,REF92449148,0.0,194.71,26796.68
2022-12-31,2022-12-31,Invoice payment - Customer_0026,REF11568713,0.0,144.12,26940.8
2022-12-31,2022-12-31,Payment from Customer_0048,REF18152983,0.0,159.25,27100.05
2022-12-31,2022-12-31,Service payment - Customer_0061,REF29030623,0.0,234.97,27335.02
2022-12-31,2022-12-31,Project payment - Customer_0039,REF14076436,0.0,196.03,27531.05
2022-12-31,2022-12-31,Service payment - Customer_0031,REF43728113,0.0,219.22,27750.27
2022-12-31,2022-12-31,Service payment - Customer_0033,REF87410226,0.0,94.4,27844.67
2022-12-31,2022-12-31,Payment from Customer_0090,REF18373463,0.0,105.83,27950.5
2022-12-31,2022-12-31,Service payment - Customer_0020,REF31442335,0.0,103.56,28054.06
2022-12-31,2022-12-31,Project payment - Customer_0054,REF21399187,0.0,134.02,28188.08
2022-12-31,2022-12-31,Invoice payment - Customer_0073,REF49271367,0.0,190.4,28378.48
2022-12-31,2022-12-31,Invoice payment - Customer_0097,REF11604947,0.0,82.93,28461.41
2023-01-01,2023-01-01,Pos Systems expense,REF53639982,38.05,0.0,28423.36
2023-01-01,2023-01-01,Project payment - Customer_0084,REF17618174,0.0,63.38,28486.74
2023-01-01,2023-01-01,Service payment - Customer_0027,REF58856068,0.0,63.75,28550.49
2023-01-01,2023-01-01,Project payment - Customer_0075,REF57247108,0.0,104.4,28654.89
2023-01-01,2023-01-01,Monthly office rent,REF39284571,963.89,0.0,27691.0
2023-01-01,2023-01-01,Service payment - Customer_0071,REF86253435,0.0,32.89,27723.89
2023-01-01,2023-01-01,Service payment - Customer_0062,REF94228036,0.0,46.18,27770.07
2023-01-01,2023-01-01,Invoice payment - Customer_0002,REF74109761,0.0,70.2,27840.27
2023-01-01,2023-01-01,Service payment - Customer_0089,REF81545609,0.0,139.87,27980.14
2023-01-02,2023-01-02,Service payment - Customer_0071,REF38094677,0.0,25.61,28005.75
2023-01-02,2023-01-02,Project payment - Customer_0031,REF95076207,0.0,57.99,28063.74
2023-01-02,2023-01-02,Project payment - Customer_0030,REF63333123,0.0,30.85,28094.59
2023-01-02,2023-01-02,Project payment - Customer_0093,REF17129107,0.0,88.89,28183.48
2023-01-02,2023-01-02,Invoice payment - Customer_0098,REF48232855,0.0,69.08,28252.56
2023-01-02,2023-01-02,Payment from Customer_0037,REF31149070,0.0,86.76,28339.32
2023-01-02,2023-01-02,Project payment - Customer_0038,REF73353982,0.0,44.92,28384.24
2023-01-02,2023-01-02,Service payment - Customer_0084,REF28815126,0.0,78.52,28462.76
2023-01-03,2023-01-03,Payment from Customer_0081,REF71192119,0.0,65.72,28528.48
2023-01-03,2023-01-03,Invoice payment - Customer_0011,REF49002871,0.0,92.81,28621.29
2023-01-03,2023-01-03,Project payment - Customer_0017,REF69470243,0.0,53.51,28674.8
2023-01-03,2023-01-03,Service payment - Customer_0058,REF29019602,0.0,39.29,28714.09
2023-01-03,2023-01-03,Project payment - Customer_0039,REF16246646,0.0,80.77,28794.86
2023-01-03,2023-01-03,Invoice payment - Customer_0077,REF51492331,0.0,62.87,28857.73
2023-01-03,2023-01-03,Service payment - Customer_0022,REF85570850,0.0,51.05,28908.78
2023-01-03,2023-01-03,Project payment - Customer_0096,REF69419498,0.0,78.66,28987.44
2023-01-03,2023-01-03,Invoice payment - Customer_0068,REF60829204,0.0,46.56,29034.0
2023-01-03,2023-01-03,Invoice payment - Customer_0005,REF41907132,0.0,27.03,29061.03
2023-01-04,2023-01-04,Project payment - Customer_0057,REF76389293,0.0,82.88,29143.91
2023-01-04,2023-01-04,Service payment - Customer_0097,REF64438733,0.0,59.86,29203.77
2023-01-04,2023-01-04,Payment from Customer_0023,REF85325036,0.0,84.14,29287.91
2023-01-04,2023-01-04,Invoice payment - Customer_0094,REF35106498,0.0,81.86,29369.77
2023-01-04,2023-01-04,Payment from Customer_0002,REF47920509,0.0,78.59,29448.36
2023-01-04,2023-01-04,Invoice payment - Customer_0040,REF40471807,0.0,32.88,29481.24
2023-01-04,2023-01-04,Payment from Customer_0004,REF78731107,0.0,46.9,29528.14
2023-01-04,2023-01-04,Project payment - Customer_0038,REF72606410,0.0,52.34,29580.48
2023-01-05,2023-01-05,Professional Services expense,REF13749147,135.3,0.0,29445.18
2023-01-05,2023-01-05,Invoice payment - Customer_0090,REF49143208,0.0,61.72,29506.9
2023-01-05,2023-01-05,Project payment - Customer_0022,REF38416073,0.0,39.95,29546.85
2023-01-05,2023-01-05,Invoice payment - Customer_0024,REF14790133,0.0,87.39,29634.24
2023-01-05,2023-01-05,Payment from Customer_0069,REF34386800,0.0,61.45,29695.69
2023-01-05,2023-01-05,Project payment - Customer_0006,REF82957635,0.0,54.93,29750.62
2023-01-05,2023-01-05,Marketing expenses,REF15090103,226.63,0.0,29523.99
2023-01-05,2023-01-05,Service payment - Customer_0068,REF47485474,0.0,43.51,29567.5
2023-01-05,2023-01-05,Invoice payment - Customer_0083,REF75684727,0.0,54.95,29622.45
2023-01-05,2023-01-05,Project payment - Customer_0034,REF11298480,0.0,76.55,29699.0
2023-01-05,2023-01-05,Project payment - Customer_0040,REF67293571,0.0,30.24,29729.24
2023-01-06,2023-01-06,Payment from Customer_0076,REF76031203,0.0,10.0,29739.24
2023-01-06,2023-01-06,Service payment - Customer_0057,REF27334113,0.0,110.87,29850.11
2023-01-06,2023-01-06,Invoice payment - Customer_0017,REF35618270,0.0,61.2,29911.31
2023-01-06,2023-01-06,Service payment - Customer_0069,REF48659911,0.0,65.2,29976.51
2023-01-06,2023-01-06,Payment from Customer_0026,REF26017163,0.0,80.22,30056.73
2023-01-07,2023-01-07,Project payment - Customer_0010,REF48976089,0.0,63.73,30120.46
2023-01-07,2023-01-07,Invoice payment - Customer_0018,REF30697310,0.0,49.86,30170.32
2023-01-07,2023-01-07,Invoice payment - Customer_0064,REF15619257,0.0,22.28,30192.6
2023-01-07,2023-01-07,Project payment - Customer_0014,REF74876465,0.0,81.08,30273.68
2023-01-07,2023-01-07,Service payment - Customer_0060,REF90722713,0.0,77.72,30351.4
2023-01-07,2023-01-07,Payment from Customer_0052,REF15243136,0.0,36.6,30388.0
2023-01-07,2023-01-07,Invoice payment - Customer_0080,REF62329766,0.0,35.33,30423.33
2023-01-07,2023-01-07,Service payment - Customer_0099,REF90932672,0.0,33.02,30456.35
2023-01-07,2023-01-07,Project payment - Customer_0079,REF24661982,0.0,65.97,30522.32
2023-01-07,2023-01-07,Project payment - Customer_0015,REF58179903,0.0,118.63,30640.95
2023-01-07,2023-01-07,Payment from Customer_0009,REF71892089,0.0,62.05,30703.0
2023-01-07,2023-01-07,Project payment - Customer_0043,REF25346323,0.0,105.78,30808.78
2023-01-08,2023-01-08,Invoice payment - Customer_0081,REF27544250,0.0,66.59,30875.37
2023-01-08,2023-01-08,Invoice payment - Customer_0045,REF29075176,0.0,73.0,30948.37
2023-01-08,2023-01-08,Project payment - Customer_0054,REF34157603,0.0,64.02,31012.39
2023-01-08,2023-01-08,Service payment - Customer_0057,REF82709300,0.0,88.5,31100.89
2023-01-08,2023-01-08,Service payment - Customer_0065,REF24620401,0.0,49.03,31149.92
2023-01-08,2023-01-08,Payment from Customer_0099,REF92915385,0.0,42.25,31192.17
2023-01-08,2023-01-08,Project payment - Customer_0083,REF32411223,0.0,45.03,31237.2
2023-01-09,2023-01-09,Service payment - Customer_0001,REF54905190,0.0,65.52,31302.72
2023-01-09,2023-01-09,Invoice payment - Customer_0090,REF36956965,0.0,78.4,31381.12
2023-01-09,2023-01-09,Project payment - Customer_0005,REF83951363,0.0,25.82,31406.94
2023-01-09,2023-01-09,Payment from Customer_0020,REF61030292,0.0,90.67,31497.61
2023-01-09,2023-01-09,Payment from Customer_0015,REF29359654,0.0,108.74,31606.35
2023-01-09,2023-01-09,Invoice payment - Customer_0057,REF27807351,0.0,95.12,31701.47
2023-01-09,2023-01-09,Project payment - Customer_0019,REF21734749,0.0,87.71,31789.18
2023-01-09,2023-01-09,Payment from Customer_0091,REF84114840,0.0,135.24,31924.42
2023-01-09,2023-01-09,Payment from Customer_0087,REF92344562,0.0,86.63,32011.05
2023-01-09,2023-01-09,Payment from Customer_0048,REF34896993,0.0,60.4,32071.45
2023-01-09,2023-01-09,Project payment - Customer_0069,REF39637614,0.0,59.9,32131.35
2023-01-09,2023-01-09,Service payment - Customer_0073,REF75749960,0.0,97.96,32229.31
2023-01-09,2023-01-09,Payment from Customer_0025,REF82080260,0.0,99.13,32328.44
2023-01-09,2023-01-09,Service payment - Customer_0000,REF99984178,0.0,37.7,32366.14
2023-01-09,2023-01-09,Payment from Customer_0043,REF17368053,0.0,103.05,32469.19
2023-01-09,2023-01-09,Payment from Customer_0030,REF74608674,0.0,40.11,32509.3
2023-01-10,2023-01-10,Payment from Customer_0088,REF28456834,0.0,113.73,32623.03
2023-01-10,2023-01-10,Project payment - Customer_0025,REF65376365,0.0,89.96,32712.99
2023-01-10,2023-01-10,Payment from Customer_0005,REF64727960,0.0,25.85,32738.84
2023-01-10,2023-01-10,Payment from Customer_0065,REF44500570,0.0,49.96,32788.8
2023-01-10,2023-01-10,Project payment - Customer_0042,REF99386281,0.0,82.01,32870.81
2023-01-10,2023-01-10,Service payment - Customer_0017,REF13063906,0.0,52.55,32923.36
2023-01-10,2023-01-10,Service payment - Customer_0077,REF48163132,0.0,67.95,32991.31
2023-01-10,2023-01-10,Invoice payment - Customer_0008,REF20404674,0.0,59.24,33050.55
2023-01-10,2023-01-10,Packaging Shipping expense,REF88696427,255.71,0.0,32794.84
2023-01-11,2023-01-11,Service payment - Customer_0065,REF27314878,0.0,47.28,32842.12
2023-01-11,2023-01-11,Invoice payment - Customer_0055,REF93398412,0.0,60.37,32902.49
2023-01-11,2023-01-11,Service payment - Customer_0020,REF53509531,0.0,92.56,32995.05
2023-01-11,2023-01-11,Invoice payment - Customer_0043,REF58920558,0.0,105.45,33100.5
2023-01-11,2023-01-11,Invoice payment - Customer_0017,REF60603824,0.0,59.92,33160.42
2023-01-11,2023-01-11,Service payment - Customer_0076,REF10825302,0.0,10.0,33170.42
2023-01-11,2023-01-11,Service payment - Customer_0036,REF69846533,0.0,52.22,33222.64
2023-01-11,2023-01-11,Invoice payment - Customer_0096,REF77335587,0.0,74.89,33297.53
2023-01-11,2023-01-11,Payment from Customer_0062,REF67114475,0.0,54.0,33351.53
2023-01-12,2023-01-12,Service payment - Customer_0033,REF57506235,0.0,47.74,33399.27
2023-01-12,2023-01-12,Payment from Customer_0008,REF50863016,0.0,78.16,33477.43
2023-01-12,2023-01-12,Project payment - Customer_0091,REF71163847,0.0,93.03,33570.46
2023-01-12,2023-01-12,Payment from Customer_0021,REF72359842,0.0,48.12,33618.58
2023-01-12,2023-01-12,Project payment - Customer_0015,REF19216133,0.0,117.7,33736.28
2023-01-12,2023-01-12,Payment from Customer_0079,REF85015159,0.0,77.38,33813.66
2023-01-12,2023-01-12,Service payment - Customer_0095,REF32427393,0.0,42.43,33856.09
2023-01-12,2023-01-12,Payment from Customer_0081,REF33850150,0.0,68.54,33924.63
2023-01-12,2023-01-12,Service payment - Customer_0022,REF80625108,0.0,57.03,33981.66
2023-01-12,2023-01-12,Project payment - Customer_0024,REF55060741,0.0,73.35,34055.01
2023-01-12,2023-01-12,Payment from Customer_0000,REF37265279,0.0,32.02,34087.03
2023-01-12,2023-01-12,Payment from Customer_0098,REF58515742,0.0,65.68,34152.71
2023-01-12,2023-01-12,Project payment - Customer_0054,REF65796050,0.0,53.34,34206.05
2023-01-12,2023-01-12,Project payment - Customer_0007,REF69390732,0.0,82.56,34288.61
2023-01-13,2023-01-13,Project payment - Customer_0090,REF80314294,0.0,82.4,34371.01
2023-01-13,2023-01-13,Payment from Customer_0092,REF54160784,0.0,57.2,34428.21
2023-01-13,2023-01-13,Service payment - Customer_0058,REF71356802,0.0,36.05,34464.26
2023-01-13,2023-01-13,Invoice payment - Customer_0001,REF47825822,0.0,41.43,34505.69
2023-01-13,2023-01-13,Service payment - Customer_0074,REF22283794,0.0,34.0,34539.69
2023-01-13,2023-01-13,Project payment - Customer_0003,REF20894631,0.0,54.53,34594.22
2023-01-13,2023-01-13,Project payment - Customer_0086,REF79162542,0.0,70.62,34664.84
2023-01-13,2023-01-13,Invoice payment - Customer_0032,REF86529202,0.0,56.04,34720.88
2023-01-13,2023-01-13,Payment from Customer_0046,REF40953959,0.0,107.5,34828.38
2023-01-13,2023-01-13,Invoice payment - Customer_0033,REF80821561,0.0,48.78,34877.16
2023-01-13,2023-01-13,Invoice payment - Customer_0035,REF20904786,0.0,99.48,34976.64
2023-01-14,2023-01-14,Invoice payment - Customer_0099,REF42212502,0.0,35.45,35012.09
2023-01-14,2023-01-14,Payment from Customer_0070,REF63647150,0.0,32.16,35044.25
2023-01-14,2023-01-14,Project payment - Customer_0033,REF21974159,0.0,48.41,35092.66
2023-01-14,2023-01-14,Invoice payment - Customer_0006,REF11923872,0.0,58.26,35150.92
2023-01-14,2023-01-14,Service payment - Customer_0020,REF81834502,0.0,106.6,35257.52
2023-01-14,2023-01-14,Project payment - Customer_0018,REF82526860,0.0,62.76,35320.28
2023-01-14,2023-01-14,Service payment - Customer_0045,REF38192685,0.0,70.1,35390.38
2023-01-14,2023-01-14,Project payment - Customer_0013,REF71121573,0.0,67.06,35457.44
2023-01-14,2023-01-14,Project payment - Customer_0010,REF92815600,0.0,72.73,35530.17
2023-01-14,2023-01-14,Project payment - Customer_0096,REF10579527,0.0,78.95,35609.12
2023-01-14,2023-01-14,Invoice payment - Customer_0030,REF50710152,0.0,36.43,35645.55
2023-01-14,2023-01-14,Project payment - Customer_0025,REF87231589,0.0,90.0,35735.55
2023-01-15,2023-01-15,Service payment - Customer_0054,REF52618504,0.0,72.5,35808.05
2023-01-15,2023-01-15,Payment from Customer_0059,REF37534421,0.0,57.62,35865.67
2023-01-15,2023-01-15,Payment from Customer_0025,REF62605338,0.0,81.12,35946.79
2023-01-15,2023-01-15,Service payment - Customer_0035,REF65546034,0.0,78.18,36024.97
2023-01-15,2023-01-15,Project payment - Customer_0027,REF74614484,0.0,82.4,36107.37
2023-01-15,2023-01-15,Project payment - Customer_0033,REF48864756,0.0,50.15,36157.52
2023-01-15,2023-01-15,Service payment - Customer_0056,REF36741604,0.0,19.96,36177.48
2023-01-15,2023-01-15,Service payment - Customer_0093,REF58968822,0.0,120.6,36298.08
2023-01-15,2023-01-15,Project payment - Customer_0030,REF61210947,0.0,36.2,36334.28
2023-01-15,2023-01-15,Invoice payment - Customer_0077,REF23586018,0.0,79.07,36413.35
2023-01-15,2023-01-15,Invoice payment - Customer_0061,REF50882827,0.0,93.77,36507.12
2023-01-15,2023-01-15,Project payment - Customer_0020,REF80541156,0.0,96.02,36603.14
2023-01-15,2023-01-15,Business insurance premium,REF64281761,144.57,0.0,36458.57
2023-01-16,2023-01-16,Invoice payment - Customer_0061,REF21648010,0.0,90.74,36549.31
2023-01-16,2023-01-16,Payment from Customer_0086,REF56973531,0.0,58.21,36607.52
2023-01-16,2023-01-16,Payment from Customer_0006,REF94619451,0.0,71.21,36678.73
2023-01-16,2023-01-16,Service payment - Customer_0094,REF58976105,0.0,43.11,36721.84
2023-01-16,2023-01-16,Project payment - Customer_0009,REF66873079,0.0,53.84,36775.68
2023-01-16,2023-01-16,Project payment - Customer_0064,REF37106893,0.0,31.71,36807.39
2023-01-16,2023-01-16,Payment from Customer_0002,REF86983359,0.0,76.77,36884.16
2023-01-16,2023-01-16,Payment from Customer_0044,REF19272131,0.0,29.3,36913.46
2023-01-16,2023-01-16,Payment from Customer_0062,REF65814540,0.0,37.47,36950.93
2023-01-17,2023-01-17,Service payment - Customer_0004,REF86385321,0.0,47.61,36998.54
2023-01-17,2023-01-17,Project payment - Customer_0097,REF99300054,0.0,51.76,37050.3
2023-01-17,2023-01-17,Service payment - Customer_0008,REF99291587,0.0,87.46,37137.76
2023-01-17,2023-01-17,Payment from Customer_0086,REF95347234,0.0,56.17,37193.93
2023-01-17,2023-01-17,Payment from Customer_0005,REF71329122,0.0,27.72,37221.65
2023-01-17,2023-01-17,Project payment - Customer_0080,REF74037124,0.0,28.87,37250.52
2023-01-17,2023-01-17,Payment from Customer_0079,REF73028885,0.0,77.01,37327.53
2023-01-17,2023-01-17,Project payment - Customer_0046,REF83239889,0.0,98.65,37426.18
2023-01-17,2023-01-17,Invoice payment - Customer_0051,REF44185347,0.0,69.62,37495.8
2023-01-17,2023-01-17,Inventory purchase,REF52455377,2805.87,0.0,34689.93
2023-01-17,2023-01-17,Invoice payment - Customer_0078,REF56721021,0.0,112.36,34802.29
2023-01-18,2023-01-18,Payment from Customer_0055,REF34472965,0.0,49.83,34852.12
2023-01-18,2023-01-18,Service payment - Customer_0012,REF56281541,0.0,44.3,34896.42
2023-01-18,2023-01-18,Invoice payment - Customer_0075,REF37218095,0.0,103.67,35000.09
2023-01-18,2023-01-18,Project payment - Customer_0099,REF83489155,0.0,32.32,35032.41
2023-01-18,2023-01-18,Service payment - Customer_0059,REF17952790,0.0,74.56,35106.97
2023-01-18,2023-01-18,Project payment - Customer_0088,REF57681508,0.0,100.57,35207.54
2023-01-19,2023-01-19,Payment from Customer_0001,REF43523896,0.0,45.59,35253.13
2023-01-19,2023-01-19,Invoice payment - Customer_0096,REF89381412,0.0,104.39,35357.52
2023-01-19,2023-01-19,Project payment - Customer_0099,REF86539750,0.0,36.53,35394.05
2023-01-19,2023-01-19,Payment from Customer_0048,REF78987238,0.0,73.22,35467.27
2023-01-19,2023-01-19,Payment from Customer_0020,REF38838800,0.0,92.34,35559.61
2023-01-19,2023-01-19,Service payment - Customer_0030,REF35896215,0.0,35.97,35595.58
2023-01-19,2023-01-19,Payment from Customer_0052,REF69628582,0.0,33.57,35629.15
2023-01-19,2023-01-19,Payment from Customer_0021,REF70472215,0.0,63.76,35692.91
2023-01-19,2023-01-19,Invoice payment - Customer_0029,REF60076144,0.0,64.47,35757.38
2023-01-19,2023-01-19,Invoice payment - Customer_0090,REF48905489,0.0,84.45,35841.83
2023-01-19,2023-01-19,Invoice payment - Customer_0012,REF69316529,0.0,66.95,35908.78
2023-01-19,2023-01-19,Payment from Customer_0036,REF12704510,0.0,50.61,35959.39
2023-01-20,2023-01-20,Service payment - Customer_0052,REF49469121,0.0,35.29,35994.68
2023-01-20,2023-01-20,Payment from Customer_0090,REF98632758,0.0,82.78,36077.46
2023-01-20,2023-01-20,Payment from Customer_0062,REF58033617,0.0,52.71,36130.17
2023-01-20,2023-01-20,Payment from Customer_0048,REF24264385,0.0,77.51,36207.68
2023-01-20,2023-01-20,Invoice payment - Customer_0067,REF57324803,0.0,114.02,36321.7
2023-01-20,2023-01-20,Service payment - Customer_0051,REF10772945,0.0,86.85,36408.55
2023-01-21,2023-01-21,Project payment - Customer_0034,REF71443308,0.0,84.57,36493.12
2023-01-21,2023-01-21,Project payment - Customer_0063,REF97926555,0.0,61.29,36554.41
2023-01-21,2023-01-21,Project payment - Customer_0081,REF54773371,0.0,63.24,36617.65
2023-01-21,2023-01-21,Service payment - Customer_0064,REF26441487,0.0,36.82,36654.47
2023-01-21,2023-01-21,Invoice payment - Customer_0030,REF67648192,0.0,31.66,36686.13
2023-01-21,2023-01-21,Payment from Customer_0050,REF56720489,0.0,112.63,36798.76
2023-01-22,2023-01-22,Inventory purchase,REF97387390,2227.13,0.0,34571.63
2023-01-22,2023-01-22,Utility bill payment,REF32916373,104.41,0.0,34467.22
2023-01-22,2023-01-22,Invoice payment - Customer_0038,REF58041266,0.0,42.41,34509.63
2023-01-22,2023-01-22,Invoice payment - Customer_0041,REF42260071,0.0,87.74,34597.37
2023-01-22,2023-01-22,Invoice payment - Customer_0052,REF10543066,0.0,35.59,34632.96
2023-01-22,2023-01-22,Service payment - Customer_0001,REF66941266,0.0,66.34,34699.3
2023-01-22,2023-01-22,Service payment - Customer_0074,REF18299676,0.0,39.24,34738.54
2023-01-22,2023-01-22,Project payment - Customer_0058,REF37838155,0.0,39.48,34778.02
2023-01-22,2023-01-22,Invoice payment - Customer_0075,REF12113812,0.0,89.65,34867.67
2023-01-22,2023-01-22,Invoice payment - Customer_0028,REF26078835,0.0,58.25,34925.92
2023-01-22,2023-01-22,Invoice payment - Customer_0008,REF15448419,0.0,101.83,35027.75
2023-01-23,2023-01-23,Invoice payment - Customer_0092,REF13736186,0.0,45.35,35073.1
2023-01-23,2023-01-23,Payment from Customer_0096,REF91335715,0.0,67.2,35140.3
2023-01-23,2023-01-23,Payment from Customer_0072,REF53726993,0.0,101.77,35242.07
2023-01-24,2023-01-24,Invoice payment - Customer_0085,REF45665148,0.0,85.99,35328.06
2023-01-24,2023-01-24,Service payment - Customer_0027,REF90387894,0.0,68.35,35396.41
2023-01-24,2023-01-24,Project payment - Customer_0010,REF96812334,0.0,69.46,35465.87
2023-01-24,2023-01-24,Payment from Customer_0015,REF96765787,0.0,85.77,35551.64
2023-01-24,2023-01-24,Invoice payment - Customer_0034,REF51796897,0.0,61.14,35612.78
2023-01-24,2023-01-24,Pos Systems expense,REF69646111,60.13,0.0,35552.65
2023-01-24,2023-01-24,Project payment - Customer_0052,REF96917706,0.0,29.21,35581.86
2023-01-24,2023-01-24,Invoice payment - Customer_0089,REF51882099,0.0,117.32,35699.18
2023-01-24,2023-01-24,Invoice payment - Customer_0046,REF33120294,0.0,83.38,35782.56
2023-01-24,2023-01-24,Service payment - Customer_0082,REF37571625,0.0,93.91,35876.47
2023-01-24,2023-01-24,Invoice payment - Customer_0066,REF30499850,0.0,55.48,35931.95
2023-01-24,2023-01-24,Project payment - Customer_0071,REF93830711,0.0,26.67,35958.62
2023-01-24,2023-01-24,Project payment - Customer_0072,REF19890685,0.0,72.28,36030.9
2023-01-24,2023-01-24,Payment from Customer_0033,REF29504554,0.0,36.58,36067.48
2023-01-24,2023-01-24,Payment from Customer_0055,REF28399075,0.0,46.2,36113.68
2023-01-25,2023-01-25,Payment from Customer_0095,REF51731408,0.0,66.2,36179.88
2023-01-25,2023-01-25,Service payment - Customer_0041,REF90272074,0.0,128.05,36307.93
2023-01-25,2023-01-25,Project payment - Customer_0091,REF20540144,0.0,114.17,36422.1
2023-01-25,2023-01-25,Invoice payment - Customer_0044,REF22436814,0.0,31.75,36453.85
2023-01-25,2023-01-25,Project payment - Customer_0074,REF49189218,0.0,39.9,36493.75
2023-01-25,2023-01-25,Service payment - Customer_0017,REF22087446,0.0,42.33,36536.08
2023-01-25,2023-01-25,Project payment - Customer_0047,REF76878841,0.0,94.37,36630.45
2023-01-26,2023-01-26,Invoice payment - Customer_0081,REF53075837,0.0,78.41,36708.86
2023-01-26,2023-01-26,Payment from Customer_0015,REF80594610,0.0,99.21,36808.07
2023-01-26,2023-01-26,Invoice payment - Customer_0093,REF97385588,0.0,79.46,36887.53
2023-01-26,2023-01-26,Service payment - Customer_0044,REF35159700,0.0,28.79,36916.32
2023-01-26,2023-01-26,Payment from Customer_0021,REF18115541,0.0,56.21,36972.53
2023-01-27,2023-01-27,Service payment - Customer_0098,REF47042038,0.0,52.46,37024.99
2023-01-27,2023-01-27,Invoice payment - Customer_0062,REF25287064,0.0,62.52,37087.51
2023-01-27,2023-01-27,Invoice payment - Customer_0075,REF49503169,0.0,79.24,37166.75
2023-01-27,2023-01-27,Invoice payment - Customer_0081,REF29378841,0.0,85.47,37252.22
2023-01-27,2023-01-27,Invoice payment - Customer_0045,REF31523366,0.0,70.43,37322.65
2023-01-28,2023-01-28,Invoice payment - Customer_0064,REF25651951,0.0,35.64,37358.29
2023-01-28,2023-01-28,Payment from Customer_0001,REF19579776,0.0,48.38,37406.67
2023-01-28,2023-01-28,Project payment - Customer_0048,REF53839032,0.0,78.64,37485.31
2023-01-28,2023-01-28,Project payment - Customer_0080,REF53031721,0.0,25.33,37510.64
2023-01-28,2023-01-28,Invoice payment - Customer_0054,REF17160622,0.0,80.56,37591.2
2023-01-28,2023-01-28,Service payment - Customer_0013,REF77251584,0.0,66.87,37658.07
2023-01-28,2023-01-28,Service payment - Customer_0055,REF81207453,0.0,56.13,37714.2
2023-01-28,2023-01-28,Invoice payment - Customer_0042,REF75729158,0.0,75.55,37789.75
2023-01-29,2023-01-29,Service payment - Customer_0088,REF63203628,0.0,90.64,37880.39
2023-01-29,2023-01-29,Invoice payment - Customer_0065,REF20867208,0.0,41.18,37921.57
2023-01-29,2023-01-29,Payment from Customer_0055,REF42230911,0.0,55.09,37976.66
2023-01-29,2023-01-29,Invoice payment - Customer_0037,REF25884160,0.0,98.38,38075.04
2023-01-29,2023-01-29,Invoice payment - Customer_0084,REF23186362,0.0,80.86,38155.9
2023-01-29,2023-01-29,Invoice payment - Customer_0027,REF44292243,0.0,66.72,38222.62
2023-01-29,2023-01-29,Service payment - Customer_0001,REF10311557,0.0,50.49,38273.11
2023-01-29,2023-01-29,Payment from Customer_0083,REF89434873,0.0,66.21,38339.32
2023-01-29,2023-01-29,Project payment - Customer_0003,REF28436137,0.0,39.94,38379.26
2023-01-30,2023-01-30,Project payment - Customer_0044,REF60244340,0.0,24.49,38403.75
2023-01-30,2023-01-30,Payment from Customer_0064,REF14860199,0.0,32.8,38436.55
2023-01-30,2023-01-30,Service payment - Customer_0074,REF38863445,0.0,41.38,38477.93
2023-01-30,2023-01-30,Invoice payment - Customer_0031,REF60767921,0.0,81.21,38559.14
2023-01-30,2023-01-30,Invoice payment - Customer_0051,REF64898885,0.0,61.51,38620.65
2023-01-30,2023-01-30,Payment from Customer_0002,REF15593658,0.0,58.08,38678.73
2023-01-30,2023-01-30,Project payment - Customer_0043,REF41798040,0.0,145.03,38823.76
2023-01-30,2023-01-30,Invoice payment - Customer_0014,REF16098480,0.0,74.35,38898.11
2023-01-30,2023-01-30,Invoice payment - Customer_0091,REF90772996,0.0,140.74,39038.85
2023-01-30,2023-01-30,Service payment - Customer_0045,REF38342343,0.0,84.82,39123.67
2023-01-30,2023-01-30,Payment from Customer_0086,REF29262939,0.0,63.14,39186.81
2023-01-30,2023-01-30,Service payment - Customer_0028,REF24087058,0.0,75.08,39261.89
2023-01-31,2023-01-31,Invoice payment - Customer_0017,REF17195315,0.0,51.95,39313.84
2023-01-31,2023-01-31,Payment from Customer_0021,REF81973782,0.0,54.87,39368.71
2023-01-31,2023-01-31,Service payment - Customer_0096,REF43650306,0.0,60.68,39429.39
2023-01-31,2023-01-31,Invoice payment - Customer_0061,REF41723054,0.0,88.74,39518.13
2023-01-31,2023-01-31,Service payment - Customer_0053,REF37333893,0.0,111.66,39629.79
2023-01-31,2023-01-31,Payment from Customer_0060,REF40052159,0.0,81.63,39711.42
2023-01-31,2023-01-31,Payment from Customer_0088,REF75806269,0.0,94.84,39806.26
2023-01-31,2023-01-31,Payment from Customer_0079,REF64870311,0.0,62.33,39868.59
2023-02-01,2023-02-01,Project payment - Customer_0067,REF63261714,0.0,89.53,39958.12
2023-02-01,2023-02-01,Invoice payment - Customer_0037,REF40026483,0.0,124.27,40082.39
2023-02-01,2023-02-01,Monthly office rent,REF52453027,1058.9,0.0,39023.49
2023-02-01,2023-02-01,Payment from Customer_0055,REF77989132,0.0,58.98,39082.47
2023-02-01,2023-02-01,Service payment - Customer_0027,REF25251100,0.0,71.83,39154.3
2023-02-02,2023-02-02,Payment from Customer_0079,REF58289535,0.0,87.42,39241.72
2023-02-02,2023-02-02,Payment from Customer_0084,REF24537974,0.0,70.4,39312.12
2023-02-02,2023-02-02,Service payment - Customer_0009,REF39135952,0.0,67.38,39379.5
2023-02-02,2023-02-02,Payment from Customer_0066,REF44994807,0.0,58.81,39438.31
2023-02-02,2023-02-02,Payment from Customer_0097,REF96250985,0.0,66.53,39504.84
2023-02-02,2023-02-02,Payment from Customer_0040,REF60673667,0.0,33.82,39538.66
2023-02-02,2023-02-02,Payment from Customer_0099,REF89151739,0.0,40.73,39579.39
2023-02-02,2023-02-02,Project payment - Customer_0047,REF71829793,0.0,89.21,39668.6
2023-02-02,2023-02-02,Payment from Customer_0095,REF22912964,0.0,73.24,39741.84
2023-02-03,2023-02-03,Payment from Customer_0094,REF39836974,0.0,62.35,39804.19
2023-02-03,2023-02-03,Service payment - Customer_0001,REF45968644,0.0,68.49,39872.68
2023-02-03,2023-02-03,Service payment - Customer_0003,REF87273767,0.0,58.63,39931.31
2023-02-03,2023-02-03,Project payment - Customer_0076,REF49608631,0.0,10.0,39941.31
2023-02-03,2023-02-03,Payment from Customer_0031,REF25596638,0.0,69.42,40010.73
2023-02-03,2023-02-03,Service payment - Customer_0028,REF28023310,0.0,83.87,40094.6
2023-02-04,2023-02-04,Invoice payment - Customer_0067,REF27133790,0.0,119.88,40214.48
2023-02-04,2023-02-04,Payment from Customer_0028,REF47579396,0.0,82.92,40297.4
2023-02-04,2023-02-04,Payment from Customer_0002,REF37705088,0.0,80.3,40377.7
2023-02-04,2023-02-04,Project payment - Customer_0033,REF59591073,0.0,72.09,40449.79
2023-02-04,2023-02-04,Invoice payment - Customer_0042,REF56859055,0.0,96.73,40546.52
2023-02-04,2023-02-04,Payment from Customer_0029,REF24095495,0.0,77.84,40624.36
2023-02-05,2023-02-05,Invoice payment - Customer_0010,REF78151854,0.0,69.04,40693.4
2023-02-05,2023-02-05,Project payment - Customer_0017,REF28678801,0.0,88.52,40781.92
2023-02-05,2023-02-05,Invoice payment - Customer_0073,REF42515159,0.0,108.82,40890.74
2023-02-05,2023-02-05,Payment from Customer_0097,REF47701644,0.0,71.59,40962.33
2023-02-05,2023-02-05,Payment from Customer_0041,REF43988967,0.0,118.66,41080.99
2023-02-05,2023-02-05,Project payment - Customer_0083,REF34113129,0.0,61.55,41142.54
2023-02-05,2023-02-05,Invoice payment - Customer_0011,REF12687058,0.0,91.61,41234.15
2023-02-05,2023-02-05,Payment from Customer_0076,REF59018104,0.0,10.0,41244.15
2023-02-05,2023-02-05,Project payment - Customer_0056,REF11619520,0.0,28.64,41272.79
2023-02-05,2023-02-05,Service payment - Customer_0098,REF47878735,0.0,59.7,41332.49
2023-02-05,2023-02-05,Project payment - Customer_0026,REF36534915,0.0,108.93,41441.42
2023-02-05,2023-02-05,Service payment - Customer_0023,REF13214289,0.0,75.76,41517.18
2023-02-06,2023-02-06,Payment from Customer_0074,REF98021106,0.0,51.61,41568.79
2023-02-06,2023-02-06,Invoice payment - Customer_0035,REF83224889,0.0,143.65,41712.44
2023-02-06,2023-02-06,Project payment - Customer_0007,REF40668675,0.0,130.3,41842.74
2023-02-06,2023-02-06,Project payment - Customer_0026,REF33134873,0.0,99.57,41942.31
2023-02-07,2023-02-07,Payment from Customer_0084,REF14190338,0.0,72.95,42015.26
2023-02-07,2023-02-07,Invoice payment - Customer_0029,REF13352099,0.0,47.26,42062.52
2023-02-07,2023-02-07,Service payment - Customer_0097,REF84293562,0.0,61.76,42124.28
2023-02-07,2023-02-07,Project payment - Customer_0054,REF40598015,0.0,72.51,42196.79
2023-02-07,2023-02-07,Service payment - Customer_0053,REF81323823,0.0,98.18,42294.97
2023-02-07,2023-02-07,Payment from Customer_0052,REF17116300,0.0,33.51,42328.48
2023-02-07,2023-02-07,Invoice payment - Customer_0089,REF38743828,0.0,98.49,42426.97
2023-02-07,2023-02-07,Service payment - Customer_0079,REF48200589,0.0,66.99,42493.96
2023-02-07,2023-02-07,Service payment - Customer_0076,REF24307131,0.0,10.0,42503.96
2023-02-07,2023-02-07,Project payment - Customer_0032,REF72713672,0.0,60.08,42564.04
2023-02-08,2023-02-08,Project payment - Customer_0028,REF84999354,0.0,77.89,42641.93
2023-02-08,2023-02-08,Project payment - Customer_0067,REF87477838,0.0,129.53,42771.46
2023-02-08,2023-02-08,Invoice payment - Customer_0070,REF71376135,0.0,46.01,42817.47
2023-02-08,2023-02-08,Payment from Customer_0087,REF76374796,0.0,92.73,42910.2
2023-02-08,2023-02-08,Invoice payment - Customer_0024,REF72859940,0.0,89.1,42999.3
2023-02-09,2023-02-09,Project payment - Customer_0021,REF92610747,0.0,67.72,43067.02
2023-02-09,2023-02-09,Payment from Customer_0067,REF52364530,0.0,75.05,43142.07
2023-02-09,2023-02-09,Payment from Customer_0016,REF19211394,0.0,35.02,43177.09
2023-02-09,2023-02-09,Project payment - Customer_0013,REF37705718,0.0,77.62,43254.71
2023-02-09,2023-02-09,Payment from Customer_0093,REF90800722,0.0,97.48,43352.19
2023-02-09,2023-02-09,Invoice payment - Customer_0049,REF35493684,0.0,75.69,43427.88
2023-02-09,2023-02-09,Service payment - Customer_0090,REF21945892,0.0,76.8,43504.68
2023-02-09,2023-02-09,Project payment - Customer_0023,REF74117477,0.0,93.47,43598.15
2023-02-09,2023-02-09,Project payment - Customer_0035,REF74333158,0.0,122.84,43720.99
2023-02-09,2023-02-09,Pos Systems expense,REF16836661,59.1,0.0,43661.89
2023-02-10,2023-02-10,Invoice payment - Customer_0091,REF13259699,0.0,135.46,43797.35
2023-02-10,2023-02-10,Service payment - Customer_0050,REF88982273,0.0,105.68,43903.03
2023-02-10,2023-02-10,Invoice payment - Customer_0088,REF12632217,0.0,128.77,44031.8
2023-02-10,2023-02-10,Invoice payment - Customer_0098,REF40834002,0.0,68.41,44100.21
2023-02-10,2023-02-10,Service payment - Customer_0013,REF85550754,0.0,78.34,44178.55
2023-02-10,2023-02-10,Project payment - Customer_0070,REF80690704,0.0,52.74,44231.29
2023-02-10,2023-02-10,Payment from Customer_0019,REF79709796,0.0,68.73,44300.02
2023-02-10,2023-02-10,Service payment - Customer_0076,REF22947263,0.0,10.0,44310.02
2023-02-10,2023-02-10,Service payment - Customer_0065,REF34582804,0.0,60.09,44370.11
2023-02-11,2023-02-11,Service payment - Customer_0067,REF36117016,0.0,124.98,44495.09
2023-02-11,2023-02-11,Service payment - Customer_0096,REF82492545,0.0,85.56,44580.65
2023-02-11,2023-02-11,Invoice payment - Customer_0000,REF55510449,0.0,33.36,44614.01
2023-02-11,2023-02-11,Service payment - Customer_0077,REF88573579,0.0,81.34,44695.35
2023-02-11,2023-02-11,Invoice payment - Customer_0072,REF73369706,0.0,103.81,44799.16
2023-02-11,2023-02-11,Service payment - Customer_0003,REF10418137,0.0,71.45,44870.61
2023-02-11,2023-02-11,Service payment - Customer_0061,REF32200422,0.0,108.55,44979.16
2023-02-11,2023-02-11,Payment from Customer_0064,REF31446451,0.0,34.04,45013.2
2023-02-11,2023-02-11,Payment from Customer_0007,REF52916802,0.0,157.36,45170.56
2023-02-11,2023-02-11,Invoice payment - Customer_0053,REF42777330,0.0,133.31,45303.87
2023-02-11,2023-02-11,Payment from Customer_0088,REF97642885,0.0,126.5,45430.37
2023-02-11,2023-02-11,Project payment - Customer_0074,REF89903060,0.0,53.0,45483.37
2023-02-12,2023-02-12,Invoice payment - Customer_0094,REF93015069,0.0,72.18,45555.55
2023-02-12,2023-02-12,Payment from Customer_0018,REF30038642,0.0,72.52,45628.07
2023-02-12,2023-02-12,Payment from Customer_0041,REF76793448,0.0,115.23,45743.3
2023-02-12,2023-02-12,Invoice payment - Customer_0077,REF45944325,0.0,74.59,45817.89
2023-02-12,2023-02-12,Project payment - Customer_0011,REF59055389,0.0,94.18,45912.07
2023-02-12,2023-02-12,Invoice payment - Customer_0088,REF64515499,0.0,138.06,46050.13
2023-02-12,2023-02-12,Service payment - Customer_0024,REF85399759,0.0,88.12,46138.25
2023-02-12,2023-02-12,Payment from Customer_0035,REF62894364,0.0,115.57,46253.82
2023-02-13,2023-02-13,Service payment - Customer_0089,REF84379587,0.0,124.57,46378.39
2023-02-13,2023-02-13,Payment from Customer_0027,REF28944983,0.0,80.51,46458.9
2023-02-13,2023-02-13,Payment from Customer_0043,REF11992740,0.0,113.1,46572.0
2023-02-13,2023-02-13,Service payment - Customer_0051,REF74418191,0.0,82.22,46654.22
2023-02-13,2023-02-13,Inventory purchase,REF31288733,3390.31,0.0,43263.91
2023-02-13,2023-02-13,Service payment - Customer_0035,REF27717864,0.0,117.41,43381.32
2023-02-13,2023-02-13,Payment from Customer_0052,REF89227472,0.0,45.59,43426.91
2023-02-14,2023-02-14,Invoice payment - Customer_0041,REF21570393,0.0,111.26,43538.17
2023-02-14,2023-02-14,Payment from Customer_0099,REF53562474,0.0,46.72,43584.89
2023-02-14,2023-02-14,Invoice payment - Customer_0089,REF66084744,0.0,129.26,43714.15
2023-02-14,2023-02-14,Invoice payment - Customer_0021,REF80964694,0.0,51.51,43765.66
2023-02-14,2023-02-14,Service payment - Customer_0073,REF43129769,0.0,141.86,43907.52
2023-02-14,2023-02-14,Payment from Customer_0042,REF53085510,0.0,91.31,43998.83
2023-02-14,2023-02-14,Service payment - Customer_0003,REF98635043,0.0,62.75,44061.58
2023-02-14,2023-02-14,Project payment - Customer_0029,REF89973285,0.0,87.99,44149.57
2023-02-14,2023-02-14,Service payment - Customer_0064,REF49464730,0.0,37.19,44186.76
2023-02-14,2023-02-14,Invoice payment - Customer_0053,REF18621239,0.0,113.04,44299.8
2023-02-14,2023-02-14,Employee payroll,REF75804702,1940.96,0.0,42358.84
2023-02-14,2023-02-14,Invoice payment - Customer_0096,REF57589801,0.0,82.65,42441.49
2023-02-15,2023-02-15,Payment from Customer_0093,REF97050420,0.0,94.51,42536.0
2023-02-15,2023-02-15,Service payment - Customer_0065,REF84958297,0.0,49.52,42585.52
2023-02-15,2023-02-15,Invoice payment - Customer_0095,REF76553476,0.0,76.78,42662.3
2023-02-15,2023-02-15,Payment from Customer_0099,REF26195151,0.0,42.64,42704.94
2023-02-15,2023-02-15,Invoice payment - Customer_0081,REF84927913,0.0,88.24,42793.18
2023-02-15,2023-02-15,Business insurance premium,REF23171242,176.18,0.0,42617.0
2023-02-15,2023-02-15,Project payment - Customer_0022,REF60784835,0.0,55.89,42672.89
2023-02-15,2023-02-15,Service payment - Customer_0001,REF19971232,0.0,58.47,42731.36
2023-02-15,2023-02-15,Invoice payment - Customer_0044,REF75061336,0.0,35.93,42767.29
2023-02-15,2023-02-15,Invoice payment - Customer_0084,REF78001912,0.0,63.21,42830.5
2023-02-15,2023-02-15,Service payment - Customer_0032,REF16699957,0.0,53.78,42884.28
2023-02-15,2023-02-15,Service payment - Customer_0041,REF23723412,0.0,83.63,42967.91
2023-02-15,2023-02-15,Service payment - Customer_0064,REF13014529,0.0,42.13,43010.04
2023-02-16,2023-02-16,Project payment - Customer_0024,REF50703938,0.0,86.34,43096.38
2023-02-16,2023-02-16,Service payment - Customer_0011,REF48740232,0.0,90.88,43187.26
2023-02-16,2023-02-16,Invoice payment - Customer_0094,REF40294442,0.0,54.35,43241.61
2023-02-16,2023-02-16,Project payment - Customer_0055,REF30040440,0.0,63.96,43305.57
2023-02-16,2023-02-16,Project payment - Customer_0072,REF81211644,0.0,107.28,43412.85
2023-02-16,2023-02-16,Project payment - Customer_0007,REF84073479,0.0,152.68,43565.53
2023-02-16,2023-02-16,Service payment - Customer_0061,REF26254540,0.0,146.23,43711.76
2023-02-17,2023-02-17,Payment from Customer_0011,REF63627392,0.0,100.44,43812.2
2023-02-17,2023-02-17,Payment from Customer_0056,REF32546401,0.0,37.0,43849.2
2023-02-17,2023-02-17,Project payment - Customer_0035,REF45556402,0.0,110.9,43960.1
2023-02-17,2023-02-17,Payment from Customer_0080,REF21363769,0.0,36.2,43996.3
2023-02-17,2023-02-17,Payment from Customer_0015,REF33910493,0.0,105.21,44101.51
2023-02-17,2023-02-17,Service payment - Customer_0000,REF30213968,0.0,45.6,44147.11
2023-02-17,2023-02-17,Project payment - Customer_0062,REF68184260,0.0,59.84,44206.95
2023-02-17,2023-02-17,Project payment - Customer_0060,REF28451039,0.0,78.38,44285.33
2023-02-17,2023-02-17,Invoice payment - Customer_0032,REF43884839,0.0,69.99,44355.32
2023-02-18,2023-02-18,Project payment - Customer_0001,REF72946015,0.0,72.78,44428.1
2023-02-18,2023-02-18,Invoice payment - Customer_0096,REF23699573,0.0,67.51,44495.61
2023-02-18,2023-02-18,Payment from Customer_0078,REF25313543,0.0,119.42,44615.03
2023-02-18,2023-02-18,Invoice payment - Customer_0002,REF87372494,0.0,42.61,44657.64
2023-02-18,2023-02-18,Service payment - Customer_0081,REF63429431,0.0,101.71,44759.35
2023-02-18,2023-02-18,Invoice payment - Customer_0018,REF98272926,0.0,64.18,44823.53
2023-02-18,2023-02-18,Service payment - Customer_0091,REF79773975,0.0,108.37,44931.9
2023-02-18,2023-02-18,Invoice payment - Customer_0082,REF80267957,0.0,100.38,45032.28
2023-02-18,2023-02-18,Service payment - Customer_0009,REF49901144,0.0,63.05,45095.33
2023-02-19,2023-02-19,Payment from Customer_0043,REF36463142,0.0,117.29,45212.62
2023-02-19,2023-02-19,Service payment - Customer_0099,REF50716580,0.0,39.75,45252.37
2023-02-19,2023-02-19,Invoice payment - Customer_0073,REF15843559,0.0,115.91,45368.28
2023-02-19,2023-02-19,Invoice payment - Customer_0075,REF94215035,0.0,131.93,45500.21
2023-02-19,2023-02-19,Payment from Customer_0086,REF39973503,0.0,68.46,45568.67
2023-02-19,2023-02-19,Payment from Customer_0007,REF26577722,0.0,134.17,45702.84
2023-02-19,2023-02-19,Invoice payment - Customer_0024,REF63726634,0.0,75.23,45778.07
2023-02-20,2023-02-20,Payment from Customer_0042,REF22626041,0.0,90.54,45868.61
2023-02-20,2023-02-20,Payment from Customer_0063,REF56769803,0.0,60.31,45928.92
2023-02-20,2023-02-20,Payment from Customer_0007,REF86953618,0.0,114.99,46043.91
2023-02-20,2023-02-20,Employee payroll,REF46838356,2085.04,0.0,43958.87
2023-02-20,2023-02-20,Service payment - Customer_0047,REF12543717,0.0,87.82,44046.69
2023-02-20,2023-02-20,Invoice payment - Customer_0026,REF16806836,0.0,101.05,44147.74
2023-02-20,2023-02-20,Payment from Customer_0089,REF15941472,0.0,137.01,44284.75
2023-02-20,2023-02-20,Payment from Customer_0052,REF23390924,0.0,38.84,44323.59
2023-02-20,2023-02-20,Service payment - Customer_0055,REF26467062,0.0,40.72,44364.31
2023-02-20,2023-02-20,Invoice payment - Customer_0020,REF75218535,0.0,149.47,44513.78
2023-02-21,2023-02-21,Invoice payment - Customer_0050,REF96800894,0.0,150.79,44664.57
2023-02-21,2023-02-21,Project payment - Customer_0010,REF53136454,0.0,91.95,44756.52
2023-02-21,2023-02-21,Project payment - Customer_0015,REF12454098,0.0,133.44,44889.96
2023-02-21,2023-02-21,Payment from Customer_0004,REF17996803,0.0,48.44,44938.4
2023-02-21,2023-02-21,Payment from Customer_0062,REF75348610,0.0,57.83,44996.23
2023-02-21,2023-02-21,Invoice payment - Customer_0046,REF14106961,0.0,104.88,45101.11
2023-02-21,2023-02-21,Project payment - Customer_0013,REF81499230,0.0,46.38,45147.49
2023-02-21,2023-02-21,Payment from Customer_0095,REF13246270,0.0,83.07,45230.56
2023-02-21,2023-02-21,Payment from Customer_0052,REF86229158,0.0,32.08,45262.64
2023-02-22,2023-02-22,Utility bill payment,REF58081924,131.99,0.0,45130.65
2023-02-22,2023-02-22,Service payment - Customer_0054,REF14580578,0.0,70.88,45201.53
2023-02-22,2023-02-22,Payment from Customer_0017,REF65690386,0.0,57.06,45258.59
2023-02-22,2023-02-22,Project payment - Customer_0075,REF31416246,0.0,93.82,45352.41
2023-02-22,2023-02-22,Invoice payment - Customer_0089,REF38062265,0.0,110.19,45462.6
2023-02-22,2023-02-22,Service payment - Customer_0093,REF31430002,0.0,124.98,45587.58
2023-02-22,2023-02-22,Service payment - Customer_0038,REF63504816,0.0,55.15,45642.73
2023-02-22,2023-02-22,Payment from Customer_0052,REF73544968,0.0,36.33,45679.06
2023-02-22,2023-02-22,Payment from Customer_0045,REF71702169,0.0,105.2,45784.26
2023-02-22,2023-02-22,Service payment - Customer_0012,REF55356502,0.0,57.0,45841.26
2023-02-22,2023-02-22,Invoice payment - Customer_0003,REF67536347,0.0,65.25,45906.51
2023-02-22,2023-02-22,Service payment - Customer_0004,REF68787461,0.0,56.35,45962.86
2023-02-22,2023-02-22,Project payment - Customer_0095,REF56940178,0.0,54.14,46017.0
2023-02-22,2023-02-22,Invoice payment - Customer_0081,REF97966143,0.0,73.64,46090.64
2023-02-22,2023-02-22,Project payment - Customer_0030,REF78501975,0.0,40.25,46130.89
2023-02-22,2023-02-22,Payment from Customer_0055,REF15940653,0.0,66.26,46197.15
2023-02-23,2023-02-23,Project payment - Customer_0000,REF85100234,0.0,37.71,46234.86
2023-02-23,2023-02-23,Service payment - Customer_0060,REF83533489,0.0,56.77,46291.63
2023-02-23,2023-02-23,Invoice payment - Customer_0075,REF13784902,0.0,114.94,46406.57
2023-02-23,2023-02-23,Invoice payment - Customer_0080,REF61663121,0.0,35.51,46442.08
2023-02-23,2023-02-23,Payment from Customer_0094,REF66684030,0.0,68.78,46510.86
2023-02-23,2023-02-23,Invoice payment - Customer_0038,REF63202921,0.0,56.95,46567.81
2023-02-23,2023-02-23,Project payment - Customer_0079,REF10073961,0.0,69.23,46637.04
2023-02-23,2023-02-23,Invoice payment - Customer_0083,REF53342698,0.0,59.95,46696.99
2023-02-23,2023-02-23,Invoice payment - Customer_0069,REF58878229,0.0,62.39,46759.38
2023-02-23,2023-02-23,Invoice payment - Customer_0034,REF25887308,0.0,79.36,46838.74
2023-02-23,2023-02-23,Invoice payment - Customer_0084,REF93940093,0.0,46.5,46885.24
2023-02-23,2023-02-23,Service payment - Customer_0032,REF25481906,0.0,66.07,46951.31
2023-02-23,2023-02-23,Project payment - Customer_0054,REF61579688,0.0,69.95,47021.26
2023-02-23,2023-02-23,Service payment - Customer_0061,REF24006167,0.0,113.41,47134.67
2023-02-23,2023-02-23,Payment from Customer_0010,REF79212493,0.0,54.43,47189.1
2023-02-23,2023-02-23,Invoice payment - Customer_0035,REF94863531,0.0,120.15,47309.25
2023-02-24,2023-02-24,Invoice payment - Customer_0081,REF24516540,0.0,81.25,47390.5
2023-02-24,2023-02-24,Invoice payment - Customer_0026,REF28949538,0.0,87.82,47478.32
2023-02-24,2023-02-24,Payment from Customer_0063,REF95765444,0.0,53.06,47531.38
2023-02-24,2023-02-24,Invoice payment - Customer_0056,REF45127700,0.0,24.57,47555.95
2023-02-24,2023-02-24,Project payment - Customer_0043,REF86749330,0.0,102.19,47658.14
2023-02-24,2023-02-24,Service payment - Customer_0099,REF36098755,0.0,47.55,47705.69
2023-02-24,2023-02-24,Project payment - Customer_0048,REF96218897,0.0,106.47,47812.16
2023-02-25,2023-02-25,Service payment - Customer_0041,REF54420959,0.0,107.14,47919.3
2023-02-25,2023-02-25,Payment from Customer_0049,REF67871298,0.0,79.72,47999.02
2023-02-25,2023-02-25,Payment from Customer_0071,REF22886360,0.0,48.26,48047.28
2023-02-25,2023-02-25,Payment from Customer_0046,REF22143054,0.0,132.61,48179.89
2023-02-25,2023-02-25,Payment from Customer_0043,REF51492343,0.0,94.99,48274.88
2023-02-25,2023-02-25,Project payment - Customer_0060,REF63826393,0.0,68.02,48342.9
2023-02-26,2023-02-26,Service payment - Customer_0025,REF70991942,0.0,108.51,48451.41
2023-02-26,2023-02-26,Payment from Customer_0066,REF90588305,0.0,57.74,48509.15
2023-02-26,2023-02-26,Project payment - Customer_0036,REF35810527,0.0,46.43,48555.58
2023-02-26,2023-02-26,Service payment - Customer_0003,REF16733146,0.0,66.89,48622.47
2023-02-26,2023-02-26,Marketing expenses,REF87722026,275.29,0.0,48347.18
2023-02-26,2023-02-26,Service payment - Customer_0032,REF14963616,0.0,79.57,48426.75
2023-02-26,2023-02-26,Invoice payment - Customer_0092,REF30585573,0.0,61.71,48488.46
2023-02-26,2023-02-26,Project payment - Customer_0096,REF52417846,0.0,65.52,48553.98
2023-02-26,2023-02-26,Project payment - Customer_0013,REF66842034,0.0,51.2,48605.18
2023-02-27,2023-02-27,Service payment - Customer_0043,REF58616078,0.0,125.18,48730.36
2023-02-27,2023-02-27,Invoice payment - Customer_0096,REF50621051,0.0,84.33,48814.69
2023-02-27,2023-02-27,Payment from Customer_0008,REF25266894,0.0,84.91,48899.6
2023-02-27,2023-02-27,Invoice payment - Customer_0097,REF15917699,0.0,50.53,48950.13
2023-02-27,2023-02-27,Project payment - Customer_0099,REF10179695,0.0,32.18,48982.31
2023-02-27,2023-02-27,Project payment - Customer_0020,REF38313291,0.0,124.76,49107.07
2023-02-28,2023-02-28,Invoice payment - Customer_0026,REF49961959,0.0,103.83,49210.9
2023-02-28,2023-02-28,Invoice payment - Customer_0040,REF73198641,0.0,26.46,49237.36
2023-02-28,2023-02-28,Payment from Customer_0074,REF35396209,0.0,38.29,49275.65
2023-02-28,2023-02-28,Service payment - Customer_0075,REF97626102,0.0,117.69,49393.34
2023-02-28,2023-02-28,Payment from Customer_0059,REF11315173,0.0,50.14,49443.48
2023-02-28,2023-02-28,Service payment - Customer_0088,REF56453949,0.0,100.31,49543.79
2023-02-28,2023-02-28,Invoice payment - Customer_0048,REF73418946,0.0,100.08,49643.87
2023-02-28,2023-02-28,Project payment - Customer_0084,REF25451508,0.0,67.54,49711.41
2023-02-28,2023-02-28,Invoice payment - Customer_0038,REF86143685,0.0,48.25,49759.66
2023-02-28,2023-02-28,Service payment - Customer_0039,REF88534868,0.0,109.27,49868.93
2023-02-28,2023-02-28,Invoice payment - Customer_0043,REF35520627,0.0,99.58,49968.51
2023-03-01,2023-03-01,Monthly office rent,REF13364305,1080.5,0.0,48888.01
2023-03-01,2023-03-01,Service payment - Customer_0007,REF66074414,0.0,120.45,49008.46
2023-03-01,2023-03-01,Payment from Customer_0003,REF40493408,0.0,70.55,49079.01
2023-03-01,2023-03-01,Invoice payment - Customer_0057,REF80593256,0.0,108.26,49187.27
2023-03-01,2023-03-01,Project payment - Customer_0094,REF85316434,0.0,72.94,49260.21
2023-03-02,2023-03-02,Payment from Customer_0095,REF83063472,0.0,60.9,49321.11
2023-03-02,2023-03-02,Project payment - Customer_0027,REF56962594,0.0,91.76,49412.87
2023-03-02,2023-03-02,Invoice payment - Customer_0057,REF79820122,0.0,123.53,49536.4
2023-03-02,2023-03-02,Project payment - Customer_0045,REF19151210,0.0,75.8,49612.2
2023-03-02,2023-03-02,Payment from Customer_0084,REF88371381,0.0,61.41,49673.61
2023-03-02,2023-03-02,Project payment - Customer_0020,REF53159482,0.0,100.16,49773.77
2023-03-03,2023-03-03,Project payment - Customer_0098,REF87354598,0.0,66.01,49839.78
2023-03-03,2023-03-03,Service payment - Customer_0028,REF16933997,0.0,83.22,49923.0
2023-03-03,2023-03-03,Service payment - Customer_0043,REF31358424,0.0,100.84,50023.84
2023-03-03,2023-03-03,Payment from Customer_0057,REF68464934,0.0,93.31,50117.15
2023-03-03,2023-03-03,Payment from Customer_0078,REF70596382,0.0,118.39,50235.54
2023-03-03,2023-03-03,Project payment - Customer_0067,REF81002256,0.0,142.02,50377.56
2023-03-03,2023-03-03,Service payment - Customer_0003,REF20675063,0.0,88.07,50465.63
2023-03-03,2023-03-03,Payment from Customer_0081,REF37348625,0.0,100.56,50566.19
2023-03-03,2023-03-03,Invoice payment - Customer_0064,REF23211471,0.0,47.83,50614.02
2023-03-03,2023-03-03,Project payment - Customer_0076,REF86109412,0.0,11.93,50625.95
2023-03-04,2023-03-04,Service payment - Customer_0096,REF47589079,0.0,118.71,50744.66
2023-03-04,2023-03-04,Payment from Customer_0073,REF88788137,0.0,104.62,50849.28
2023-03-04,2023-03-04,Service payment - Customer_0052,REF82503710,0.0,43.47,50892.75
2023-03-04,2023-03-04,Service payment - Customer_0071,REF83295786,0.0,54.18,50946.93
2023-03-04,2023-03-04,Invoice payment - Customer_0047,REF43065452,0.0,122.63,51069.56
2023-03-04,2023-03-04,Payment from Customer_0004,REF70029769,0.0,53.78,51123.34
2023-03-04,2023-03-04,Payment from Customer_0034,REF34184724,0.0,66.9,51190.24
2023-03-04,2023-03-04,Invoice payment - Customer_0054,REF41359148,0.0,74.45,51264.69
2023-03-04,2023-03-04,Project payment - Customer_0017,REF38593101,0.0,81.96,51346.65
2023-03-04,2023-03-04,Project payment - Customer_0062,REF42552900,0.0,64.89,51411.54
2023-03-04,2023-03-04,Invoice payment - Customer_0070,REF72927144,0.0,55.2,51466.74
2023-03-04,2023-03-04,Invoice payment - Customer_0003,REF25360657,0.0,83.52,51550.26
2023-03-04,2023-03-04,Invoice payment - Customer_0098,REF89030119,0.0,78.4,51628.66
2023-03-04,2023-03-04,Invoice payment - Customer_0072,REF86757921,0.0,138.61,51767.27
2023-03-04,2023-03-04,Service payment - Customer_0094,REF46999830,0.0,74.82,51842.09
2023-03-05,2023-03-05,Project payment - Customer_0059,REF98180647,0.0,68.81,51910.9
2023-03-05,2023-03-05,Invoice payment - Customer_0052,REF18553199,0.0,57.17,51968.07
2023-03-05,2023-03-05,Payment from Customer_0015,REF83683856,0.0,100.78,52068.85
2023-03-05,2023-03-05,Service payment - Customer_0012,REF68481429,0.0,62.95,52131.8
2023-03-05,2023-03-05,Project payment - Customer_0076,REF72740254,0.0,10.26,52142.06
2023-03-05,2023-03-05,Project payment - Customer_0043,REF18488109,0.0,115.03,52257.09
2023-03-05,2023-03-05,Payment from Customer_0003,REF15757281,0.0,76.16,52333.25
2023-03-05,2023-03-05,Project payment - Customer_0098,REF43709832,0.0,87.81,52421.06
2023-03-05,2023-03-05,Invoice payment - Customer_0049,REF83329534,0.0,71.82,52492.88
2023-03-06,2023-03-06,Invoice payment - Customer_0002,REF20447486,0.0,88.28,52581.16
2023-03-06,2023-03-06,Service payment - Customer_0005,REF99226647,0.0,17.1,52598.26
2023-03-06,2023-03-06,Invoice payment - Customer_0029,REF33000081,0.0,54.64,52652.9
2023-03-06,2023-03-06,Invoice payment - Customer_0096,REF93987155,0.0,93.86,52746.76
2023-03-06,2023-03-06,Payment from Customer_0043,REF80225852,0.0,147.23,52893.99
2023-03-06,2023-03-06,Project payment - Customer_0080,REF24553963,0.0,31.74,52925.73
2023-03-06,2023-03-06,Invoice payment - Customer_0071,REF64082362,0.0,57.89,52983.62
2023-03-06,2023-03-06,Project payment - Customer_0085,REF12922802,0.0,130.31,53113.93
2023-03-06,2023-03-06,Invoice payment - Customer_0090,REF47265438,0.0,83.55,53197.48
2023-03-06,2023-03-06,Invoice payment - Customer_0000,REF69105187,0.0,45.48,53242.96
2023-03-07,2023-03-07,Service payment - Customer_0068,REF96753145,0.0,37.45,53280.41
2023-03-07,2023-03-07,Invoice payment - Customer_0091,REF16981237,0.0,143.37,53423.78
2023-03-07,2023-03-07,Invoice payment - Customer_0027,REF45515672,0.0,88.06,53511.84
2023-03-07,2023-03-07,Service payment - Customer_0040,REF17751044,0.0,35.18,53547.02
2023-03-07,2023-03-07,Payment from Customer_0029,REF39276544,0.0,101.13,53648.15
2023-03-07,2023-03-07,Invoice payment - Customer_0088,REF19444745,0.0,153.76,53801.91
2023-03-07,2023-03-07,Payment from Customer_0016,REF28959986,0.0,33.44,53835.35
2023-03-08,2023-03-08,Project payment - Customer_0021,REF83890789,0.0,68.97,53904.32
2023-03-08,2023-03-08,Inventory purchase,REF96619442,4214.19,0.0,49690.13
2023-03-08,2023-03-08,Service payment - Customer_0009,REF75917238,0.0,71.93,49762.06
2023-03-08,2023-03-08,Payment from Customer_0020,REF63398654,0.0,103.94,49866.0
2023-03-08,2023-03-08,Project payment - Customer_0067,REF45288048,0.0,136.22,50002.22
2023-03-08,2023-03-08,Project payment - Customer_0091,REF58721261,0.0,166.39,50168.61
2023-03-08,2023-03-08,Invoice payment - Customer_0068,REF30987954,0.0,47.09,50215.7
2023-03-08,2023-03-08,Service payment - Customer_0098,REF11663579,0.0,92.9,50308.6
2023-03-08,2023-03-08,Project payment - Customer_0073,REF60234575,0.0,145.19,50453.79
2023-03-08,2023-03-08,Payment from Customer_0034,REF10226593,0.0,91.21,50545.0
2023-03-08,2023-03-08,Service payment - Customer_0017,REF99367895,0.0,61.53,50606.53
2023-03-08,2023-03-08,Invoice payment - Customer_0042,REF54075281,0.0,115.11,50721.64
2023-03-08,2023-03-08,Service payment - Customer_0002,REF61363413,0.0,77.64,50799.28
2023-03-08,2023-03-08,Invoice payment - Customer_0043,REF85169815,0.0,130.79,50930.07
2023-03-08,2023-03-08,Service payment - Customer_0025,REF83575876,0.0,123.9,51053.97
2023-03-09,2023-03-09,Project payment - Customer_0024,REF65716237,0.0,84.1,51138.07
2023-03-09,2023-03-09,Payment from Customer_0067,REF38080334,0.0,90.28,51228.35
2023-03-09,2023-03-09,Invoice payment - Customer_0066,REF52536698,0.0,56.06,51284.41
2023-03-09,2023-03-09,Invoice payment - Customer_0068,REF24872475,0.0,41.0,51325.41
2023-03-09,2023-03-09,Service payment - Customer_0033,REF30201731,0.0,58.75,51384.16
2023-03-10,2023-03-10,Service payment - Customer_0099,REF90188608,0.0,56.53,51440.69
2023-03-10,2023-03-10,Service payment - Customer_0046,REF71927868,0.0,158.08,51598.77
2023-03-10,2023-03-10,Project payment - Customer_0062,REF68810145,0.0,72.88,51671.65
2023-03-10,2023-03-10,Project payment - Customer_0063,REF19852052,0.0,73.88,51745.53
2023-03-10,2023-03-10,Payment from Customer_0082,REF74727902,0.0,110.75,51856.28
2023-03-10,2023-03-10,Payment from Customer_0023,REF82388767,0.0,102.68,51958.96
2023-03-10,2023-03-10,Project payment - Customer_0009,REF51447280,0.0,67.83,52026.79
2023-03-10,2023-03-10,Invoice payment - Customer_0032,REF76654485,0.0,81.01,52107.8
2023-03-10,2023-03-10,Invoice payment - Customer_0045,REF66742499,0.0,77.88,52185.68
2023-03-10,2023-03-10,Payment from Customer_0098,REF16594452,0.0,79.9,52265.58
2023-03-10,2023-03-10,Payment from Customer_0072,REF67574310,0.0,116.47,52382.05
2023-03-11,2023-03-11,Project payment - Customer_0042,REF76871000,0.0,109.21,52491.26
2023-03-11,2023-03-11,Invoice payment - Customer_0026,REF37747634,0.0,137.72,52628.98
2023-03-11,2023-03-11,Project payment - Customer_0092,REF27612010,0.0,65.5,52694.48
2023-03-11,2023-03-11,Invoice payment - Customer_0099,REF90449621,0.0,37.18,52731.66
2023-03-11,2023-03-11,Marketing expenses,REF59844976,232.29,0.0,52499.37
2023-03-11,2023-03-11,Payment from Customer_0044,REF46897158,0.0,34.16,52533.53
2023-03-11,2023-03-11,Project payment - Customer_0059,REF18762012,0.0,76.65,52610.18
2023-03-11,2023-03-11,Invoice payment - Customer_0076,REF12227960,0.0,10.0,52620.18
2023-03-12,2023-03-12,Project payment - Customer_0027,REF69707520,0.0,95.63,52715.81
2023-03-12,2023-03-12,Project payment - Customer_0057,REF48373380,0.0,112.27,52828.08
2023-03-12,2023-03-12,Payment from Customer_0039,REF43684269,0.0,145.64,52973.72
2023-03-12,2023-03-12,Service payment - Customer_0098,REF72098441,0.0,65.84,53039.56
2023-03-12,2023-03-12,Invoice payment - Customer_0020,REF61268711,0.0,118.27,53157.83
2023-03-12,2023-03-12,Invoice payment - Customer_0044,REF19626197,0.0,35.47,53193.3
2023-03-12,2023-03-12,Service payment - Customer_0047,REF30498021,0.0,117.27,53310.57
2023-03-12,2023-03-12,Project payment - Customer_0083,REF11756181,0.0,59.01,53369.58
2023-03-12,2023-03-12,Inventory purchase,REF89669603,2981.73,0.0,50387.85
2023-03-13,2023-03-13,Payment from Customer_0040,REF83548343,0.0,32.75,50420.6
2023-03-13,2023-03-13,Project payment - Customer_0090,REF99410886,0.0,67.97,50488.57
2023-03-13,2023-03-13,Project payment - Customer_0067,REF38364024,0.0,141.67,50630.24
2023-03-13,2023-03-13,Invoice payment - Customer_0019,REF22958725,0.0,94.56,50724.8
2023-03-13,2023-03-13,Invoice payment - Customer_0078,REF81327643,0.0,137.24,50862.04
2023-03-13,2023-03-13,Invoice payment - Customer_0030,REF70531703,0.0,33.59,50895.63
2023-03-13,2023-03-13,Invoice payment - Customer_0027,REF44514969,0.0,79.18,50974.81
2023-03-13,2023-03-13,Project payment - Customer_0002,REF10805924,0.0,107.58,51082.39
2023-03-13,2023-03-13,Service payment - Customer_0014,REF82552518,0.0,91.52,51173.91
2023-03-13,2023-03-13,Project payment - Customer_0034,REF75049023,0.0,93.22,51267.13
2023-03-13,2023-03-13,Invoice payment - Customer_0021,REF86741977,0.0,56.12,51323.25
2023-03-13,2023-03-13,Project payment - Customer_0006,REF67455053,0.0,81.34,51404.59
2023-03-14,2023-03-14,Service payment - Customer_0007,REF53927720,0.0,136.45,51541.04
2023-03-14,2023-03-14,Invoice payment - Customer_0068,REF52695000,0.0,56.51,51597.55
2023-03-14,2023-03-14,Marketing expenses,REF78808125,342.48,0.0,51255.07
2023-03-14,2023-03-14,Payment from Customer_0003,REF29347956,0.0,82.53,51337.6
2023-03-14,2023-03-14,Service payment - Customer_0000,REF15654823,0.0,28.56,51366.16
2023-03-14,2023-03-14,Payment from Customer_0027,REF85189048,0.0,74.91,51441.07
2023-03-14,2023-03-14,Payment from Customer_0082,REF94741110,0.0,128.33,51569.4
2023-03-14,2023-03-14,Payment from Customer_0071,REF24422817,0.0,37.54,51606.94
2023-03-14,2023-03-14,Service payment - Customer_0097,REF84338031,0.0,71.01,51677.95
2023-03-14,2023-03-14,Project payment - Customer_0041,REF18895093,0.0,99.53,51777.48
2023-03-14,2023-03-14,Service payment - Customer_0018,REF62493054,0.0,58.62,51836.1
2023-03-14,2023-03-14,Service payment - Customer_0096,REF69838986,0.0,98.22,51934.32
2023-03-15,2023-03-15,Service payment - Customer_0057,REF97281745,0.0,111.09,52045.41
2023-03-15,2023-03-15,Service payment - Customer_0008,REF34987004,0.0,100.05,52145.46
2023-03-15,2023-03-15,Service payment - Customer_0067,REF19493018,0.0,155.67,52301.13
2023-03-15,2023-03-15,Service payment - Customer_0077,REF11460032,0.0,97.61,52398.74
2023-03-15,2023-03-15,Business insurance premium,REF37788978,179.1,0.0,52219.64
2023-03-15,2023-03-15,Payment from Customer_0062,REF96119354,0.0,61.38,52281.02
2023-03-15,2023-03-15,Invoice payment - Customer_0045,REF91194652,0.0,89.23,52370.25
2023-03-15,2023-03-15,Payment from Customer_0091,REF98082734,0.0,162.79,52533.04
2023-03-15,2023-03-15,Invoice payment - Customer_0005,REF47303005,0.0,31.86,52564.9
2023-03-15,2023-03-15,Invoice payment - Customer_0028,REF14782646,0.0,81.59,52646.49
2023-03-15,2023-03-15,Service payment - Customer_0056,REF47759102,0.0,27.75,52674.24
2023-03-16,2023-03-16,Service payment - Customer_0096,REF58245006,0.0,100.01,52774.25
2023-03-16,2023-03-16,Project payment - Customer_0094,REF28238587,0.0,52.6,52826.85
2023-03-16,2023-03-16,Payment from Customer_0077,REF35273696,0.0,92.35,52919.2
2023-03-16,2023-03-16,Invoice payment - Customer_0040,REF31279655,0.0,42.74,52961.94
2023-03-16,2023-03-16,Payment from Customer_0097,REF90389856,0.0,61.78,53023.72
2023-03-16,2023-03-16,Payment from Customer_0052,REF51016163,0.0,43.86,53067.58
2023-03-16,2023-03-16,Payment from Customer_0043,REF83308540,0.0,136.24,53203.82
2023-03-17,2023-03-17,Invoice payment - Customer_0083,REF17359845,0.0,55.85,53259.67
2023-03-17,2023-03-17,Payment from Customer_0032,REF33487348,0.0,73.21,53332.88
2023-03-17,2023-03-17,Project payment - Customer_0063,REF87934834,0.0,60.93,53393.81
2023-03-17,2023-03-17,Invoice payment - Customer_0074,REF41348737,0.0,39.61,53433.42
2023-03-17,2023-03-17,Payment from Customer_0026,REF87972401,0.0,119.98,53553.4
2023-03-17,2023-03-17,Service payment - Customer_0071,REF89518813,0.0,43.63,53597.03
2023-03-17,2023-03-17,Invoice payment - Customer_0033,REF91044774,0.0,68.6,53665.63
2023-03-18,2023-03-18,Invoice payment - Customer_0027,REF66931246,0.0,98.11,53763.74
2023-03-18,2023-03-18,Project payment - Customer_0066,REF16212025,0.0,59.18,53822.92
2023-03-18,2023-03-18,Project payment - Customer_0061,REF46337551,0.0,118.06,53940.98
2023-03-18,2023-03-18,Payment from Customer_0039,REF87159237,0.0,171.41,54112.39
2023-03-18,2023-03-18,Service payment - Customer_0080,REF60619966,0.0,43.59,54155.98
2023-03-18,2023-03-18,Payment from Customer_0088,REF98965542,0.0,68.96,54224.94
2023-03-18,2023-03-18,Invoice payment - Customer_0035,REF46884826,0.0,113.75,54338.69
2023-03-18,2023-03-18,Payment from Customer_0057,REF77031400,0.0,129.63,54468.32
2023-03-18,2023-03-18,Project payment - Customer_0016,REF42353864,0.0,32.39,54500.71
2023-03-18,2023-03-18,Payment from Customer_0099,REF37035385,0.0,41.54,54542.25
2023-03-18,2023-03-18,Service payment - Customer_0026,REF26672212,0.0,136.02,54678.27
2023-03-18,2023-03-18,Invoice payment - Customer_0044,REF57725363,0.0,32.45,54710.72
2023-03-19,2023-03-19,Payment from Customer_0081,REF65303490,0.0,119.57,54830.29
2023-03-19,2023-03-19,Invoice payment - Customer_0000,REF12472212,0.0,52.47,54882.76
2023-03-19,2023-03-19,Project payment - Customer_0017,REF93034362,0.0,66.31,54949.07
2023-03-19,2023-03-19,Payment from Customer_0072,REF68796199,0.0,134.71,55083.78
2023-03-19,2023-03-19,Service payment - Customer_0008,REF65500671,0.0,56.17,55139.95
2023-03-19,2023-03-19,Payment from Customer_0012,REF93186269,0.0,75.02,55214.97
2023-03-19,2023-03-19,Payment from Customer_0047,REF23142621,0.0,132.12,55347.09
2023-03-19,2023-03-19,Service payment - Customer_0040,REF30778356,0.0,36.67,55383.76
2023-03-20,2023-03-20,Payment from Customer_0036,REF58953770,0.0,64.22,55447.98
2023-03-20,2023-03-20,Payment from Customer_0039,REF27361252,0.0,145.88,55593.86
2023-03-20,2023-03-20,Invoice payment - Customer_0046,REF12067869,0.0,136.84,55730.7
2023-03-20,2023-03-20,Project payment - Customer_0097,REF96338610,0.0,72.07,55802.77
2023-03-20,2023-03-20,Project payment - Customer_0098,REF79676502,0.0,32.8,55835.57
2023-03-20,2023-03-20,Payment from Customer_0071,REF39650922,0.0,36.45,55872.02
2023-03-20,2023-03-20,Service payment - Customer_0085,REF28069348,0.0,113.16,55985.18
2023-03-20,2023-03-20,Invoice payment - Customer_0099,REF72891134,0.0,49.56,56034.74
2023-03-20,2023-03-20,Service payment - Customer_0023,REF78913492,0.0,114.2,56148.94
2023-03-21,2023-03-21,Service payment - Customer_0001,REF37378341,0.0,77.06,56226.0
2023-03-21,2023-03-21,Payment from Customer_0063,REF30899233,0.0,72.78,56298.78
2023-03-21,2023-03-21,Payment from Customer_0045,REF38593749,0.0,83.15,56381.93
2023-03-21,2023-03-21,Project payment - Customer_0049,REF42106300,0.0,114.99,56496.92
2023-03-21,2023-03-21,Service payment - Customer_0005,REF22519156,0.0,29.09,56526.01
2023-03-21,2023-03-21,Project payment - Customer_0035,REF29817634,0.0,116.39,56642.4
2023-03-21,2023-03-21,Invoice payment - Customer_0040,REF59163634,0.0,40.05,56682.45
2023-03-21,2023-03-21,Project payment - Customer_0020,REF98162197,0.0,119.4,56801.85
2023-03-21,2023-03-21,Invoice payment - Customer_0058,REF27299567,0.0,53.68,56855.53
2023-03-21,2023-03-21,Service payment - Customer_0056,REF62293678,0.0,23.79,56879.32
2023-03-22,2023-03-22,Utility bill payment,REF45082953,153.65,0.0,56725.67
2023-03-22,2023-03-22,Invoice payment - Customer_0084,REF50861576,0.0,87.07,56812.74
2023-03-22,2023-03-22,Payment from Customer_0075,REF71256938,0.0,119.69,56932.43
2023-03-22,2023-03-22,Pos Systems expense,REF95054392,28.59,0.0,56903.84
2023-03-23,2023-03-23,Invoice payment - Customer_0026,REF16564431,0.0,132.9,57036.74
2023-03-23,2023-03-23,Invoice payment - Customer_0036,REF82140844,0.0,72.97,57109.71
2023-03-23,2023-03-23,Payment from Customer_0090,REF41147389,0.0,106.08,57215.79
2023-03-23,2023-03-23,Project payment - Customer_0046,REF56095024,0.0,120.27,57336.06
2023-03-23,2023-03-23,Service payment - Customer_0025,REF46603026,0.0,82.7,57418.76
2023-03-23,2023-03-23,Payment from Customer_0058,REF30758965,0.0,48.62,57467.38
2023-03-23,2023-03-23,Invoice payment - Customer_0020,REF55183604,0.0,133.92,57601.3
2023-03-23,2023-03-23,Service payment - Customer_0074,REF20222254,0.0,53.75,57655.05
2023-03-23,2023-03-23,Service payment - Customer_0028,REF18851769,0.0,81.23,57736.28
2023-03-23,2023-03-23,Invoice payment - Customer_0067,REF83931883,0.0,166.89,57903.17
2023-03-23,2023-03-23,Project payment - Customer_0035,REF78307985,0.0,113.11,58016.28
2023-03-23,2023-03-23,Invoice payment - Customer_0000,REF58754489,0.0,47.15,58063.43
2023-03-24,2023-03-24,Project payment - Customer_0035,REF15752276,0.0,112.55,58175.98
2023-03-24,2023-03-24,Invoice payment - Customer_0032,REF80077595,0.0,64.02,58240.0
2023-03-24,2023-03-24,Invoice payment - Customer_0087,REF93775125,0.0,61.84,58301.84
2023-03-24,2023-03-24,Payment from Customer_0015,REF27471497,0.0,148.66,58450.5
2023-03-24,2023-03-24,Service payment - Customer_0027,REF87879049,0.0,102.95,58553.45
2023-03-24,2023-03-24,Project payment - Customer_0021,REF79812250,0.0,65.31,58618.76
2023-03-24,2023-03-24,Project payment - Customer_0008,REF92529698,0.0,104.8,58723.56
2023-03-24,2023-03-24,Payment from Customer_0072,REF76321805,0.0,117.83,58841.39
2023-03-25,2023-03-25,Invoice payment - Customer_0030,REF70221947,0.0,36.91,58878.3
2023-03-25,2023-03-25,Payment from Customer_0036,REF65553596,0.0,58.13,58936.43
2023-03-25,2023-03-25,Service payment - Customer_0073,REF29760346,0.0,120.79,59057.22
2023-03-25,2023-03-25,Invoice payment - Customer_0099,REF23103951,0.0,48.44,59105.66
2023-03-25,2023-03-25,Service payment - Customer_0017,REF52849277,0.0,59.89,59165.55
2023-03-25,2023-03-25,Payment from Customer_0082,REF56603468,0.0,143.73,59309.28
2023-03-26,2023-03-26,Payment from Customer_0058,REF33749280,0.0,62.14,59371.42
2023-03-26,2023-03-26,Project payment - Customer_0084,REF88622314,0.0,86.92,59458.34
2023-03-26,2023-03-26,Invoice payment - Customer_0088,REF94010423,0.0,117.76,59576.1
2023-03-26,2023-03-26,Service payment - Customer_0006,REF75371468,0.0,73.47,59649.57
2023-03-26,2023-03-26,Service payment - Customer_0041,REF96192588,0.0,101.86,59751.43
2023-03-26,2023-03-26,Project payment - Customer_0021,REF24211154,0.0,48.39,59799.82
2023-03-27,2023-03-27,Service payment - Customer_0049,REF42264880,0.0,77.46,59877.28
2023-03-27,2023-03-27,Invoice payment - Customer_0057,REF57313747,0.0,117.79,59995.07
2023-03-27,2023-03-27,Invoice payment - Customer_0025,REF18467597,0.0,87.81,60082.88
2023-03-27,2023-03-27,Payment from Customer_0009,REF98922771,0.0,77.53,60160.41
2023-03-27,2023-03-27,Project payment - Customer_0029,REF64941767,0.0,76.4,60236.81
2023-03-27,2023-03-27,Payment from Customer_0016,REF18526680,0.0,24.95,60261.76
2023-03-28,2023-03-28,Payment from Customer_0076,REF26456594,0.0,10.52,60272.28
2023-03-28,2023-03-28,Project payment - Customer_0046,REF30549682,0.0,141.77,60414.05
2023-03-28,2023-03-28,Invoice payment - Customer_0075,REF49030440,0.0,117.79,60531.84
2023-03-28,2023-03-28,Project payment - Customer_0023,REF98639487,0.0,89.33,60621.17
2023-03-28,2023-03-28,Invoice payment - Customer_0040,REF77338485,0.0,31.43,60652.6
2023-03-28,2023-03-28,Payment from Customer_0048,REF27536518,0.0,110.35,60762.95
2023-03-28,2023-03-28,Project payment - Customer_0045,REF13553701,0.0,108.81,60871.76
2023-03-28,2023-03-28,Payment from Customer_0099,REF69497432,0.0,49.98,60921.74
2023-03-28,2023-03-28,Invoice payment - Customer_0064,REF55023789,0.0,33.7,60955.44
2023-03-28,2023-03-28,Project payment - Customer_0011,REF70848062,0.0,84.71,61040.15
2023-03-28,2023-03-28,Project payment - Customer_0095,REF53067033,0.0,80.47,61120.62
2023-03-29,2023-03-29,Project payment - Customer_0006,REF58825636,0.0,92.24,61212.86
2023-03-29,2023-03-29,Invoice payment - Customer_0097,REF95073645,0.0,56.81,61269.67
2023-03-29,2023-03-29,Service payment - Customer_0032,REF45600985,0.0,91.57,61361.24
2023-03-29,2023-03-29,Invoice payment - Customer_0076,REF54278012,0.0,10.31,61371.55
2023-03-29,2023-03-29,Project payment - Customer_0009,REF73117481,0.0,57.76,61429.31
2023-03-29,2023-03-29,Project payment - Customer_0082,REF26806217,0.0,188.1,61617.41
2023-03-29,2023-03-29,Service payment - Customer_0096,REF73621218,0.0,83.79,61701.2
2023-03-29,2023-03-29,Invoice payment - Customer_0017,REF18043084,0.0,81.01,61782.21
2023-03-29,2023-03-29,Payment from Customer_0023,REF89450356,0.0,95.03,61877.24
2023-03-30,2023-03-30,Packaging Shipping expense,REF35775560,253.81,0.0,61623.43
2023-03-30,2023-03-30,Invoice payment - Customer_0072,REF19147468,0.0,84.2,61707.63
2023-03-30,2023-03-30,Service payment - Customer_0097,REF25171745,0.0,34.97,61742.6
2023-03-30,2023-03-30,Payment from Customer_0034,REF43766179,0.0,81.86,61824.46
2023-03-30,2023-03-30,Service payment - Customer_0057,REF42273501,0.0,150.51,61974.97
2023-03-30,2023-03-30,Service payment - Customer_0028,REF66594949,0.0,98.3,62073.27
2023-03-30,2023-03-30,Project payment - Customer_0045,REF50699175,0.0,89.11,62162.38
2023-03-31,2023-03-31,Invoice payment - Customer_0059,REF61257593,0.0,72.88,62235.26
2023-03-31,2023-03-31,Service payment - Customer_0055,REF35741527,0.0,57.98,62293.24
2023-03-31,2023-03-31,Invoice payment - Customer_0074,REF34571201,0.0,66.94,62360.18
2023-03-31,2023-03-31,Project payment - Customer_0050,REF49441655,0.0,178.83,62539.01
2023-03-31,2023-03-31,Payment from Customer_0089,REF91404526,0.0,153.77,62692.78
2023-03-31,2023-03-31,Service payment - Customer_0086,REF48230044,0.0,105.15,62797.93
2023-03-31,2023-03-31,Invoice payment - Customer_0060,REF27959411,0.0,106.66,62904.59
2023-03-31,2023-03-31,Project payment - Customer_0048,REF15507769,0.0,75.67,62980.26
2023-03-31,2023-03-31,Service payment - Customer_0098,REF42157187,0.0,84.53,63064.79
2023-03-31,2023-03-31,Service payment - Customer_0091,REF52607724,0.0,122.5,63187.29
2023-03-31,2023-03-31,Project payment - Customer_0046,REF33683102,0.0,154.36,63341.65
2023-03-31,2023-03-31,Service payment - Customer_0001,REF40485373,0.0,61.79,63403.44
2023-03-31,2023-03-31,Project payment - Customer_0099,REF55250885,0.0,38.92,63442.36
2023-04-01,2023-04-01,Project payment - Customer_0012,REF83830149,0.0,58.09,63500.45
2023-04-01,2023-04-01,Service payment - Customer_0066,REF47717997,0.0,67.56,63568.01
2023-04-01,2023-04-01,Service payment - Customer_0073,REF94820916,0.0,157.17,63725.18
2023-04-01,2023-04-01,Payment from Customer_0027,REF15198024,0.0,82.58,63807.76
2023-04-01,2023-04-01,Service payment - Customer_0064,REF32093442,0.0,40.57,63848.33
2023-04-01,2023-04-01,Monthly office rent,REF22047003,1191.26,0.0,62657.07
2023-04-01,2023-04-01,Project payment - Customer_0057,REF50677123,0.0,137.82,62794.89
2023-04-01,2023-04-01,Payment from Customer_0001,REF13955327,0.0,78.14,62873.03
2023-04-01,2023-04-01,Invoice payment - Customer_0097,REF55806528,0.0,65.23,62938.26
2023-04-01,2023-04-01,Project payment - Customer_0004,REF19372878,0.0,50.24,62988.5
2023-04-01,2023-04-01,Invoice payment - Customer_0038,REF35831261,0.0,58.59,63047.09
2023-04-02,2023-04-02,Service payment - Customer_0079,REF96481441,0.0,68.81,63115.9
2023-04-02,2023-04-02,Service payment - Customer_0077,REF10345588,0.0,98.69,63214.59
2023-04-02,2023-04-02,Payment from Customer_0020,REF35930803,0.0,93.37,63307.96
2023-04-02,2023-04-02,Payment from Customer_0059,REF15868175,0.0,71.6,63379.56
2023-04-02,2023-04-02,Payment from Customer_0012,REF97610420,0.0,69.44,63449.0
2023-04-02,2023-04-02,Payment from Customer_0084,REF77826222,0.0,89.64,63538.64
2023-04-02,2023-04-02,Project payment - Customer_0058,REF82201957,0.0,54.46,63593.1
2023-04-02,2023-04-02,Service payment - Customer_0013,REF13806554,0.0,76.39,63669.49
2023-04-03,2023-04-03,Invoice payment - Customer_0090,REF71450388,0.0,84.37,63753.86
2023-04-03,2023-04-03,Service payment - Customer_0078,REF87686892,0.0,122.73,63876.59
2023-04-03,2023-04-03,Project payment - Customer_0045,REF95579597,0.0,97.31,63973.9
2023-04-03,2023-04-03,Project payment - Customer_0011,REF72187058,0.0,89.8,64063.7
2023-04-03,2023-04-03,Invoice payment - Customer_0082,REF90611828,0.0,200.73,64264.43
2023-04-03,2023-04-03,Invoice payment - Customer_0089,REF48318034,0.0,134.21,64398.64
2023-04-03,2023-04-03,Invoice payment - Customer_0033,REF52667660,0.0,60.07,64458.71
2023-04-03,2023-04-03,Payment from Customer_0096,REF27447911,0.0,81.48,64540.19
2023-04-03,2023-04-03,Service payment - Customer_0002,REF84063897,0.0,84.8,64624.99
2023-04-03,2023-04-03,Project payment - Customer_0074,REF80174125,0.0,61.02,64686.01
2023-04-04,2023-04-04,Project payment - Customer_0010,REF28116713,0.0,80.13,64766.14
2023-04-04,2023-04-04,Project payment - Customer_0090,REF29277589,0.0,100.6,64866.74
2023-04-04,2023-04-04,Project payment - Customer_0037,REF20925741,0.0,131.27,64998.01
2023-04-04,2023-04-04,Project payment - Customer_0001,REF72966509,0.0,61.06,65059.07
2023-04-04,2023-04-04,Project payment - Customer_0060,REF74688140,0.0,90.1,65149.17
2023-04-04,2023-04-04,Project payment - Customer_0047,REF22078774,0.0,97.23,65246.4
2023-04-04,2023-04-04,Invoice payment - Customer_0070,REF80933991,0.0,59.61,65306.01
2023-04-04,2023-04-04,Project payment - Customer_0053,REF90915860,0.0,144.51,65450.52
2023-04-04,2023-04-04,Payment from Customer_0004,REF30306552,0.0,53.59,65504.11
2023-04-04,2023-04-04,Project payment - Customer_0052,REF44462701,0.0,39.8,65543.91
2023-04-04,2023-04-04,Invoice payment - Customer_0000,REF88466902,0.0,43.42,65587.33
2023-04-05,2023-04-05,Service payment - Customer_0080,REF27379747,0.0,47.84,65635.17
2023-04-05,2023-04-05,Service payment - Customer_0058,REF26002692,0.0,41.98,65677.15
2023-04-05,2023-04-05,Service payment - Customer_0020,REF89534801,0.0,132.06,65809.21
2023-04-05,2023-04-05,Payment from Customer_0093,REF65735798,0.0,118.82,65928.03
2023-04-05,2023-04-05,Service payment - Customer_0043,REF87167993,0.0,146.17,66074.2
2023-04-06,2023-04-06,Invoice payment - Customer_0000,REF11745646,0.0,39.09,66113.29
2023-04-06,2023-04-06,Payment from Customer_0072,REF53450057,0.0,89.76,66203.05
2023-04-06,2023-04-06,Payment from Customer_0064,REF18427256,0.0,31.69,66234.74
2023-04-06,2023-04-06,Service payment - Customer_0075,REF82657148,0.0,104.09,66338.83
2023-04-06,2023-04-06,Payment from Customer_0015,REF49329404,0.0,132.35,66471.18
2023-04-06,2023-04-06,Invoice payment - Customer_0089,REF80828785,0.0,151.83,66623.01
2023-04-06,2023-04-06,Project payment - Customer_0004,REF18365444,0.0,55.58,66678.59
2023-04-06,2023-04-06,Inventory purchase,REF58340079,5001.14,0.0,61677.45
2023-04-07,2023-04-07,Invoice payment - Customer_0024,REF72617643,0.0,79.55,61757.0
2023-04-07,2023-04-07,Service payment - Customer_0051,REF51456902,0.0,66.2,61823.2
2023-04-07,2023-04-07,Payment from Customer_0076,REF22699265,0.0,10.07,61833.27
2023-04-07,2023-04-07,Project payment - Customer_0068,REF74350299,0.0,35.08,61868.35
2023-04-07,2023-04-07,Payment from Customer_0092,REF61594673,0.0,75.55,61943.9
2023-04-07,2023-04-07,Project payment - Customer_0098,REF81554036,0.0,74.98,62018.88
2023-04-07,2023-04-07,Payment from Customer_0027,REF20660350,0.0,88.19,62107.07
2023-04-07,2023-04-07,Service payment - Customer_0037,REF24452666,0.0,165.39,62272.46
2023-04-07,2023-04-07,Payment from Customer_0093,REF63490437,0.0,70.55,62343.01
2023-04-07,2023-04-07,Service payment - Customer_0082,REF84419612,0.0,172.72,62515.73
2023-04-08,2023-04-08,Payment from Customer_0035,REF97178022,0.0,133.98,62649.71
2023-04-08,2023-04-08,Invoice payment - Customer_0066,REF26415114,0.0,50.11,62699.82
2023-04-08,2023-04-08,Payment from Customer_0059,REF75523007,0.0,86.59,62786.41
2023-04-08,2023-04-08,Service payment - Customer_0063,REF88130133,0.0,74.72,62861.13
2023-04-08,2023-04-08,Project payment - Customer_0096,REF38122527,0.0,103.09,62964.22
2023-04-08,2023-04-08,Project payment - Customer_0046,REF57460044,0.0,149.89,63114.11
2023-04-08,2023-04-08,Payment from Customer_0078,REF63501061,0.0,97.23,63211.34
2023-04-08,2023-04-08,Project payment - Customer_0061,REF66351683,0.0,94.53,63305.87
2023-04-08,2023-04-08,Project payment - Customer_0049,REF81373789,0.0,103.02,63408.89
2023-04-09,2023-04-09,Invoice payment - Customer_0058,REF54543073,0.0,47.96,63456.85
2023-04-09,2023-04-09,Payment from Customer_0024,REF40984762,0.0,95.54,63552.39
2023-04-09,2023-04-09,Project payment - Customer_0071,REF44212014,0.0,48.84,63601.23
2023-04-09,2023-04-09,Service payment - Customer_0039,REF61098202,0.0,141.78,63743.01
2023-04-09,2023-04-09,Project payment - Customer_0023,REF88244511,0.0,113.61,63856.62
2023-04-09,2023-04-09,Payment from Customer_0051,REF56740179,0.0,64.89,63921.51
2023-04-09,2023-04-09,Service payment - Customer_0014,REF83340168,0.0,91.88,64013.39
2023-04-09,2023-04-09,Payment from Customer_0063,REF31111386,0.0,53.52,64066.91
2023-04-09,2023-04-09,Payment from Customer_0076,REF37218370,0.0,10.0,64076.91
2023-04-10,2023-04-10,Project payment - Customer_0008,REF52912332,0.0,125.29,64202.2
2023-04-10,2023-04-10,Project payment - Customer_0066,REF65323556,0.0,61.81,64264.01
2023-04-10,2023-04-10,Payment from Customer_0076,REF26037307,0.0,10.0,64274.01
2023-04-10,2023-04-10,Payment from Customer_0020,REF96344664,0.0,130.41,64404.42
2023-04-10,2023-04-10,Project payment - Customer_0064,REF12932753,0.0,38.9,64443.32
2023-04-10,2023-04-10,Invoice payment - Customer_0055,REF64915055,0.0,71.04,64514.36
2023-04-11,2023-04-11,Service payment - Customer_0039,REF78422087,0.0,108.02,64622.38
2023-04-11,2023-04-11,Project payment - Customer_0045,REF50485109,0.0,77.48,64699.86
2023-04-11,2023-04-11,Payment from Customer_0074,REF27632938,0.0,48.27,64748.13
2023-04-11,2023-04-11,Payment from Customer_0000,REF32967331,0.0,35.31,64783.44
2023-04-11,2023-04-11,Invoice payment - Customer_0056,REF20894758,0.0,24.54,64807.98
2023-04-11,2023-04-11,Service payment - Customer_0012,REF80436467,0.0,57.88,64865.86
2023-04-11,2023-04-11,Payment from Customer_0051,REF95906273,0.0,84.27,64950.13
2023-04-11,2023-04-11,Service payment - Customer_0076,REF68889535,0.0,10.79,64960.92
2023-04-11,2023-04-11,Invoice payment - Customer_0090,REF62391051,0.0,94.75,65055.67
2023-04-12,2023-04-12,Invoice payment - Customer_0089,REF25607851,0.0,125.14,65180.81
2023-04-12,2023-04-12,Payment from Customer_0091,REF73746475,0.0,177.47,65358.28
2023-04-12,2023-04-12,Service payment - Customer_0080,REF62878588,0.0,36.77,65395.05
2023-04-12,2023-04-12,Service payment - Customer_0021,REF65005552,0.0,66.18,65461.23
2023-04-12,2023-04-12,Service payment - Customer_0083,REF20164059,0.0,57.85,65519.08
2023-04-12,2023-04-12,Invoice payment - Customer_0070,REF49141057,0.0,41.17,65560.25
2023-04-13,2023-04-13,Payment from Customer_0008,REF21572858,0.0,102.19,65662.44
2023-04-13,2023-04-13,Project payment - Customer_0048,REF32294131,0.0,84.91,65747.35
2023-04-13,2023-04-13,Invoice payment - Customer_0033,REF44704810,0.0,85.42,65832.77
2023-04-13,2023-04-13,Project payment - Customer_0099,REF82197845,0.0,51.67,65884.44
2023-04-13,2023-04-13,Project payment - Customer_0055,REF59512545,0.0,47.66,65932.1
2023-04-13,2023-04-13,Service payment - Customer_0036,REF68322899,0.0,63.43,65995.53
2023-04-13,2023-04-13,Project payment - Customer_0037,REF56693036,0.0,124.03,66119.56
2023-04-13,2023-04-13,Service payment - Customer_0057,REF76923570,0.0,114.9,66234.46
2023-04-13,2023-04-13,Project payment - Customer_0020,REF42822988,0.0,114.28,66348.74
2023-04-13,2023-04-13,Invoice payment - Customer_0053,REF77667183,0.0,181.8,66530.54
2023-04-14,2023-04-14,Service payment - Customer_0008,REF83877316,0.0,129.44,66659.98
2023-04-14,2023-04-14,Payment from Customer_0094,REF51478916,0.0,46.24,66706.22
2023-04-14,2023-04-14,Invoice payment - Customer_0090,REF13341581,0.0,69.76,66775.98
2023-04-14,2023-04-14,Payment from Customer_0014,REF39012212,0.0,92.18,66868.16
2023-04-14,2023-04-14,Payment from Customer_0043,REF41533429,0.0,113.73,66981.89
2023-04-14,2023-04-14,Payment from Customer_0057,REF33957684,0.0,122.14,67104.03
2023-04-14,2023-04-14,Service payment - Customer_0085,REF37479553,0.0,114.97,67219.0
2023-04-14,2023-04-14,Payment from Customer_0082,REF48964918,0.0,171.59,67390.59
2023-04-14,2023-04-14,Service payment - Customer_0097,REF87001876,0.0,63.66,67454.25
2023-04-14,2023-04-14,Pos Systems expense,REF54266100,46.71,0.0,67407.54
2023-04-15,2023-04-15,Payment from Customer_0009,REF12412540,0.0,73.05,67480.59
2023-04-15,2023-04-15,Project payment - Customer_0067,REF20256786,0.0,136.06,67616.65
2023-04-15,2023-04-15,Payment from Customer_0033,REF49831168,0.0,62.5,67679.15
2023-04-15,2023-04-15,Business insurance premium,REF97206147,182.14,0.0,67497.01
2023-04-15,2023-04-15,Project payment - Customer_0063,REF76361667,0.0,72.96,67569.97
2023-04-15,2023-04-15,Project payment - Customer_0038,REF27606994,0.0,52.01,67621.98
2023-04-15,2023-04-15,Invoice payment - Customer_0008,REF45940171,0.0,112.53,67734.51
2023-04-16,2023-04-16,Service payment - Customer_0094,REF23475825,0.0,76.29,67810.8
2023-04-16,2023-04-16,Service payment - Customer_0004,REF49344903,0.0,57.29,67868.09
2023-04-16,2023-04-16,Service payment - Customer_0055,REF53640504,0.0,69.8,67937.89
2023-04-16,2023-04-16,Invoice payment - Customer_0048,REF23735196,0.0,93.94,68031.83
2023-04-16,2023-04-16,Service payment - Customer_0032,REF24733791,0.0,73.65,68105.48
2023-04-16,2023-04-16,Invoice payment - Customer_0056,REF62856484,0.0,30.91,68136.39
2023-04-16,2023-04-16,Service payment - Customer_0083,REF19040059,0.0,63.84,68200.23
2023-04-16,2023-04-16,Payment from Customer_0029,REF62581519,0.0,74.58,68274.81
2023-04-16,2023-04-16,Payment from Customer_0066,REF65506325,0.0,47.8,68322.61
2023-04-16,2023-04-16,Project payment - Customer_0091,REF59607463,0.0,155.66,68478.27
2023-04-16,2023-04-16,Service payment - Customer_0065,REF14933658,0.0,52.37,68530.64
2023-04-16,2023-04-16,Service payment - Customer_0023,REF28083323,0.0,81.15,68611.79
2023-04-16,2023-04-16,Invoice payment - Customer_0061,REF85381345,0.0,131.92,68743.71
2023-04-17,2023-04-17,Invoice payment - Customer_0016,REF31782656,0.0,35.06,68778.77
2023-04-17,2023-04-17,Project payment - Customer_0088,REF58407815,0.0,116.5,68895.27
2023-04-17,2023-04-17,Project payment - Customer_0099,REF32284886,0.0,53.22,68948.49
2023-04-17,2023-04-17,Service payment - Customer_0091,REF59175974,0.0,148.52,69097.01
2023-04-17,2023-04-17,Invoice payment - Customer_0043,REF16677467,0.0,125.94,69222.95
2023-04-17,2023-04-17,Project payment - Customer_0025,REF41858109,0.0,136.02,69358.97
2023-04-17,2023-04-17,Project payment - Customer_0087,REF53882340,0.0,77.71,69436.68
2023-04-17,2023-04-17,Invoice payment - Customer_0000,REF62550388,0.0,36.55,69473.23
2023-04-17,2023-04-17,Project payment - Customer_0062,REF89526704,0.0,61.84,69535.07
2023-04-18,2023-04-18,Service payment - Customer_0022,REF85477379,0.0,57.14,69592.21
2023-04-18,2023-04-18,Service payment - Customer_0034,REF55172485,0.0,97.38,69689.59
2023-04-18,2023-04-18,Project payment - Customer_0010,REF92170266,0.0,130.86,69820.45
2023-04-18,2023-04-18,Invoice payment - Customer_0081,REF95199668,0.0,81.1,69901.55
2023-04-18,2023-04-18,Invoice payment - Customer_0011,REF53352543,0.0,89.49,69991.04
2023-04-18,2023-04-18,Invoice payment - Customer_0038,REF52252472,0.0,54.58,70045.62
2023-04-19,2023-04-19,Project payment - Customer_0040,REF22300945,0.0,33.22,70078.84
2023-04-19,2023-04-19,Project payment - Customer_0094,REF75869662,0.0,76.56,70155.4
2023-04-19,2023-04-19,Payment from Customer_0049,REF33838478,0.0,89.99,70245.39
2023-04-19,2023-04-19,Invoice payment - Customer_0010,REF79776121,0.0,99.37,70344.76
2023-04-19,2023-04-19,Invoice payment - Customer_0066,REF76430037,0.0,76.6,70421.36
2023-04-19,2023-04-19,Project payment - Customer_0061,REF75864055,0.0,120.32,70541.68
2023-04-19,2023-04-19,Service payment - Customer_0057,REF14233501,0.0,91.57,70633.25
2023-04-19,2023-04-19,Invoice payment - Customer_0074,REF39619112,0.0,46.77,70680.02
2023-04-19,2023-04-19,Service payment - Customer_0096,REF77067129,0.0,120.49,70800.51
2023-04-19,2023-04-19,Project payment - Customer_0045,REF26198764,0.0,75.6,70876.11
2023-04-20,2023-04-20,Invoice payment - Customer_0006,REF65236483,0.0,94.21,70970.32
2023-04-20,2023-04-20,Service payment - Customer_0059,REF73852194,0.0,68.84,71039.16
2023-04-20,2023-04-20,Project payment - Customer_0088,REF60675011,0.0,111.59,71150.75
2023-04-20,2023-04-20,Invoice payment - Customer_0000,REF84645135,0.0,38.08,71188.83
2023-04-20,2023-04-20,Project payment - Customer_0057,REF53103417,0.0,107.83,71296.66
2023-04-20,2023-04-20,Payment from Customer_0058,REF56577488,0.0,48.0,71344.66
2023-04-20,2023-04-20,Project payment - Customer_0099,REF83799618,0.0,39.69,71384.35
2023-04-20,2023-04-20,Invoice payment - Customer_0056,REF77863315,0.0,31.08,71415.43
2023-04-20,2023-04-20,Service payment - Customer_0062,REF98057195,0.0,61.28,71476.71
2023-04-20,2023-04-20,Professional Services expense,REF42993412,126.93,0.0,71349.78
2023-04-21,2023-04-21,Project payment - Customer_0097,REF58018687,0.0,77.16,71426.94
2023-04-21,2023-04-21,Service payment - Customer_0024,REF90872388,0.0,75.76,71502.7
2023-04-21,2023-04-21,Service payment - Customer_0026,REF35877974,0.0,113.38,71616.08
2023-04-21,2023-04-21,Invoice payment - Customer_0010,REF18323914,0.0,106.06,71722.14
2023-04-21,2023-04-21,Service payment - Customer_0052,REF53618487,0.0,49.28,71771.42
2023-04-21,2023-04-21,Project payment - Customer_0063,REF54064821,0.0,67.78,71839.2
2023-04-21,2023-04-21,Project payment - Customer_0071,REF50240075,0.0,44.49,71883.69
2023-04-21,2023-04-21,Invoice payment - Customer_0090,REF65765973,0.0,101.85,71985.54
2023-04-21,2023-04-21,Service payment - Customer_0001,REF43467543,0.0,69.38,72054.92
2023-04-21,2023-04-21,Invoice payment - Customer_0058,REF62329441,0.0,57.21,72112.13
2023-04-21,2023-04-21,Project payment - Customer_0045,REF81877005,0.0,122.89,72235.02
2023-04-22,2023-04-22,Utility bill payment,REF41655988,134.3,0.0,72100.72
2023-04-22,2023-04-22,Payment from Customer_0049,REF58025017,0.0,110.77,72211.49
2023-04-22,2023-04-22,Project payment - Customer_0011,REF52498212,0.0,70.75,72282.24
2023-04-22,2023-04-22,Project payment - Customer_0076,REF95696443,0.0,11.48,72293.72
2023-04-22,2023-04-22,Service payment - Customer_0057,REF37720738,0.0,120.37,72414.09
2023-04-22,2023-04-22,Invoice payment - Customer_0060,REF93611416,0.0,100.3,72514.39
2023-04-22,2023-04-22,Service payment - Customer_0092,REF37150760,0.0,52.28,72566.67
2023-04-22,2023-04-22,Service payment - Customer_0046,REF14196501,0.0,128.11,72694.78
2023-04-22,2023-04-22,Invoice payment - Customer_0020,REF49860355,0.0,104.17,72798.95
2023-04-22,2023-04-22,Invoice payment - Customer_0005,REF92943572,0.0,30.86,72829.81
2023-04-23,2023-04-23,Service payment - Customer_0016,REF18305964,0.0,36.6,72866.41
2023-04-23,2023-04-23,Payment from Customer_0028,REF88931132,0.0,93.92,72960.33
2023-04-23,2023-04-23,Invoice payment - Customer_0064,REF72711335,0.0,42.14,73002.47
2023-04-23,2023-04-23,Payment from Customer_0004,REF82499119,0.0,54.97,73057.44
2023-04-23,2023-04-23,Service payment - Customer_0085,REF81169137,0.0,117.18,73174.62
2023-04-23,2023-04-23,Service payment - Customer_0089,REF41775517,0.0,117.43,73292.05
2023-04-23,2023-04-23,Service payment - Customer_0067,REF40545303,0.0,146.91,73438.96
2023-04-24,2023-04-24,Payment from Customer_0037,REF94015547,0.0,160.85,73599.81
2023-04-24,2023-04-24,Project payment - Customer_0028,REF25391362,0.0,105.46,73705.27
2023-04-24,2023-04-24,Project payment - Customer_0066,REF47013713,0.0,57.47,73762.74
2023-04-24,2023-04-24,Project payment - Customer_0043,REF61731408,0.0,118.91,73881.65
2023-04-24,2023-04-24,Payment from Customer_0077,REF44813031,0.0,102.76,73984.41
2023-04-24,2023-04-24,Payment from Customer_0062,REF75219254,0.0,68.97,74053.38
2023-04-25,2023-04-25,Payment from Customer_0085,REF83048704,0.0,117.85,74171.23
2023-04-25,2023-04-25,Invoice payment - Customer_0078,REF53744382,0.0,152.69,74323.92
2023-04-25,2023-04-25,Invoice payment - Customer_0054,REF89696385,0.0,71.33,74395.25
2023-04-25,2023-04-25,Project payment - Customer_0020,REF87098760,0.0,95.11,74490.36
2023-04-25,2023-04-25,Invoice payment - Customer_0061,REF16308434,0.0,112.64,74603.0
2023-04-25,2023-04-25,Payment from Customer_0008,REF65318851,0.0,113.46,74716.46
2023-04-25,2023-04-25,Service payment - Customer_0051,REF40550210,0.0,58.38,74774.84
2023-04-25,2023-04-25,Project payment - Customer_0033,REF17857045,0.0,56.66,74831.5
2023-04-25,2023-04-25,Service payment - Customer_0005,REF55337007,0.0,25.13,74856.63
2023-04-25,2023-04-25,Payment from Customer_0042,REF82152696,0.0,104.1,74960.73
2023-04-25,2023-04-25,Project payment - Customer_0096,REF59565963,0.0,101.14,75061.87
2023-04-25,2023-04-25,Payment from Customer_0001,REF21182739,0.0,71.17,75133.04
2023-04-26,2023-04-26,Payment from Customer_0040,REF48019569,0.0,36.62,75169.66
2023-04-26,2023-04-26,Project payment - Customer_0037,REF10521502,0.0,104.21,75273.87
2023-04-26,2023-04-26,Payment from Customer_0096,REF28780575,0.0,106.9,75380.77
2023-04-26,2023-04-26,Project payment - Customer_0006,REF67076871,0.0,66.65,75447.42
2023-04-26,2023-04-26,Service payment - Customer_0048,REF66291954,0.0,108.72,75556.14
2023-04-26,2023-04-26,Service payment - Customer_0061,REF69301473,0.0,105.64,75661.78
2023-04-26,2023-04-26,Service payment - Customer_0038,REF56628811,0.0,50.17,75711.95
2023-04-26,2023-04-26,Payment from Customer_0015,REF96506752,0.0,103.19,75815.14
2023-04-26,2023-04-26,Project payment - Customer_0065,REF34137159,0.0,73.77,75888.91
2023-04-26,2023-04-26,Service payment - Customer_0008,REF37620769,0.0,140.97,76029.88
2023-04-26,2023-04-26,Payment from Customer_0016,REF51573112,0.0,32.52,76062.4
2023-04-26,2023-04-26,Invoice payment - Customer_0069,REF95493607,0.0,73.66,76136.06
2023-04-26,2023-04-26,Service payment - Customer_0022,REF28676181,0.0,78.66,76214.72
2023-04-26,2023-04-26,Service payment - Customer_0056,REF83322918,0.0,21.75,76236.47
2023-04-26,2023-04-26,Invoice payment - Customer_0055,REF82198626,0.0,62.6,76299.07
2023-04-26,2023-04-26,Invoice payment - Customer_0074,REF79366299,0.0,52.78,76351.85
2023-04-27,2023-04-27,Payment from Customer_0082,REF90884664,0.0,142.19,76494.04
2023-04-27,2023-04-27,Payment from Customer_0019,REF56471333,0.0,86.77,76580.81
2023-04-27,2023-04-27,Project payment - Customer_0006,REF24455447,0.0,76.99,76657.8
2023-04-27,2023-04-27,Project payment - Customer_0075,REF83330035,0.0,142.51,76800.31
2023-04-27,2023-04-27,Project payment - Customer_0074,REF98981354,0.0,52.32,76852.63
2023-04-27,2023-04-27,Invoice payment - Customer_0023,REF14855530,0.0,99.39,76952.02
2023-04-27,2023-04-27,Invoice payment - Customer_0047,REF47075721,0.0,114.54,77066.56
2023-04-27,2023-04-27,Payment from Customer_0015,REF79793078,0.0,139.98,77206.54
2023-04-27,2023-04-27,Service payment - Customer_0003,REF70304455,0.0,69.99,77276.53
2023-04-28,2023-04-28,Invoice payment - Customer_0041,REF34655410,0.0,151.88,77428.41
2023-04-28,2023-04-28,Service payment - Customer_0067,REF15194961,0.0,90.06,77518.47
2023-04-28,2023-04-28,Invoice payment - Customer_0027,REF42991722,0.0,96.12,77614.59
2023-04-28,2023-04-28,Payment from Customer_0098,REF49108849,0.0,75.8,77690.39
2023-04-28,2023-04-28,Payment from Customer_0030,REF74631339,0.0,38.68,77729.07
2023-04-28,2023-04-28,Service payment - Customer_0064,REF20944243,0.0,36.51,77765.58
2023-04-28,2023-04-28,Service payment - Customer_0088,REF63001588,0.0,124.4,77889.98
2023-04-28,2023-04-28,Service payment - Customer_0007,REF34582331,0.0,149.73,78039.71
2023-04-28,2023-04-28,Service payment - Customer_0071,REF57425317,0.0,47.08,78086.79
2023-04-28,2023-04-28,Invoice payment - Customer_0003,REF45939725,0.0,79.92,78166.71
2023-04-29,2023-04-29,Project payment - Customer_0001,REF22119610,0.0,62.31,78229.02
2023-04-29,2023-04-29,Payment from Customer_0094,REF56079198,0.0,72.92,78301.94
2023-04-29,2023-04-29,Project payment - Customer_0004,REF97926844,0.0,53.6,78355.54
2023-04-29,2023-04-29,Invoice payment - Customer_0063,REF75366575,0.0,88.14,78443.68
2023-04-29,2023-04-29,Invoice payment - Customer_0022,REF20214671,0.0,63.9,78507.58
2023-04-29,2023-04-29,Invoice payment - Customer_0070,REF34159474,0.0,54.1,78561.68
2023-04-29,2023-04-29,Invoice payment - Customer_0043,REF32402316,0.0,129.7,78691.38
2023-04-30,2023-04-30,Service payment - Customer_0048,REF90762649,0.0,88.48,78779.86
2023-04-30,2023-04-30,Project payment - Customer_0063,REF48831447,0.0,75.3,78855.16
2023-04-30,2023-04-30,Project payment - Customer_0044,REF99724079,0.0,34.32,78889.48
2023-04-30,2023-04-30,Service payment - Customer_0040,REF34315469,0.0,29.68,78919.16
2023-04-30,2023-04-30,Payment from Customer_0073,REF67715397,0.0,129.64,79048.8
2023-04-30,2023-04-30,Invoice payment - Customer_0024,REF51033759,0.0,93.62,79142.42
2023-04-30,2023-04-30,Service payment - Customer_0015,REF51030636,0.0,137.92,79280.34
2023-05-01,2023-05-01,Payment from Customer_0017,REF23588740,0.0,80.54,79360.88
2023-05-01,2023-05-01,Project payment - Customer_0091,REF41653255,0.0,111.32,79472.2
2023-05-01,2023-05-01,Project payment - Customer_0081,REF90777152,0.0,85.59,79557.79
2023-05-01,2023-05-01,Payment from Customer_0032,REF82556280,0.0,64.39,79622.18
2023-05-01,2023-05-01,Project payment - Customer_0064,REF44575607,0.0,43.03,79665.21
2023-05-01,2023-05-01,Service payment - Customer_0084,REF95544885,0.0,88.81,79754.02
2023-05-01,2023-05-01,Service payment - Customer_0087,REF71826286,0.0,92.15,79846.17
2023-05-01,2023-05-01,Project payment - Customer_0043,REF58381121,0.0,160.87,80007.04
2023-05-01,2023-05-01,Project payment - Customer_0024,REF11807749,0.0,102.22,80109.26
2023-05-01,2023-05-01,Payment from Customer_0072,REF40567931,0.0,122.69,80231.95
2023-05-01,2023-05-01,Project payment - Customer_0083,REF48067069,0.0,72.81,80304.76
2023-05-01,2023-05-01,Service payment - Customer_0069,REF67954210,0.0,62.51,80367.27
2023-05-01,2023-05-01,Invoice payment - Customer_0010,REF40019207,0.0,112.66,80479.93
2023-05-01,2023-05-01,Invoice payment - Customer_0031,REF17562134,0.0,153.76,80633.69
2023-05-01,2023-05-01,Monthly office rent,REF27024445,1419.07,0.0,79214.62
2023-05-02,2023-05-02,Service payment - Customer_0041,REF49789273,0.0,138.98,79353.6
2023-05-02,2023-05-02,Payment from Customer_0032,REF83082006,0.0,91.64,79445.24
2023-05-02,2023-05-02,Invoice payment - Customer_0008,REF70774994,0.0,91.75,79536.99
2023-05-02,2023-05-02,Invoice payment - Customer_0013,REF60008714,0.0,72.99,79609.98
2023-05-02,2023-05-02,Payment from Customer_0065,REF49045192,0.0,61.56,79671.54
2023-05-02,2023-05-02,Service payment - Customer_0020,REF81192180,0.0,134.41,79805.95
2023-05-02,2023-05-02,Project payment - Customer_0046,REF69015068,0.0,178.29,79984.24
2023-05-02,2023-05-02,Project payment - Customer_0016,REF84523420,0.0,37.91,80022.15
2023-05-02,2023-05-02,Invoice payment - Customer_0027,REF11963817,0.0,118.66,80140.81
2023-05-02,2023-05-02,Invoice payment - Customer_0053,REF44743572,0.0,187.35,80328.16
2023-05-03,2023-05-03,Service payment - Customer_0083,REF20858686,0.0,79.81,80407.97
2023-05-03,2023-05-03,Packaging Shipping expense,REF15838159,231.57,0.0,80176.4
2023-05-03,2023-05-03,Service payment - Customer_0096,REF19700794,0.0,97.2,80273.6
2023-05-04,2023-05-04,Payment from Customer_0040,REF62994247,0.0,32.24,80305.84
2023-05-04,2023-05-04,Service payment - Customer_0067,REF99086423,0.0,167.29,80473.13
2023-05-04,2023-05-04,Payment from Customer_0003,REF54668429,0.0,69.43,80542.56
2023-05-04,2023-05-04,Project payment - Customer_0068,REF28688773,0.0,47.19,80589.75
2023-05-04,2023-05-04,Invoice payment - Customer_0062,REF63639871,0.0,63.43,80653.18
2023-05-04,2023-05-04,Payment from Customer_0000,REF23787107,0.0,44.37,80697.55
2023-05-04,2023-05-04,Payment from Customer_0082,REF67560593,0.0,127.34,80824.89
2023-05-04,2023-05-04,Project payment - Customer_0086,REF80468034,0.0,97.53,80922.42
2023-05-04,2023-05-04,Payment from Customer_0007,REF71143918,0.0,184.21,81106.63
2023-05-04,2023-05-04,Service payment - Customer_0021,REF46250924,0.0,83.25,81189.88
2023-05-04,2023-05-04,Project payment - Customer_0065,REF85767484,0.0,66.38,81256.26
2023-05-04,2023-05-04,Project payment - Customer_0071,REF12204871,0.0,39.85,81296.11
2023-05-05,2023-05-05,Service payment - Customer_0011,REF64348054,0.0,137.41,81433.52
2023-05-05,2023-05-05,Invoice payment - Customer_0047,REF27040722,0.0,135.36,81568.88
2023-05-05,2023-05-05,Project payment - Customer_0065,REF20564861,0.0,69.06,81637.94
2023-05-05,2023-05-05,Service payment - Customer_0089,REF97668707,0.0,157.51,81795.45
2023-05-05,2023-05-05,Service payment - Customer_0021,REF52974900,0.0,69.57,81865.02
2023-05-05,2023-05-05,Project payment - Customer_0025,REF80076118,0.0,164.38,82029.4
2023-05-05,2023-05-05,Payment from Customer_0085,REF44423659,0.0,113.03,82142.43
2023-05-05,2023-05-05,Service payment - Customer_0058,REF56363770,0.0,65.18,82207.61
2023-05-05,2023-05-05,Invoice payment - Customer_0028,REF23176902,0.0,106.57,82314.18
2023-05-05,2023-05-05,Service payment - Customer_0029,REF30409323,0.0,84.98,82399.16
2023-05-06,2023-05-06,Invoice payment - Customer_0042,REF56150885,0.0,81.67,82480.83
2023-05-06,2023-05-06,Invoice payment - Customer_0073,REF11294291,0.0,123.0,82603.83
2023-05-06,2023-05-06,Payment from Customer_0030,REF60372671,0.0,47.16,82650.99
2023-05-06,2023-05-06,Service payment - Customer_0026,REF15925042,0.0,106.21,82757.2
2023-05-06,2023-05-06,Invoice payment - Customer_0066,REF68156174,0.0,67.83,82825.03
2023-05-06,2023-05-06,Inventory purchase,REF63690158,4344.31,0.0,78480.72
2023-05-06,2023-05-06,Employee payroll,REF76240241,3325.85,0.0,75154.87
2023-05-06,2023-05-06,Invoice payment - Customer_0035,REF86893083,0.0,90.08,75244.95
2023-05-06,2023-05-06,Invoice payment - Customer_0049,REF54942328,0.0,95.89,75340.84
2023-05-07,2023-05-07,Project payment - Customer_0096,REF49395368,0.0,83.99,75424.83
2023-05-07,2023-05-07,Payment from Customer_0005,REF57767515,0.0,25.43,75450.26
2023-05-07,2023-05-07,Project payment - Customer_0024,REF28021891,0.0,79.7,75529.96
2023-05-07,2023-05-07,Project payment - Customer_0066,REF62011365,0.0,73.72,75603.68
2023-05-07,2023-05-07,Project payment - Customer_0030,REF78719397,0.0,49.84,75653.52
2023-05-07,2023-05-07,Service payment - Customer_0071,REF50256567,0.0,56.02,75709.54
2023-05-07,2023-05-07,Invoice payment - Customer_0047,REF13072538,0.0,106.69,75816.23
2023-05-07,2023-05-07,Service payment - Customer_0062,REF19837502,0.0,57.95,75874.18
2023-05-07,2023-05-07,Inventory purchase,REF95088706,4760.84,0.0,71113.34
2023-05-07,2023-05-07,Project payment - Customer_0022,REF79776616,0.0,78.79,71192.13
2023-05-07,2023-05-07,Payment from Customer_0097,REF97650854,0.0,70.92,71263.05
2023-05-08,2023-05-08,Payment from Customer_0005,REF21329154,0.0,40.4,71303.45
2023-05-08,2023-05-08,Payment from Customer_0076,REF22698486,0.0,12.76,71316.21
2023-05-08,2023-05-08,Payment from Customer_0082,REF15485631,0.0,188.37,71504.58
2023-05-08,2023-05-08,Service payment - Customer_0071,REF93007847,0.0,39.61,71544.19
2023-05-08,2023-05-08,Pos Systems expense,REF34293859,61.29,0.0,71482.9
2023-05-08,2023-05-08,Employee payroll,REF42423568,2305.17,0.0,69177.73
2023-05-08,2023-05-08,Service payment - Customer_0019,REF28345851,0.0,105.21,69282.94
2023-05-08,2023-05-08,Service payment - Customer_0089,REF33110108,0.0,187.56,69470.5
2023-05-08,2023-05-08,Invoice payment - Customer_0062,REF73352770,0.0,75.37,69545.87
2023-05-08,2023-05-08,Payment from Customer_0007,REF86049820,0.0,165.54,69711.41
2023-05-09,2023-05-09,Invoice payment - Customer_0093,REF69825271,0.0,120.63,69832.04
2023-05-09,2023-05-09,Payment from Customer_0050,REF60025658,0.0,171.88,70003.92
2023-05-09,2023-05-09,Payment from Customer_0073,REF27082725,0.0,82.28,70086.2
2023-05-09,2023-05-09,Payment from Customer_0055,REF32350604,0.0,67.65,70153.85
2023-05-09,2023-05-09,Project payment - Customer_0066,REF79340982,0.0,53.0,70206.85
2023-05-09,2023-05-09,Project payment - Customer_0072,REF83520165,0.0,129.39,70336.24
2023-05-09,2023-05-09,Payment from Customer_0002,REF83856178,0.0,93.35,70429.59
2023-05-09,2023-05-09,Payment from Customer_0036,REF78828004,0.0,85.82,70515.41
2023-05-09,2023-05-09,Payment from Customer_0067,REF44462892,0.0,132.08,70647.49
2023-05-10,2023-05-10,Project payment - Customer_0007,REF27548088,0.0,171.58,70819.07
2023-05-10,2023-05-10,Service payment - Customer_0078,REF34037485,0.0,127.27,70946.34
2023-05-10,2023-05-10,Service payment - Customer_0096,REF78257278,0.0,102.42,71048.76
2023-05-10,2023-05-10,Service payment - Customer_0087,REF83085359,0.0,109.95,71158.71
2023-05-10,2023-05-10,Invoice payment - Customer_0058,REF23902260,0.0,39.47,71198.18
2023-05-10,2023-05-10,Project payment - Customer_0072,REF29857214,0.0,138.7,71336.88
2023-05-10,2023-05-10,Service payment - Customer_0093,REF68375335,0.0,136.13,71473.01
2023-05-10,2023-05-10,Invoice payment - Customer_0068,REF61553333,0.0,69.05,71542.06
2023-05-11,2023-05-11,Payment from Customer_0034,REF23469562,0.0,98.17,71640.23
2023-05-11,2023-05-11,Invoice payment - Customer_0039,REF41546373,0.0,122.1,71762.33
2023-05-11,2023-05-11,Project payment - Customer_0009,REF17579534,0.0,78.96,71841.29
2023-05-11,2023-05-11,Invoice payment - Customer_0006,REF47243691,0.0,107.19,71948.48
2023-05-11,2023-05-11,Project payment - Customer_0032,REF44188440,0.0,79.75,72028.23
2023-05-11,2023-05-11,Payment from Customer_0002,REF96298724,0.0,99.97,72128.2
2023-05-11,2023-05-11,Project payment - Customer_0057,REF87879600,0.0,163.11,72291.31
2023-05-11,2023-05-11,Project payment - Customer_0074,REF90028554,0.0,44.59,72335.9
2023-05-11,2023-05-11,Project payment - Customer_0058,REF99037762,0.0,57.38,72393.28
2023-05-11,2023-05-11,Project payment - Customer_0044,REF45156734,0.0,41.72,72435.0
2023-05-11,2023-05-11,Payment from Customer_0017,REF49118759,0.0,93.58,72528.58
2023-05-11,2023-05-11,Service payment - Customer_0023,REF96318582,0.0,106.25,72634.83
2023-05-12,2023-05-12,Payment from Customer_0048,REF19413187,0.0,82.12,72716.95
2023-05-12,2023-05-12,Project payment - Customer_0000,REF13987815,0.0,49.37,72766.32
2023-05-12,2023-05-12,Project payment - Customer_0083,REF82482750,0.0,73.46,72839.78
2023-05-12,2023-05-12,Invoice payment - Customer_0037,REF65317882,0.0,161.68,73001.46
2023-05-12,2023-05-12,Invoice payment - Customer_0055,REF66271103,0.0,93.12,73094.58
2023-05-12,2023-05-12,Payment from Customer_0090,REF35324924,0.0,77.96,73172.54
2023-05-12,2023-05-12,Payment from Customer_0024,REF56582332,0.0,110.1,73282.64
2023-05-12,2023-05-12,Invoice payment - Customer_0019,REF17497405,0.0,93.5,73376.14
2023-05-13,2023-05-13,Service payment - Customer_0002,REF96173292,0.0,49.92,73426.06
2023-05-13,2023-05-13,Project payment - Customer_0062,REF23722883,0.0,76.38,73502.44
2023-05-13,2023-05-13,Payment from Customer_0015,REF17332211,0.0,117.15,73619.59
2023-05-13,2023-05-13,Project payment - Customer_0031,REF70144801,0.0,109.34,73728.93
2023-05-13,2023-05-13,Payment from Customer_0032,REF93633372,0.0,78.36,73807.29
2023-05-13,2023-05-13,Service payment - Customer_0080,REF29169829,0.0,41.53,73848.82
2023-05-13,2023-05-13,Payment from Customer_0071,REF65396714,0.0,49.1,73897.92
2023-05-14,2023-05-14,Service payment - Customer_0063,REF73746811,0.0,89.4,73987.32
2023-05-14,2023-05-14,Payment from Customer_0012,REF32226314,0.0,61.45,74048.77
2023-05-14,2023-05-14,Service payment - Customer_0044,REF37394122,0.0,41.2,74089.97
2023-05-14,2023-05-14,Service payment - Customer_0073,REF30044013,0.0,120.67,74210.64
2023-05-14,2023-05-14,Invoice payment - Customer_0095,REF74851572,0.0,79.38,74290.02
2023-05-14,2023-05-14,Payment from Customer_0048,REF52285693,0.0,114.36,74404.38
2023-05-14,2023-05-14,Project payment - Customer_0010,REF60942774,0.0,85.17,74489.55
2023-05-14,2023-05-14,Project payment - Customer_0069,REF60654881,0.0,91.84,74581.39
2023-05-14,2023-05-14,Service payment - Customer_0009,REF12700040,0.0,69.8,74651.19
2023-05-14,2023-05-14,Project payment - Customer_0037,REF55104061,0.0,155.02,74806.21
2023-05-14,2023-05-14,Invoice payment - Customer_0015,REF28050911,0.0,118.53,74924.74
2023-05-15,2023-05-15,Payment from Customer_0042,REF51944298,0.0,94.37,75019.11
2023-05-15,2023-05-15,Service payment - Customer_0091,REF47275938,0.0,116.84,75135.95
2023-05-15,2023-05-15,Project payment - Customer_0082,REF74973537,0.0,178.23,75314.18
2023-05-15,2023-05-15,Payment from Customer_0076,REF83105182,0.0,11.37,75325.55
2023-05-15,2023-05-15,Project payment - Customer_0070,REF16443380,0.0,40.98,75366.53
2023-05-15,2023-05-15,Business insurance premium,REF22779066,203.01,0.0,75163.52
2023-05-15,2023-05-15,Project payment - Customer_0061,REF94720853,0.0,134.81,75298.33
2023-05-15,2023-05-15,Payment from Customer_0056,REF24185355,0.0,37.28,75335.61
2023-05-15,2023-05-15,Payment from Customer_0099,REF25307763,0.0,53.82,75389.43
2023-05-15,2023-05-15,Service payment - Customer_0021,REF30436276,0.0,64.66,75454.09
2023-05-16,2023-05-16,Invoice payment - Customer_0012,REF26282370,0.0,58.97,75513.06
2023-05-16,2023-05-16,Invoice payment - Customer_0053,REF54145540,0.0,134.24,75647.3
2023-05-16,2023-05-16,Service payment - Customer_0089,REF30148549,0.0,103.35,75750.65
2023-05-16,2023-05-16,Invoice payment - Customer_0011,REF91565219,0.0,86.59,75837.24
2023-05-16,2023-05-16,Invoice payment - Customer_0073,REF11227452,0.0,123.93,75961.17
2023-05-16,2023-05-16,Invoice payment - Customer_0022,REF14048407,0.0,52.25,76013.42
2023-05-16,2023-05-16,Invoice payment - Customer_0082,REF54206231,0.0,145.7,76159.12
2023-05-16,2023-05-16,Payment from Customer_0016,REF44889042,0.0,44.87,76203.99
2023-05-16,2023-05-16,Invoice payment - Customer_0068,REF44656297,0.0,43.83,76247.82
2023-05-17,2023-05-17,Project payment - Customer_0062,REF44863412,0.0,77.4,76325.22
2023-05-17,2023-05-17,Service payment - Customer_0004,REF97710884,0.0,54.15,76379.37
2023-05-17,2023-05-17,Service payment - Customer_0007,REF49496196,0.0,115.2,76494.57
2023-05-17,2023-05-17,Service payment - Customer_0050,REF51215966,0.0,142.26,76636.83
2023-05-17,2023-05-17,Service payment - Customer_0022,REF21624300,0.0,78.43,76715.26
2023-05-17,2023-05-17,Payment from Customer_0021,REF45883478,0.0,93.85,76809.11
2023-05-17,2023-05-17,Project payment - Customer_0072,REF46383309,0.0,134.55,76943.66
2023-05-17,2023-05-17,Project payment - Customer_0018,REF65303772,0.0,55.67,76999.33
2023-05-18,2023-05-18,Invoice payment - Customer_0055,REF90939154,0.0,69.39,77068.72
2023-05-18,2023-05-18,Payment from Customer_0017,REF50073607,0.0,93.31,77162.03
2023-05-19,2023-05-19,Project payment - Customer_0046,REF56539783,0.0,136.18,77298.21
2023-05-19,2023-05-19,Invoice payment - Customer_0018,REF22105461,0.0,103.67,77401.88
2023-05-19,2023-05-19,Payment from Customer_0098,REF46417905,0.0,86.28,77488.16
2023-05-19,2023-05-19,Invoice payment - Customer_0041,REF80343639,0.0,146.09,77634.25
2023-05-19,2023-05-19,Payment from Customer_0059,REF34523952,0.0,71.66,77705.91
2023-05-19,2023-05-19,Pos Systems expense,REF41469922,42.16,0.0,77663.75
2023-05-19,2023-05-19,Project payment - Customer_0090,REF95405145,0.0,77.15,77740.9
2023-05-19,2023-05-19,Project payment - Customer_0092,REF77287328,0.0,83.33,77824.23
2023-05-20,2023-05-20,Service payment - Customer_0072,REF70137111,0.0,130.67,77954.9
2023-05-20,2023-05-20,Project payment - Customer_0073,REF70440650,0.0,116.91,78071.81
2023-05-20,2023-05-20,Service payment - Customer_0046,REF80968917,0.0,111.26,78183.07
2023-05-20,2023-05-20,Project payment - Customer_0087,REF79851456,0.0,120.37,78303.44
2023-05-20,2023-05-20,Invoice payment - Customer_0074,REF21040469,0.0,54.13,78357.57
2023-05-20,2023-05-20,Service payment - Customer_0035,REF39914472,0.0,153.69,78511.26
2023-05-20,2023-05-20,Invoice payment - Customer_0088,REF54453198,0.0,101.8,78613.06
2023-05-21,2023-05-21,Payment from Customer_0057,REF53626027,0.0,133.02,78746.08
2023-05-21,2023-05-21,Payment from Customer_0093,REF91413485,0.0,113.98,78860.06
2023-05-21,2023-05-21,Payment from Customer_0082,REF99540379,0.0,181.47,79041.53
2023-05-21,2023-05-21,Payment from Customer_0016,REF10745687,0.0,42.05,79083.58
2023-05-21,2023-05-21,Payment from Customer_0069,REF89892447,0.0,91.17,79174.75
2023-05-21,2023-05-21,Project payment - Customer_0002,REF17372085,0.0,71.67,79246.42
2023-05-22,2023-05-22,Utility bill payment,REF59306613,179.48,0.0,79066.94
2023-05-22,2023-05-22,Service payment - Customer_0089,REF37612106,0.0,169.87,79236.81
2023-05-22,2023-05-22,Invoice payment - Customer_0028,REF81792515,0.0,116.55,79353.36
2023-05-22,2023-05-22,Invoice payment - Customer_0045,REF92822995,0.0,94.19,79447.55
2023-05-22,2023-05-22,Payment from Customer_0044,REF51135418,0.0,54.08,79501.63
2023-05-22,2023-05-22,Project payment - Customer_0097,REF12593141,0.0,76.25,79577.88
2023-05-22,2023-05-22,Service payment - Customer_0080,REF84914941,0.0,50.53,79628.41
2023-05-22,2023-05-22,Invoice payment - Customer_0099,REF90135366,0.0,46.95,79675.36
2023-05-22,2023-05-22,Payment from Customer_0043,REF37324991,0.0,133.94,79809.3
2023-05-22,2023-05-22,Invoice payment - Customer_0053,REF95506649,0.0,149.56,79958.86
2023-05-22,2023-05-22,Invoice payment - Customer_0041,REF70517616,0.0,162.03,80120.89
2023-05-22,2023-05-22,Project payment - Customer_0006,REF35303652,0.0,92.79,80213.68
2023-05-22,2023-05-22,Service payment - Customer_0077,REF55377925,0.0,112.06,80325.74
2023-05-23,2023-05-23,Professional Services expense,REF22986846,186.84,0.0,80138.9
2023-05-23,2023-05-23,Service payment - Customer_0090,REF16487759,0.0,92.85,80231.75
2023-05-23,2023-05-23,Project payment - Customer_0041,REF71016231,0.0,129.42,80361.17
2023-05-23,2023-05-23,Invoice payment - Customer_0065,REF97013626,0.0,62.26,80423.43
2023-05-23,2023-05-23,Service payment - Customer_0003,REF72646897,0.0,100.21,80523.64
2023-05-23,2023-05-23,Invoice payment - Customer_0013,REF69674137,0.0,83.26,80606.9
2023-05-23,2023-05-23,Service payment - Customer_0063,REF16908887,0.0,70.87,80677.77
2023-05-23,2023-05-23,Project payment - Customer_0054,REF34477243,0.0,71.97,80749.74
2023-05-23,2023-05-23,Invoice payment - Customer_0087,REF21058887,0.0,111.7,80861.44
2023-05-23,2023-05-23,Payment from Customer_0057,REF55453652,0.0,154.23,81015.67
2023-05-23,2023-05-23,Invoice payment - Customer_0015,REF40369189,0.0,147.03,81162.7
2023-05-23,2023-05-23,Payment from Customer_0052,REF39066736,0.0,46.45,81209.15
2023-05-24,2023-05-24,Service payment - Customer_0080,REF11345868,0.0,38.16,81247.31
2023-05-24,2023-05-24,Invoice payment - Customer_0036,REF98227302,0.0,58.16,81305.47
2023-05-24,2023-05-24,Invoice payment - Customer_0011,REF85093299,0.0,123.7,81429.17
2023-05-24,2023-05-24,Project payment - Customer_0032,REF52000791,0.0,99.15,81528.32
2023-05-24,2023-05-24,Service payment - Customer_0071,REF59876727,0.0,51.65,81579.97
2023-05-24,2023-05-24,Project payment - Customer_0029,REF79105875,0.0,76.49,81656.46
2023-05-24,2023-05-24,Service payment - Customer_0096,REF67925590,0.0,94.23,81750.69
2023-05-24,2023-05-24,Project payment - Customer_0008,REF24566994,0.0,143.85,81894.54
2023-05-24,2023-05-24,Service payment - Customer_0033,REF44268765,0.0,90.58,81985.12
2023-05-24,2023-05-24,Service payment - Customer_0068,REF80661485,0.0,47.7,82032.82
2023-05-24,2023-05-24,Invoice payment - Customer_0094,REF70866208,0.0,85.39,82118.21
2023-05-24,2023-05-24,Payment from Customer_0035,REF27317195,0.0,115.97,82234.18
2023-05-24,2023-05-24,Service payment - Customer_0073,REF52595663,0.0,106.5,82340.68
2023-05-25,2023-05-25,Project payment - Customer_0038,REF18014879,0.0,58.49,82399.17
2023-05-25,2023-05-25,Invoice payment - Customer_0003,REF60139949,0.0,84.69,82483.86
2023-05-25,2023-05-25,Payment from Customer_0078,REF78861407,0.0,159.51,82643.37
2023-05-25,2023-05-25,Payment from Customer_0047,REF69310344,0.0,84.35,82727.72
2023-05-25,2023-05-25,Invoice payment - Customer_0040,REF36169855,0.0,40.06,82767.78
2023-05-25,2023-05-25,Invoice payment - Customer_0035,REF85091733,0.0,159.07,82926.85
2023-05-25,2023-05-25,Payment from Customer_0094,REF84451519,0.0,101.64,83028.49
2023-05-26,2023-05-26,Invoice payment - Customer_0082,REF96003719,0.0,150.76,83179.25
2023-05-26,2023-05-26,Invoice payment - Customer_0052,REF34266525,0.0,52.14,83231.39
2023-05-26,2023-05-26,Service payment - Customer_0017,REF13873075,0.0,60.86,83292.25
2023-05-26,2023-05-26,Service payment - Customer_0031,REF90407515,0.0,96.35,83388.6
2023-05-26,2023-05-26,Project payment - Customer_0084,REF18250010,0.0,77.65,83466.25
2023-05-26,2023-05-26,Project payment - Customer_0075,REF89211985,0.0,112.95,83579.2
2023-05-26,2023-05-26,Project payment - Customer_0043,REF12689903,0.0,189.65,83768.85
2023-05-26,2023-05-26,Project payment - Customer_0090,REF24378383,0.0,72.4,83841.25
2023-05-26,2023-05-26,Project payment - Customer_0071,REF89099033,0.0,44.46,83885.71
2023-05-26,2023-05-26,Payment from Customer_0014,REF89343958,0.0,71.94,83957.65
2023-05-26,2023-05-26,Service payment - Customer_0056,REF23105691,0.0,38.57,83996.22
2023-05-27,2023-05-27,Service payment - Customer_0097,REF70244317,0.0,50.46,84046.68
2023-05-27,2023-05-27,Project payment - Customer_0052,REF46490943,0.0,51.9,84098.58
2023-05-27,2023-05-27,Invoice payment - Customer_0022,REF80230566,0.0,85.4,84183.98
2023-05-27,2023-05-27,Project payment - Customer_0031,REF98193077,0.0,102.68,84286.66
2023-05-27,2023-05-27,Project payment - Customer_0056,REF91010018,0.0,34.82,84321.48
2023-05-27,2023-05-27,Invoice payment - Customer_0037,REF62814449,0.0,192.93,84514.41
2023-05-27,2023-05-27,Payment from Customer_0082,REF42198695,0.0,142.23,84656.64
2023-05-27,2023-05-27,Payment from Customer_0014,REF73734471,0.0,101.45,84758.09
2023-05-27,2023-05-27,Payment from Customer_0024,REF77149354,0.0,100.79,84858.88
2023-05-27,2023-05-27,Service payment - Customer_0099,REF41232190,0.0,43.17,84902.05
2023-05-27,2023-05-27,Invoice payment - Customer_0064,REF22318916,0.0,48.2,84950.25
2023-05-28,2023-05-28,Project payment - Customer_0005,REF94688407,0.0,37.79,84988.04
2023-05-28,2023-05-28,Service payment - Customer_0092,REF17821779,0.0,72.65,85060.69
2023-05-28,2023-05-28,Payment from Customer_0043,REF57722518,0.0,145.9,85206.59
2023-05-28,2023-05-28,Service payment - Customer_0067,REF20311390,0.0,155.71,85362.3
2023-05-28,2023-05-28,Payment from Customer_0045,REF67295369,0.0,107.81,85470.11
2023-05-28,2023-05-28,Service payment - Customer_0001,REF37105476,0.0,75.95,85546.06
2023-05-28,2023-05-28,Service payment - Customer_0068,REF80096061,0.0,56.99,85603.05
2023-05-28,2023-05-28,Project payment - Customer_0047,REF62871473,0.0,140.26,85743.31
2023-05-28,2023-05-28,Invoice payment - Customer_0095,REF73883727,0.0,87.65,85830.96
2023-05-29,2023-05-29,Payment from Customer_0038,REF40040771,0.0,59.87,85890.83
2023-05-29,2023-05-29,Payment from Customer_0017,REF92210336,0.0,82.42,85973.25
2023-05-29,2023-05-29,Payment from Customer_0076,REF89949746,0.0,10.0,85983.25
2023-05-29,2023-05-29,Payment from Customer_0009,REF88862574,0.0,94.96,86078.21
2023-05-29,2023-05-29,Project payment - Customer_0089,REF47245551,0.0,148.31,86226.52
2023-05-29,2023-05-29,Service payment - Customer_0014,REF27059231,0.0,88.15,86314.67
2023-05-29,2023-05-29,Pos Systems expense,REF74197995,65.4,0.0,86249.27
2023-05-30,2023-05-30,Project payment - Customer_0050,REF81652722,0.0,163.52,86412.79
2023-05-30,2023-05-30,Project payment - Customer_0026,REF64444284,0.0,121.69,86534.48
2023-05-30,2023-05-30,Project payment - Customer_0017,REF44672248,0.0,78.01,86612.49
2023-05-30,2023-05-30,Project payment - Customer_0038,REF95538911,0.0,65.15,86677.64
2023-05-31,2023-05-31,Service payment - Customer_0006,REF65369590,0.0,58.52,86736.16
2023-05-31,2023-05-31,Payment from Customer_0074,REF43555022,0.0,63.15,86799.31
2023-05-31,2023-05-31,Invoice payment - Customer_0024,REF38047409,0.0,83.99,86883.3
2023-05-31,2023-05-31,Payment from Customer_0079,REF19869826,0.0,105.44,86988.74
2023-05-31,2023-05-31,Invoice payment - Customer_0072,REF46015800,0.0,156.0,87144.74
2023-05-31,2023-05-31,Project payment - Customer_0084,REF49859521,0.0,86.97,87231.71
2023-05-31,2023-05-31,Project payment - Customer_0048,REF96313335,0.0,105.88,87337.59
2023-05-31,2023-05-31,Payment from Customer_0011,REF47691104,0.0,119.23,87456.82
2023-05-31,2023-05-31,Service payment - Customer_0083,REF18510135,0.0,75.46,87532.28
2023-05-31,2023-05-31,Payment from Customer_0004,REF57929336,0.0,54.98,87587.26
2023-05-31,2023-05-31,Payment from Customer_0020,REF15486676,0.0,106.62,87693.88
2023-06-01,2023-06-01,Payment from Customer_0064,REF76411579,0.0,41.34,87735.22
2023-06-01,2023-06-01,Invoice payment - Customer_0072,REF50789502,0.0,91.36,87826.58
2023-06-01,2023-06-01,Payment from Customer_0052,REF79539959,0.0,46.6,87873.18
2023-06-01,2023-06-01,Payment from Customer_0008,REF10836399,0.0,82.77,87955.95
2023-06-01,2023-06-01,Invoice payment - Customer_0069,REF29856035,0.0,86.93,88042.88
2023-06-01,2023-06-01,Invoice payment - Customer_0085,REF21819096,0.0,137.96,88180.84
2023-06-01,2023-06-01,Service payment - Customer_0032,REF54730279,0.0,73.65,88254.49
2023-06-01,2023-06-01,Payment from Customer_0087,REF24254475,0.0,111.58,88366.07
2023-06-01,2023-06-01,Monthly office rent,REF27755582,1145.36,0.0,87220.71
2023-06-01,2023-06-01,Service payment - Customer_0079,REF98860496,0.0,87.01,87307.72
2023-06-01,2023-06-01,Invoice payment - Customer_0017,REF83412915,0.0,89.45,87397.17
2023-06-01,2023-06-01,Project payment - Customer_0076,REF44740711,0.0,10.45,87407.62
2023-06-01,2023-06-01,Project payment - Customer_0045,REF28504258,0.0,116.32,87523.94
2023-06-01,2023-06-01,Invoice payment - Customer_0034,REF51520667,0.0,73.72,87597.66
2023-06-02,2023-06-02,Payment from Customer_0069,REF90761928,0.0,67.12,87664.78
2023-06-02,2023-06-02,Payment from Customer_0040,REF83772170,0.0,34.69,87699.47
2023-06-02,2023-06-02,Invoice payment - Customer_0006,REF26930737,0.0,78.93,87778.4
2023-06-02,2023-06-02,Project payment - Customer_0033,REF43666611,0.0,64.48,87842.88
2023-06-02,2023-06-02,Payment from Customer_0035,REF23425765,0.0,137.73,87980.61
2023-06-02,2023-06-02,Payment from Customer_0022,REF67782782,0.0,69.8,88050.41
2023-06-03,2023-06-03,Service payment - Customer_0060,REF30162174,0.0,74.98,88125.39
2023-06-03,2023-06-03,Invoice payment - Customer_0046,REF87108158,0.0,128.15,88253.54
2023-06-03,2023-06-03,Invoice payment - Customer_0020,REF65192619,0.0,129.46,88383.0
2023-06-03,2023-06-03,Project payment - Customer_0006,REF38339556,0.0,89.12,88472.12
2023-06-03,2023-06-03,Payment from Customer_0099,REF52861520,0.0,51.61,88523.73
2023-06-03,2023-06-03,Project payment - Customer_0072,REF13989696,0.0,137.0,88660.73
2023-06-03,2023-06-03,Service payment - Customer_0053,REF80462487,0.0,149.56,88810.29
2023-06-03,2023-06-03,Payment from Customer_0063,REF65971885,0.0,77.6,88887.89
2023-06-03,2023-06-03,Project payment - Customer_0067,REF35982335,0.0,144.0,89031.89
2023-06-04,2023-06-04,Professional Services expense,REF98571563,143.17,0.0,88888.72
2023-06-04,2023-06-04,Payment from Customer_0001,REF60203955,0.0,61.29,88950.01
2023-06-04,2023-06-04,Service payment - Customer_0047,REF85342150,0.0,116.08,89066.09
2023-06-04,2023-06-04,Service payment - Customer_0060,REF67743298,0.0,82.63,89148.72
2023-06-04,2023-06-04,Invoice payment - Customer_0007,REF95667754,0.0,156.45,89305.17
2023-06-04,2023-06-04,Payment from Customer_0048,REF99739853,0.0,98.7,89403.87
2023-06-04,2023-06-04,Invoice payment - Customer_0023,REF78345863,0.0,118.49,89522.36
2023-06-04,2023-06-04,Payment from Customer_0064,REF58392334,0.0,28.51,89550.87
2023-06-04,2023-06-04,Service payment - Customer_0037,REF63024225,0.0,146.06,89696.93
2023-06-05,2023-06-05,Payment from Customer_0055,REF73040803,0.0,73.57,89770.5
2023-06-05,2023-06-05,Invoice payment - Customer_0071,REF57261534,0.0,50.24,89820.74
2023-06-05,2023-06-05,Payment from Customer_0014,REF14107474,0.0,87.33,89908.07
2023-06-05,2023-06-05,Service payment - Customer_0079,REF32963316,0.0,85.05,89993.12
2023-06-05,2023-06-05,Service payment - Customer_0024,REF76252523,0.0,91.29,90084.41
2023-06-05,2023-06-05,Project payment - Customer_0093,REF77750524,0.0,143.2,90227.61
2023-06-05,2023-06-05,Invoice payment - Customer_0099,REF88531333,0.0,42.04,90269.65
2023-06-05,2023-06-05,Service payment - Customer_0077,REF64428291,0.0,77.68,90347.33
2023-06-05,2023-06-05,Service payment - Customer_0066,REF44157626,0.0,53.54,90400.87
2023-06-05,2023-06-05,Payment from Customer_0037,REF34114003,0.0,155.9,90556.77
2023-06-05,2023-06-05,Invoice payment - Customer_0092,REF52374566,0.0,56.94,90613.71
2023-06-05,2023-06-05,Service payment - Customer_0054,REF34385344,0.0,43.86,90657.57
2023-06-05,2023-06-05,Service payment - Customer_0036,REF85379858,0.0,49.4,90706.97
2023-06-06,2023-06-06,Invoice payment - Customer_0085,REF79980959,0.0,129.71,90836.68
2023-06-06,2023-06-06,Invoice payment - Customer_0006,REF38490117,0.0,92.44,90929.12
2023-06-06,2023-06-06,Payment from Customer_0023,REF66566880,0.0,105.1,91034.22
2023-06-06,2023-06-06,Payment from Customer_0007,REF71789362,0.0,183.03,91217.25
2023-06-07,2023-06-07,Payment from Customer_0099,REF96566760,0.0,45.8,91263.05
2023-06-07,2023-06-07,Payment from Customer_0031,REF26957799,0.0,126.9,91389.95
2023-06-07,2023-06-07,Service payment - Customer_0034,REF25780824,0.0,83.22,91473.17
2023-06-07,2023-06-07,Service payment - Customer_0088,REF81377911,0.0,111.85,91585.02
2023-06-07,2023-06-07,Payment from Customer_0052,REF30509043,0.0,44.52,91629.54
2023-06-07,2023-06-07,Service payment - Customer_0007,REF49018657,0.0,197.36,91826.9
2023-06-07,2023-06-07,Invoice payment - Customer_0037,REF53710588,0.0,155.55,91982.45
2023-06-07,2023-06-07,Invoice payment - Customer_0017,REF15432798,0.0,76.47,92058.92
2023-06-07,2023-06-07,Payment from Customer_0047,REF93963209,0.0,116.53,92175.45
2023-06-07,2023-06-07,Project payment - Customer_0051,REF78641309,0.0,52.34,92227.79
2023-06-07,2023-06-07,Project payment - Customer_0068,REF59412017,0.0,25.68,92253.47
2023-06-07,2023-06-07,Project payment - Customer_0000,REF14773835,0.0,48.38,92301.85
2023-06-07,2023-06-07,Payment from Customer_0010,REF75101741,0.0,86.61,92388.46
2023-06-07,2023-06-07,Service payment - Customer_0027,REF34800392,0.0,85.17,92473.63
2023-06-07,2023-06-07,Service payment - Customer_0077,REF78373074,0.0,76.93,92550.56
2023-06-08,2023-06-08,Payment from Customer_0099,REF93675156,0.0,64.68,92615.24
2023-06-08,2023-06-08,Invoice payment - Customer_0042,REF40307408,0.0,90.62,92705.86
2023-06-08,2023-06-08,Payment from Customer_0083,REF86315651,0.0,66.68,92772.54
2023-06-08,2023-06-08,Service payment - Customer_0006,REF69738329,0.0,78.24,92850.78
2023-06-08,2023-06-08,Invoice payment - Customer_0016,REF88337898,0.0,31.92,92882.7
2023-06-09,2023-06-09,Project payment - Customer_0008,REF25819414,0.0,123.55,93006.25
2023-06-09,2023-06-09,Payment from Customer_0037,REF59128204,0.0,160.31,93166.56
2023-06-09,2023-06-09,Payment from Customer_0040,REF17187860,0.0,37.23,93203.79
2023-06-09,2023-06-09,Service payment - Customer_0087,REF36709122,0.0,99.53,93303.32
2023-06-09,2023-06-09,Service payment - Customer_0090,REF19160445,0.0,71.6,93374.92
2023-06-09,2023-06-09,Payment from Customer_0036,REF88910921,0.0,54.65,93429.57
2023-06-09,2023-06-09,Invoice payment - Customer_0094,REF26918782,0.0,69.0,93498.57
2023-06-09,2023-06-09,Project payment - Customer_0070,REF70066673,0.0,58.69,93557.26
2023-06-09,2023-06-09,Service payment - Customer_0080,REF97056304,0.0,41.52,93598.78
2023-06-09,2023-06-09,Payment from Customer_0068,REF63427914,0.0,50.56,93649.34
2023-06-09,2023-06-09,Invoice payment - Customer_0002,REF91737072,0.0,80.5,93729.84
2023-06-10,2023-06-10,Payment from Customer_0014,REF22213611,0.0,79.93,93809.77
2023-06-10,2023-06-10,Payment from Customer_0095,REF37402540,0.0,79.7,93889.47
2023-06-10,2023-06-10,Payment from Customer_0026,REF86260767,0.0,79.11,93968.58
2023-06-10,2023-06-10,Project payment - Customer_0086,REF17192961,0.0,83.46,94052.04
2023-06-10,2023-06-10,Payment from Customer_0021,REF89082231,0.0,49.19,94101.23
2023-06-10,2023-06-10,Project payment - Customer_0055,REF40394409,0.0,84.03,94185.26
2023-06-10,2023-06-10,Invoice payment - Customer_0058,REF16117056,0.0,44.9,94230.16
2023-06-10,2023-06-10,Payment from Customer_0012,REF35634366,0.0,71.43,94301.59
2023-06-10,2023-06-10,Invoice payment - Customer_0020,REF69221943,0.0,113.6,94415.19
2023-06-10,2023-06-10,Employee payroll,REF56463532,2125.49,0.0,92289.7
2023-06-10,2023-06-10,Project payment - Customer_0043,REF31652097,0.0,164.76,92454.46
2023-06-10,2023-06-10,Invoice payment - Customer_0016,REF19823388,0.0,35.51,92489.97
2023-06-10,2023-06-10,Project payment - Customer_0079,REF57794306,0.0,84.46,92574.43
2023-06-10,2023-06-10,Invoice payment - Customer_0024,REF60855491,0.0,79.13,92653.56
2023-06-10,2023-06-10,Service payment - Customer_0051,REF76909163,0.0,73.68,92727.24
2023-06-11,2023-06-11,Project payment - Customer_0048,REF21878156,0.0,68.86,92796.1
2023-06-11,2023-06-11,Invoice payment - Customer_0011,REF12465415,0.0,107.1,92903.2
2023-06-11,2023-06-11,Project payment - Customer_0021,REF71526058,0.0,65.14,92968.34
2023-06-11,2023-06-11,Invoice payment - Customer_0085,REF85674415,0.0,113.2,93081.54
2023-06-11,2023-06-11,Project payment - Customer_0099,REF13729662,0.0,40.43,93121.97
2023-06-12,2023-06-12,Invoice payment - Customer_0017,REF15589968,0.0,93.29,93215.26
2023-06-12,2023-06-12,Project payment - Customer_0091,REF70728882,0.0,150.61,93365.87
2023-06-12,2023-06-12,Payment from Customer_0025,REF34086293,0.0,114.07,93479.94
2023-06-12,2023-06-12,Project payment - Customer_0067,REF53296369,0.0,110.92,93590.86
2023-06-12,2023-06-12,Payment from Customer_0057,REF72569909,0.0,147.14,93738.0
2023-06-12,2023-06-12,Invoice payment - Customer_0095,REF40420650,0.0,89.54,93827.54
2023-06-12,2023-06-12,Payment from Customer_0036,REF55790541,0.0,54.27,93881.81
2023-06-12,2023-06-12,Service payment - Customer_0094,REF22355868,0.0,60.82,93942.63
2023-06-12,2023-06-12,Project payment - Customer_0054,REF80918344,0.0,68.62,94011.25
2023-06-12,2023-06-12,Payment from Customer_0028,REF94910466,0.0,102.84,94114.09
2023-06-13,2023-06-13,Invoice payment - Customer_0054,REF68492861,0.0,75.18,94189.27
2023-06-13,2023-06-13,Service payment - Customer_0013,REF69906000,0.0,55.44,94244.71
2023-06-13,2023-06-13,Invoice payment - Customer_0029,REF61829054,0.0,67.89,94312.6
2023-06-13,2023-06-13,Payment from Customer_0024,REF46571604,0.0,97.46,94410.06
2023-06-13,2023-06-13,Project payment - Customer_0014,REF80009024,0.0,101.01,94511.07
2023-06-13,2023-06-13,Service payment - Customer_0007,REF62821440,0.0,181.37,94692.44
2023-06-13,2023-06-13,Payment from Customer_0091,REF73290796,0.0,174.41,94866.85
2023-06-13,2023-06-13,Service payment - Customer_0048,REF29960524,0.0,96.92,94963.77
2023-06-14,2023-06-14,Payment from Customer_0026,REF24276077,0.0,130.53,95094.3
2023-06-14,2023-06-14,Project payment - Customer_0064,REF30736898,0.0,38.86,95133.16
2023-06-14,2023-06-14,Invoice payment - Customer_0045,REF43219228,0.0,116.03,95249.19
2023-06-14,2023-06-14,Project payment - Customer_0035,REF96158037,0.0,133.66,95382.85
2023-06-14,2023-06-14,Payment from Customer_0079,REF94183839,0.0,83.27,95466.12
2023-06-14,2023-06-14,Project payment - Customer_0078,REF43924074,0.0,126.45,95592.57
2023-06-14,2023-06-14,Payment from Customer_0018,REF17944378,0.0,82.68,95675.25
2023-06-14,2023-06-14,Payment from Customer_0048,REF22727208,0.0,96.51,95771.76
2023-06-15,2023-06-15,Payment from Customer_0054,REF96683537,0.0,69.91,95841.67
2023-06-15,2023-06-15,Invoice payment - Customer_0026,REF91692019,0.0,84.12,95925.79
2023-06-15,2023-06-15,Payment from Customer_0007,REF75386452,0.0,179.04,96104.83
2023-06-15,2023-06-15,Service payment - Customer_0041,REF95648447,0.0,154.26,96259.09
2023-06-15,2023-06-15,Service payment - Customer_0065,REF42734890,0.0,44.81,96303.9
2023-06-15,2023-06-15,Project payment - Customer_0076,REF87880286,0.0,11.6,96315.5
2023-06-15,2023-06-15,Payment from Customer_0084,REF35754033,0.0,74.24,96389.74
2023-06-15,2023-06-15,Invoice payment - Customer_0032,REF43473535,0.0,51.53,96441.27
2023-06-15,2023-06-15,Payment from Customer_0051,REF74102044,0.0,78.59,96519.86
2023-06-15,2023-06-15,Business insurance premium,REF82916282,197.64,0.0,96322.22
2023-06-16,2023-06-16,Invoice payment - Customer_0057,REF68172137,0.0,96.7,96418.92
2023-06-16,2023-06-16,Payment from Customer_0053,REF55197764,0.0,96.11,96515.03
2023-06-16,2023-06-16,Payment from Customer_0025,REF33451283,0.0,112.03,96627.06
2023-06-16,2023-06-16,Service payment - Customer_0005,REF57992781,0.0,40.6,96667.66
2023-06-16,2023-06-16,Payment from Customer_0002,REF69277092,0.0,91.14,96758.8
2023-06-16,2023-06-16,Invoice payment - Customer_0028,REF32979447,0.0,78.29,96837.09
2023-06-16,2023-06-16,Project payment - Customer_0020,REF76128024,0.0,125.72,96962.81
2023-06-16,2023-06-16,Project payment - Customer_0037,REF90808643,0.0,152.86,97115.67
2023-06-16,2023-06-16,Invoice payment - Customer_0090,REF23325491,0.0,92.28,97207.95
2023-06-16,2023-06-16,Payment from Customer_0050,REF57938283,0.0,177.55,97385.5
2023-06-17,2023-06-17,Service payment - Customer_0068,REF92377127,0.0,37.65,97423.15
2023-06-17,2023-06-17,Invoice payment - Customer_0078,REF35195129,0.0,131.77,97554.92
2023-06-17,2023-06-17,Invoice payment - Customer_0083,REF29866215,0.0,58.18,97613.1
2023-06-17,2023-06-17,Invoice payment - Customer_0053,REF69205818,0.0,123.26,97736.36
2023-06-17,2023-06-17,Project payment - Customer_0065,REF75172169,0.0,55.31,97791.67
2023-06-17,2023-06-17,Project payment - Customer_0045,REF72523260,0.0,121.18,97912.85
2023-06-17,2023-06-17,Service payment - Customer_0079,REF51829389,0.0,79.39,97992.24
2023-06-17,2023-06-17,Payment from Customer_0077,REF10008604,0.0,107.32,98099.56
2023-06-17,2023-06-17,Service payment - Customer_0041,REF55988217,0.0,128.71,98228.27
2023-06-17,2023-06-17,Payment from Customer_0039,REF60370825,0.0,159.88,98388.15
2023-06-17,2023-06-17,Project payment - Customer_0094,REF42184462,0.0,88.51,98476.66
2023-06-18,2023-06-18,Project payment - Customer_0099,REF61809324,0.0,47.04,98523.7
2023-06-18,2023-06-18,Payment from Customer_0076,REF87375044,0.0,10.0,98533.7
2023-06-18,2023-06-18,Payment from Customer_0085,REF50578049,0.0,84.61,98618.31
2023-06-18,2023-06-18,Invoice payment - Customer_0095,REF25699907,0.0,81.2,98699.51
2023-06-18,2023-06-18,Service payment - Customer_0025,REF86946688,0.0,103.96,98803.47
2023-06-18,2023-06-18,Project payment - Customer_0069,REF73530526,0.0,80.35,98883.82
2023-06-18,2023-06-18,Project payment - Customer_0037,REF93316401,0.0,132.69,99016.51
2023-06-18,2023-06-18,Payment from Customer_0080,REF71972450,0.0,34.15,99050.66
2023-06-18,2023-06-18,Project payment - Customer_0067,REF42946522,0.0,164.05,99214.71
2023-06-18,2023-06-18,Service payment - Customer_0013,REF58844315,0.0,76.64,99291.35
2023-06-18,2023-06-18,Payment from Customer_0007,REF49611327,0.0,139.7,99431.05
2023-06-18,2023-06-18,Payment from Customer_0039,REF24899928,0.0,124.45,99555.5
2023-06-18,2023-06-18,Project payment - Customer_0045,REF88274228,0.0,92.47,99647.97
2023-06-18,2023-06-18,Service payment - Customer_0004,REF57911736,0.0,43.89,99691.86
2023-06-19,2023-06-19,Payment from Customer_0021,REF48503748,0.0,62.7,99754.56
2023-06-19,2023-06-19,Project payment - Customer_0030,REF51068145,0.0,42.91,99797.47
2023-06-19,2023-06-19,Service payment - Customer_0082,REF56275533,0.0,105.8,99903.27
2023-06-19,2023-06-19,Invoice payment - Customer_0069,REF25377925,0.0,77.8,99981.07
2023-06-19,2023-06-19,Service payment - Customer_0096,REF21558895,0.0,110.63,100091.7
2023-06-19,2023-06-19,Project payment - Customer_0047,REF99997936,0.0,88.3,100180.0
2023-06-19,2023-06-19,Payment from Customer_0048,REF43672553,0.0,82.86,100262.86
2023-06-19,2023-06-19,Invoice payment - Customer_0034,REF82916895,0.0,95.4,100358.26
2023-06-19,2023-06-19,Service payment - Customer_0062,REF47182740,0.0,68.1,100426.36
2023-06-19,2023-06-19,Payment from Customer_0086,REF23575611,0.0,93.13,100519.49
2023-06-19,2023-06-19,Service payment - Customer_0070,REF60575793,0.0,58.83,100578.32
2023-06-19,2023-06-19,Service payment - Customer_0076,REF20425147,0.0,11.3,100589.62
2023-06-20,2023-06-20,Invoice payment - Customer_0060,REF98690172,0.0,90.36,100679.98
2023-06-20,2023-06-20,Payment from Customer_0062,REF48809385,0.0,60.75,100740.73
2023-06-20,2023-06-20,Invoice payment - Customer_0017,REF61203800,0.0,72.78,100813.51
2023-06-20,2023-06-20,Service payment - Customer_0022,REF12081328,0.0,54.68,100868.19
2023-06-20,2023-06-20,Invoice payment - Customer_0053,REF52965940,0.0,158.61,101026.8
2023-06-20,2023-06-20,Payment from Customer_0051,REF77917258,0.0,84.03,101110.83
2023-06-20,2023-06-20,Service payment - Customer_0014,REF51608200,0.0,72.47,101183.3
2023-06-20,2023-06-20,Payment from Customer_0085,REF85448357,0.0,90.7,101274.0
2023-06-20,2023-06-20,Service payment - Customer_0037,REF84935170,0.0,152.15,101426.15
2023-06-21,2023-06-21,Service payment - Customer_0061,REF72782515,0.0,116.6,101542.75
2023-06-21,2023-06-21,Project payment - Customer_0022,REF69628111,0.0,68.8,101611.55
2023-06-21,2023-06-21,Payment from Customer_0006,REF95198731,0.0,76.34,101687.89
2023-06-21,2023-06-21,Service payment - Customer_0051,REF80163882,0.0,102.44,101790.33
2023-06-21,2023-06-21,Project payment - Customer_0097,REF65876135,0.0,64.84,101855.17
2023-06-21,2023-06-21,Invoice payment - Customer_0004,REF97637023,0.0,46.91,101902.08
2023-06-21,2023-06-21,Service payment - Customer_0034,REF31947671,0.0,102.49,102004.57
2023-06-21,2023-06-21,Service payment - Customer_0092,REF37679406,0.0,73.61,102078.18
2023-06-22,2023-06-22,Invoice payment - Customer_0049,REF25569794,0.0,86.46,102164.64
2023-06-22,2023-06-22,Project payment - Customer_0078,REF27501555,0.0,90.87,102255.51
2023-06-22,2023-06-22,Project payment - Customer_0000,REF52029054,0.0,43.09,102298.6
2023-06-22,2023-06-22,Project payment - Customer_0042,REF51927921,0.0,110.49,102409.09
2023-06-22,2023-06-22,Service payment - Customer_0063,REF84048687,0.0,56.73,102465.82
2023-06-22,2023-06-22,Service payment - Customer_0076,REF95197565,0.0,11.12,102476.94
2023-06-22,2023-06-22,Service payment - Customer_0029,REF52769962,0.0,84.53,102561.47
2023-06-22,2023-06-22,Utility bill payment,REF85738564,149.48,0.0,102411.99
2023-06-23,2023-06-23,Project payment - Customer_0006,REF45332439,0.0,66.24,102478.23
2023-06-23,2023-06-23,Invoice payment - Customer_0009,REF86768451,0.0,86.32,102564.55
2023-06-23,2023-06-23,Project payment - Customer_0032,REF12638998,0.0,85.44,102649.99
2023-06-23,2023-06-23,Service payment - Customer_0082,REF18428169,0.0,173.4,102823.39
2023-06-23,2023-06-23,Invoice payment - Customer_0013,REF15811375,0.0,71.76,102895.15
2023-06-23,2023-06-23,Invoice payment - Customer_0078,REF73005410,0.0,130.46,103025.61
2023-06-23,2023-06-23,Invoice payment - Customer_0037,REF13778179,0.0,154.77,103180.38
2023-06-23,2023-06-23,Invoice payment - Customer_0026,REF39112142,0.0,114.04,103294.42
2023-06-23,2023-06-23,Project payment - Customer_0024,REF44366646,0.0,84.73,103379.15
2023-06-24,2023-06-24,Payment from Customer_0099,REF65206641,0.0,43.94,103423.09
2023-06-24,2023-06-24,Payment from Customer_0015,REF29193479,0.0,127.49,103550.58
2023-06-24,2023-06-24,Payment from Customer_0032,REF63050367,0.0,74.04,103624.62
2023-06-24,2023-06-24,Project payment - Customer_0052,REF97379835,0.0,55.27,103679.89
2023-06-24,2023-06-24,Invoice payment - Customer_0008,REF87994687,0.0,102.92,103782.81
2023-06-24,2023-06-24,Project payment - Customer_0026,REF81639043,0.0,107.24,103890.05
2023-06-24,2023-06-24,Project payment - Customer_0036,REF74495166,0.0,56.4,103946.45
2023-06-24,2023-06-24,Payment from Customer_0073,REF22520450,0.0,131.44,104077.89
2023-06-24,2023-06-24,Project payment - Customer_0068,REF66510526,0.0,40.2,104118.09
2023-06-24,2023-06-24,Invoice payment - Customer_0022,REF92968134,0.0,58.27,104176.36
2023-06-25,2023-06-25,Service payment - Customer_0012,REF16260419,0.0,70.14,104246.5
2023-06-25,2023-06-25,Service payment - Customer_0053,REF87345839,0.0,152.04,104398.54
2023-06-25,2023-06-25,Invoice payment - Customer_0024,REF96568086,0.0,75.82,104474.36
2023-06-25,2023-06-25,Service payment - Customer_0061,REF25473264,0.0,150.32,104624.68
2023-06-25,2023-06-25,Project payment - Customer_0067,REF39034914,0.0,109.88,104734.56
2023-06-25,2023-06-25,Payment from Customer_0034,REF25761525,0.0,87.91,104822.47
2023-06-25,2023-06-25,Service payment - Customer_0042,REF99621694,0.0,109.54,104932.01
2023-06-25,2023-06-25,Invoice payment - Customer_0064,REF49464285,0.0,34.16,104966.17
2023-06-25,2023-06-25,Service payment - Customer_0016,REF76033409,0.0,39.28,105005.45
2023-06-25,2023-06-25,Professional Services expense,REF54796987,162.01,0.0,104843.44
2023-06-25,2023-06-25,Invoice payment - Customer_0099,REF24547770,0.0,40.22,104883.66
2023-06-25,2023-06-25,Payment from Customer_0052,REF18873695,0.0,55.71,104939.37
2023-06-25,2023-06-25,Service payment - Customer_0074,REF13131866,0.0,48.56,104987.93
2023-06-26,2023-06-26,Payment from Customer_0067,REF56665384,0.0,114.52,105102.45
2023-06-26,2023-06-26,Project payment - Customer_0027,REF46179578,0.0,95.29,105197.74
2023-06-26,2023-06-26,Project payment - Customer_0033,REF98493283,0.0,73.36,105271.1
2023-06-26,2023-06-26,Project payment - Customer_0060,REF65938085,0.0,80.16,105351.26
2023-06-26,2023-06-26,Project payment - Customer_0014,REF15685944,0.0,90.52,105441.78
2023-06-26,2023-06-26,Invoice payment - Customer_0020,REF60546389,0.0,75.94,105517.72
2023-06-26,2023-06-26,Invoice payment - Customer_0070,REF52422945,0.0,51.27,105568.99
2023-06-26,2023-06-26,Inventory purchase,REF30462242,1787.54,0.0,103781.45
2023-06-27,2023-06-27,Project payment - Customer_0031,REF77841576,0.0,86.18,103867.63
2023-06-27,2023-06-27,Project payment - Customer_0025,REF90562700,0.0,111.88,103979.51
2023-06-27,2023-06-27,Service payment - Customer_0076,REF53835237,0.0,10.0,103989.51
2023-06-27,2023-06-27,Service payment - Customer_0042,REF43331009,0.0,116.63,104106.14
2023-06-27,2023-06-27,Service payment - Customer_0078,REF44542438,0.0,162.28,104268.42
2023-06-27,2023-06-27,Service payment - Customer_0007,REF86377153,0.0,132.57,104400.99
2023-06-27,2023-06-27,Invoice payment - Customer_0082,REF17062441,0.0,121.69,104522.68
2023-06-28,2023-06-28,Payment from Customer_0010,REF60409525,0.0,130.21,104652.89
2023-06-28,2023-06-28,Invoice payment - Customer_0093,REF58345205,0.0,105.69,104758.58
2023-06-28,2023-06-28,Service payment - Customer_0055,REF45214712,0.0,57.82,104816.4
2023-06-28,2023-06-28,Invoice payment - Customer_0058,REF48064050,0.0,45.31,104861.71
2023-06-28,2023-06-28,Invoice payment - Customer_0052,REF59511263,0.0,51.08,104912.79
2023-06-28,2023-06-28,Invoice payment - Customer_0051,REF37539853,0.0,92.46,105005.25
2023-06-28,2023-06-28,Project payment - Customer_0081,REF71440692,0.0,75.7,105080.95
2023-06-28,2023-06-28,Project payment - Customer_0028,REF77399697,0.0,108.03,105188.98
2023-06-28,2023-06-28,Project payment - Customer_0000,REF80156964,0.0,46.56,105235.54
2023-06-28,2023-06-28,Service payment - Customer_0004,REF93587927,0.0,53.37,105288.91
2023-06-28,2023-06-28,Service payment - Customer_0080,REF56074612,0.0,43.1,105332.01
2023-06-28,2023-06-28,Invoice payment - Customer_0095,REF15895448,0.0,86.96,105418.97
2023-06-28,2023-06-28,Service payment - Customer_0089,REF47449725,0.0,173.42,105592.39
2023-06-28,2023-06-28,Project payment - Customer_0064,REF75380245,0.0,28.96,105621.35
2023-06-29,2023-06-29,Payment from Customer_0046,REF21044927,0.0,118.34,105739.69
2023-06-29,2023-06-29,Invoice payment - Customer_0058,REF23024919,0.0,61.75,105801.44
2023-06-29,2023-06-29,Project payment - Customer_0022,REF13747950,0.0,57.64,105859.08
2023-06-29,2023-06-29,Invoice payment - Customer_0090,REF96604343,0.0,94.38,105953.46
2023-06-29,2023-06-29,Invoice payment - Customer_0011,REF45586370,0.0,143.23,106096.69
2023-06-29,2023-06-29,Project payment - Customer_0005,REF56542380,0.0,28.76,106125.45
2023-06-29,2023-06-29,Service payment - Customer_0043,REF59511826,0.0,140.21,106265.66
2023-06-29,2023-06-29,Project payment - Customer_0088,REF88398166,0.0,143.61,106409.27
2023-06-30,2023-06-30,Service payment - Customer_0065,REF10694409,0.0,39.98,106449.25
2023-06-30,2023-06-30,Project payment - Customer_0048,REF58186163,0.0,78.53,106527.78
2023-06-30,2023-06-30,Payment from Customer_0096,REF42813793,0.0,113.16,106640.94
2023-06-30,2023-06-30,Invoice payment - Customer_0088,REF74976517,0.0,137.65,106778.59
2023-06-30,2023-06-30,Invoice payment - Customer_0064,REF48869014,0.0,46.67,106825.26
2023-06-30,2023-06-30,Invoice payment - Customer_0003,REF57959217,0.0,85.97,106911.23
2023-06-30,2023-06-30,Payment from Customer_0089,REF90934856,0.0,122.49,107033.72
2023-06-30,2023-06-30,Invoice payment - Customer_0080,REF86331945,0.0,33.52,107067.24
2023-06-30,2023-06-30,Payment from Customer_0084,REF73505701,0.0,90.25,107157.49
2023-07-01,2023-07-01,Service payment - Customer_0002,REF77030858,0.0,76.29,107233.78
2023-07-01,2023-07-01,Payment from Customer_0055,REF87531804,0.0,74.62,107308.4
2023-07-01,2023-07-01,Monthly office rent,REF30453643,1282.85,0.0,106025.55
2023-07-01,2023-07-01,Invoice payment - Customer_0014,REF87975207,0.0,111.77,106137.32
2023-07-01,2023-07-01,Payment from Customer_0070,REF76308470,0.0,52.16,106189.48
2023-07-01,2023-07-01,Payment from Customer_0010,REF73469622,0.0,93.48,106282.96
2023-07-01,2023-07-01,Payment from Customer_0016,REF69688983,0.0,25.76,106308.72
2023-07-01,2023-07-01,Service payment - Customer_0035,REF35040080,0.0,100.74,106409.46
2023-07-01,2023-07-01,Payment from Customer_0000,REF86056172,0.0,47.18,106456.64
2023-07-01,2023-07-01,Invoice payment - Customer_0025,REF47008249,0.0,80.72,106537.36
2023-07-02,2023-07-02,Payment from Customer_0095,REF50564306,0.0,75.53,106612.89
2023-07-02,2023-07-02,Invoice payment - Customer_0087,REF77713802,0.0,91.95,106704.84
2023-07-02,2023-07-02,Service payment - Customer_0029,REF27920317,0.0,79.54,106784.38
2023-07-02,2023-07-02,Project payment - Customer_0085,REF12126751,0.0,129.69,106914.07
2023-07-02,2023-07-02,Service payment - Customer_0030,REF55155570,0.0,35.8,106949.87
2023-07-02,2023-07-02,Pos Systems expense,REF50293284,72.49,0.0,106877.38
2023-07-02,2023-07-02,Invoice payment - Customer_0054,REF80066552,0.0,68.1,106945.48
2023-07-02,2023-07-02,Service payment - Customer_0071,REF83991059,0.0,46.74,106992.22
2023-07-02,2023-07-02,Service payment - Customer_0066,REF38690745,0.0,71.38,107063.6
2023-07-03,2023-07-03,Project payment - Customer_0015,REF74009026,0.0,122.33,107185.93
2023-07-03,2023-07-03,Project payment - Customer_0005,REF25540330,0.0,31.44,107217.37
2023-07-03,2023-07-03,Project payment - Customer_0042,REF85134395,0.0,112.77,107330.14
2023-07-03,2023-07-03,Invoice payment - Customer_0023,REF79411545,0.0,91.75,107421.89
2023-07-03,2023-07-03,Invoice payment - Customer_0000,REF75953933,0.0,40.69,107462.58
2023-07-03,2023-07-03,Payment from Customer_0089,REF97242652,0.0,119.23,107581.81
2023-07-03,2023-07-03,Project payment - Customer_0017,REF18183479,0.0,73.15,107654.96
2023-07-03,2023-07-03,Payment from Customer_0088,REF69338405,0.0,134.59,107789.55
2023-07-03,2023-07-03,Project payment - Customer_0083,REF71225966,0.0,75.52,107865.07
2023-07-04,2023-07-04,Payment from Customer_0027,REF27640366,0.0,92.97,107958.04
2023-07-04,2023-07-04,Project payment - Customer_0083,REF34312421,0.0,36.92,107994.96
2023-07-04,2023-07-04,Service payment - Customer_0011,REF27866253,0.0,65.64,108060.6
2023-07-05,2023-07-05,Invoice payment - Customer_0039,REF32975306,0.0,114.98,108175.58
2023-07-05,2023-07-05,Service payment - Customer_0062,REF48741373,0.0,60.16,108235.74
2023-07-05,2023-07-05,Payment from Customer_0046,REF71760684,0.0,129.11,108364.85
2023-07-05,2023-07-05,Service payment - Customer_0072,REF81786440,0.0,107.56,108472.41
2023-07-05,2023-07-05,Payment from Customer_0040,REF40949825,0.0,36.59,108509.0
2023-07-05,2023-07-05,Project payment - Customer_0080,REF91153791,0.0,32.88,108541.88
2023-07-05,2023-07-05,Payment from Customer_0029,REF39125632,0.0,63.85,108605.73
2023-07-05,2023-07-05,Project payment - Customer_0036,REF69059026,0.0,63.64,108669.37
2023-07-05,2023-07-05,Invoice payment - Customer_0092,REF74534845,0.0,51.13,108720.5
2023-07-05,2023-07-05,Project payment - Customer_0084,REF78597008,0.0,89.54,108810.04
2023-07-05,2023-07-05,Payment from Customer_0020,REF27330143,0.0,80.38,108890.42
2023-07-06,2023-07-06,Service payment - Customer_0063,REF20163066,0.0,72.56,108962.98
2023-07-06,2023-07-06,Invoice payment - Customer_0043,REF80384507,0.0,85.45,109048.43
2023-07-06,2023-07-06,Service payment - Customer_0038,REF42165645,0.0,57.14,109105.57
2023-07-06,2023-07-06,Invoice payment - Customer_0029,REF92777790,0.0,66.91,109172.48
2023-07-06,2023-07-06,Payment from Customer_0069,REF74137092,0.0,82.57,109255.05
2023-07-06,2023-07-06,Payment from Customer_0079,REF52560985,0.0,117.0,109372.05
2023-07-06,2023-07-06,Service payment - Customer_0076,REF59578608,0.0,10.95,109383.0
2023-07-06,2023-07-06,Project payment - Customer_0073,REF87701157,0.0,123.34,109506.34
2023-07-06,2023-07-06,Service payment - Customer_0053,REF66416811,0.0,133.21,109639.55
2023-07-06,2023-07-06,Project payment - Customer_0055,REF27759069,0.0,51.18,109690.73
2023-07-06,2023-07-06,Project payment - Customer_0052,REF13653427,0.0,36.86,109727.59
2023-07-06,2023-07-06,Invoice payment - Customer_0078,REF75821910,0.0,156.86,109884.45
2023-07-06,2023-07-06,Project payment - Customer_0086,REF80426469,0.0,84.23,109968.68
2023-07-07,2023-07-07,Service payment - Customer_0060,REF62534065,0.0,87.67,110056.35
2023-07-07,2023-07-07,Service payment - Customer_0025,REF90140954,0.0,87.44,110143.79
2023-07-07,2023-07-07,Service payment - Customer_0076,REF58825410,0.0,10.0,110153.79
2023-07-07,2023-07-07,Invoice payment - Customer_0011,REF97438578,0.0,99.35,110253.14
2023-07-07,2023-07-07,Project payment - Customer_0099,REF77407410,0.0,69.97,110323.11
2023-07-07,2023-07-07,Invoice payment - Customer_0041,REF27870758,0.0,121.13,110444.24
2023-07-07,2023-07-07,Project payment - Customer_0052,REF57714181,0.0,50.36,110494.6
2023-07-07,2023-07-07,Payment from Customer_0015,REF23234426,0.0,154.71,110649.31
2023-07-07,2023-07-07,Project payment - Customer_0096,REF38608596,0.0,102.46,110751.77
2023-07-07,2023-07-07,Project payment - Customer_0069,REF97085821,0.0,70.17,110821.94
2023-07-07,2023-07-07,Payment from Customer_0024,REF91047240,0.0,104.24,110926.18
2023-07-07,2023-07-07,Payment from Customer_0074,REF73881973,0.0,50.59,110976.77
2023-07-08,2023-07-08,Service payment - Customer_0013,REF40053828,0.0,101.42,111078.19
2023-07-08,2023-07-08,Payment from Customer_0094,REF97572089,0.0,82.38,111160.57
2023-07-08,2023-07-08,Project payment - Customer_0040,REF57928385,0.0,31.09,111191.66
2023-07-08,2023-07-08,Payment from Customer_0004,REF82265472,0.0,47.77,111239.43
2023-07-08,2023-07-08,Invoice payment - Customer_0070,REF86623771,0.0,68.93,111308.36
2023-07-08,2023-07-08,Invoice payment - Customer_0090,REF16980887,0.0,98.07,111406.43
2023-07-08,2023-07-08,Payment from Customer_0012,REF89902120,0.0,79.32,111485.75
2023-07-08,2023-07-08,Payment from Customer_0049,REF96345525,0.0,93.55,111579.3
2023-07-08,2023-07-08,Service payment - Customer_0043,REF30904303,0.0,149.49,111728.79
2023-07-08,2023-07-08,Invoice payment - Customer_0002,REF30442467,0.0,97.6,111826.39
2023-07-08,2023-07-08,Service payment - Customer_0071,REF36162642,0.0,47.45,111873.84
2023-07-08,2023-07-08,Service payment - Customer_0031,REF79750771,0.0,74.19,111948.03
2023-07-08,2023-07-08,Project payment - Customer_0078,REF57868361,0.0,125.24,112073.27
2023-07-09,2023-07-09,Service payment - Customer_0021,REF26022570,0.0,59.98,112133.25
2023-07-09,2023-07-09,Project payment - Customer_0076,REF92276535,0.0,10.0,112143.25
2023-07-09,2023-07-09,Invoice payment - Customer_0059,REF43211772,0.0,72.39,112215.64
2023-07-09,2023-07-09,Invoice payment - Customer_0079,REF24950544,0.0,93.49,112309.13
2023-07-09,2023-07-09,Service payment - Customer_0016,REF31926356,0.0,44.61,112353.74
2023-07-09,2023-07-09,Invoice payment - Customer_0034,REF32686381,0.0,77.97,112431.71
2023-07-09,2023-07-09,Project payment - Customer_0067,REF42516815,0.0,121.17,112552.88
2023-07-09,2023-07-09,Project payment - Customer_0077,REF23069942,0.0,78.2,112631.08
2023-07-09,2023-07-09,Service payment - Customer_0092,REF43482902,0.0,61.89,112692.97
2023-07-09,2023-07-09,Project payment - Customer_0053,REF86246352,0.0,90.8,112783.77
2023-07-10,2023-07-10,Payment from Customer_0022,REF30284128,0.0,69.16,112852.93
2023-07-10,2023-07-10,Invoice payment - Customer_0096,REF54244543,0.0,87.07,112940.0
2023-07-10,2023-07-10,Invoice payment - Customer_0086,REF32777211,0.0,90.58,113030.58
2023-07-10,2023-07-10,Invoice payment - Customer_0039,REF43260095,0.0,119.09,113149.67
2023-07-10,2023-07-10,Payment from Customer_0020,REF51587064,0.0,116.71,113266.38
2023-07-10,2023-07-10,Packaging Shipping expense,REF49230970,76.07,0.0,113190.31
2023-07-10,2023-07-10,Invoice payment - Customer_0003,REF59730911,0.0,78.1,113268.41
2023-07-10,2023-07-10,Service payment - Customer_0056,REF35553984,0.0,28.25,113296.66
2023-07-10,2023-07-10,Project payment - Customer_0099,REF68219935,0.0,53.59,113350.25
2023-07-10,2023-07-10,Project payment - Customer_0009,REF44177151,0.0,88.67,113438.92
2023-07-10,2023-07-10,Invoice payment - Customer_0066,REF28316090,0.0,69.52,113508.44
2023-07-10,2023-07-10,Invoice payment - Customer_0042,REF53020946,0.0,84.29,113592.73
2023-07-11,2023-07-11,Service payment - Customer_0049,REF56350789,0.0,96.17,113688.9
2023-07-11,2023-07-11,Service payment - Customer_0095,REF71486276,0.0,72.7,113761.6
2023-07-11,2023-07-11,Invoice payment - Customer_0093,REF93688596,0.0,101.82,113863.42
2023-07-11,2023-07-11,Invoice payment - Customer_0006,REF67481219,0.0,68.86,113932.28
2023-07-11,2023-07-11,Invoice payment - Customer_0024,REF60663778,0.0,109.2,114041.48
2023-07-11,2023-07-11,Invoice payment - Customer_0052,REF63146467,0.0,38.51,114079.99
2023-07-11,2023-07-11,Payment from Customer_0080,REF16600922,0.0,35.58,114115.57
2023-07-11,2023-07-11,Payment from Customer_0011,REF19068566,0.0,102.27,114217.84
2023-07-11,2023-07-11,Service payment - Customer_0097,REF33924690,0.0,59.38,114277.22
2023-07-11,2023-07-11,Service payment - Customer_0098,REF10921333,0.0,88.73,114365.95
2023-07-11,2023-07-11,Project payment - Customer_0067,REF89083640,0.0,130.55,114496.5
2023-07-12,2023-07-12,Project payment - Customer_0031,REF68612712,0.0,131.43,114627.93
2023-07-12,2023-07-12,Payment from Customer_0005,REF47310963,0.0,37.29,114665.22
2023-07-12,2023-07-12,Payment from Customer_0084,REF81905960,0.0,63.92,114729.14
2023-07-12,2023-07-12,Payment from Customer_0075,REF62992618,0.0,146.54,114875.68
2023-07-12,2023-07-12,Service payment - Customer_0092,REF14929234,0.0,64.78,114940.46
2023-07-12,2023-07-12,Invoice payment - Customer_0048,REF94439778,0.0,104.44,115044.9
2023-07-12,2023-07-12,Invoice payment - Customer_0043,REF27089861,0.0,111.98,115156.88
2023-07-12,2023-07-12,Service payment - Customer_0067,REF47349097,0.0,135.0,115291.88
2023-07-12,2023-07-12,Payment from Customer_0040,REF12126108,0.0,36.04,115327.92
2023-07-12,2023-07-12,Invoice payment - Customer_0057,REF23628680,0.0,154.43,115482.35
2023-07-13,2023-07-13,Project payment - Customer_0023,REF59950626,0.0,100.28,115582.63
2023-07-13,2023-07-13,Service payment - Customer_0025,REF63446375,0.0,120.17,115702.8
2023-07-13,2023-07-13,Invoice payment - Customer_0005,REF53333925,0.0,37.74,115740.54
2023-07-13,2023-07-13,Payment from Customer_0048,REF43205980,0.0,96.04,115836.58
2023-07-13,2023-07-13,Payment from Customer_0062,REF24242218,0.0,59.82,115896.4
2023-07-13,2023-07-13,Invoice payment - Customer_0004,REF30730330,0.0,36.9,115933.3
2023-07-13,2023-07-13,Project payment - Customer_0056,REF66448395,0.0,26.12,115959.42
2023-07-13,2023-07-13,Project payment - Customer_0068,REF62685038,0.0,42.41,116001.83
2023-07-14,2023-07-14,Payment from Customer_0060,REF41739558,0.0,79.9,116081.73
2023-07-14,2023-07-14,Project payment - Customer_0014,REF82117213,0.0,85.76,116167.49
2023-07-14,2023-07-14,Payment from Customer_0040,REF24141131,0.0,31.14,116198.63
2023-07-14,2023-07-14,Payment from Customer_0025,REF89425116,0.0,144.3,116342.93
2023-07-14,2023-07-14,Service payment - Customer_0003,REF59600937,0.0,67.02,116409.95
2023-07-14,2023-07-14,Service payment - Customer_0054,REF12099299,0.0,76.72,116486.67
2023-07-14,2023-07-14,Service payment - Customer_0001,REF98319963,0.0,58.63,116545.3
2023-07-15,2023-07-15,Project payment - Customer_0019,REF51068619,0.0,87.91,116633.21
2023-07-15,2023-07-15,Invoice payment - Customer_0051,REF65577790,0.0,65.58,116698.79
2023-07-15,2023-07-15,Service payment - Customer_0001,REF24024120,0.0,68.24,116767.03
2023-07-15,2023-07-15,Service payment - Customer_0029,REF83143365,0.0,80.13,116847.16
2023-07-15,2023-07-15,Project payment - Customer_0079,REF34941632,0.0,98.68,116945.84
2023-07-15,2023-07-15,Business insurance premium,REF12482437,186.73,0.0,116759.11
2023-07-15,2023-07-15,Invoice payment - Customer_0096,REF21500523,0.0,96.31,116855.42
2023-07-15,2023-07-15,Payment from Customer_0068,REF78084369,0.0,43.25,116898.67
2023-07-15,2023-07-15,Project payment - Customer_0038,REF83011969,0.0,57.08,116955.75
2023-07-15,2023-07-15,Project payment - Customer_0009,REF32759204,0.0,59.85,117015.6
2023-07-15,2023-07-15,Project payment - Customer_0056,REF71381715,0.0,45.61,117061.21
2023-07-15,2023-07-15,Invoice payment - Customer_0045,REF46805003,0.0,115.01,117176.22
2023-07-15,2023-07-15,Project payment - Customer_0098,REF99451084,0.0,95.03,117271.25
2023-07-15,2023-07-15,Invoice payment - Customer_0042,REF22523384,0.0,107.17,117378.42
2023-07-16,2023-07-16,Payment from Customer_0022,REF18551110,0.0,67.64,117446.06
2023-07-16,2023-07-16,Project payment - Customer_0025,REF63406444,0.0,126.08,117572.14
2023-07-16,2023-07-16,Invoice payment - Customer_0076,REF37236813,0.0,11.34,117583.48
2023-07-16,2023-07-16,Pos Systems expense,REF98302980,41.76,0.0,117541.72
2023-07-17,2023-07-17,Marketing expenses,REF81994990,170.99,0.0,117370.73
2023-07-17,2023-07-17,Payment from Customer_0001,REF95915447,0.0,69.31,117440.04
2023-07-17,2023-07-17,Service payment - Customer_0082,REF18281417,0.0,173.39,117613.43
2023-07-17,2023-07-17,Project payment - Customer_0006,REF18696015,0.0,79.52,117692.95
2023-07-17,2023-07-17,Service payment - Customer_0093,REF44419633,0.0,127.25,117820.2
2023-07-17,2023-07-17,Service payment - Customer_0088,REF17265567,0.0,121.11,117941.31
2023-07-17,2023-07-17,Project payment - Customer_0064,REF80829363,0.0,40.61,117981.92
2023-07-18,2023-07-18,Service payment - Customer_0010,REF17565332,0.0,80.56,118062.48
2023-07-18,2023-07-18,Invoice payment - Customer_0025,REF82787981,0.0,104.6,118167.08
2023-07-18,2023-07-18,Project payment - Customer_0006,REF78803081,0.0,75.07,118242.15
2023-07-18,2023-07-18,Invoice payment - Customer_0015,REF59863437,0.0,118.11,118360.26
2023-07-18,2023-07-18,Service payment - Customer_0045,REF54980379,0.0,116.01,118476.27
2023-07-18,2023-07-18,Payment from Customer_0014,REF41301003,0.0,97.53,118573.8
2023-07-18,2023-07-18,Payment from Customer_0066,REF46153623,0.0,58.5,118632.3
2023-07-18,2023-07-18,Payment from Customer_0098,REF90859167,0.0,89.85,118722.15
2023-07-18,2023-07-18,Invoice payment - Customer_0013,REF94385957,0.0,89.21,118811.36
2023-07-19,2023-07-19,Project payment - Customer_0018,REF20658117,0.0,51.54,118862.9
2023-07-19,2023-07-19,Invoice payment - Customer_0014,REF18461153,0.0,104.63,118967.53
2023-07-19,2023-07-19,Service payment - Customer_0011,REF67738998,0.0,91.85,119059.38
2023-07-19,2023-07-19,Service payment - Customer_0005,REF60789065,0.0,32.68,119092.06
2023-07-19,2023-07-19,Payment from Customer_0017,REF67050073,0.0,69.33,119161.39
2023-07-19,2023-07-19,Service payment - Customer_0001,REF89993409,0.0,60.15,119221.54
2023-07-19,2023-07-19,Project payment - Customer_0096,REF28692100,0.0,97.04,119318.58
2023-07-19,2023-07-19,Service payment - Customer_0044,REF47181684,0.0,35.73,119354.31
2023-07-19,2023-07-19,Service payment - Customer_0042,REF12331013,0.0,79.9,119434.21
2023-07-19,2023-07-19,Invoice payment - Customer_0012,REF95424927,0.0,82.63,119516.84
2023-07-19,2023-07-19,Invoice payment - Customer_0048,REF77630395,0.0,115.98,119632.82
2023-07-19,2023-07-19,Project payment - Customer_0054,REF12570328,0.0,69.84,119702.66
2023-07-19,2023-07-19,Payment from Customer_0090,REF27852689,0.0,119.63,119822.29
2023-07-20,2023-07-20,Payment from Customer_0062,REF13655028,0.0,55.85,119878.14
2023-07-20,2023-07-20,Project payment - Customer_0072,REF87258798,0.0,119.93,119998.07
2023-07-20,2023-07-20,Service payment - Customer_0083,REF41241680,0.0,64.81,120062.88
2023-07-20,2023-07-20,Service payment - Customer_0001,REF78740866,0.0,70.26,120133.14
2023-07-20,2023-07-20,Service payment - Customer_0095,REF20129846,0.0,89.67,120222.81
2023-07-20,2023-07-20,Invoice payment - Customer_0068,REF82321790,0.0,58.82,120281.63
2023-07-20,2023-07-20,Pos Systems expense,REF32861537,52.05,0.0,120229.58
2023-07-20,2023-07-20,Project payment - Customer_0032,REF98409724,0.0,72.45,120302.03
2023-07-20,2023-07-20,Payment from Customer_0079,REF41916563,0.0,89.22,120391.25
2023-07-20,2023-07-20,Project payment - Customer_0006,REF63951310,0.0,74.25,120465.5
2023-07-21,2023-07-21,Project payment - Customer_0015,REF91510680,0.0,121.0,120586.5
2023-07-21,2023-07-21,Invoice payment - Customer_0091,REF72350649,0.0,142.1,120728.6
2023-07-21,2023-07-21,Project payment - Customer_0060,REF67739914,0.0,76.96,120805.56
2023-07-21,2023-07-21,Service payment - Customer_0021,REF49399288,0.0,83.23,120888.79
2023-07-21,2023-07-21,Invoice payment - Customer_0073,REF39863159,0.0,101.82,120990.61
2023-07-21,2023-07-21,Payment from Customer_0093,REF53400214,0.0,101.99,121092.6
2023-07-21,2023-07-21,Payment from Customer_0026,REF44418250,0.0,120.61,121213.21
2023-07-21,2023-07-21,Payment from Customer_0018,REF41817718,0.0,68.23,121281.44
2023-07-21,2023-07-21,Packaging Shipping expense,REF38423178,130.69,0.0,121150.75
2023-07-22,2023-07-22,Payment from Customer_0084,REF90254452,0.0,90.9,121241.65
2023-07-22,2023-07-22,Service payment - Customer_0072,REF39793314,0.0,151.1,121392.75
2023-07-22,2023-07-22,Project payment - Customer_0000,REF84276542,0.0,51.36,121444.11
2023-07-22,2023-07-22,Utility bill payment,REF15426472,149.68,0.0,121294.43
2023-07-22,2023-07-22,Invoice payment - Customer_0029,REF27013752,0.0,109.47,121403.9
2023-07-22,2023-07-22,Invoice payment - Customer_0079,REF55838397,0.0,58.82,121462.72
2023-07-22,2023-07-22,Project payment - Customer_0041,REF62481194,0.0,128.95,121591.67
2023-07-22,2023-07-22,Project payment - Customer_0031,REF13554702,0.0,103.08,121694.75
2023-07-22,2023-07-22,Invoice payment - Customer_0086,REF50476840,0.0,88.18,121782.93
2023-07-22,2023-07-22,Payment from Customer_0048,REF58541336,0.0,98.29,121881.22
2023-07-22,2023-07-22,Pos Systems expense,REF38797119,62.42,0.0,121818.8
2023-07-23,2023-07-23,Invoice payment - Customer_0014,REF44362597,0.0,78.09,121896.89
2023-07-23,2023-07-23,Payment from Customer_0043,REF57145032,0.0,137.21,122034.1
2023-07-23,2023-07-23,Project payment - Customer_0088,REF19276531,0.0,120.67,122154.77
2023-07-23,2023-07-23,Marketing expenses,REF34665719,195.33,0.0,121959.44
2023-07-23,2023-07-23,Project payment - Customer_0069,REF56101058,0.0,79.64,122039.08
2023-07-23,2023-07-23,Project payment - Customer_0038,REF83354703,0.0,69.9,122108.98
2023-07-23,2023-07-23,Payment from Customer_0067,REF19088443,0.0,134.87,122243.85
2023-07-23,2023-07-23,Payment from Customer_0044,REF80142912,0.0,34.54,122278.39
2023-07-24,2023-07-24,Invoice payment - Customer_0030,REF54766168,0.0,38.75,122317.14
2023-07-24,2023-07-24,Service payment - Customer_0017,REF95184762,0.0,58.77,122375.91
2023-07-24,2023-07-24,Project payment - Customer_0090,REF33773375,0.0,86.86,122462.77
2023-07-24,2023-07-24,Payment from Customer_0033,REF32438570,0.0,69.85,122532.62
2023-07-24,2023-07-24,Project payment - Customer_0008,REF86338032,0.0,99.35,122631.97
2023-07-24,2023-07-24,Service payment - Customer_0005,REF55216618,0.0,36.49,122668.46
2023-07-24,2023-07-24,Invoice payment - Customer_0099,REF85821921,0.0,54.43,122722.89
2023-07-25,2023-07-25,Invoice payment - Customer_0091,REF39816109,0.0,118.18,122841.07
2023-07-25,2023-07-25,Invoice payment - Customer_0081,REF20851640,0.0,95.27,122936.34
2023-07-25,2023-07-25,Service payment - Customer_0023,REF47317171,0.0,96.09,123032.43
2023-07-25,2023-07-25,Invoice payment - Customer_0001,REF30172075,0.0,62.35,123094.78
2023-07-25,2023-07-25,Payment from Customer_0071,REF26818326,0.0,43.15,123137.93
2023-07-25,2023-07-25,Payment from Customer_0006,REF15048763,0.0,72.44,123210.37
2023-07-25,2023-07-25,Service payment - Customer_0061,REF49954973,0.0,151.06,123361.43
2023-07-25,2023-07-25,Invoice payment - Customer_0080,REF72526584,0.0,34.92,123396.35
2023-07-25,2023-07-25,Invoice payment - Customer_0041,REF20537876,0.0,148.34,123544.69
2023-07-25,2023-07-25,Project payment - Customer_0072,REF90647911,0.0,139.64,123684.33
2023-07-26,2023-07-26,Payment from Customer_0016,REF28156162,0.0,31.85,123716.18
2023-07-26,2023-07-26,Service payment - Customer_0084,REF40209710,0.0,87.7,123803.88
2023-07-26,2023-07-26,Service payment - Customer_0083,REF15663525,0.0,77.51,123881.39
2023-07-26,2023-07-26,Service payment - Customer_0080,REF98716433,0.0,38.22,123919.61
2023-07-26,2023-07-26,Payment from Customer_0050,REF64178098,0.0,134.17,124053.78
2023-07-26,2023-07-26,Invoice payment - Customer_0046,REF77598688,0.0,133.3,124187.08
2023-07-26,2023-07-26,Payment from Customer_0029,REF44020487,0.0,94.99,124282.07
2023-07-26,2023-07-26,Invoice payment - Customer_0014,REF45624138,0.0,87.35,124369.42
2023-07-27,2023-07-27,Service payment - Customer_0062,REF22957693,0.0,66.58,124436.0
2023-07-27,2023-07-27,Project payment - Customer_0045,REF34480474,0.0,116.18,124552.18
2023-07-27,2023-07-27,Payment from Customer_0036,REF41289133,0.0,68.7,124620.88
2023-07-27,2023-07-27,Project payment - Customer_0034,REF54551868,0.0,92.98,124713.86
2023-07-27,2023-07-27,Project payment - Customer_0084,REF19285555,0.0,77.29,124791.15
2023-07-27,2023-07-27,Payment from Customer_0027,REF77998609,0.0,76.85,124868.0
2023-07-27,2023-07-27,Service payment - Customer_0088,REF36477257,0.0,120.26,124988.26
2023-07-27,2023-07-27,Payment from Customer_0017,REF54774559,0.0,64.63,125052.89
2023-07-27,2023-07-27,Service payment - Customer_0085,REF63073842,0.0,113.35,125166.24
2023-07-27,2023-07-27,Project payment - Customer_0072,REF83242660,0.0,156.09,125322.33
2023-07-27,2023-07-27,Invoice payment - Customer_0016,REF75398412,0.0,33.4,125355.73
2023-07-27,2023-07-27,Project payment - Customer_0074,REF86311632,0.0,43.05,125398.78
2023-07-27,2023-07-27,Project payment - Customer_0031,REF50649062,0.0,110.86,125509.64
2023-07-27,2023-07-27,Invoice payment - Customer_0007,REF30981007,0.0,117.13,125626.77
2023-07-27,2023-07-27,Payment from Customer_0050,REF78632039,0.0,144.52,125771.29
2023-07-27,2023-07-27,Payment from Customer_0095,REF67504495,0.0,75.21,125846.5
2023-07-28,2023-07-28,Professional Services expense,REF88051894,160.92,0.0,125685.58
2023-07-28,2023-07-28,Project payment - Customer_0098,REF10302208,0.0,80.27,125765.85
2023-07-28,2023-07-28,Project payment - Customer_0086,REF90858524,0.0,71.04,125836.89
2023-07-28,2023-07-28,Service payment - Customer_0078,REF80862343,0.0,138.47,125975.36
2023-07-28,2023-07-28,Invoice payment - Customer_0019,REF37113152,0.0,92.86,126068.22
2023-07-28,2023-07-28,Project payment - Customer_0025,REF48494088,0.0,131.84,126200.06
2023-07-28,2023-07-28,Payment from Customer_0088,REF63597604,0.0,130.71,126330.77
2023-07-28,2023-07-28,Project payment - Customer_0021,REF82251949,0.0,54.62,126385.39
2023-07-28,2023-07-28,Payment from Customer_0070,REF17476858,0.0,51.46,126436.85
2023-07-28,2023-07-28,Invoice payment - Customer_0003,REF57046471,0.0,67.47,126504.32
2023-07-29,2023-07-29,Service payment - Customer_0087,REF62146908,0.0,82.29,126586.61
2023-07-29,2023-07-29,Invoice payment - Customer_0044,REF99872016,0.0,32.31,126618.92
2023-07-29,2023-07-29,Invoice payment - Customer_0077,REF66603129,0.0,89.75,126708.67
2023-07-29,2023-07-29,Payment from Customer_0052,REF23046714,0.0,48.7,126757.37
2023-07-29,2023-07-29,Service payment - Customer_0090,REF87066879,0.0,95.71,126853.08
2023-07-29,2023-07-29,Invoice payment - Customer_0063,REF90545333,0.0,64.39,126917.47
2023-07-29,2023-07-29,Invoice payment - Customer_0093,REF27532907,0.0,121.64,127039.11
2023-07-29,2023-07-29,Service payment - Customer_0074,REF58923750,0.0,47.61,127086.72
2023-07-30,2023-07-30,Service payment - Customer_0047,REF93004935,0.0,134.42,127221.14
2023-07-30,2023-07-30,Project payment - Customer_0013,REF41263553,0.0,75.71,127296.85
2023-07-30,2023-07-30,Payment from Customer_0008,REF67129185,0.0,114.94,127411.79
2023-07-30,2023-07-30,Payment from Customer_0034,REF25569118,0.0,83.49,127495.28
2023-07-30,2023-07-30,Invoice payment - Customer_0095,REF43978386,0.0,64.05,127559.33
2023-07-30,2023-07-30,Project payment - Customer_0010,REF95206448,0.0,90.14,127649.47
2023-07-30,2023-07-30,Invoice payment - Customer_0080,REF35346458,0.0,37.99,127687.46
2023-07-30,2023-07-30,Invoice payment - Customer_0022,REF88127364,0.0,86.25,127773.71
2023-07-30,2023-07-30,Invoice payment - Customer_0073,REF34673494,0.0,113.46,127887.17
2023-07-31,2023-07-31,Professional Services expense,REF42591771,124.47,0.0,127762.7
2023-07-31,2023-07-31,Payment from Customer_0057,REF69494840,0.0,118.62,127881.32
2023-07-31,2023-07-31,Payment from Customer_0055,REF63231771,0.0,47.98,127929.3
2023-07-31,2023-07-31,Invoice payment - Customer_0067,REF11070357,0.0,141.94,128071.24
2023-07-31,2023-07-31,Project payment - Customer_0039,REF53121371,0.0,131.49,128202.73
2023-07-31,2023-07-31,Payment from Customer_0093,REF98867745,0.0,103.11,128305.84
2023-08-01,2023-08-01,Project payment - Customer_0072,REF54972172,0.0,113.05,128418.89
2023-08-01,2023-08-01,Service payment - Customer_0088,REF38289391,0.0,122.11,128541.0
2023-08-01,2023-08-01,Invoice payment - Customer_0089,REF73881669,0.0,121.73,128662.73
2023-08-01,2023-08-01,Project payment - Customer_0056,REF67481264,0.0,24.06,128686.79
2023-08-01,2023-08-01,Invoice payment - Customer_0057,REF90147048,0.0,91.6,128778.39
2023-08-01,2023-08-01,Monthly office rent,REF94627664,1113.38,0.0,127665.01
2023-08-02,2023-08-02,Service payment - Customer_0068,REF88114067,0.0,56.38,127721.39
2023-08-02,2023-08-02,Payment from Customer_0087,REF48627522,0.0,106.08,127827.47
2023-08-02,2023-08-02,Payment from Customer_0049,REF64407009,0.0,89.22,127916.69
2023-08-02,2023-08-02,Service payment - Customer_0040,REF28464220,0.0,32.49,127949.18
2023-08-02,2023-08-02,Project payment - Customer_0012,REF22036726,0.0,70.19,128019.37
2023-08-02,2023-08-02,Invoice payment - Customer_0060,REF40622551,0.0,70.95,128090.32
2023-08-02,2023-08-02,Project payment - Customer_0032,REF14731841,0.0,69.13,128159.45
2023-08-02,2023-08-02,Project payment - Customer_0093,REF66719209,0.0,95.66,128255.11
2023-08-03,2023-08-03,Service payment - Customer_0038,REF59124813,0.0,66.99,128322.1
2023-08-03,2023-08-03,Payment from Customer_0054,REF44341034,0.0,69.13,128391.23
2023-08-03,2023-08-03,Invoice payment - Customer_0019,REF59580299,0.0,82.91,128474.14
2023-08-03,2023-08-03,Service payment - Customer_0063,REF90696708,0.0,73.36,128547.5
2023-08-03,2023-08-03,Invoice payment - Customer_0093,REF26322622,0.0,116.03,128663.53
2023-08-03,2023-08-03,Service payment - Customer_0069,REF16673264,0.0,80.53,128744.06
2023-08-04,2023-08-04,Service payment - Customer_0069,REF80662068,0.0,88.04,128832.1
2023-08-04,2023-08-04,Project payment - Customer_0011,REF79345538,0.0,96.58,128928.68
2023-08-04,2023-08-04,Service payment - Customer_0083,REF99749135,0.0,65.39,128994.07
2023-08-04,2023-08-04,Project payment - Customer_0035,REF39038421,0.0,117.92,129111.99
2023-08-04,2023-08-04,Payment from Customer_0029,REF27437097,0.0,78.27,129190.26
2023-08-04,2023-08-04,Invoice payment - Customer_0058,REF33429689,0.0,39.67,129229.93
2023-08-05,2023-08-05,Project payment - Customer_0022,REF84107317,0.0,65.24,129295.17
2023-08-05,2023-08-05,Project payment - Customer_0041,REF80305356,0.0,135.37,129430.54
2023-08-05,2023-08-05,Payment from Customer_0062,REF63309394,0.0,47.35,129477.89
2023-08-05,2023-08-05,Invoice payment - Customer_0043,REF17205103,0.0,134.09,129611.98
2023-08-05,2023-08-05,Service payment - Customer_0087,REF24467651,0.0,99.3,129711.28
2023-08-05,2023-08-05,Packaging Shipping expense,REF17445112,117.44,0.0,129593.84
2023-08-05,2023-08-05,Invoice payment - Customer_0042,REF17157449,0.0,102.56,129696.4
2023-08-05,2023-08-05,Service payment - Customer_0095,REF93239114,0.0,100.4,129796.8
2023-08-05,2023-08-05,Service payment - Customer_0026,REF95154293,0.0,104.73,129901.53
2023-08-05,2023-08-05,Project payment - Customer_0073,REF71823262,0.0,118.59,130020.12
2023-08-05,2023-08-05,Service payment - Customer_0096,REF42908930,0.0,83.26,130103.38
2023-08-05,2023-08-05,Service payment - Customer_0032,REF28461334,0.0,68.78,130172.16
2023-08-06,2023-08-06,Payment from Customer_0011,REF41549205,0.0,103.91,130276.07
2023-08-06,2023-08-06,Payment from Customer_0014,REF32441695,0.0,87.42,130363.49
2023-08-06,2023-08-06,Payment from Customer_0017,REF70124431,0.0,85.29,130448.78
2023-08-06,2023-08-06,Project payment - Customer_0013,REF20355369,0.0,74.93,130523.71
2023-08-06,2023-08-06,Service payment - Customer_0064,REF85838594,0.0,32.83,130556.54
2023-08-06,2023-08-06,Invoice payment - Customer_0055,REF55804021,0.0,52.27,130608.81
2023-08-07,2023-08-07,Project payment - Customer_0043,REF23839858,0.0,106.71,130715.52
2023-08-07,2023-08-07,Invoice payment - Customer_0082,REF35817784,0.0,155.21,130870.73
2023-08-07,2023-08-07,Payment from Customer_0002,REF22569439,0.0,71.04,130941.77
2023-08-07,2023-08-07,Project payment - Customer_0048,REF62722306,0.0,92.79,131034.56
2023-08-07,2023-08-07,Invoice payment - Customer_0021,REF37434643,0.0,79.92,131114.48
2023-08-07,2023-08-07,Payment from Customer_0022,REF14469312,0.0,65.65,131180.13
2023-08-07,2023-08-07,Payment from Customer_0033,REF33623611,0.0,69.52,131249.65
2023-08-07,2023-08-07,Service payment - Customer_0023,REF61781335,0.0,103.55,131353.2
2023-08-07,2023-08-07,Invoice payment - Customer_0068,REF31082005,0.0,47.41,131400.61
2023-08-07,2023-08-07,Project payment - Customer_0059,REF58125255,0.0,68.68,131469.29
2023-08-07,2023-08-07,Payment from Customer_0066,REF65984588,0.0,75.12,131544.41
2023-08-07,2023-08-07,Project payment - Customer_0095,REF40821370,0.0,95.44,131639.85
2023-08-08,2023-08-08,Payment from Customer_0092,REF25275821,0.0,78.42,131718.27
2023-08-08,2023-08-08,Invoice payment - Customer_0064,REF98068630,0.0,40.05,131758.32
2023-08-08,2023-08-08,Service payment - Customer_0098,REF29061340,0.0,79.45,131837.77
2023-08-08,2023-08-08,Payment from Customer_0016,REF29426542,0.0,29.37,131867.14
2023-08-08,2023-08-08,Payment from Customer_0093,REF74677524,0.0,99.22,131966.36
2023-08-08,2023-08-08,Invoice payment - Customer_0085,REF60338293,0.0,106.39,132072.75
2023-08-08,2023-08-08,Service payment - Customer_0065,REF85061978,0.0,61.87,132134.62
2023-08-08,2023-08-08,Service payment - Customer_0032,REF90576232,0.0,66.6,132201.22
2023-08-08,2023-08-08,Project payment - Customer_0095,REF66771612,0.0,65.31,132266.53
2023-08-08,2023-08-08,Inventory purchase,REF37244089,4297.55,0.0,127968.98
2023-08-08,2023-08-08,Payment from Customer_0017,REF50435085,0.0,57.0,128025.98
2023-08-09,2023-08-09,Project payment - Customer_0056,REF77763927,0.0,28.58,128054.56
2023-08-09,2023-08-09,Invoice payment - Customer_0040,REF60412829,0.0,32.81,128087.37
2023-08-09,2023-08-09,Payment from Customer_0080,REF55578173,0.0,43.69,128131.06
2023-08-09,2023-08-09,Project payment - Customer_0045,REF18221204,0.0,102.18,128233.24
2023-08-09,2023-08-09,Payment from Customer_0098,REF27945596,0.0,82.72,128315.96
2023-08-09,2023-08-09,Service payment - Customer_0086,REF30020606,0.0,65.88,128381.84
2023-08-09,2023-08-09,Invoice payment - Customer_0074,REF65230519,0.0,66.53,128448.37
2023-08-09,2023-08-09,Payment from Customer_0082,REF38138541,0.0,155.1,128603.47
2023-08-09,2023-08-09,Invoice payment - Customer_0031,REF33677629,0.0,98.93,128702.4
2023-08-09,2023-08-09,Invoice payment - Customer_0018,REF37123416,0.0,51.99,128754.39
2023-08-09,2023-08-09,Project payment - Customer_0048,REF78388764,0.0,90.68,128845.07
2023-08-09,2023-08-09,Payment from Customer_0015,REF82981576,0.0,80.55,128925.62
2023-08-10,2023-08-10,Invoice payment - Customer_0025,REF67348479,0.0,133.09,129058.71
2023-08-10,2023-08-10,Service payment - Customer_0030,REF19590953,0.0,41.05,129099.76
2023-08-10,2023-08-10,Invoice payment - Customer_0045,REF42440721,0.0,116.98,129216.74
2023-08-10,2023-08-10,Service payment - Customer_0008,REF54402065,0.0,105.81,129322.55
2023-08-10,2023-08-10,Inventory purchase,REF35834418,3147.98,0.0,126174.57
2023-08-11,2023-08-11,Service payment - Customer_0095,REF91941087,0.0,71.9,126246.47
2023-08-11,2023-08-11,Payment from Customer_0037,REF47945456,0.0,143.75,126390.22
2023-08-11,2023-08-11,Invoice payment - Customer_0034,REF49096414,0.0,69.12,126459.34
2023-08-11,2023-08-11,Project payment - Customer_0069,REF90479253,0.0,54.83,126514.17
2023-08-11,2023-08-11,Payment from Customer_0047,REF13393556,0.0,82.67,126596.84
2023-08-11,2023-08-11,Invoice payment - Customer_0061,REF71771223,0.0,112.28,126709.12
2023-08-11,2023-08-11,Payment from Customer_0053,REF18488515,0.0,160.79,126869.91
2023-08-11,2023-08-11,Project payment - Customer_0024,REF78232343,0.0,115.37,126985.28
2023-08-12,2023-08-12,Project payment - Customer_0080,REF84645416,0.0,40.64,127025.92
2023-08-12,2023-08-12,Project payment - Customer_0093,REF66768533,0.0,132.84,127158.76
2023-08-12,2023-08-12,Invoice payment - Customer_0008,REF29444935,0.0,122.98,127281.74
2023-08-12,2023-08-12,Payment from Customer_0046,REF84028469,0.0,134.43,127416.17
2023-08-13,2023-08-13,Invoice payment - Customer_0036,REF54533818,0.0,50.02,127466.19
2023-08-13,2023-08-13,Payment from Customer_0010,REF11359471,0.0,90.64,127556.83
2023-08-13,2023-08-13,Service payment - Customer_0097,REF60665030,0.0,63.95,127620.78
2023-08-13,2023-08-13,Service payment - Customer_0094,REF95616361,0.0,64.88,127685.66
2023-08-13,2023-08-13,Invoice payment - Customer_0017,REF89078723,0.0,95.37,127781.03
2023-08-13,2023-08-13,Invoice payment - Customer_0025,REF19974372,0.0,99.5,127880.53
2023-08-13,2023-08-13,Payment from Customer_0050,REF42054354,0.0,127.9,128008.43
2023-08-13,2023-08-13,Service payment - Customer_0096,REF25807102,0.0,111.48,128119.91
2023-08-14,2023-08-14,Service payment - Customer_0069,REF63386789,0.0,64.44,128184.35
2023-08-14,2023-08-14,Payment from Customer_0084,REF76867386,0.0,68.64,128252.99
2023-08-14,2023-08-14,Invoice payment - Customer_0045,REF43600082,0.0,102.82,128355.81
2023-08-14,2023-08-14,Invoice payment - Customer_0066,REF17635880,0.0,62.99,128418.8
2023-08-14,2023-08-14,Service payment - Customer_0088,REF15620761,0.0,117.82,128536.62
2023-08-14,2023-08-14,Payment from Customer_0024,REF31383246,0.0,115.53,128652.15
2023-08-14,2023-08-14,Service payment - Customer_0092,REF62128397,0.0,57.41,128709.56
2023-08-14,2023-08-14,Payment from Customer_0050,REF82701102,0.0,138.94,128848.5
2023-08-15,2023-08-15,Invoice payment - Customer_0003,REF31050691,0.0,85.99,128934.49
2023-08-15,2023-08-15,Business insurance premium,REF78711310,172.21,0.0,128762.28
2023-08-15,2023-08-15,Invoice payment - Customer_0091,REF95273869,0.0,177.67,128939.95
2023-08-15,2023-08-15,Service payment - Customer_0000,REF58883300,0.0,44.97,128984.92
2023-08-15,2023-08-15,Payment from Customer_0068,REF64121222,0.0,48.25,129033.17
2023-08-15,2023-08-15,Project payment - Customer_0067,REF42517791,0.0,134.48,129167.65
2023-08-16,2023-08-16,Invoice payment - Customer_0018,REF42212555,0.0,62.83,129230.48
2023-08-16,2023-08-16,Project payment - Customer_0028,REF19422178,0.0,79.02,129309.5
2023-08-16,2023-08-16,Invoice payment - Customer_0057,REF62626184,0.0,131.17,129440.67
2023-08-16,2023-08-16,Project payment - Customer_0023,REF47061395,0.0,97.96,129538.63
2023-08-16,2023-08-16,Service payment - Customer_0059,REF19160299,0.0,81.72,129620.35
2023-08-16,2023-08-16,Project payment - Customer_0063,REF48692555,0.0,64.95,129685.3
2023-08-17,2023-08-17,Project payment - Customer_0043,REF51203922,0.0,119.44,129804.74
2023-08-17,2023-08-17,Service payment - Customer_0020,REF31401465,0.0,135.1,129939.84
2023-08-17,2023-08-17,Service payment - Customer_0085,REF79157627,0.0,122.89,130062.73
2023-08-17,2023-08-17,Project payment - Customer_0057,REF41465678,0.0,142.63,130205.36
2023-08-17,2023-08-17,Payment from Customer_0013,REF53348580,0.0,76.21,130281.57
2023-08-17,2023-08-17,Project payment - Customer_0096,REF26879562,0.0,69.01,130350.58
2023-08-17,2023-08-17,Service payment - Customer_0044,REF58240224,0.0,43.15,130393.73
2023-08-17,2023-08-17,Invoice payment - Customer_0050,REF21561819,0.0,157.77,130551.5
2023-08-17,2023-08-17,Project payment - Customer_0055,REF22420365,0.0,58.84,130610.34
2023-08-17,2023-08-17,Project payment - Customer_0015,REF28236256,0.0,102.01,130712.35
2023-08-17,2023-08-17,Payment from Customer_0016,REF58587561,0.0,31.13,130743.48
2023-08-18,2023-08-18,Invoice payment - Customer_0096,REF19520524,0.0,82.87,130826.35
2023-08-18,2023-08-18,Payment from Customer_0097,REF94547596,0.0,84.73,130911.08
2023-08-18,2023-08-18,Project payment - Customer_0063,REF19753063,0.0,74.65,130985.73
2023-08-18,2023-08-18,Invoice payment - Customer_0012,REF90577128,0.0,80.31,131066.04
2023-08-18,2023-08-18,Service payment - Customer_0005,REF86974295,0.0,36.54,131102.58
2023-08-18,2023-08-18,Payment from Customer_0079,REF90212653,0.0,74.19,131176.77
2023-08-19,2023-08-19,Payment from Customer_0010,REF32579102,0.0,84.7,131261.47
2023-08-19,2023-08-19,Payment from Customer_0029,REF37728954,0.0,76.9,131338.37
2023-08-19,2023-08-19,Payment from Customer_0035,REF92061545,0.0,120.82,131459.19
2023-08-19,2023-08-19,Service payment - Customer_0082,REF99736431,0.0,121.46,131580.65
2023-08-20,2023-08-20,Service payment - Customer_0062,REF69354226,0.0,53.65,131634.3
2023-08-20,2023-08-20,Service payment - Customer_0076,REF57991860,0.0,11.36,131645.66
2023-08-20,2023-08-20,Project payment - Customer_0022,REF65012654,0.0,63.21,131708.87
2023-08-20,2023-08-20,Professional Services expense,REF40518694,121.94,0.0,131586.93
2023-08-20,2023-08-20,Payment from Customer_0051,REF67824320,0.0,83.8,131670.73
2023-08-20,2023-08-20,Invoice payment - Customer_0072,REF79282704,0.0,142.02,131812.75
2023-08-20,2023-08-20,Payment from Customer_0060,REF23587622,0.0,94.36,131907.11
2023-08-20,2023-08-20,Project payment - Customer_0091,REF57956630,0.0,108.5,132015.61
2023-08-20,2023-08-20,Payment from Customer_0061,REF17211667,0.0,132.5,132148.11
2023-08-20,2023-08-20,Project payment - Customer_0078,REF51909035,0.0,141.63,132289.74
2023-08-20,2023-08-20,Payment from Customer_0098,REF33444586,0.0,70.61,132360.35
2023-08-20,2023-08-20,Payment from Customer_0065,REF40138903,0.0,72.46,132432.81
2023-08-21,2023-08-21,Project payment - Customer_0048,REF10707237,0.0,60.91,132493.72
2023-08-21,2023-08-21,Project payment - Customer_0089,REF75026597,0.0,159.79,132653.51
2023-08-21,2023-08-21,Service payment - Customer_0028,REF87540791,0.0,63.64,132717.15
2023-08-21,2023-08-21,Payment from Customer_0071,REF97709156,0.0,44.35,132761.5
2023-08-21,2023-08-21,Service payment - Customer_0062,REF89729550,0.0,51.15,132812.65
2023-08-21,2023-08-21,Project payment - Customer_0021,REF41738349,0.0,72.13,132884.78
2023-08-21,2023-08-21,Invoice payment - Customer_0008,REF40839053,0.0,93.15,132977.93
2023-08-21,2023-08-21,Service payment - Customer_0065,REF79741306,0.0,50.94,133028.87
2023-08-21,2023-08-21,Invoice payment - Customer_0037,REF31986191,0.0,102.05,133130.92
2023-08-22,2023-08-22,Service payment - Customer_0086,REF61642139,0.0,88.48,133219.4
2023-08-22,2023-08-22,Utility bill payment,REF85570566,144.25,0.0,133075.15
2023-08-22,2023-08-22,Invoice payment - Customer_0082,REF11560645,0.0,157.19,133232.34
2023-08-22,2023-08-22,Payment from Customer_0005,REF59017342,0.0,38.73,133271.07
2023-08-22,2023-08-22,Payment from Customer_0044,REF66018085,0.0,40.08,133311.15
2023-08-22,2023-08-22,Project payment - Customer_0091,REF83308284,0.0,190.98,133502.13
2023-08-22,2023-08-22,Payment from Customer_0067,REF91028653,0.0,128.8,133630.93
2023-08-22,2023-08-22,Payment from Customer_0017,REF37024939,0.0,90.54,133721.47
2023-08-22,2023-08-22,Payment from Customer_0060,REF36277582,0.0,96.74,133818.21
2023-08-23,2023-08-23,Invoice payment - Customer_0017,REF78859633,0.0,71.39,133889.6
2023-08-23,2023-08-23,Service payment - Customer_0099,REF59760056,0.0,50.71,133940.31
2023-08-23,2023-08-23,Project payment - Customer_0078,REF68991669,0.0,147.63,134087.94
2023-08-23,2023-08-23,Service payment - Customer_0067,REF58778917,0.0,93.27,134181.21
2023-08-23,2023-08-23,Invoice payment - Customer_0002,REF62980674,0.0,105.68,134286.89
2023-08-23,2023-08-23,Payment from Customer_0023,REF80841452,0.0,105.73,134392.62
2023-08-23,2023-08-23,Service payment - Customer_0057,REF70010274,0.0,115.54,134508.16
2023-08-24,2023-08-24,Invoice payment - Customer_0019,REF41996614,0.0,107.66,134615.82
2023-08-24,2023-08-24,Payment from Customer_0002,REF79338638,0.0,105.96,134721.78
2023-08-24,2023-08-24,Invoice payment - Customer_0003,REF40680759,0.0,81.06,134802.84
2023-08-24,2023-08-24,Service payment - Customer_0065,REF92217336,0.0,55.69,134858.53
2023-08-24,2023-08-24,Invoice payment - Customer_0095,REF72093546,0.0,85.91,134944.44
2023-08-24,2023-08-24,Payment from Customer_0099,REF16586666,0.0,52.92,134997.36
2023-08-24,2023-08-24,Employee payroll,REF42977947,3585.33,0.0,131412.03
2023-08-24,2023-08-24,Invoice payment - Customer_0032,REF36199949,0.0,71.97,131484.0
2023-08-24,2023-08-24,Project payment - Customer_0046,REF34085701,0.0,166.09,131650.09
2023-08-25,2023-08-25,Project payment - Customer_0048,REF19397370,0.0,87.72,131737.81
2023-08-25,2023-08-25,Project payment - Customer_0004,REF54270109,0.0,64.4,131802.21
2023-08-25,2023-08-25,Service payment - Customer_0060,REF32061696,0.0,105.93,131908.14
2023-08-25,2023-08-25,Invoice payment - Customer_0071,REF18634393,0.0,35.75,131943.89
2023-08-25,2023-08-25,Payment from Customer_0070,REF48010531,0.0,52.33,131996.22
2023-08-25,2023-08-25,Invoice payment - Customer_0037,REF19156831,0.0,142.13,132138.35
2023-08-25,2023-08-25,Service payment - Customer_0006,REF15732124,0.0,82.96,132221.31
2023-08-25,2023-08-25,Invoice payment - Customer_0029,REF26482905,0.0,82.91,132304.22
2023-08-25,2023-08-25,Invoice payment - Customer_0098,REF59827418,0.0,107.18,132411.4
2023-08-25,2023-08-25,Service payment - Customer_0057,REF66724785,0.0,104.27,132515.67
2023-08-26,2023-08-26,Invoice payment - Customer_0014,REF80857905,0.0,99.71,132615.38
2023-08-26,2023-08-26,Invoice payment - Customer_0069,REF78238237,0.0,55.89,132671.27
2023-08-26,2023-08-26,Invoice payment - Customer_0048,REF17286073,0.0,93.42,132764.69
2023-08-26,2023-08-26,Service payment - Customer_0067,REF80566093,0.0,126.2,132890.89
2023-08-26,2023-08-26,Inventory purchase,REF14992793,3576.93,0.0,129313.96
2023-08-26,2023-08-26,Service payment - Customer_0041,REF94098582,0.0,150.86,129464.82
2023-08-26,2023-08-26,Project payment - Customer_0036,REF74706361,0.0,57.31,129522.13
2023-08-27,2023-08-27,Payment from Customer_0018,REF99747404,0.0,76.09,129598.22
2023-08-27,2023-08-27,Project payment - Customer_0042,REF51071225,0.0,97.18,129695.4
2023-08-27,2023-08-27,Project payment - Customer_0023,REF84699587,0.0,114.73,129810.13
2023-08-27,2023-08-27,Project payment - Customer_0096,REF95425486,0.0,83.41,129893.54
2023-08-27,2023-08-27,Invoice payment - Customer_0047,REF17256545,0.0,107.91,130001.45
2023-08-27,2023-08-27,Service payment - Customer_0080,REF23959143,0.0,45.25,130046.7
2023-08-27,2023-08-27,Pos Systems expense,REF11144119,72.19,0.0,129974.51
2023-08-27,2023-08-27,Project payment - Customer_0001,REF66598965,0.0,47.97,130022.48
2023-08-27,2023-08-27,Invoice payment - Customer_0063,REF45848982,0.0,81.34,130103.82
2023-08-28,2023-08-28,Invoice payment - Customer_0076,REF63696937,0.0,12.26,130116.08
2023-08-28,2023-08-28,Payment from Customer_0051,REF31799183,0.0,61.23,130177.31
2023-08-28,2023-08-28,Payment from Customer_0016,REF99328788,0.0,30.33,130207.64
2023-08-28,2023-08-28,Payment from Customer_0031,REF62724052,0.0,73.68,130281.32
2023-08-28,2023-08-28,Project payment - Customer_0066,REF12621575,0.0,59.1,130340.42
2023-08-28,2023-08-28,Payment from Customer_0054,REF94047046,0.0,99.36,130439.78
2023-08-28,2023-08-28,Project payment - Customer_0032,REF78937429,0.0,74.11,130513.89
2023-08-28,2023-08-28,Payment from Customer_0075,REF89092646,0.0,88.22,130602.11
2023-08-29,2023-08-29,Service payment - Customer_0060,REF72530225,0.0,100.96,130703.07
2023-08-29,2023-08-29,Payment from Customer_0006,REF43148095,0.0,73.04,130776.11
2023-08-29,2023-08-29,Project payment - Customer_0094,REF79585714,0.0,91.45,130867.56
2023-08-29,2023-08-29,Payment from Customer_0066,REF35999460,0.0,54.06,130921.62
2023-08-29,2023-08-29,Payment from Customer_0033,REF54247492,0.0,73.74,130995.36
2023-08-29,2023-08-29,Payment from Customer_0097,REF45865740,0.0,71.88,131067.24
2023-08-29,2023-08-29,Service payment - Customer_0039,REF22667667,0.0,97.28,131164.52
2023-08-29,2023-08-29,Payment from Customer_0010,REF66284286,0.0,103.16,131267.68
2023-08-29,2023-08-29,Service payment - Customer_0090,REF93425299,0.0,82.89,131350.57
2023-08-29,2023-08-29,Invoice payment - Customer_0053,REF16157040,0.0,132.03,131482.6
2023-08-29,2023-08-29,Project payment - Customer_0096,REF20073287,0.0,77.53,131560.13
2023-08-29,2023-08-29,Invoice payment - Customer_0092,REF89336790,0.0,76.6,131636.73
2023-08-30,2023-08-30,Project payment - Customer_0048,REF97830737,0.0,95.08,131731.81
2023-08-30,2023-08-30,Payment from Customer_0003,REF73004884,0.0,71.22,131803.03
2023-08-30,2023-08-30,Payment from Customer_0064,REF69321589,0.0,37.58,131840.61
2023-08-30,2023-08-30,Payment from Customer_0097,REF21111190,0.0,59.69,131900.3
2023-08-30,2023-08-30,Payment from Customer_0009,REF70318053,0.0,59.91,131960.21
2023-08-30,2023-08-30,Service payment - Customer_0001,REF63208557,0.0,60.68,132020.89
2023-08-30,2023-08-30,Invoice payment - Customer_0017,REF55309183,0.0,90.74,132111.63
2023-08-30,2023-08-30,Service payment - Customer_0061,REF94995059,0.0,86.11,132197.74
2023-08-31,2023-08-31,Service payment - Customer_0090,REF54651120,0.0,107.02,132304.76
2023-08-31,2023-08-31,Service payment - Customer_0042,REF77029456,0.0,90.17,132394.93
2023-08-31,2023-08-31,Project payment - Customer_0073,REF66567518,0.0,122.66,132517.59
2023-08-31,2023-08-31,Project payment - Customer_0046,REF80033779,0.0,125.67,132643.26
2023-08-31,2023-08-31,Project payment - Customer_0051,REF22924266,0.0,66.21,132709.47
2023-08-31,2023-08-31,Project payment - Customer_0032,REF74196692,0.0,73.11,132782.58
2023-08-31,2023-08-31,Payment from Customer_0025,REF73202633,0.0,113.04,132895.62
2023-08-31,2023-08-31,Invoice payment - Customer_0086,REF22705592,0.0,87.23,132982.85
2023-08-31,2023-08-31,Project payment - Customer_0084,REF40115625,0.0,81.01,133063.86
2023-08-31,2023-08-31,Payment from Customer_0010,REF44821948,0.0,71.36,133135.22
2023-08-31,2023-08-31,Payment from Customer_0041,REF94685147,0.0,127.41,133262.63
2023-08-31,2023-08-31,Payment from Customer_0018,REF56771425,0.0,33.18,133295.81
2023-08-31,2023-08-31,Service payment - Customer_0053,REF93455925,0.0,121.34,133417.15
2023-09-01,2023-09-01,Invoice payment - Customer_0041,REF77164739,0.0,118.67,133535.82
2023-09-01,2023-09-01,Invoice payment - Customer_0020,REF22030821,0.0,100.32,133636.14
2023-09-01,2023-09-01,Project payment - Customer_0076,REF87690646,0.0,10.53,133646.67
2023-09-01,2023-09-01,Service payment - Customer_0035,REF91558238,0.0,119.82,133766.49
2023-09-01,2023-09-01,Service payment - Customer_0062,REF70575819,0.0,60.31,133826.8
2023-09-01,2023-09-01,Project payment - Customer_0029,REF48332332,0.0,67.64,133894.44
2023-09-01,2023-09-01,Invoice payment - Customer_0031,REF41894899,0.0,88.55,133982.99
2023-09-01,2023-09-01,Monthly office rent,REF41160204,1191.86,0.0,132791.13
2023-09-01,2023-09-01,Payment from Customer_0095,REF60245163,0.0,67.56,132858.69
2023-09-01,2023-09-01,Service payment - Customer_0006,REF30741376,0.0,97.69,132956.38
2023-09-01,2023-09-01,Project payment - Customer_0066,REF98710128,0.0,47.0,133003.38
2023-09-01,2023-09-01,Service payment - Customer_0072,REF55951518,0.0,115.79,133119.17
2023-09-01,2023-09-01,Service payment - Customer_0077,REF43112065,0.0,80.84,133200.01
2023-09-02,2023-09-02,Service payment - Customer_0095,REF43418761,0.0,76.6,133276.61
2023-09-02,2023-09-02,Project payment - Customer_0073,REF15448634,0.0,126.15,133402.76
2023-09-02,2023-09-02,Invoice payment - Customer_0034,REF96147101,0.0,54.74,133457.5
2023-09-02,2023-09-02,Service payment - Customer_0041,REF30681988,0.0,127.93,133585.43
2023-09-02,2023-09-02,Invoice payment - Customer_0048,REF85793147,0.0,90.06,133675.49
2023-09-02,2023-09-02,Payment from Customer_0040,REF40363260,0.0,38.25,133713.74
2023-09-02,2023-09-02,Payment from Customer_0037,REF57877301,0.0,131.36,133845.1
2023-09-02,2023-09-02,Project payment - Customer_0001,REF82281859,0.0,56.02,133901.12
2023-09-02,2023-09-02,Service payment - Customer_0018,REF32283065,0.0,67.43,133968.55
2023-09-02,2023-09-02,Service payment - Customer_0056,REF54517727,0.0,26.33,133994.88
2023-09-03,2023-09-03,Payment from Customer_0069,REF41447599,0.0,79.13,134074.01
2023-09-03,2023-09-03,Invoice payment - Customer_0059,REF94776627,0.0,82.42,134156.43
2023-09-03,2023-09-03,Project payment - Customer_0002,REF26347603,0.0,94.99,134251.42
2023-09-03,2023-09-03,Project payment - Customer_0053,REF48143612,0.0,162.82,134414.24
2023-09-03,2023-09-03,Payment from Customer_0007,REF58733264,0.0,157.99,134572.23
2023-09-03,2023-09-03,Project payment - Customer_0026,REF77453689,0.0,90.78,134663.01
2023-09-03,2023-09-03,Payment from Customer_0094,REF36193973,0.0,48.68,134711.69
2023-09-04,2023-09-04,Project payment - Customer_0083,REF32049212,0.0,58.34,134770.03
2023-09-04,2023-09-04,Payment from Customer_0056,REF80275616,0.0,27.29,134797.32
2023-09-04,2023-09-04,Service payment - Customer_0068,REF52293937,0.0,40.33,134837.65
2023-09-04,2023-09-04,Invoice payment - Customer_0015,REF52682163,0.0,95.38,134933.03
2023-09-04,2023-09-04,Service payment - Customer_0069,REF89108817,0.0,86.81,135019.84
2023-09-04,2023-09-04,Payment from Customer_0079,REF96080908,0.0,101.51,135121.35
2023-09-04,2023-09-04,Invoice payment - Customer_0033,REF42058523,0.0,84.66,135206.01
2023-09-04,2023-09-04,Payment from Customer_0010,REF45009482,0.0,96.41,135302.42
2023-09-04,2023-09-04,Invoice payment - Customer_0073,REF41356740,0.0,105.92,135408.34
2023-09-04,2023-09-04,Service payment - Customer_0091,REF22689764,0.0,161.4,135569.74
2023-09-04,2023-09-04,Invoice payment - Customer_0059,REF93780360,0.0,62.62,135632.36
2023-09-05,2023-09-05,Service payment - Customer_0087,REF75930079,0.0,87.9,135720.26
2023-09-05,2023-09-05,Project payment - Customer_0086,REF83026157,0.0,70.92,135791.18
2023-09-05,2023-09-05,Invoice payment - Customer_0035,REF58975389,0.0,105.81,135896.99
2023-09-05,2023-09-05,Service payment - Customer_0081,REF91191551,0.0,77.27,135974.26
2023-09-05,2023-09-05,Project payment - Customer_0025,REF45953921,0.0,125.01,136099.27
2023-09-05,2023-09-05,Service payment - Customer_0007,REF99349663,0.0,137.62,136236.89
2023-09-05,2023-09-05,Invoice payment - Customer_0010,REF93892001,0.0,96.77,136333.66
2023-09-05,2023-09-05,Payment from Customer_0084,REF65563437,0.0,89.99,136423.65
2023-09-05,2023-09-05,Inventory purchase,REF53019648,2377.68,0.0,134045.97
2023-09-05,2023-09-05,Project payment - Customer_0095,REF95221456,0.0,93.6,134139.57
2023-09-05,2023-09-05,Payment from Customer_0071,REF75877120,0.0,38.98,134178.55
2023-09-05,2023-09-05,Service payment - Customer_0068,REF51314332,0.0,40.79,134219.34
2023-09-06,2023-09-06,Payment from Customer_0057,REF75532785,0.0,128.91,134348.25
2023-09-06,2023-09-06,Invoice payment - Customer_0070,REF32364111,0.0,76.97,134425.22
2023-09-06,2023-09-06,Service payment - Customer_0056,REF26809523,0.0,30.37,134455.59
2023-09-06,2023-09-06,Project payment - Customer_0006,REF26663768,0.0,54.62,134510.21
2023-09-06,2023-09-06,Invoice payment - Customer_0050,REF55925015,0.0,133.32,134643.53
2023-09-06,2023-09-06,Service payment - Customer_0087,REF39218228,0.0,80.35,134723.88
2023-09-06,2023-09-06,Service payment - Customer_0013,REF46919484,0.0,97.92,134821.8
2023-09-06,2023-09-06,Project payment - Customer_0090,REF40486190,0.0,82.99,134904.79
2023-09-06,2023-09-06,Payment from Customer_0051,REF75257242,0.0,87.22,134992.01
2023-09-06,2023-09-06,Invoice payment - Customer_0097,REF46554407,0.0,66.8,135058.81
2023-09-07,2023-09-07,Invoice payment - Customer_0028,REF80560154,0.0,96.91,135155.72
2023-09-07,2023-09-07,Project payment - Customer_0030,REF90916881,0.0,44.08,135199.8
2023-09-07,2023-09-07,Payment from Customer_0019,REF69708484,0.0,66.06,135265.86
2023-09-07,2023-09-07,Project payment - Customer_0073,REF92445145,0.0,102.22,135368.08
2023-09-07,2023-09-07,Invoice payment - Customer_0052,REF34930680,0.0,45.17,135413.25
2023-09-07,2023-09-07,Invoice payment - Customer_0085,REF66748140,0.0,80.11,135493.36
2023-09-07,2023-09-07,Project payment - Customer_0062,REF48490196,0.0,42.82,135536.18
2023-09-07,2023-09-07,Payment from Customer_0022,REF16319934,0.0,70.95,135607.13
2023-09-07,2023-09-07,Service payment - Customer_0084,REF62538411,0.0,91.78,135698.91
2023-09-08,2023-09-08,Service payment - Customer_0009,REF20094316,0.0,57.6,135756.51
2023-09-08,2023-09-08,Invoice payment - Customer_0032,REF97304942,0.0,79.98,135836.49
2023-09-08,2023-09-08,Invoice payment - Customer_0083,REF13173282,0.0,56.68,135893.17
2023-09-08,2023-09-08,Invoice payment - Customer_0018,REF71923806,0.0,68.31,135961.48
2023-09-08,2023-09-08,Invoice payment - Customer_0094,REF91702817,0.0,81.5,136042.98
2023-09-08,2023-09-08,Project payment - Customer_0073,REF46175975,0.0,100.17,136143.15
2023-09-08,2023-09-08,Payment from Customer_0041,REF41994822,0.0,157.09,136300.24
2023-09-08,2023-09-08,Payment from Customer_0025,REF42742844,0.0,94.12,136394.36
2023-09-09,2023-09-09,Payment from Customer_0018,REF83251957,0.0,58.42,136452.78
2023-09-09,2023-09-09,Payment from Customer_0008,REF83760292,0.0,79.21,136531.99
2023-09-09,2023-09-09,Payment from Customer_0064,REF77087871,0.0,35.3,136567.29
2023-09-09,2023-09-09,Service payment - Customer_0056,REF25731696,0.0,25.54,136592.83
2023-09-09,2023-09-09,Invoice payment - Customer_0026,REF67753925,0.0,102.61,136695.44
2023-09-09,2023-09-09,Payment from Customer_0051,REF73998106,0.0,88.22,136783.66
2023-09-09,2023-09-09,Payment from Customer_0029,REF70706101,0.0,108.72,136892.38
2023-09-09,2023-09-09,Service payment - Customer_0016,REF98037601,0.0,30.86,136923.24
2023-09-09,2023-09-09,Invoice payment - Customer_0015,REF83081046,0.0,140.21,137063.45
2023-09-09,2023-09-09,Service payment - Customer_0035,REF38873469,0.0,151.34,137214.79
2023-09-09,2023-09-09,Project payment - Customer_0032,REF59281412,0.0,73.19,137287.98
2023-09-09,2023-09-09,Payment from Customer_0073,REF54432946,0.0,92.11,137380.09
2023-09-09,2023-09-09,Invoice payment - Customer_0081,REF25648345,0.0,97.26,137477.35
2023-09-10,2023-09-10,Invoice payment - Customer_0034,REF66366996,0.0,63.55,137540.9
2023-09-10,2023-09-10,Project payment - Customer_0044,REF46013054,0.0,38.56,137579.46
2023-09-10,2023-09-10,Project payment - Customer_0096,REF75609451,0.0,108.64,137688.1
2023-09-10,2023-09-10,Project payment - Customer_0083,REF64045964,0.0,64.16,137752.26
2023-09-10,2023-09-10,Invoice payment - Customer_0086,REF26792555,0.0,75.5,137827.76
2023-09-10,2023-09-10,Payment from Customer_0081,REF45780173,0.0,70.06,137897.82
2023-09-10,2023-09-10,Invoice payment - Customer_0097,REF91213152,0.0,63.85,137961.67
2023-09-10,2023-09-10,Service payment - Customer_0008,REF79753579,0.0,100.52,138062.19
2023-09-10,2023-09-10,Payment from Customer_0006,REF35046284,0.0,99.39,138161.58
2023-09-10,2023-09-10,Service payment - Customer_0004,REF59623415,0.0,50.93,138212.51
2023-09-10,2023-09-10,Service payment - Customer_0056,REF38522052,0.0,36.04,138248.55
2023-09-10,2023-09-10,Invoice payment - Customer_0002,REF44699794,0.0,70.79,138319.34
2023-09-10,2023-09-10,Invoice payment - Customer_0094,REF84456873,0.0,74.01,138393.35
2023-09-10,2023-09-10,Invoice payment - Customer_0045,REF26176470,0.0,79.97,138473.32
2023-09-11,2023-09-11,Invoice payment - Customer_0043,REF26465987,0.0,116.73,138590.05
2023-09-11,2023-09-11,Service payment - Customer_0041,REF41657648,0.0,140.17,138730.22
2023-09-11,2023-09-11,Project payment - Customer_0057,REF24860790,0.0,99.67,138829.89
2023-09-11,2023-09-11,Invoice payment - Customer_0081,REF22318950,0.0,103.16,138933.05
2023-09-11,2023-09-11,Project payment - Customer_0010,REF36799290,0.0,81.74,139014.79
2023-09-11,2023-09-11,Project payment - Customer_0071,REF52283624,0.0,38.61,139053.4
2023-09-11,2023-09-11,Payment from Customer_0066,REF69852854,0.0,61.28,139114.68
2023-09-11,2023-09-11,Project payment - Customer_0001,REF13457924,0.0,59.36,139174.04
2023-09-11,2023-09-11,Service payment - Customer_0089,REF23423086,0.0,108.11,139282.15
2023-09-11,2023-09-11,Project payment - Customer_0013,REF34540318,0.0,103.35,139385.5
2023-09-11,2023-09-11,Invoice payment - Customer_0058,REF88314748,0.0,47.33,139432.83
2023-09-12,2023-09-12,Payment from Customer_0039,REF91437013,0.0,114.51,139547.34
2023-09-12,2023-09-12,Service payment - Customer_0073,REF79348174,0.0,113.28,139660.62
2023-09-12,2023-09-12,Service payment - Customer_0009,REF40116116,0.0,66.22,139726.84
2023-09-12,2023-09-12,Project payment - Customer_0005,REF82024084,0.0,31.09,139757.93
2023-09-12,2023-09-12,Payment from Customer_0044,REF28832180,0.0,40.85,139798.78
2023-09-12,2023-09-12,Service payment - Customer_0030,REF45780516,0.0,57.28,139856.06
2023-09-12,2023-09-12,Service payment - Customer_0065,REF68382125,0.0,73.8,139929.86
2023-09-12,2023-09-12,Service payment - Customer_0061,REF92434511,0.0,144.79,140074.65
2023-09-13,2023-09-13,Payment from Customer_0081,REF78014365,0.0,91.25,140165.9
2023-09-13,2023-09-13,Project payment - Customer_0058,REF59240760,0.0,49.55,140215.45
2023-09-13,2023-09-13,Invoice payment - Customer_0069,REF78047976,0.0,65.1,140280.55
2023-09-13,2023-09-13,Payment from Customer_0091,REF35872354,0.0,146.09,140426.64
2023-09-13,2023-09-13,Project payment - Customer_0042,REF64351870,0.0,89.25,140515.89
2023-09-13,2023-09-13,Invoice payment - Customer_0055,REF44647118,0.0,52.95,140568.84
2023-09-13,2023-09-13,Service payment - Customer_0025,REF57402075,0.0,88.94,140657.78
2023-09-13,2023-09-13,Invoice payment - Customer_0071,REF29488522,0.0,50.1,140707.88
2023-09-13,2023-09-13,Service payment - Customer_0059,REF26446253,0.0,56.72,140764.6
2023-09-13,2023-09-13,Service payment - Customer_0023,REF35301232,0.0,120.73,140885.33
2023-09-13,2023-09-13,Service payment - Customer_0022,REF26996132,0.0,72.97,140958.3
2023-09-13,2023-09-13,Invoice payment - Customer_0015,REF46128093,0.0,162.2,141120.5
2023-09-13,2023-09-13,Payment from Customer_0013,REF33025794,0.0,63.29,141183.79
2023-09-13,2023-09-13,Payment from Customer_0096,REF94433650,0.0,80.44,141264.23
2023-09-13,2023-09-13,Service payment - Customer_0062,REF56997274,0.0,54.98,141319.21
2023-09-14,2023-09-14,Project payment - Customer_0006,REF88034003,0.0,63.09,141382.3
2023-09-14,2023-09-14,Project payment - Customer_0081,REF77646433,0.0,91.22,141473.52
2023-09-14,2023-09-14,Service payment - Customer_0003,REF57920326,0.0,62.1,141535.62
2023-09-14,2023-09-14,Payment from Customer_0088,REF41104942,0.0,146.12,141681.74
2023-09-14,2023-09-14,Payment from Customer_0030,REF77572674,0.0,45.98,141727.72
2023-09-14,2023-09-14,Payment from Customer_0002,REF79646840,0.0,88.97,141816.69
2023-09-14,2023-09-14,Project payment - Customer_0082,REF40276919,0.0,193.6,142010.29
2023-09-14,2023-09-14,Project payment - Customer_0033,REF61814432,0.0,89.01,142099.3
2023-09-15,2023-09-15,Project payment - Customer_0075,REF96953389,0.0,136.71,142236.01
2023-09-15,2023-09-15,Service payment - Customer_0002,REF76513889,0.0,95.53,142331.54
2023-09-15,2023-09-15,Invoice payment - Customer_0001,REF51299838,0.0,76.75,142408.29
2023-09-15,2023-09-15,Service payment - Customer_0008,REF49862496,0.0,96.72,142505.01
2023-09-15,2023-09-15,Project payment - Customer_0007,REF69368808,0.0,142.72,142647.73
2023-09-15,2023-09-15,Project payment - Customer_0057,REF19997367,0.0,112.57,142760.3
2023-09-15,2023-09-15,Business insurance premium,REF21175939,186.52,0.0,142573.78
2023-09-16,2023-09-16,Service payment - Customer_0024,REF24690152,0.0,89.27,142663.05
2023-09-16,2023-09-16,Payment from Customer_0016,REF16416744,0.0,29.92,142692.97
2023-09-16,2023-09-16,Payment from Customer_0075,REF15617126,0.0,160.15,142853.12
2023-09-16,2023-09-16,Project payment - Customer_0012,REF37777173,0.0,59.78,142912.9
2023-09-16,2023-09-16,Service payment - Customer_0053,REF47046531,0.0,124.67,143037.57
2023-09-16,2023-09-16,Invoice payment - Customer_0072,REF42002176,0.0,120.12,143157.69
2023-09-16,2023-09-16,Project payment - Customer_0007,REF72080934,0.0,150.19,143307.88
2023-09-16,2023-09-16,Project payment - Customer_0082,REF79669259,0.0,135.22,143443.1
2023-09-16,2023-09-16,Project payment - Customer_0039,REF46277962,0.0,134.01,143577.11
2023-09-16,2023-09-16,Invoice payment - Customer_0081,REF22003209,0.0,91.96,143669.07
2023-09-17,2023-09-17,Payment from Customer_0025,REF10234411,0.0,98.01,143767.08
2023-09-17,2023-09-17,Invoice payment - Customer_0026,REF55471794,0.0,125.87,143892.95
2023-09-17,2023-09-17,Payment from Customer_0001,REF83418752,0.0,46.82,143939.77
2023-09-17,2023-09-17,Project payment - Customer_0054,REF27702661,0.0,87.39,144027.16
2023-09-17,2023-09-17,Project payment - Customer_0050,REF22588178,0.0,165.58,144192.74
2023-09-17,2023-09-17,Payment from Customer_0037,REF83456498,0.0,111.29,144304.03
2023-09-17,2023-09-17,Project payment - Customer_0013,REF99917472,0.0,54.25,144358.28
2023-09-17,2023-09-17,Service payment - Customer_0015,REF10846120,0.0,154.62,144512.9
2023-09-17,2023-09-17,Service payment - Customer_0012,REF76785273,0.0,63.63,144576.53
2023-09-18,2023-09-18,Project payment - Customer_0097,REF34243694,0.0,70.98,144647.51
2023-09-18,2023-09-18,Invoice payment - Customer_0062,REF91687638,0.0,41.0,144688.51
2023-09-18,2023-09-18,Service payment - Customer_0025,REF45797083,0.0,113.0,144801.51
2023-09-18,2023-09-18,Invoice payment - Customer_0081,REF52679341,0.0,71.9,144873.41
2023-09-18,2023-09-18,Invoice payment - Customer_0005,REF64227637,0.0,30.86,144904.27
2023-09-18,2023-09-18,Project payment - Customer_0061,REF26439077,0.0,132.25,145036.52
2023-09-18,2023-09-18,Project payment - Customer_0079,REF40315927,0.0,100.76,145137.28
2023-09-19,2023-09-19,Project payment - Customer_0062,REF47680853,0.0,59.82,145197.1
2023-09-19,2023-09-19,Invoice payment - Customer_0063,REF60172181,0.0,71.6,145268.7
2023-09-19,2023-09-19,Invoice payment - Customer_0070,REF16088275,0.0,41.51,145310.21
2023-09-19,2023-09-19,Payment from Customer_0081,REF33406059,0.0,112.74,145422.95
2023-09-19,2023-09-19,Invoice payment - Customer_0099,REF64084800,0.0,45.19,145468.14
2023-09-19,2023-09-19,Payment from Customer_0089,REF10737251,0.0,118.47,145586.61
2023-09-19,2023-09-19,Project payment - Customer_0093,REF95999309,0.0,86.99,145673.6
2023-09-19,2023-09-19,Payment from Customer_0085,REF66394295,0.0,117.92,145791.52
2023-09-19,2023-09-19,Project payment - Customer_0080,REF22303533,0.0,43.94,145835.46
2023-09-20,2023-09-20,Payment from Customer_0005,REF16558123,0.0,37.58,145873.04
2023-09-20,2023-09-20,Project payment - Customer_0065,REF69991422,0.0,46.66,145919.7
2023-09-20,2023-09-20,Payment from Customer_0071,REF79908931,0.0,42.76,145962.46
2023-09-20,2023-09-20,Project payment - Customer_0012,REF64615317,0.0,79.64,146042.1
2023-09-20,2023-09-20,Payment from Customer_0072,REF47851442,0.0,126.14,146168.24
2023-09-21,2023-09-21,Project payment - Customer_0022,REF65620560,0.0,45.44,146213.68
2023-09-21,2023-09-21,Service payment - Customer_0020,REF96274605,0.0,104.97,146318.65
2023-09-21,2023-09-21,Project payment - Customer_0050,REF32669676,0.0,160.83,146479.48
2023-09-21,2023-09-21,Service payment - Customer_0084,REF17479188,0.0,52.2,146531.68
2023-09-21,2023-09-21,Payment from Customer_0000,REF39103874,0.0,53.83,146585.51
2023-09-21,2023-09-21,Invoice payment - Customer_0089,REF94899147,0.0,104.15,146689.66
2023-09-21,2023-09-21,Payment from Customer_0078,REF84874335,0.0,95.65,146785.31
2023-09-21,2023-09-21,Packaging Shipping expense,REF32093573,271.96,0.0,146513.35
2023-09-22,2023-09-22,Utility bill payment,REF97025407,152.85,0.0,146360.5
2023-09-22,2023-09-22,Service payment - Customer_0063,REF84653117,0.0,61.58,146422.08
2023-09-22,2023-09-22,Payment from Customer_0076,REF86967113,0.0,11.7,146433.78
2023-09-22,2023-09-22,Invoice payment - Customer_0041,REF85471301,0.0,117.08,146550.86
2023-09-22,2023-09-22,Project payment - Customer_0074,REF18037810,0.0,40.71,146591.57
2023-09-22,2023-09-22,Payment from Customer_0025,REF76148662,0.0,105.42,146696.99
2023-09-22,2023-09-22,Payment from Customer_0038,REF25596920,0.0,62.12,146759.11
2023-09-22,2023-09-22,Payment from Customer_0068,REF92961621,0.0,45.21,146804.32
2023-09-22,2023-09-22,Project payment - Customer_0055,REF63369954,0.0,62.35,146866.67
2023-09-22,2023-09-22,Service payment - Customer_0028,REF93861204,0.0,93.52,146960.19
2023-09-22,2023-09-22,Invoice payment - Customer_0013,REF74998659,0.0,92.61,147052.8
2023-09-23,2023-09-23,Inventory purchase,REF33058115,774.04,0.0,146278.76
2023-09-23,2023-09-23,Invoice payment - Customer_0078,REF81547523,0.0,146.05,146424.81
2023-09-23,2023-09-23,Invoice payment - Customer_0072,REF70193878,0.0,124.84,146549.65
2023-09-23,2023-09-23,Service payment - Customer_0014,REF24778336,0.0,104.12,146653.77
2023-09-23,2023-09-23,Service payment - Customer_0071,REF62390439,0.0,44.87,146698.64
2023-09-23,2023-09-23,Payment from Customer_0053,REF92371027,0.0,171.65,146870.29
2023-09-23,2023-09-23,Project payment - Customer_0097,REF43396999,0.0,60.04,146930.33
2023-09-24,2023-09-24,Service payment - Customer_0039,REF43785817,0.0,170.16,147100.49
2023-09-24,2023-09-24,Payment from Customer_0002,REF86543414,0.0,81.81,147182.3
2023-09-24,2023-09-24,Invoice payment - Customer_0034,REF88008519,0.0,77.86,147260.16
2023-09-24,2023-09-24,Invoice payment - Customer_0016,REF74986383,0.0,25.26,147285.42
2023-09-24,2023-09-24,Invoice payment - Customer_0011,REF55664339,0.0,76.22,147361.64
2023-09-24,2023-09-24,Service payment - Customer_0033,REF28958827,0.0,76.42,147438.06
2023-09-24,2023-09-24,Payment from Customer_0046,REF63183045,0.0,113.77,147551.83
2023-09-24,2023-09-24,Service payment - Customer_0032,REF44684761,0.0,78.91,147630.74
2023-09-24,2023-09-24,Invoice payment - Customer_0085,REF80053209,0.0,94.6,147725.34
2023-09-24,2023-09-24,Service payment - Customer_0081,REF27064871,0.0,72.58,147797.92
2023-09-24,2023-09-24,Service payment - Customer_0001,REF29510414,0.0,56.19,147854.11
2023-09-24,2023-09-24,Payment from Customer_0059,REF62701386,0.0,59.41,147913.52
2023-09-24,2023-09-24,Service payment - Customer_0018,REF46940514,0.0,59.0,147972.52
2023-09-24,2023-09-24,Professional Services expense,REF28654199,82.24,0.0,147890.28
2023-09-25,2023-09-25,Project payment - Customer_0099,REF38211048,0.0,47.7,147937.98
2023-09-25,2023-09-25,Invoice payment - Customer_0049,REF97316580,0.0,72.75,148010.73
2023-09-25,2023-09-25,Project payment - Customer_0079,REF12821561,0.0,77.76,148088.49
2023-09-25,2023-09-25,Service payment - Customer_0084,REF61547760,0.0,75.47,148163.96
2023-09-25,2023-09-25,Invoice payment - Customer_0066,REF88513137,0.0,48.89,148212.85
2023-09-25,2023-09-25,Service payment - Customer_0040,REF75616197,0.0,35.53,148248.38
2023-09-25,2023-09-25,Invoice payment - Customer_0072,REF40214681,0.0,95.41,148343.79
2023-09-25,2023-09-25,Invoice payment - Customer_0097,REF13723493,0.0,68.05,148411.84
2023-09-25,2023-09-25,Payment from Customer_0008,REF56131609,0.0,120.13,148531.97
2023-09-25,2023-09-25,Invoice payment - Customer_0053,REF55611003,0.0,128.64,148660.61
2023-09-25,2023-09-25,Service payment - Customer_0076,REF25109899,0.0,10.0,148670.61
2023-09-25,2023-09-25,Payment from Customer_0090,REF50398685,0.0,94.01,148764.62
2023-09-25,2023-09-25,Service payment - Customer_0042,REF72294441,0.0,111.85,148876.47
2023-09-25,2023-09-25,Payment from Customer_0082,REF93674207,0.0,161.69,149038.16
2023-09-26,2023-09-26,Invoice payment - Customer_0052,REF90104810,0.0,40.8,149078.96
2023-09-26,2023-09-26,Service payment - Customer_0010,REF13612459,0.0,96.33,149175.29
2023-09-26,2023-09-26,Invoice payment - Customer_0077,REF95303000,0.0,76.74,149252.03
2023-09-26,2023-09-26,Project payment - Customer_0033,REF70526587,0.0,81.77,149333.8
2023-09-26,2023-09-26,Invoice payment - Customer_0028,REF59316963,0.0,70.51,149404.31
2023-09-26,2023-09-26,Service payment - Customer_0095,REF68067324,0.0,69.35,149473.66
2023-09-26,2023-09-26,Project payment - Customer_0014,REF83228710,0.0,90.44,149564.1
2023-09-26,2023-09-26,Project payment - Customer_0092,REF10998445,0.0,73.31,149637.41
2023-09-26,2023-09-26,Payment from Customer_0009,REF80786706,0.0,71.72,149709.13
2023-09-26,2023-09-26,Project payment - Customer_0037,REF71073015,0.0,168.16,149877.29
2023-09-27,2023-09-27,Payment from Customer_0011,REF51767759,0.0,110.32,149987.61
2023-09-27,2023-09-27,Project payment - Customer_0076,REF12157020,0.0,11.13,149998.74
2023-09-27,2023-09-27,Service payment - Customer_0016,REF56872211,0.0,28.45,150027.19
2023-09-27,2023-09-27,Project payment - Customer_0035,REF89498746,0.0,118.81,150146.0
2023-09-28,2023-09-28,Project payment - Customer_0086,REF56267050,0.0,62.56,150208.56
2023-09-28,2023-09-28,Invoice payment - Customer_0016,REF64997203,0.0,30.69,150239.25
2023-09-28,2023-09-28,Project payment - Customer_0044,REF99991423,0.0,33.76,150273.01
2023-09-28,2023-09-28,Service payment - Customer_0050,REF17242225,0.0,164.59,150437.6
2023-09-28,2023-09-28,Invoice payment - Customer_0095,REF93915657,0.0,71.42,150509.02
2023-09-28,2023-09-28,Service payment - Customer_0006,REF91784932,0.0,67.51,150576.53
2023-09-28,2023-09-28,Invoice payment - Customer_0029,REF46497939,0.0,92.55,150669.08
2023-09-28,2023-09-28,Service payment - Customer_0070,REF11928439,0.0,56.0,150725.08
2023-09-28,2023-09-28,Service payment - Customer_0009,REF94923506,0.0,64.01,150789.09
2023-09-29,2023-09-29,Service payment - Customer_0066,REF49474343,0.0,55.47,150844.56
2023-09-29,2023-09-29,Service payment - Customer_0062,REF91073380,0.0,61.31,150905.87
2023-09-29,2023-09-29,Payment from Customer_0010,REF59168806,0.0,115.16,151021.03
2023-09-29,2023-09-29,Service payment - Customer_0081,REF85665148,0.0,77.91,151098.94
2023-09-29,2023-09-29,Service payment - Customer_0036,REF69717592,0.0,48.99,151147.93
2023-09-29,2023-09-29,Payment from Customer_0098,REF86942247,0.0,78.8,151226.73
2023-09-29,2023-09-29,Payment from Customer_0080,REF98994159,0.0,28.62,151255.35
2023-09-30,2023-09-30,Service payment - Customer_0010,REF34235218,0.0,86.52,151341.87
2023-09-30,2023-09-30,Project payment - Customer_0087,REF66238153,0.0,117.1,151458.97
2023-09-30,2023-09-30,Payment from Customer_0005,REF86576596,0.0,32.74,151491.71
2023-09-30,2023-09-30,Invoice payment - Customer_0058,REF78557707,0.0,36.47,151528.18
2023-09-30,2023-09-30,Service payment - Customer_0072,REF55020577,0.0,115.76,151643.94
2023-09-30,2023-09-30,Project payment - Customer_0002,REF93066211,0.0,86.25,151730.19
2023-09-30,2023-09-30,Project payment - Customer_0090,REF51091285,0.0,75.39,151805.58
2023-09-30,2023-09-30,Service payment - Customer_0081,REF20086848,0.0,90.91,151896.49
2023-09-30,2023-09-30,Project payment - Customer_0031,REF95372693,0.0,94.91,151991.4
2023-09-30,2023-09-30,Project payment - Customer_0011,REF45148078,0.0,106.71,152098.11
2023-10-01,2023-10-01,Payment from Customer_0021,REF49936545,0.0,80.15,152178.26
2023-10-01,2023-10-01,Payment from Customer_0047,REF63299499,0.0,147.17,152325.43
2023-10-01,2023-10-01,Invoice payment - Customer_0032,REF35841373,0.0,88.28,152413.71
2023-10-01,2023-10-01,Invoice payment - Customer_0045,REF94523965,0.0,102.36,152516.07
2023-10-01,2023-10-01,Payment from Customer_0013,REF33510259,0.0,94.8,152610.87
2023-10-01,2023-10-01,Project payment - Customer_0084,REF53881496,0.0,87.61,152698.48
2023-10-01,2023-10-01,Project payment - Customer_0027,REF81003973,0.0,88.35,152786.83
2023-10-01,2023-10-01,Invoice payment - Customer_0051,REF81528812,0.0,76.63,152863.46
2023-10-01,2023-10-01,Monthly office rent,REF92737280,1324.32,0.0,151539.14
2023-10-01,2023-10-01,Invoice payment - Customer_0075,REF31529413,0.0,143.7,151682.84
2023-10-01,2023-10-01,Project payment - Customer_0078,REF15231409,0.0,131.02,151813.86
2023-10-01,2023-10-01,Project payment - Customer_0071,REF18030321,0.0,42.97,151856.83
2023-10-01,2023-10-01,Service payment - Customer_0002,REF18302979,0.0,98.72,151955.55
2023-10-01,2023-10-01,Payment from Customer_0060,REF53315549,0.0,81.48,152037.03
2023-10-01,2023-10-01,Service payment - Customer_0069,REF14860338,0.0,74.85,152111.88
2023-10-02,2023-10-02,Service payment - Customer_0084,REF52857651,0.0,82.9,152194.78
2023-10-02,2023-10-02,Invoice payment - Customer_0073,REF86691491,0.0,150.24,152345.02
2023-10-02,2023-10-02,Project payment - Customer_0095,REF93296707,0.0,84.93,152429.95
2023-10-02,2023-10-02,Service payment - Customer_0046,REF28285550,0.0,157.96,152587.91
2023-10-02,2023-10-02,Invoice payment - Customer_0063,REF34955026,0.0,83.11,152671.02
2023-10-02,2023-10-02,Service payment - Customer_0038,REF99533307,0.0,68.65,152739.67
2023-10-03,2023-10-03,Project payment - Customer_0035,REF41850677,0.0,152.87,152892.54
2023-10-03,2023-10-03,Project payment - Customer_0038,REF41986424,0.0,62.06,152954.6
2023-10-03,2023-10-03,Project payment - Customer_0008,REF72332056,0.0,125.6,153080.2
2023-10-03,2023-10-03,Project payment - Customer_0069,REF32029400,0.0,70.48,153150.68
2023-10-04,2023-10-04,Project payment - Customer_0087,REF35732489,0.0,102.88,153253.56
2023-10-04,2023-10-04,Service payment - Customer_0000,REF56431010,0.0,34.5,153288.06
2023-10-04,2023-10-04,Service payment - Customer_0069,REF31720667,0.0,84.44,153372.5
2023-10-04,2023-10-04,Service payment - Customer_0099,REF79790637,0.0,53.45,153425.95
2023-10-04,2023-10-04,Invoice payment - Customer_0007,REF65506918,0.0,127.19,153553.14
2023-10-04,2023-10-04,Invoice payment - Customer_0076,REF25659068,0.0,11.23,153564.37
2023-10-04,2023-10-04,Service payment - Customer_0035,REF64103173,0.0,108.36,153672.73
2023-10-04,2023-10-04,Payment from Customer_0073,REF68128158,0.0,123.52,153796.25
2023-10-05,2023-10-05,Project payment - Customer_0017,REF27395806,0.0,81.12,153877.37
2023-10-05,2023-10-05,Invoice payment - Customer_0042,REF77849741,0.0,115.07,153992.44
2023-10-05,2023-10-05,Invoice payment - Customer_0051,REF78643215,0.0,90.58,154083.02
2023-10-05,2023-10-05,Project payment - Customer_0021,REF91206851,0.0,73.3,154156.32
2023-10-05,2023-10-05,Payment from Customer_0092,REF34948907,0.0,44.19,154200.51
2023-10-05,2023-10-05,Project payment - Customer_0081,REF23239984,0.0,95.05,154295.56
2023-10-05,2023-10-05,Payment from Customer_0074,REF34429556,0.0,48.79,154344.35
2023-10-05,2023-10-05,Project payment - Customer_0075,REF24692301,0.0,97.54,154441.89
2023-10-06,2023-10-06,Payment from Customer_0012,REF66827565,0.0,79.09,154520.98
2023-10-06,2023-10-06,Project payment - Customer_0025,REF90340840,0.0,118.33,154639.31
2023-10-06,2023-10-06,Invoice payment - Customer_0078,REF80750233,0.0,125.59,154764.9
2023-10-06,2023-10-06,Project payment - Customer_0091,REF39972958,0.0,103.36,154868.26
2023-10-06,2023-10-06,Payment from Customer_0008,REF43480154,0.0,104.25,154972.51
2023-10-06,2023-10-06,Payment from Customer_0027,REF62368390,0.0,94.82,155067.33
2023-10-06,2023-10-06,Invoice payment - Customer_0017,REF10795818,0.0,70.8,155138.13
2023-10-06,2023-10-06,Employee payroll,REF35456739,2627.04,0.0,152511.09
2023-10-07,2023-10-07,Service payment - Customer_0085,REF68817725,0.0,121.67,152632.76
2023-10-07,2023-10-07,Invoice payment - Customer_0052,REF36971225,0.0,51.29,152684.05
2023-10-07,2023-10-07,Project payment - Customer_0000,REF35662194,0.0,43.07,152727.12
2023-10-07,2023-10-07,Invoice payment - Customer_0086,REF11978090,0.0,66.33,152793.45
2023-10-07,2023-10-07,Project payment - Customer_0089,REF53447370,0.0,187.78,152981.23
2023-10-07,2023-10-07,Service payment - Customer_0006,REF83976620,0.0,76.24,153057.47
2023-10-07,2023-10-07,Payment from Customer_0047,REF13453441,0.0,143.36,153200.83
2023-10-08,2023-10-08,Project payment - Customer_0015,REF82924868,0.0,135.11,153335.94
2023-10-08,2023-10-08,Project payment - Customer_0041,REF32603785,0.0,89.76,153425.7
2023-10-08,2023-10-08,Invoice payment - Customer_0088,REF67280750,0.0,138.27,153563.97
2023-10-08,2023-10-08,Project payment - Customer_0098,REF14859105,0.0,74.62,153638.59
2023-10-08,2023-10-08,Payment from Customer_0016,REF80346153,0.0,33.29,153671.88
2023-10-08,2023-10-08,Project payment - Customer_0055,REF13149913,0.0,94.06,153765.94
2023-10-08,2023-10-08,Invoice payment - Customer_0039,REF17049794,0.0,162.67,153928.61
2023-10-08,2023-10-08,Invoice payment - Customer_0065,REF43261449,0.0,54.73,153983.34
2023-10-08,2023-10-08,Project payment - Customer_0060,REF43045628,0.0,79.79,154063.13
2023-10-08,2023-10-08,Payment from Customer_0086,REF20508908,0.0,73.22,154136.35
2023-10-08,2023-10-08,Service payment - Customer_0051,REF75158181,0.0,93.1,154229.45
2023-10-09,2023-10-09,Project payment - Customer_0015,REF22948911,0.0,134.95,154364.4
2023-10-09,2023-10-09,Invoice payment - Customer_0017,REF85419059,0.0,75.32,154439.72
2023-10-09,2023-10-09,Payment from Customer_0023,REF36418087,0.0,94.59,154534.31
2023-10-09,2023-10-09,Invoice payment - Customer_0095,REF81698158,0.0,98.61,154632.92
2023-10-09,2023-10-09,Payment from Customer_0073,REF33889583,0.0,104.33,154737.25
2023-10-09,2023-10-09,Service payment - Customer_0016,REF13805370,0.0,37.17,154774.42
2023-10-09,2023-10-09,Project payment - Customer_0099,REF85398780,0.0,55.06,154829.48
2023-10-09,2023-10-09,Project payment - Customer_0041,REF65660389,0.0,150.22,154979.7
2023-10-10,2023-10-10,Payment from Customer_0025,REF70775110,0.0,108.65,155088.35
2023-10-10,2023-10-10,Payment from Customer_0026,REF88915251,0.0,101.44,155189.79
2023-10-10,2023-10-10,Project payment - Customer_0066,REF18150065,0.0,65.67,155255.46
2023-10-10,2023-10-10,Project payment - Customer_0041,REF89808154,0.0,165.18,155420.64
2023-10-10,2023-10-10,Payment from Customer_0078,REF95747516,0.0,144.88,155565.52
2023-10-10,2023-10-10,Project payment - Customer_0020,REF88655827,0.0,119.9,155685.42
2023-10-10,2023-10-10,Payment from Customer_0048,REF19501637,0.0,119.99,155805.41
2023-10-10,2023-10-10,Service payment - Customer_0008,REF52632432,0.0,115.09,155920.5
2023-10-10,2023-10-10,Payment from Customer_0021,REF74834508,0.0,77.98,155998.48
2023-10-11,2023-10-11,Invoice payment - Customer_0086,REF72769125,0.0,78.51,156076.99
2023-10-11,2023-10-11,Service payment - Customer_0071,REF98741277,0.0,49.03,156126.02
2023-10-11,2023-10-11,Project payment - Customer_0081,REF98110963,0.0,102.67,156228.69
2023-10-11,2023-10-11,Invoice payment - Customer_0078,REF63990977,0.0,108.24,156336.93
2023-10-11,2023-10-11,Payment from Customer_0027,REF50573323,0.0,106.8,156443.73
2023-10-11,2023-10-11,Invoice payment - Customer_0004,REF19679424,0.0,60.82,156504.55
2023-10-11,2023-10-11,Payment from Customer_0052,REF25834657,0.0,46.03,156550.58
2023-10-11,2023-10-11,Payment from Customer_0015,REF82574115,0.0,147.53,156698.11
2023-10-11,2023-10-11,Service payment - Customer_0057,REF64473624,0.0,133.49,156831.6
2023-10-11,2023-10-11,Service payment - Customer_0097,REF59233020,0.0,94.77,156926.37
2023-10-12,2023-10-12,Invoice payment - Customer_0042,REF97370784,0.0,116.69,157043.06
2023-10-12,2023-10-12,Service payment - Customer_0010,REF31579556,0.0,112.28,157155.34
2023-10-12,2023-10-12,Payment from Customer_0057,REF23139000,0.0,134.65,157289.99
2023-10-12,2023-10-12,Service payment - Customer_0082,REF69591186,0.0,160.14,157450.13
2023-10-12,2023-10-12,Invoice payment - Customer_0052,REF95404975,0.0,42.67,157492.8
2023-10-12,2023-10-12,Payment from Customer_0019,REF90952715,0.0,110.98,157603.78
2023-10-12,2023-10-12,Inventory purchase,REF26307040,1519.88,0.0,156083.9
2023-10-12,2023-10-12,Service payment - Customer_0050,REF10861817,0.0,177.27,156261.17
2023-10-12,2023-10-12,Payment from Customer_0041,REF58277679,0.0,108.08,156369.25
2023-10-12,2023-10-12,Service payment - Customer_0027,REF95998755,0.0,63.39,156432.64
2023-10-12,2023-10-12,Service payment - Customer_0094,REF73974313,0.0,79.34,156511.98
2023-10-12,2023-10-12,Invoice payment - Customer_0013,REF36886453,0.0,83.17,156595.15
2023-10-12,2023-10-12,Project payment - Customer_0062,REF95560504,0.0,58.17,156653.32
2023-10-12,2023-10-12,Payment from Customer_0036,REF43333419,0.0,67.04,156720.36
2023-10-12,2023-10-12,Project payment - Customer_0064,REF53182089,0.0,43.91,156764.27
2023-10-12,2023-10-12,Invoice payment - Customer_0021,REF55648122,0.0,75.0,156839.27
2023-10-13,2023-10-13,Invoice payment - Customer_0083,REF73538528,0.0,68.36,156907.63
2023-10-13,2023-10-13,Project payment - Customer_0052,REF66431100,0.0,47.68,156955.31
2023-10-13,2023-10-13,Invoice payment - Customer_0060,REF75471754,0.0,93.87,157049.18
2023-10-13,2023-10-13,Service payment - Customer_0024,REF49156620,0.0,94.38,157143.56
2023-10-13,2023-10-13,Payment from Customer_0095,REF51845598,0.0,60.89,157204.45
2023-10-13,2023-10-13,Service payment - Customer_0099,REF87175210,0.0,58.08,157262.53
2023-10-13,2023-10-13,Service payment - Customer_0097,REF26787919,0.0,72.84,157335.37
2023-10-14,2023-10-14,Service payment - Customer_0096,REF18341083,0.0,125.4,157460.77
2023-10-14,2023-10-14,Service payment - Customer_0005,REF85776783,0.0,29.32,157490.09
2023-10-14,2023-10-14,Payment from Customer_0070,REF32159539,0.0,51.01,157541.1
2023-10-14,2023-10-14,Project payment - Customer_0029,REF93461758,0.0,93.9,157635.0
2023-10-14,2023-10-14,Service payment - Customer_0032,REF97254826,0.0,92.29,157727.29
2023-10-15,2023-10-15,Project payment - Customer_0014,REF61132315,0.0,111.42,157838.71
2023-10-15,2023-10-15,Service payment - Customer_0085,REF52345126,0.0,92.25,157930.96
2023-10-15,2023-10-15,Payment from Customer_0055,REF29453247,0.0,78.21,158009.17
2023-10-15,2023-10-15,Invoice payment - Customer_0093,REF53324878,0.0,117.35,158126.52
2023-10-15,2023-10-15,Service payment - Customer_0023,REF42348583,0.0,138.53,158265.05
2023-10-15,2023-10-15,Service payment - Customer_0021,REF11739397,0.0,72.87,158337.92
2023-10-15,2023-10-15,Payment from Customer_0058,REF10049708,0.0,57.73,158395.65
2023-10-15,2023-10-15,Business insurance premium,REF77950244,193.83,0.0,158201.82
2023-10-15,2023-10-15,Payment from Customer_0049,REF60293633,0.0,83.98,158285.8
2023-10-15,2023-10-15,Payment from Customer_0000,REF23636077,0.0,36.22,158322.02
2023-10-15,2023-10-15,Invoice payment - Customer_0010,REF20004472,0.0,113.26,158435.28
2023-10-15,2023-10-15,Project payment - Customer_0072,REF52610837,0.0,145.96,158581.24
2023-10-15,2023-10-15,Service payment - Customer_0078,REF99331808,0.0,139.31,158720.55
2023-10-16,2023-10-16,Service payment - Customer_0082,REF18592847,0.0,200.07,158920.62
2023-10-16,2023-10-16,Service payment - Customer_0031,REF56987869,0.0,116.83,159037.45
2023-10-16,2023-10-16,Invoice payment - Customer_0079,REF72959855,0.0,100.93,159138.38
2023-10-16,2023-10-16,Payment from Customer_0011,REF49856960,0.0,123.01,159261.39
2023-10-16,2023-10-16,Payment from Customer_0021,REF31096722,0.0,58.73,159320.12
2023-10-16,2023-10-16,Invoice payment - Customer_0064,REF13147891,0.0,42.65,159362.77
2023-10-16,2023-10-16,Service payment - Customer_0045,REF90476492,0.0,100.15,159462.92
2023-10-16,2023-10-16,Project payment - Customer_0044,REF19291281,0.0,40.62,159503.54
2023-10-17,2023-10-17,Project payment - Customer_0003,REF12700963,0.0,92.06,159595.6
2023-10-17,2023-10-17,Service payment - Customer_0078,REF52925422,0.0,106.99,159702.59
2023-10-17,2023-10-17,Payment from Customer_0066,REF57970382,0.0,67.89,159770.48
2023-10-17,2023-10-17,Service payment - Customer_0009,REF34280358,0.0,88.99,159859.47
2023-10-17,2023-10-17,Service payment - Customer_0070,REF97059381,0.0,66.71,159926.18
2023-10-17,2023-10-17,Invoice payment - Customer_0015,REF78602386,0.0,111.3,160037.48
2023-10-17,2023-10-17,Project payment - Customer_0021,REF63723913,0.0,68.82,160106.3
2023-10-17,2023-10-17,Payment from Customer_0094,REF92550186,0.0,91.88,160198.18
2023-10-17,2023-10-17,Project payment - Customer_0093,REF93837679,0.0,116.31,160314.49
2023-10-18,2023-10-18,Invoice payment - Customer_0022,REF96842438,0.0,82.29,160396.78
2023-10-18,2023-10-18,Invoice payment - Customer_0095,REF34139330,0.0,116.91,160513.69
2023-10-18,2023-10-18,Invoice payment - Customer_0053,REF31984531,0.0,160.72,160674.41
2023-10-18,2023-10-18,Payment from Customer_0019,REF74892008,0.0,74.46,160748.87
2023-10-18,2023-10-18,Payment from Customer_0030,REF74537312,0.0,44.08,160792.95
2023-10-18,2023-10-18,Payment from Customer_0035,REF45890539,0.0,197.09,160990.04
2023-10-18,2023-10-18,Payment from Customer_0082,REF51148242,0.0,175.19,161165.23
2023-10-18,2023-10-18,Payment from Customer_0093,REF65427334,0.0,121.19,161286.42
2023-10-18,2023-10-18,Service payment - Customer_0087,REF70207136,0.0,49.22,161335.64
2023-10-18,2023-10-18,Service payment - Customer_0002,REF28183485,0.0,89.93,161425.57
2023-10-18,2023-10-18,Service payment - Customer_0041,REF18978916,0.0,137.62,161563.19
2023-10-19,2023-10-19,Invoice payment - Customer_0021,REF21705703,0.0,69.76,161632.95
2023-10-19,2023-10-19,Payment from Customer_0049,REF45886910,0.0,81.32,161714.27
2023-10-19,2023-10-19,Project payment - Customer_0053,REF37550026,0.0,104.99,161819.26
2023-10-19,2023-10-19,Invoice payment - Customer_0016,REF43565902,0.0,31.51,161850.77
2023-10-19,2023-10-19,Payment from Customer_0096,REF67136945,0.0,111.55,161962.32
2023-10-19,2023-10-19,Invoice payment - Customer_0047,REF32602984,0.0,125.11,162087.43
2023-10-19,2023-10-19,Invoice payment - Customer_0008,REF88032676,0.0,110.27,162197.7
2023-10-19,2023-10-19,Payment from Customer_0033,REF28682664,0.0,102.69,162300.39
2023-10-20,2023-10-20,Invoice payment - Customer_0075,REF56398012,0.0,127.44,162427.83
2023-10-20,2023-10-20,Project payment - Customer_0093,REF20663921,0.0,112.11,162539.94
2023-10-20,2023-10-20,Project payment - Customer_0030,REF61670928,0.0,74.91,162614.85
2023-10-20,2023-10-20,Project payment - Customer_0056,REF76290818,0.0,40.61,162655.46
2023-10-20,2023-10-20,Service payment - Customer_0018,REF45777454,0.0,77.62,162733.08
2023-10-20,2023-10-20,Service payment - Customer_0011,REF89647022,0.0,146.47,162879.55
2023-10-20,2023-10-20,Invoice payment - Customer_0069,REF26267006,0.0,53.44,162932.99
2023-10-20,2023-10-20,Project payment - Customer_0097,REF74915046,0.0,89.93,163022.92
2023-10-20,2023-10-20,Payment from Customer_0035,REF49992819,0.0,144.12,163167.04
2023-10-21,2023-10-21,Invoice payment - Customer_0037,REF44123324,0.0,118.32,163285.36
2023-10-21,2023-10-21,Service payment - Customer_0053,REF16821438,0.0,124.04,163409.4
2023-10-21,2023-10-21,Project payment - Customer_0095,REF57017070,0.0,122.38,163531.78
2023-10-21,2023-10-21,Payment from Customer_0090,REF25228614,0.0,56.56,163588.34
2023-10-21,2023-10-21,Service payment - Customer_0080,REF99207624,0.0,45.32,163633.66
2023-10-21,2023-10-21,Service payment - Customer_0076,REF49423786,0.0,10.0,163643.66
2023-10-21,2023-10-21,Project payment - Customer_0030,REF34134383,0.0,45.49,163689.15
2023-10-21,2023-10-21,Payment from Customer_0038,REF64758722,0.0,68.68,163757.83
2023-10-21,2023-10-21,Payment from Customer_0044,REF39140036,0.0,47.23,163805.06
2023-10-21,2023-10-21,Project payment - Customer_0039,REF38076620,0.0,125.72,163930.78
2023-10-22,2023-10-22,Invoice payment - Customer_0029,REF94399401,0.0,78.11,164008.89
2023-10-22,2023-10-22,Payment from Customer_0048,REF28257730,0.0,94.23,164103.12
2023-10-22,2023-10-22,Project payment - Customer_0015,REF92174598,0.0,145.67,164248.79
2023-10-22,2023-10-22,Project payment - Customer_0062,REF76737929,0.0,57.31,164306.1
2023-10-22,2023-10-22,Project payment - Customer_0079,REF36016838,0.0,87.67,164393.77
2023-10-22,2023-10-22,Project payment - Customer_0032,REF65545318,0.0,85.67,164479.44
2023-10-22,2023-10-22,Service payment - Customer_0088,REF15878523,0.0,133.77,164613.21
2023-10-22,2023-10-22,Utility bill payment,REF24396288,155.61,0.0,164457.6
2023-10-22,2023-10-22,Project payment - Customer_0049,REF69244065,0.0,108.29,164565.89
2023-10-22,2023-10-22,Invoice payment - Customer_0036,REF85280591,0.0,70.37,164636.26
2023-10-23,2023-10-23,Invoice payment - Customer_0062,REF48973929,0.0,50.4,164686.66
2023-10-23,2023-10-23,Project payment - Customer_0088,REF54426603,0.0,130.94,164817.6
2023-10-23,2023-10-23,Service payment - Customer_0079,REF26645270,0.0,68.8,164886.4
2023-10-23,2023-10-23,Service payment - Customer_0076,REF86404876,0.0,12.31,164898.71
2023-10-23,2023-10-23,Service payment - Customer_0007,REF98777213,0.0,152.53,165051.24
2023-10-23,2023-10-23,Service payment - Customer_0073,REF25964080,0.0,138.22,165189.46
2023-10-24,2023-10-24,Payment from Customer_0067,REF30595389,0.0,163.75,165353.21
2023-10-24,2023-10-24,Payment from Customer_0080,REF80959843,0.0,35.99,165389.2
2023-10-24,2023-10-24,Project payment - Customer_0011,REF24850760,0.0,129.3,165518.5
2023-10-24,2023-10-24,Invoice payment - Customer_0084,REF96448997,0.0,84.54,165603.04
2023-10-24,2023-10-24,Payment from Customer_0097,REF72505365,0.0,62.33,165665.37
2023-10-24,2023-10-24,Invoice payment - Customer_0083,REF89613573,0.0,71.7,165737.07
2023-10-24,2023-10-24,Payment from Customer_0029,REF24610186,0.0,103.4,165840.47
2023-10-24,2023-10-24,Payment from Customer_0037,REF94142516,0.0,210.06,166050.53
2023-10-25,2023-10-25,Project payment - Customer_0079,REF56979252,0.0,104.12,166154.65
2023-10-25,2023-10-25,Invoice payment - Customer_0095,REF32572936,0.0,96.22,166250.87
2023-10-25,2023-10-25,Payment from Customer_0071,REF88975974,0.0,53.33,166304.2
2023-10-25,2023-10-25,Project payment - Customer_0021,REF66431463,0.0,74.45,166378.65
2023-10-25,2023-10-25,Invoice payment - Customer_0048,REF46765375,0.0,98.9,166477.55
2023-10-25,2023-10-25,Payment from Customer_0067,REF87329038,0.0,144.09,166621.64
2023-10-25,2023-10-25,Payment from Customer_0027,REF39000307,0.0,111.73,166733.37
2023-10-25,2023-10-25,Service payment - Customer_0008,REF47796212,0.0,107.85,166841.22
2023-10-25,2023-10-25,Invoice payment - Customer_0019,REF67342768,0.0,89.4,166930.62
2023-10-25,2023-10-25,Invoice payment - Customer_0057,REF48131491,0.0,126.75,167057.37
2023-10-25,2023-10-25,Invoice payment - Customer_0070,REF81985858,0.0,57.81,167115.18
2023-10-26,2023-10-26,Project payment - Customer_0056,REF10141186,0.0,33.98,167149.16
2023-10-26,2023-10-26,Payment from Customer_0022,REF58075268,0.0,89.04,167238.2
2023-10-26,2023-10-26,Project payment - Customer_0070,REF24187554,0.0,66.68,167304.88
2023-10-26,2023-10-26,Invoice payment - Customer_0012,REF50550223,0.0,91.35,167396.23
2023-10-26,2023-10-26,Service payment - Customer_0001,REF19701955,0.0,68.33,167464.56
2023-10-26,2023-10-26,Project payment - Customer_0019,REF99409408,0.0,109.58,167574.14
2023-10-26,2023-10-26,Invoice payment - Customer_0037,REF31339094,0.0,167.21,167741.35
2023-10-26,2023-10-26,Project payment - Customer_0043,REF94295000,0.0,138.37,167879.72
2023-10-26,2023-10-26,Project payment - Customer_0048,REF50174629,0.0,107.46,167987.18
2023-10-26,2023-10-26,Project payment - Customer_0063,REF43369736,0.0,72.97,168060.15
2023-10-27,2023-10-27,Payment from Customer_0042,REF57961752,0.0,121.2,168181.35
2023-10-27,2023-10-27,Project payment - Customer_0037,REF82100654,0.0,113.58,168294.93
2023-10-27,2023-10-27,Invoice payment - Customer_0060,REF66530964,0.0,113.1,168408.03
2023-10-27,2023-10-27,Service payment - Customer_0045,REF48866292,0.0,92.06,168500.09
2023-10-27,2023-10-27,Payment from Customer_0005,REF87235675,0.0,29.46,168529.55
2023-10-27,2023-10-27,Service payment - Customer_0022,REF78556777,0.0,83.35,168612.9
2023-10-27,2023-10-27,Invoice payment - Customer_0011,REF98682949,0.0,105.68,168718.58
2023-10-27,2023-10-27,Project payment - Customer_0079,REF44196421,0.0,113.06,168831.64
2023-10-27,2023-10-27,Invoice payment - Customer_0099,REF87124839,0.0,60.91,168892.55
2023-10-28,2023-10-28,Project payment - Customer_0093,REF81636165,0.0,120.78,169013.33
2023-10-28,2023-10-28,Invoice payment - Customer_0004,REF50118467,0.0,49.04,169062.37
2023-10-28,2023-10-28,Service payment - Customer_0081,REF88991417,0.0,107.16,169169.53
2023-10-28,2023-10-28,Service payment - Customer_0071,REF51108544,0.0,60.3,169229.83
2023-10-28,2023-10-28,Service payment - Customer_0036,REF89848458,0.0,72.72,169302.55
2023-10-28,2023-10-28,Project payment - Customer_0035,REF38694184,0.0,113.99,169416.54
2023-10-28,2023-10-28,Service payment - Customer_0058,REF19886028,0.0,52.98,169469.52
2023-10-28,2023-10-28,Invoice payment - Customer_0028,REF22174215,0.0,111.89,169581.41
2023-10-29,2023-10-29,Project payment - Customer_0053,REF15165898,0.0,149.89,169731.3
2023-10-29,2023-10-29,Project payment - Customer_0027,REF46650518,0.0,93.55,169824.85
2023-10-29,2023-10-29,Payment from Customer_0025,REF98287350,0.0,131.5,169956.35
2023-10-29,2023-10-29,Project payment - Customer_0010,REF91863172,0.0,99.62,170055.97
2023-10-29,2023-10-29,Invoice payment - Customer_0052,REF81874312,0.0,40.05,170096.02
2023-10-29,2023-10-29,Payment from Customer_0078,REF69645705,0.0,157.57,170253.59
2023-10-29,2023-10-29,Payment from Customer_0046,REF14004883,0.0,181.9,170435.49
2023-10-29,2023-10-29,Payment from Customer_0032,REF27819906,0.0,77.68,170513.17
2023-10-29,2023-10-29,Service payment - Customer_0073,REF82571644,0.0,116.54,170629.71
2023-10-30,2023-10-30,Invoice payment - Customer_0042,REF15647831,0.0,110.91,170740.62
2023-10-30,2023-10-30,Invoice payment - Customer_0087,REF45816854,0.0,107.85,170848.47
2023-10-31,2023-10-31,Project payment - Customer_0018,REF18562729,0.0,99.89,170948.36
2023-10-31,2023-10-31,Project payment - Customer_0053,REF14715730,0.0,157.91,171106.27
2023-10-31,2023-10-31,Service payment - Customer_0023,REF91194272,0.0,117.74,171224.01
2023-10-31,2023-10-31,Service payment - Customer_0068,REF85713123,0.0,53.43,171277.44
2023-10-31,2023-10-31,Service payment - Customer_0050,REF59323235,0.0,173.6,171451.04
2023-10-31,2023-10-31,Project payment - Customer_0078,REF89727418,0.0,140.16,171591.2
2023-10-31,2023-10-31,Invoice payment - Customer_0087,REF58778442,0.0,88.51,171679.71
2023-11-01,2023-11-01,Invoice payment - Customer_0054,REF62378253,0.0,83.47,171763.18
2023-11-01,2023-11-01,Payment from Customer_0089,REF22631576,0.0,163.7,171926.88
2023-11-01,2023-11-01,Service payment - Customer_0003,REF88854778,0.0,96.93,172023.81
2023-11-01,2023-11-01,Monthly office rent,REF65601223,1548.85,0.0,170474.96
2023-11-01,2023-11-01,Invoice payment - Customer_0049,REF63715311,0.0,134.81,170609.77
2023-11-01,2023-11-01,Payment from Customer_0066,REF75766922,0.0,78.96,170688.73
2023-11-01,2023-11-01,Inventory purchase,REF66473407,4052.9,0.0,166635.83
2023-11-01,2023-11-01,Payment from Customer_0096,REF74889312,0.0,110.16,166745.99
2023-11-01,2023-11-01,Service payment - Customer_0048,REF63465060,0.0,135.78,166881.77
2023-11-01,2023-11-01,Project payment - Customer_0053,REF42799806,0.0,216.48,167098.25
2023-11-01,2023-11-01,Service payment - Customer_0059,REF16466737,0.0,104.75,167203.0
2023-11-02,2023-11-02,Payment from Customer_0079,REF10946294,0.0,115.65,167318.65
2023-11-02,2023-11-02,Invoice payment - Customer_0053,REF86660871,0.0,169.04,167487.69
2023-11-02,2023-11-02,Invoice payment - Customer_0061,REF63041099,0.0,211.07,167698.76
2023-11-02,2023-11-02,Service payment - Customer_0060,REF32090257,0.0,137.4,167836.16
2023-11-03,2023-11-03,Employee payroll,REF60007559,3079.71,0.0,164756.45
2023-11-03,2023-11-03,Service payment - Customer_0067,REF99208080,0.0,148.71,164905.16
2023-11-03,2023-11-03,Project payment - Customer_0002,REF79799534,0.0,127.74,165032.9
2023-11-03,2023-11-03,Payment from Customer_0081,REF30738134,0.0,122.31,165155.21
2023-11-03,2023-11-03,Payment from Customer_0088,REF40478450,0.0,142.59,165297.8
2023-11-03,2023-11-03,Service payment - Customer_0033,REF71942634,0.0,105.99,165403.79
2023-11-03,2023-11-03,Project payment - Customer_0003,REF64668313,0.0,102.8,165506.59
2023-11-03,2023-11-03,Service payment - Customer_0092,REF18688153,0.0,76.61,165583.2
2023-11-03,2023-11-03,Invoice payment - Customer_0041,REF48218240,0.0,171.32,165754.52
2023-11-04,2023-11-04,Service payment - Customer_0035,REF47825891,0.0,184.28,165938.8
2023-11-04,2023-11-04,Invoice payment - Customer_0085,REF84015799,0.0,205.08,166143.88
2023-11-04,2023-11-04,Invoice payment - Customer_0053,REF91702647,0.0,190.46,166334.34
2023-11-04,2023-11-04,Service payment - Customer_0016,REF60279311,0.0,50.47,166384.81
2023-11-04,2023-11-04,Invoice payment - Customer_0074,REF86338773,0.0,90.48,166475.29
2023-11-04,2023-11-04,Invoice payment - Customer_0093,REF81723752,0.0,184.69,166659.98
2023-11-04,2023-11-04,Service payment - Customer_0007,REF15210710,0.0,173.56,166833.54
2023-11-04,2023-11-04,Professional Services expense,REF56206211,258.87,0.0,166574.67
2023-11-04,2023-11-04,Service payment - Customer_0082,REF77073522,0.0,190.59,166765.26
2023-11-05,2023-11-05,Service payment - Customer_0025,REF40884650,0.0,143.79,166909.05
2023-11-05,2023-11-05,Service payment - Customer_0043,REF14749261,0.0,153.25,167062.3
2023-11-05,2023-11-05,Service payment - Customer_0056,REF49473196,0.0,47.85,167110.15
2023-11-05,2023-11-05,Payment from Customer_0054,REF43958398,0.0,79.58,167189.73
2023-11-05,2023-11-05,Invoice payment - Customer_0072,REF43363929,0.0,139.66,167329.39
2023-11-05,2023-11-05,Project payment - Customer_0026,REF82473502,0.0,167.17,167496.56
2023-11-05,2023-11-05,Invoice payment - Customer_0021,REF63090352,0.0,91.46,167588.02
2023-11-06,2023-11-06,Invoice payment - Customer_0009,REF39389220,0.0,117.44,167705.46
2023-11-06,2023-11-06,Service payment - Customer_0093,REF41434056,0.0,123.21,167828.67
2023-11-06,2023-11-06,Service payment - Customer_0044,REF41740258,0.0,61.56,167890.23
2023-11-06,2023-11-06,Payment from Customer_0061,REF61210122,0.0,164.67,168054.9
2023-11-06,2023-11-06,Payment from Customer_0082,REF89028094,0.0,246.81,168301.71
2023-11-06,2023-11-06,Project payment - Customer_0000,REF47408765,0.0,63.29,168365.0
2023-11-06,2023-11-06,Project payment - Customer_0076,REF75265968,0.0,13.97,168378.97
2023-11-07,2023-11-07,Service payment - Customer_0066,REF98355129,0.0,84.34,168463.31
2023-11-07,2023-11-07,Project payment - Customer_0060,REF33657505,0.0,115.65,168578.96
2023-11-07,2023-11-07,Payment from Customer_0020,REF65862288,0.0,162.73,168741.69
2023-11-07,2023-11-07,Invoice payment - Customer_0065,REF47204657,0.0,81.58,168823.27
2023-11-07,2023-11-07,Project payment - Customer_0064,REF96072218,0.0,54.17,168877.44
2023-11-07,2023-11-07,Payment from Customer_0007,REF43569471,0.0,187.92,169065.36
2023-11-07,2023-11-07,Invoice payment - Customer_0040,REF14623939,0.0,51.76,169117.12
2023-11-08,2023-11-08,Service payment - Customer_0043,REF90010430,0.0,167.55,169284.67
2023-11-08,2023-11-08,Project payment - Customer_0012,REF76378072,0.0,87.97,169372.64
2023-11-08,2023-11-08,Payment from Customer_0041,REF47536556,0.0,222.33,169594.97
2023-11-08,2023-11-08,Service payment - Customer_0079,REF54462588,0.0,90.28,169685.25
2023-11-08,2023-11-08,Invoice payment - Customer_0018,REF99229407,0.0,73.88,169759.13
2023-11-08,2023-11-08,Service payment - Customer_0022,REF27569583,0.0,91.19,169850.32
2023-11-08,2023-11-08,Project payment - Customer_0033,REF10820313,0.0,76.05,169926.37
2023-11-08,2023-11-08,Service payment - Customer_0090,REF48637788,0.0,160.41,170086.78
2023-11-08,2023-11-08,Invoice payment - Customer_0088,REF22484552,0.0,169.93,170256.71
2023-11-09,2023-11-09,Invoice payment - Customer_0044,REF23900739,0.0,47.48,170304.19
2023-11-09,2023-11-09,Project payment - Customer_0027,REF56662389,0.0,137.41,170441.6
2023-11-09,2023-11-09,Service payment - Customer_0068,REF48458511,0.0,63.71,170505.31
2023-11-09,2023-11-09,Invoice payment - Customer_0023,REF97898947,0.0,131.72,170637.03
2023-11-09,2023-11-09,Invoice payment - Customer_0078,REF12912221,0.0,206.51,170843.54
2023-11-09,2023-11-09,Service payment - Customer_0098,REF71376481,0.0,106.41,170949.95
2023-11-10,2023-11-10,Payment from Customer_0070,REF54175096,0.0,56.04,171005.99
2023-11-10,2023-11-10,Payment from Customer_0053,REF41869640,0.0,177.3,171183.29
2023-11-10,2023-11-10,Service payment - Customer_0008,REF58689278,0.0,110.32,171293.61
2023-11-10,2023-11-10,Service payment - Customer_0027,REF82718169,0.0,143.49,171437.1
2023-11-10,2023-11-10,Project payment - Customer_0056,REF47834753,0.0,49.5,171486.6
2023-11-10,2023-11-10,Payment from Customer_0074,REF46038935,0.0,62.45,171549.05
2023-11-10,2023-11-10,Project payment - Customer_0039,REF27228480,0.0,213.88,171762.93
2023-11-10,2023-11-10,Project payment - Customer_0007,REF31947952,0.0,230.3,171993.23
2023-11-10,2023-11-10,Invoice payment - Customer_0009,REF90991262,0.0,120.52,172113.75
2023-11-10,2023-11-10,Service payment - Customer_0036,REF38793542,0.0,79.15,172192.9
2023-11-11,2023-11-11,Project payment - Customer_0010,REF51311163,0.0,134.53,172327.43
2023-11-11,2023-11-11,Project payment - Customer_0030,REF47032827,0.0,54.12,172381.55
2023-11-11,2023-11-11,Invoice payment - Customer_0039,REF89425166,0.0,190.33,172571.88
2023-11-11,2023-11-11,Inventory purchase,REF92150783,2900.97,0.0,169670.91
2023-11-11,2023-11-11,Service payment - Customer_0064,REF51531109,0.0,44.99,169715.9
2023-11-11,2023-11-11,Invoice payment - Customer_0019,REF39229459,0.0,129.56,169845.46
2023-11-11,2023-11-11,Service payment - Customer_0043,REF61574816,0.0,163.19,170008.65
2023-11-11,2023-11-11,Payment from Customer_0080,REF37728378,0.0,40.11,170048.76
2023-11-11,2023-11-11,Payment from Customer_0074,REF54792588,0.0,60.43,170109.19
2023-11-12,2023-11-12,Payment from Customer_0011,REF47415378,0.0,130.27,170239.46
2023-11-12,2023-11-12,Service payment - Customer_0081,REF29147220,0.0,119.44,170358.9
2023-11-12,2023-11-12,Payment from Customer_0038,REF54452976,0.0,81.73,170440.63
2023-11-12,2023-11-12,Service payment - Customer_0092,REF14173794,0.0,104.79,170545.42
2023-11-12,2023-11-12,Project payment - Customer_0033,REF75817627,0.0,115.73,170661.15
2023-11-12,2023-11-12,Service payment - Customer_0039,REF88255851,0.0,128.46,170789.61
2023-11-12,2023-11-12,Payment from Customer_0030,REF26090744,0.0,58.92,170848.53
2023-11-12,2023-11-12,Payment from Customer_0024,REF55763657,0.0,143.08,170991.61
2023-11-12,2023-11-12,Payment from Customer_0048,REF65697268,0.0,118.04,171109.65
2023-11-12,2023-11-12,Service payment - Customer_0002,REF40047145,0.0,119.82,171229.47
2023-11-12,2023-11-12,Payment from Customer_0049,REF34447678,0.0,94.37,171323.84
2023-11-12,2023-11-12,Invoice payment - Customer_0072,REF97791439,0.0,189.5,171513.34
2023-11-12,2023-11-12,Payment from Customer_0005,REF26090815,0.0,46.44,171559.78
2023-11-13,2023-11-13,Service payment - Customer_0050,REF72640670,0.0,232.29,171792.07
2023-11-13,2023-11-13,Service payment - Customer_0080,REF84198879,0.0,56.2,171848.27
2023-11-13,2023-11-13,Payment from Customer_0094,REF49099739,0.0,104.88,171953.15
2023-11-13,2023-11-13,Invoice payment - Customer_0087,REF86534307,0.0,104.75,172057.9
2023-11-13,2023-11-13,Service payment - Customer_0014,REF73950127,0.0,98.26,172156.16
2023-11-13,2023-11-13,Invoice payment - Customer_0074,REF96322268,0.0,77.68,172233.84
2023-11-13,2023-11-13,Project payment - Customer_0037,REF38027701,0.0,259.41,172493.25
2023-11-13,2023-11-13,Payment from Customer_0025,REF45728076,0.0,111.93,172605.18
2023-11-14,2023-11-14,Project payment - Customer_0052,REF82392275,0.0,43.9,172649.08
2023-11-14,2023-11-14,Service payment - Customer_0095,REF60026874,0.0,106.77,172755.85
2023-11-14,2023-11-14,Service payment - Customer_0004,REF77883065,0.0,83.38,172839.23
2023-11-14,2023-11-14,Project payment - Customer_0002,REF36786498,0.0,121.55,172960.78
2023-11-14,2023-11-14,Payment from Customer_0034,REF30319496,0.0,111.58,173072.36
2023-11-14,2023-11-14,Project payment - Customer_0092,REF97554669,0.0,87.08,173159.44
2023-11-14,2023-11-14,Project payment - Customer_0049,REF80184997,0.0,146.67,173306.11
2023-11-14,2023-11-14,Invoice payment - Customer_0090,REF84113397,0.0,108.41,173414.52
2023-11-14,2023-11-14,Payment from Customer_0008,REF78873149,0.0,142.23,173556.75
2023-11-14,2023-11-14,Project payment - Customer_0028,REF59420572,0.0,132.51,173689.26
2023-11-14,2023-11-14,Service payment - Customer_0050,REF21771991,0.0,240.53,173929.79
2023-11-14,2023-11-14,Project payment - Customer_0037,REF59604044,0.0,161.67,174091.46
2023-11-14,2023-11-14,Invoice payment - Customer_0027,REF64326907,0.0,114.59,174206.05
2023-11-15,2023-11-15,Inventory purchase,REF49884714,3531.5,0.0,170674.55
2023-11-15,2023-11-15,Business insurance premium,REF66544433,256.58,0.0,170417.97
2023-11-15,2023-11-15,Service payment - Customer_0021,REF81740902,0.0,125.66,170543.63
2023-11-15,2023-11-15,Service payment - Customer_0040,REF97591749,0.0,45.64,170589.27
2023-11-15,2023-11-15,Invoice payment - Customer_0063,REF89791082,0.0,109.4,170698.67
2023-11-15,2023-11-15,Payment from Customer_0084,REF81165009,0.0,111.73,170810.4
2023-11-15,2023-11-15,Payment from Customer_0048,REF65276871,0.0,134.1,170944.5
2023-11-15,2023-11-15,Payment from Customer_0093,REF77216265,0.0,146.16,171090.66
2023-11-15,2023-11-15,Invoice payment - Customer_0006,REF52646236,0.0,92.31,171182.97
2023-11-15,2023-11-15,Service payment - Customer_0050,REF14029737,0.0,192.13,171375.1
2023-11-15,2023-11-15,Service payment - Customer_0024,REF94607524,0.0,145.34,171520.44
2023-11-15,2023-11-15,Project payment - Customer_0033,REF43918611,0.0,76.93,171597.37
2023-11-15,2023-11-15,Invoice payment - Customer_0030,REF14836568,0.0,51.31,171648.68
2023-11-15,2023-11-15,Project payment - Customer_0056,REF38030756,0.0,40.38,171689.06
2023-11-15,2023-11-15,Payment from Customer_0097,REF30102840,0.0,72.22,171761.28
2023-11-16,2023-11-16,Payment from Customer_0021,REF31275591,0.0,114.87,171876.15
2023-11-16,2023-11-16,Invoice payment - Customer_0068,REF45755024,0.0,74.99,171951.14
2023-11-16,2023-11-16,Invoice payment - Customer_0084,REF52547438,0.0,112.4,172063.54
2023-11-16,2023-11-16,Project payment - Customer_0049,REF91102778,0.0,119.55,172183.09
2023-11-17,2023-11-17,Project payment - Customer_0023,REF66687198,0.0,155.52,172338.61
2023-11-17,2023-11-17,Project payment - Customer_0027,REF45366893,0.0,81.01,172419.62
2023-11-17,2023-11-17,Payment from Customer_0040,REF96058683,0.0,60.26,172479.88
2023-11-17,2023-11-17,Service payment - Customer_0048,REF46724527,0.0,192.11,172671.99
2023-11-17,2023-11-17,Invoice payment - Customer_0095,REF19019065,0.0,132.3,172804.29
2023-11-17,2023-11-17,Project payment - Customer_0098,REF37030101,0.0,114.76,172919.05
2023-11-17,2023-11-17,Payment from Customer_0034,REF85740037,0.0,118.26,173037.31
2023-11-17,2023-11-17,Invoice payment - Customer_0082,REF95975168,0.0,215.01,173252.32
2023-11-17,2023-11-17,Invoice payment - Customer_0080,REF43523244,0.0,43.69,173296.01
2023-11-17,2023-11-17,Project payment - Customer_0008,REF43190556,0.0,178.34,173474.35
2023-11-17,2023-11-17,Project payment - Customer_0017,REF31075970,0.0,115.29,173589.64
2023-11-18,2023-11-18,Invoice payment - Customer_0074,REF18932017,0.0,83.36,173673.0
2023-11-18,2023-11-18,Project payment - Customer_0030,REF78215174,0.0,67.59,173740.59
2023-11-18,2023-11-18,Payment from Customer_0006,REF14117861,0.0,106.46,173847.05
2023-11-18,2023-11-18,Invoice payment - Customer_0003,REF53770053,0.0,131.29,173978.34
2023-11-18,2023-11-18,Invoice payment - Customer_0016,REF22864952,0.0,45.08,174023.42
2023-11-19,2023-11-19,Invoice payment - Customer_0001,REF77725352,0.0,96.68,174120.1
2023-11-19,2023-11-19,Invoice payment - Customer_0029,REF10920736,0.0,102.98,174223.08
2023-11-19,2023-11-19,Project payment - Customer_0072,REF15572577,0.0,195.7,174418.78
2023-11-19,2023-11-19,Service payment - Customer_0003,REF42407114,0.0,86.87,174505.65
2023-11-19,2023-11-19,Service payment - Customer_0098,REF40538541,0.0,127.04,174632.69
2023-11-19,2023-11-19,Service payment - Customer_0043,REF71914040,0.0,203.55,174836.24
2023-11-19,2023-11-19,Project payment - Customer_0022,REF54457918,0.0,106.85,174943.09
2023-11-19,2023-11-19,Invoice payment - Customer_0024,REF16823367,0.0,145.88,175088.97
2023-11-19,2023-11-19,Project payment - Customer_0063,REF46006321,0.0,102.64,175191.61
2023-11-20,2023-11-20,Payment from Customer_0045,REF77029008,0.0,137.08,175328.69
2023-11-20,2023-11-20,Payment from Customer_0033,REF35505152,0.0,95.16,175423.85
2023-11-20,2023-11-20,Invoice payment - Customer_0070,REF92091642,0.0,92.64,175516.49
2023-11-20,2023-11-20,Project payment - Customer_0059,REF76319573,0.0,110.75,175627.24
2023-11-20,2023-11-20,Service payment - Customer_0053,REF50346825,0.0,164.32,175791.56
2023-11-20,2023-11-20,Project payment - Customer_0011,REF90676882,0.0,119.78,175911.34
2023-11-20,2023-11-20,Invoice payment - Customer_0051,REF49033008,0.0,102.11,176013.45
2023-11-20,2023-11-20,Payment from Customer_0057,REF57589178,0.0,127.84,176141.29
2023-11-21,2023-11-21,Project payment - Customer_0049,REF97901796,0.0,140.28,176281.57
2023-11-21,2023-11-21,Project payment - Customer_0079,REF89694492,0.0,112.16,176393.73
2023-11-21,2023-11-21,Invoice payment - Customer_0076,REF26283645,0.0,11.09,176404.82
2023-11-21,2023-11-21,Invoice payment - Customer_0007,REF84708482,0.0,189.28,176594.1
2023-11-21,2023-11-21,Payment from Customer_0060,REF24980630,0.0,90.45,176684.55
2023-11-21,2023-11-21,Payment from Customer_0046,REF76654862,0.0,197.38,176881.93
2023-11-21,2023-11-21,Project payment - Customer_0035,REF43362327,0.0,196.31,177078.24
2023-11-21,2023-11-21,Invoice payment - Customer_0058,REF90437209,0.0,51.05,177129.29
2023-11-21,2023-11-21,Project payment - Customer_0011,REF88326940,0.0,142.78,177272.07
2023-11-22,2023-11-22,Inventory purchase,REF62881071,5951.99,0.0,171320.08
2023-11-22,2023-11-22,Payment from Customer_0093,REF36564902,0.0,132.15,171452.23
2023-11-22,2023-11-22,Utility bill payment,REF30361026,230.08,0.0,171222.15
2023-11-22,2023-11-22,Invoice payment - Customer_0054,REF31142622,0.0,93.25,171315.4
2023-11-22,2023-11-22,Service payment - Customer_0048,REF47508582,0.0,138.58,171453.98
2023-11-22,2023-11-22,Project payment - Customer_0085,REF87580495,0.0,147.95,171601.93
2023-11-22,2023-11-22,Payment from Customer_0073,REF62523925,0.0,147.3,171749.23
2023-11-22,2023-11-22,Payment from Customer_0057,REF58106897,0.0,205.54,171954.77
2023-11-22,2023-11-22,Service payment - Customer_0024,REF47708068,0.0,163.32,172118.09
2023-11-22,2023-11-22,Project payment - Customer_0035,REF56412654,0.0,217.41,172335.5
2023-11-22,2023-11-22,Invoice payment - Customer_0041,REF59330521,0.0,220.14,172555.64
2023-11-22,2023-11-22,Service payment - Customer_0031,REF90920252,0.0,127.14,172682.78
2023-11-23,2023-11-23,Payment from Customer_0040,REF21586010,0.0,43.15,172725.93
2023-11-23,2023-11-23,Invoice payment - Customer_0064,REF32483603,0.0,61.65,172787.58
2023-11-23,2023-11-23,Invoice payment - Customer_0012,REF48522847,0.0,105.36,172892.94
2023-11-23,2023-11-23,Payment from Customer_0090,REF70876354,0.0,125.54,173018.48
2023-11-23,2023-11-23,Payment from Customer_0001,REF17410610,0.0,95.23,173113.71
2023-11-23,2023-11-23,Invoice payment - Customer_0099,REF32961617,0.0,73.1,173186.81
2023-11-23,2023-11-23,Project payment - Customer_0025,REF96183892,0.0,158.72,173345.53
2023-11-23,2023-11-23,Service payment - Customer_0098,REF73177754,0.0,115.5,173461.03
2023-11-24,2023-11-24,Service payment - Customer_0086,REF93612907,0.0,112.16,173573.19
2023-11-24,2023-11-24,Service payment - Customer_0022,REF38030190,0.0,122.48,173695.67
2023-11-24,2023-11-24,Payment from Customer_0087,REF30028976,0.0,158.17,173853.84
2023-11-24,2023-11-24,Payment from Customer_0007,REF27682936,0.0,221.19,174075.03
2023-11-24,2023-11-24,Service payment - Customer_0066,REF42830264,0.0,72.23,174147.26
2023-11-24,2023-11-24,Project payment - Customer_0037,REF56410185,0.0,228.52,174375.78
2023-11-24,2023-11-24,Invoice payment - Customer_0079,REF93514627,0.0,132.91,174508.69
2023-11-24,2023-11-24,Project payment - Customer_0083,REF78278460,0.0,95.17,174603.86
2023-11-25,2023-11-25,Service payment - Customer_0061,REF86479068,0.0,159.27,174763.13
2023-11-25,2023-11-25,Payment from Customer_0000,REF33278945,0.0,53.84,174816.97
2023-11-25,2023-11-25,Project payment - Customer_0065,REF29603759,0.0,99.88,174916.85
2023-11-25,2023-11-25,Invoice payment - Customer_0012,REF97876100,0.0,124.74,175041.59
2023-11-25,2023-11-25,Payment from Customer_0067,REF42582232,0.0,163.55,175205.14
2023-11-25,2023-11-25,Payment from Customer_0006,REF77061995,0.0,100.25,175305.39
2023-11-25,2023-11-25,Invoice payment - Customer_0027,REF36145266,0.0,154.33,175459.72
2023-11-26,2023-11-26,Payment from Customer_0098,REF43148089,0.0,116.2,175575.92
2023-11-26,2023-11-26,Invoice payment - Customer_0016,REF10244655,0.0,41.67,175617.59
2023-11-26,2023-11-26,Invoice payment - Customer_0002,REF88884525,0.0,111.14,175728.73
2023-11-26,2023-11-26,Invoice payment - Customer_0091,REF11837443,0.0,203.08,175931.81
2023-11-26,2023-11-26,Invoice payment - Customer_0047,REF14738539,0.0,170.97,176102.78
2023-11-26,2023-11-26,Payment from Customer_0065,REF59719599,0.0,63.5,176166.28
2023-11-26,2023-11-26,Service payment - Customer_0043,REF43630235,0.0,142.04,176308.32
2023-11-26,2023-11-26,Invoice payment - Customer_0055,REF81106160,0.0,93.74,176402.06
2023-11-26,2023-11-26,Invoice payment - Customer_0031,REF79630229,0.0,159.54,176561.6
2023-11-26,2023-11-26,Invoice payment - Customer_0008,REF65153048,0.0,121.48,176683.08
2023-11-27,2023-11-27,Project payment - Customer_0011,REF97305720,0.0,131.89,176814.97
2023-11-27,2023-11-27,Project payment - Customer_0071,REF85349131,0.0,73.99,176888.96
2023-11-27,2023-11-27,Payment from Customer_0006,REF10304393,0.0,88.45,176977.41
2023-11-27,2023-11-27,Project payment - Customer_0093,REF97139538,0.0,163.94,177141.35
2023-11-27,2023-11-27,Service payment - Customer_0024,REF80927973,0.0,115.81,177257.16
2023-11-27,2023-11-27,Project payment - Customer_0055,REF79152333,0.0,74.4,177331.56
2023-11-27,2023-11-27,Payment from Customer_0064,REF48025386,0.0,53.58,177385.14
2023-11-27,2023-11-27,Payment from Customer_0020,REF23122211,0.0,181.45,177566.59
2023-11-28,2023-11-28,Payment from Customer_0073,REF99769035,0.0,167.9,177734.49
2023-11-28,2023-11-28,Project payment - Customer_0031,REF74079285,0.0,107.0,177841.49
2023-11-28,2023-11-28,Project payment - Customer_0022,REF22452899,0.0,86.68,177928.17
2023-11-28,2023-11-28,Service payment - Customer_0099,REF93654676,0.0,52.18,177980.35
2023-11-28,2023-11-28,Project payment - Customer_0071,REF86702852,0.0,70.38,178050.73
2023-11-28,2023-11-28,Project payment - Customer_0004,REF31148260,0.0,102.9,178153.63
2023-11-28,2023-11-28,Service payment - Customer_0062,REF24825012,0.0,102.39,178256.02
2023-11-28,2023-11-28,Payment from Customer_0097,REF82335928,0.0,87.35,178343.37
2023-11-29,2023-11-29,Project payment - Customer_0033,REF16630127,0.0,103.94,178447.31
2023-11-29,2023-11-29,Payment from Customer_0056,REF52489776,0.0,41.78,178489.09
2023-11-29,2023-11-29,Payment from Customer_0013,REF45625882,0.0,104.06,178593.15
2023-11-29,2023-11-29,Service payment - Customer_0042,REF56121904,0.0,120.23,178713.38
2023-11-29,2023-11-29,Invoice payment - Customer_0006,REF10372391,0.0,89.11,178802.49
2023-11-29,2023-11-29,Service payment - Customer_0036,REF43455603,0.0,72.8,178875.29
2023-11-29,2023-11-29,Service payment - Customer_0095,REF27391880,0.0,162.74,179038.03
2023-11-29,2023-11-29,Payment from Customer_0044,REF37140931,0.0,54.95,179092.98
2023-11-29,2023-11-29,Project payment - Customer_0059,REF49666525,0.0,102.01,179194.99
2023-11-29,2023-11-29,Project payment - Customer_0067,REF23425249,0.0,173.19,179368.18
2023-11-29,2023-11-29,Service payment - Customer_0004,REF85058472,0.0,85.23,179453.41
2023-11-29,2023-11-29,Payment from Customer_0094,REF91508965,0.0,80.27,179533.68
2023-11-29,2023-11-29,Invoice payment - Customer_0099,REF96409316,0.0,67.04,179600.72
2023-11-30,2023-11-30,Marketing expenses,REF69140064,173.81,0.0,179426.91
2023-11-30,2023-11-30,Invoice payment - Customer_0003,REF25323025,0.0,98.92,179525.83
2023-11-30,2023-11-30,Inventory purchase,REF69850007,5205.28,0.0,174320.55
2023-11-30,2023-11-30,Payment from Customer_0023,REF80882352,0.0,140.81,174461.36
2023-11-30,2023-11-30,Invoice payment - Customer_0017,REF81859077,0.0,78.72,174540.08
2023-11-30,2023-11-30,Payment from Customer_0036,REF39760121,0.0,92.21,174632.29
2023-11-30,2023-11-30,Service payment - Customer_0061,REF30467004,0.0,206.64,174838.93
2023-11-30,2023-11-30,Project payment - Customer_0019,REF14577998,0.0,110.34,174949.27
2023-11-30,2023-11-30,Payment from Customer_0043,REF10187509,0.0,188.13,175137.4
2023-11-30,2023-11-30,Project payment - Customer_0092,REF36481399,0.0,81.63,175219.03
2023-11-30,2023-11-30,Service payment - Customer_0080,REF27915110,0.0,69.35,175288.38
2023-11-30,2023-11-30,Project payment - Customer_0088,REF35937324,0.0,178.43,175466.81
2023-11-30,2023-11-30,Service payment - Customer_0052,REF50222288,0.0,57.61,175524.42
2023-12-01,2023-12-01,Service payment - Customer_0017,REF92010214,0.0,92.12,175616.54
2023-12-01,2023-12-01,Payment from Customer_0013,REF84305340,0.0,125.85,175742.39
2023-12-01,2023-12-01,Invoice payment - Customer_0072,REF29606786,0.0,179.32,175921.71
2023-12-01,2023-12-01,Invoice payment - Customer_0055,REF53251478,0.0,102.21,176023.92
2023-12-01,2023-12-01,Project payment - Customer_0039,REF88416491,0.0,254.77,176278.69
2023-12-01,2023-12-01,Invoice payment - Customer_0099,REF69802905,0.0,87.03,176365.72
2023-12-01,2023-12-01,Monthly office rent,REF98257107,1930.69,0.0,174435.03
2023-12-01,2023-12-01,Service payment - Customer_0022,REF39003940,0.0,111.64,174546.67
2023-12-01,2023-12-01,Invoice payment - Customer_0074,REF59824380,0.0,73.5,174620.17
2023-12-01,2023-12-01,Project payment - Customer_0052,REF19232821,0.0,61.14,174681.31
2023-12-01,2023-12-01,Project payment - Customer_0079,REF77476627,0.0,118.47,174799.78
2023-12-01,2023-12-01,Invoice payment - Customer_0023,REF44309239,0.0,201.27,175001.05
2023-12-02,2023-12-02,Project payment - Customer_0074,REF55369091,0.0,67.74,175068.79
2023-12-02,2023-12-02,Project payment - Customer_0048,REF94336330,0.0,123.51,175192.3
2023-12-02,2023-12-02,Invoice payment - Customer_0004,REF40991183,0.0,74.76,175267.06
2023-12-03,2023-12-03,Payment from Customer_0062,REF59334643,0.0,72.29,175339.35
2023-12-03,2023-12-03,Payment from Customer_0032,REF32798709,0.0,111.75,175451.1
2023-12-03,2023-12-03,Project payment - Customer_0075,REF61778630,0.0,194.14,175645.24
2023-12-03,2023-12-03,Project payment - Customer_0084,REF14800478,0.0,109.73,175754.97
2023-12-03,2023-12-03,Service payment - Customer_0039,REF73371809,0.0,223.3,175978.27
2023-12-03,2023-12-03,Payment from Customer_0099,REF45187218,0.0,62.25,176040.52
2023-12-03,2023-12-03,Payment from Customer_0054,REF86492399,0.0,113.71,176154.23
2023-12-03,2023-12-03,Payment from Customer_0036,REF50253544,0.0,94.18,176248.41
2023-12-03,2023-12-03,Invoice payment - Customer_0008,REF18214936,0.0,178.05,176426.46
2023-12-03,2023-12-03,Payment from Customer_0081,REF63826239,0.0,126.31,176552.77
2023-12-03,2023-12-03,Project payment - Customer_0031,REF35139216,0.0,162.37,176715.14
2023-12-03,2023-12-03,Service payment - Customer_0001,REF74702305,0.0,91.87,176807.01
2023-12-03,2023-12-03,Invoice payment - Customer_0085,REF79571334,0.0,186.3,176993.31
2023-12-03,2023-12-03,Project payment - Customer_0071,REF64575665,0.0,62.23,177055.54
2023-12-04,2023-12-04,Inventory purchase,REF40588431,5918.97,0.0,171136.57
2023-12-04,2023-12-04,Invoice payment - Customer_0093,REF68847180,0.0,147.15,171283.72
2023-12-04,2023-12-04,Project payment - Customer_0080,REF57772527,0.0,62.15,171345.87
2023-12-04,2023-12-04,Payment from Customer_0040,REF24360776,0.0,70.74,171416.61
2023-12-05,2023-12-05,Payment from Customer_0011,REF39910891,0.0,188.42,171605.03
2023-12-05,2023-12-05,Service payment - Customer_0034,REF34500025,0.0,133.82,171738.85
2023-12-05,2023-12-05,Invoice payment - Customer_0024,REF21884490,0.0,137.4,171876.25
2023-12-05,2023-12-05,Invoice payment - Customer_0086,REF35382126,0.0,109.3,171985.55
2023-12-05,2023-12-05,Invoice payment - Customer_0073,REF44862353,0.0,209.38,172194.93
2023-12-05,2023-12-05,Project payment - Customer_0014,REF86898816,0.0,124.42,172319.35
2023-12-05,2023-12-05,Service payment - Customer_0068,REF21105382,0.0,63.18,172382.53
2023-12-05,2023-12-05,Service payment - Customer_0002,REF44785643,0.0,134.63,172517.16
2023-12-05,2023-12-05,Payment from Customer_0070,REF64386905,0.0,105.43,172622.59
2023-12-05,2023-12-05,Service payment - Customer_0060,REF71383250,0.0,145.49,172768.08
2023-12-05,2023-12-05,Payment from Customer_0048,REF25645259,0.0,145.86,172913.94
2023-12-05,2023-12-05,Project payment - Customer_0084,REF17925552,0.0,118.09,173032.03
2023-12-05,2023-12-05,Project payment - Customer_0021,REF84527568,0.0,97.46,173129.49
2023-12-05,2023-12-05,Invoice payment - Customer_0058,REF46954678,0.0,83.94,173213.43
2023-12-05,2023-12-05,Payment from Customer_0020,REF23547961,0.0,234.42,173447.85
2023-12-06,2023-12-06,Inventory purchase,REF52103188,2437.96,0.0,171009.89
2023-12-06,2023-12-06,Project payment - Customer_0023,REF20962613,0.0,183.44,171193.33
2023-12-06,2023-12-06,Service payment - Customer_0056,REF86723285,0.0,53.4,171246.73
2023-12-06,2023-12-06,Invoice payment - Customer_0038,REF84281897,0.0,91.82,171338.55
2023-12-06,2023-12-06,Payment from Customer_0092,REF99704184,0.0,94.22,171432.77
2023-12-06,2023-12-06,Payment from Customer_0088,REF33391790,0.0,226.85,171659.62
2023-12-06,2023-12-06,Payment from Customer_0000,REF29514811,0.0,61.58,171721.2
2023-12-06,2023-12-06,Invoice payment - Customer_0069,REF82147733,0.0,162.74,171883.94
2023-12-07,2023-12-07,Project payment - Customer_0055,REF56151430,0.0,119.43,172003.37
2023-12-07,2023-12-07,Service payment - Customer_0042,REF59226948,0.0,147.08,172150.45
2023-12-07,2023-12-07,Payment from Customer_0097,REF38360486,0.0,129.79,172280.24
2023-12-07,2023-12-07,Payment from Customer_0098,REF60431720,0.0,119.14,172399.38
2023-12-07,2023-12-07,Payment from Customer_0047,REF68205042,0.0,163.58,172562.96
2023-12-07,2023-12-07,Service payment - Customer_0064,REF80144615,0.0,66.16,172629.12
2023-12-07,2023-12-07,Payment from Customer_0003,REF82170244,0.0,131.25,172760.37
2023-12-07,2023-12-07,Invoice payment - Customer_0033,REF98463733,0.0,115.41,172875.78
2023-12-07,2023-12-07,Invoice payment - Customer_0020,REF85736033,0.0,186.53,173062.31
2023-12-07,2023-12-07,Invoice payment - Customer_0016,REF44886702,0.0,47.55,173109.86
2023-12-07,2023-12-07,Payment from Customer_0004,REF41112841,0.0,68.73,173178.59
2023-12-07,2023-12-07,Service payment - Customer_0039,REF50772856,0.0,280.06,173458.65
2023-12-08,2023-12-08,Project payment - Customer_0095,REF33552507,0.0,131.02,173589.67
2023-12-08,2023-12-08,Service payment - Customer_0017,REF82990909,0.0,125.18,173714.85
2023-12-08,2023-12-08,Project payment - Customer_0097,REF43667409,0.0,76.8,173791.65
2023-12-08,2023-12-08,Service payment - Customer_0085,REF21559783,0.0,126.16,173917.81
2023-12-08,2023-12-08,Invoice payment - Customer_0088,REF39250499,0.0,231.53,174149.34
2023-12-08,2023-12-08,Service payment - Customer_0021,REF47208230,0.0,111.01,174260.35
2023-12-08,2023-12-08,Invoice payment - Customer_0015,REF72533466,0.0,193.95,174454.3
2023-12-08,2023-12-08,Service payment - Customer_0064,REF42173201,0.0,57.99,174512.29
2023-12-08,2023-12-08,Invoice payment - Customer_0016,REF39067376,0.0,48.27,174560.56
2023-12-08,2023-12-08,Payment from Customer_0001,REF49726064,0.0,128.19,174688.75
2023-12-08,2023-12-08,Invoice payment - Customer_0070,REF70771174,0.0,122.56,174811.31
2023-12-08,2023-12-08,Project payment - Customer_0080,REF24585689,0.0,63.18,174874.49
2023-12-08,2023-12-08,Service payment - Customer_0066,REF21427712,0.0,86.4,174960.89
2023-12-09,2023-12-09,Inventory purchase,REF53963256,3234.41,0.0,171726.48
2023-12-09,2023-12-09,Invoice payment - Customer_0013,REF71862111,0.0,120.79,171847.27
2023-12-09,2023-12-09,Service payment - Customer_0041,REF87834494,0.0,201.88,172049.15
2023-12-09,2023-12-09,Service payment - Customer_0009,REF25903478,0.0,145.18,172194.33
2023-12-09,2023-12-09,Project payment - Customer_0019,REF98937075,0.0,113.12,172307.45
2023-12-10,2023-12-10,Payment from Customer_0016,REF69715197,0.0,53.35,172360.8
2023-12-10,2023-12-10,Service payment - Customer_0020,REF45793991,0.0,183.52,172544.32
2023-12-10,2023-12-10,Invoice payment - Customer_0036,REF50311746,0.0,86.83,172631.15
2023-12-10,2023-12-10,Payment from Customer_0076,REF28439652,0.0,16.36,172647.51
2023-12-10,2023-12-10,Payment from Customer_0030,REF42344646,0.0,69.22,172716.73
2023-12-10,2023-12-10,Project payment - Customer_0010,REF65456009,0.0,158.63,172875.36
2023-12-10,2023-12-10,Project payment - Customer_0092,REF17367012,0.0,99.8,172975.16
2023-12-10,2023-12-10,Service payment - Customer_0066,REF65630355,0.0,70.64,173045.8
2023-12-10,2023-12-10,Project payment - Customer_0004,REF16740131,0.0,93.06,173138.86
2023-12-10,2023-12-10,Project payment - Customer_0019,REF55288984,0.0,110.44,173249.3
2023-12-10,2023-12-10,Invoice payment - Customer_0060,REF50363836,0.0,122.85,173372.15
2023-12-10,2023-12-10,Service payment - Customer_0059,REF69618254,0.0,119.69,173491.84
2023-12-10,2023-12-10,Project payment - Customer_0057,REF32946593,0.0,187.43,173679.27
2023-12-11,2023-12-11,Service payment - Customer_0091,REF44237772,0.0,235.65,173914.92
2023-12-11,2023-12-11,Project payment - Customer_0082,REF22741964,0.0,223.98,174138.9
2023-12-11,2023-12-11,Project payment - Customer_0099,REF26419673,0.0,79.67,174218.57
2023-12-11,2023-12-11,Invoice payment - Customer_0092,REF21456680,0.0,112.44,174331.01
2023-12-11,2023-12-11,Project payment - Customer_0056,REF13493058,0.0,47.46,174378.47
2023-12-11,2023-12-11,Payment from Customer_0093,REF33473940,0.0,193.13,174571.6
2023-12-12,2023-12-12,Payment from Customer_0051,REF78708731,0.0,140.23,174711.83
2023-12-12,2023-12-12,Invoice payment - Customer_0064,REF92043333,0.0,63.77,174775.6
2023-12-12,2023-12-12,Invoice payment - Customer_0045,REF32018965,0.0,154.4,174930.0
2023-12-12,2023-12-12,Project payment - Customer_0036,REF79716293,0.0,98.47,175028.47
2023-12-12,2023-12-12,Invoice payment - Customer_0086,REF67130584,0.0,122.58,175151.05
2023-12-12,2023-12-12,Payment from Customer_0059,REF18572073,0.0,123.64,175274.69
2023-12-12,2023-12-12,Payment from Customer_0087,REF87617837,0.0,158.81,175433.5
2023-12-12,2023-12-12,Payment from Customer_0094,REF95419977,0.0,116.17,175549.67
2023-12-12,2023-12-12,Invoice payment - Customer_0040,REF23068424,0.0,52.06,175601.73
2023-12-13,2023-12-13,Project payment - Customer_0090,REF90725080,0.0,159.96,175761.69
2023-12-13,2023-12-13,Payment from Customer_0064,REF17140221,0.0,45.64,175807.33
2023-12-13,2023-12-13,Payment from Customer_0084,REF14975107,0.0,96.21,175903.54
2023-12-13,2023-12-13,Service payment - Customer_0051,REF64418241,0.0,110.38,176013.92
2023-12-13,2023-12-13,Service payment - Customer_0005,REF97503519,0.0,46.91,176060.83
2023-12-13,2023-12-13,Project payment - Customer_0008,REF38168798,0.0,128.38,176189.21
2023-12-13,2023-12-13,Invoice payment - Customer_0091,REF15045536,0.0,240.79,176430.0
2023-12-13,2023-12-13,Service payment - Customer_0037,REF50287448,0.0,228.0,176658.0
2023-12-13,2023-12-13,Invoice payment - Customer_0070,REF67649390,0.0,90.4,176748.4
2023-12-13,2023-12-13,Project payment - Customer_0036,REF97432094,0.0,96.85,176845.25
2023-12-13,2023-12-13,Marketing expenses,REF72881276,639.49,0.0,176205.76
2023-12-14,2023-12-14,Service payment - Customer_0043,REF88957320,0.0,196.79,176402.55
2023-12-14,2023-12-14,Service payment - Customer_0062,REF25292644,0.0,93.51,176496.06
2023-12-14,2023-12-14,Payment from Customer_0082,REF48919110,0.0,224.24,176720.3
2023-12-14,2023-12-14,Project payment - Customer_0061,REF28707234,0.0,151.44,176871.74
2023-12-14,2023-12-14,Project payment - Customer_0098,REF61796619,0.0,106.1,176977.84
2023-12-14,2023-12-14,Payment from Customer_0084,REF51475279,0.0,177.17,177155.01
2023-12-14,2023-12-14,Project payment - Customer_0097,REF66368761,0.0,112.26,177267.27
2023-12-14,2023-12-14,Invoice payment - Customer_0064,REF14390735,0.0,52.33,177319.6
2023-12-15,2023-12-15,Service payment - Customer_0028,REF74591334,0.0,138.78,177458.38
2023-12-15,2023-12-15,Invoice payment - Customer_0050,REF78653435,0.0,288.15,177746.53
2023-12-15,2023-12-15,Project payment - Customer_0056,REF69516614,0.0,71.45,177817.98
2023-12-15,2023-12-15,Invoice payment - Customer_0020,REF35233504,0.0,165.81,177983.79
2023-12-15,2023-12-15,Service payment - Customer_0010,REF69155471,0.0,120.14,178103.93
2023-12-15,2023-12-15,Invoice payment - Customer_0037,REF95464410,0.0,265.57,178369.5
2023-12-15,2023-12-15,Business insurance premium,REF60399050,290.54,0.0,178078.96
2023-12-15,2023-12-15,Invoice payment - Customer_0019,REF95810260,0.0,137.98,178216.94
2023-12-15,2023-12-15,Payment from Customer_0018,REF41609426,0.0,114.32,178331.26
2023-12-15,2023-12-15,Project payment - Customer_0083,REF28990038,0.0,122.54,178453.8
2023-12-16,2023-12-16,Invoice payment - Customer_0000,REF12377207,0.0,75.79,178529.59
2023-12-16,2023-12-16,Invoice payment - Customer_0077,REF53646546,0.0,174.34,178703.93
2023-12-16,2023-12-16,Project payment - Customer_0074,REF13909296,0.0,76.89,178780.82
2023-12-16,2023-12-16,Service payment - Customer_0017,REF26232863,0.0,120.41,178901.23
2023-12-16,2023-12-16,Project payment - Customer_0024,REF74223493,0.0,164.41,179065.64
2023-12-16,2023-12-16,Project payment - Customer_0039,REF49237623,0.0,232.53,179298.17
2023-12-16,2023-12-16,Project payment - Customer_0038,REF93332298,0.0,76.06,179374.23
2023-12-17,2023-12-17,Project payment - Customer_0079,REF14302103,0.0,144.56,179518.79
2023-12-17,2023-12-17,Project payment - Customer_0092,REF61523257,0.0,100.69,179619.48
2023-12-17,2023-12-17,Service payment - Customer_0050,REF71180213,0.0,195.33,179814.81
2023-12-17,2023-12-17,Payment from Customer_0076,REF81450404,0.0,16.71,179831.52
2023-12-17,2023-12-17,Inventory purchase,REF71286437,4005.6,0.0,175825.92
2023-12-17,2023-12-17,Service payment - Customer_0015,REF93196654,0.0,158.3,175984.22
2023-12-17,2023-12-17,Payment from Customer_0099,REF56118215,0.0,56.64,176040.86
2023-12-18,2023-12-18,Service payment - Customer_0018,REF91367247,0.0,143.13,176183.99
2023-12-18,2023-12-18,Invoice payment - Customer_0029,REF87574518,0.0,105.55,176289.54
2023-12-18,2023-12-18,Project payment - Customer_0030,REF91000905,0.0,59.45,176348.99
2023-12-18,2023-12-18,Invoice payment - Customer_0059,REF28746063,0.0,164.83,176513.82
2023-12-18,2023-12-18,Service payment - Customer_0077,REF72847048,0.0,130.09,176643.91
2023-12-18,2023-12-18,Project payment - Customer_0039,REF70747852,0.0,177.94,176821.85
2023-12-18,2023-12-18,Project payment - Customer_0052,REF92336081,0.0,65.82,176887.67
2023-12-18,2023-12-18,Service payment - Customer_0049,REF63453235,0.0,151.14,177038.81
2023-12-18,2023-12-18,Project payment - Customer_0041,REF50602029,0.0,214.34,177253.15
2023-12-18,2023-12-18,Service payment - Customer_0089,REF40212745,0.0,269.81,177522.96
2023-12-19,2023-12-19,Invoice payment - Customer_0076,REF11868231,0.0,13.44,177536.4
2023-12-19,2023-12-19,Project payment - Customer_0044,REF31396397,0.0,77.97,177614.37
2023-12-19,2023-12-19,Payment from Customer_0006,REF45811641,0.0,93.52,177707.89
2023-12-19,2023-12-19,Invoice payment - Customer_0082,REF36021271,0.0,152.37,177860.26
2023-12-19,2023-12-19,Service payment - Customer_0050,REF79818107,0.0,261.46,178121.72
2023-12-19,2023-12-19,Invoice payment - Customer_0057,REF38809264,0.0,193.41,178315.13
2023-12-19,2023-12-19,Invoice payment - Customer_0096,REF85161660,0.0,143.83,178458.96
2023-12-19,2023-12-19,Payment from Customer_0063,REF55430515,0.0,101.5,178560.46
2023-12-19,2023-12-19,Payment from Customer_0046,REF79398609,0.0,236.06,178796.52
2023-12-19,2023-12-19,Payment from Customer_0042,REF12247311,0.0,135.33,178931.85
2023-12-19,2023-12-19,Payment from Customer_0005,REF57853571,0.0,52.86,178984.71
2023-12-19,2023-12-19,Invoice payment - Customer_0059,REF97827376,0.0,108.61,179093.32
2023-12-20,2023-12-20,Invoice payment - Customer_0037,REF45245358,0.0,230.3,179323.62
2023-12-20,2023-12-20,Service payment - Customer_0081,REF63989369,0.0,90.53,179414.15
2023-12-20,2023-12-20,Service payment - Customer_0006,REF48220307,0.0,135.59,179549.74
2023-12-20,2023-12-20,Payment from Customer_0052,REF45471219,0.0,84.9,179634.64
2023-12-20,2023-12-20,Invoice payment - Customer_0023,REF64717466,0.0,169.69,179804.33
2023-12-20,2023-12-20,Project payment - Customer_0065,REF93620977,0.0,96.74,179901.07
2023-12-20,2023-12-20,Invoice payment - Customer_0032,REF83178795,0.0,126.61,180027.68
2023-12-20,2023-12-20,Invoice payment - Customer_0030,REF49742909,0.0,59.04,180086.72
2023-12-20,2023-12-20,Project payment - Customer_0094,REF46572594,0.0,144.74,180231.46
2023-12-21,2023-12-21,Payment from Customer_0046,REF55000687,0.0,206.74,180438.2
2023-12-21,2023-12-21,Project payment - Customer_0034,REF99852876,0.0,150.17,180588.37
2023-12-21,2023-12-21,Project payment - Customer_0002,REF32774307,0.0,139.55,180727.92
2023-12-21,2023-12-21,Service payment - Customer_0064,REF70757930,0.0,60.45,180788.37
2023-12-21,2023-12-21,Project payment - Customer_0051,REF88577205,0.0,138.02,180926.39
2023-12-21,2023-12-21,Invoice payment - Customer_0048,REF10766872,0.0,150.19,181076.58
2023-12-21,2023-12-21,Payment from Customer_0087,REF76146879,0.0,167.28,181243.86
2023-12-21,2023-12-21,Payment from Customer_0054,REF33627777,0.0,106.48,181350.34
2023-12-22,2023-12-22,Utility bill payment,REF58169770,255.49,0.0,181094.85
2023-12-22,2023-12-22,Service payment - Customer_0042,REF77373901,0.0,171.44,181266.29
2023-12-22,2023-12-22,Invoice payment - Customer_0074,REF68210972,0.0,85.43,181351.72
2023-12-22,2023-12-22,Service payment - Customer_0039,REF24031869,0.0,295.35,181647.07
2023-12-22,2023-12-22,Project payment - Customer_0044,REF62954827,0.0,88.52,181735.59
2023-12-22,2023-12-22,Payment from Customer_0033,REF59328728,0.0,119.51,181855.1
2023-12-22,2023-12-22,Project payment - Customer_0014,REF14406260,0.0,156.66,182011.76
2023-12-22,2023-12-22,Service payment - Customer_0066,REF47273925,0.0,103.35,182115.11
2023-12-22,2023-12-22,Invoice payment - Customer_0067,REF73914891,0.0,182.93,182298.04
2023-12-23,2023-12-23,Invoice payment - Customer_0086,REF69844310,0.0,150.31,182448.35
2023-12-23,2023-12-23,Invoice payment - Customer_0092,REF47234883,0.0,77.12,182525.47
2023-12-23,2023-12-23,Invoice payment - Customer_0005,REF17421792,0.0,61.56,182587.03
2023-12-23,2023-12-23,Invoice payment - Customer_0069,REF19771644,0.0,107.13,182694.16
2023-12-23,2023-12-23,Invoice payment - Customer_0043,REF93995855,0.0,182.16,182876.32
2023-12-23,2023-12-23,Payment from Customer_0047,REF73350483,0.0,181.5,183057.82
2023-12-23,2023-12-23,Payment from Customer_0088,REF22825815,0.0,167.88,183225.7
2023-12-24,2023-12-24,Service payment - Customer_0029,REF55243852,0.0,120.9,183346.6
2023-12-24,2023-12-24,Invoice payment - Customer_0068,REF10228166,0.0,73.85,183420.45
2023-12-24,2023-12-24,Payment from Customer_0078,REF43703797,0.0,217.35,183637.8
2023-12-24,2023-12-24,Service payment - Customer_0010,REF28477577,0.0,114.84,183752.64
2023-12-24,2023-12-24,Service payment - Customer_0076,REF16283497,0.0,12.57,183765.21
2023-12-24,2023-12-24,Service payment - Customer_0062,REF75661403,0.0,109.21,183874.42
2023-12-24,2023-12-24,Invoice payment - Customer_0059,REF22318082,0.0,105.69,183980.11
2023-12-24,2023-12-24,Project payment - Customer_0090,REF69606928,0.0,150.99,184131.1
2023-12-25,2023-12-25,Payment from Customer_0015,REF75070148,0.0,182.95,184314.05
2023-12-25,2023-12-25,Invoice payment - Customer_0002,REF71564069,0.0,167.02,184481.07
2023-12-25,2023-12-25,Invoice payment - Customer_0031,REF91202947,0.0,200.77,184681.84
2023-12-25,2023-12-25,Invoice payment - Customer_0041,REF76314939,0.0,195.83,184877.67
2023-12-25,2023-12-25,Service payment - Customer_0068,REF15749956,0.0,79.22,184956.89
2023-12-25,2023-12-25,Service payment - Customer_0056,REF54741252,0.0,44.4,185001.29
2023-12-25,2023-12-25,Payment from Customer_0050,REF38817848,0.0,277.88,185279.17
2023-12-25,2023-12-25,Service payment - Customer_0026,REF12195690,0.0,194.7,185473.87
2023-12-25,2023-12-25,Service payment - Customer_0081,REF79242543,0.0,129.93,185603.8
2023-12-25,2023-12-25,Payment from Customer_0020,REF65557256,0.0,168.17,185771.97
2023-12-25,2023-12-25,Payment from Customer_0053,REF56627629,0.0,174.08,185946.05
2023-12-25,2023-12-25,Payment from Customer_0028,REF61569776,0.0,141.49,186087.54
2023-12-25,2023-12-25,Project payment - Customer_0014,REF44128163,0.0,144.61,186232.15
2023-12-26,2023-12-26,Pos Systems expense,REF86115041,66.0,0.0,186166.15
2023-12-26,2023-12-26,Payment from Customer_0058,REF36980114,0.0,85.67,186251.82
2023-12-26,2023-12-26,Project payment - Customer_0062,REF87607713,0.0,105.09,186356.91
2023-12-26,2023-12-26,Project payment - Customer_0011,REF66092427,0.0,147.13,186504.04
2023-12-26,2023-12-26,Invoice payment - Customer_0028,REF40583120,0.0,143.03,186647.07
2023-12-26,2023-12-26,Project payment - Customer_0005,REF15051340,0.0,43.36,186690.43
2023-12-26,2023-12-26,Professional Services expense,REF59129952,188.39,0.0,186502.04
2023-12-26,2023-12-26,Payment from Customer_0099,REF80036671,0.0,79.15,186581.19
2023-12-26,2023-12-26,Project payment - Customer_0054,REF22834333,0.0,129.99,186711.18
2023-12-26,2023-12-26,Project payment - Customer_0061,REF51449449,0.0,134.58,186845.76
2023-12-26,2023-12-26,Invoice payment - Customer_0034,REF15050455,0.0,149.89,186995.65
2023-12-26,2023-12-26,Project payment - Customer_0020,REF79756398,0.0,176.25,187171.9
2023-12-27,2023-12-27,Payment from Customer_0020,REF56273110,0.0,173.03,187344.93
2023-12-27,2023-12-27,Payment from Customer_0059,REF12373758,0.0,121.77,187466.7
2023-12-27,2023-12-27,Payment from Customer_0006,REF45559385,0.0,107.49,187574.19
2023-12-27,2023-12-27,Project payment - Customer_0033,REF94817285,0.0,116.99,187691.18
2023-12-27,2023-12-27,Payment from Customer_0077,REF13201207,0.0,143.63,187834.81
2023-12-27,2023-12-27,Invoice payment - Customer_0053,REF48841822,0.0,168.27,188003.08
2023-12-27,2023-12-27,Project payment - Customer_0088,REF33307402,0.0,195.86,188198.94
2023-12-27,2023-12-27,Invoice payment - Customer_0082,REF29800419,0.0,249.09,188448.03
2023-12-27,2023-12-27,Invoice payment - Customer_0091,REF19604367,0.0,240.81,188688.84
2023-12-28,2023-12-28,Invoice payment - Customer_0096,REF56022161,0.0,173.33,188862.17
2023-12-28,2023-12-28,Project payment - Customer_0016,REF56530123,0.0,38.38,188900.55
2023-12-28,2023-12-28,Payment from Customer_0025,REF23264815,0.0,246.1,189146.65
2023-12-28,2023-12-28,Payment from Customer_0033,REF76563576,0.0,94.73,189241.38
2023-12-28,2023-12-28,Payment from Customer_0074,REF33003483,0.0,78.65,189320.03
2023-12-28,2023-12-28,Service payment - Customer_0055,REF61064254,0.0,108.77,189428.8
2023-12-29,2023-12-29,Payment from Customer_0013,REF13890898,0.0,112.73,189541.53
2023-12-29,2023-12-29,Invoice payment - Customer_0025,REF32698306,0.0,194.59,189736.12
2023-12-29,2023-12-29,Payment from Customer_0006,REF80610146,0.0,110.85,189846.97
2023-12-29,2023-12-29,Service payment - Customer_0029,REF18587104,0.0,111.45,189958.42
2023-12-29,2023-12-29,Invoice payment - Customer_0083,REF59090730,0.0,103.9,190062.32
2023-12-29,2023-12-29,Payment from Customer_0015,REF50539810,0.0,260.09,190322.41
2023-12-29,2023-12-29,Payment from Customer_0076,REF16666726,0.0,17.44,190339.85
2023-12-30,2023-12-30,Invoice payment - Customer_0080,REF16116942,0.0,42.3,190382.15
2023-12-30,2023-12-30,Service payment - Customer_0090,REF59759932,0.0,145.33,190527.48
2023-12-30,2023-12-30,Project payment - Customer_0028,REF73601284,0.0,145.21,190672.69
2023-12-30,2023-12-30,Service payment - Customer_0022,REF75049543,0.0,113.12,190785.81
2023-12-30,2023-12-30,Service payment - Customer_0047,REF25480785,0.0,193.57,190979.38
2023-12-30,2023-12-30,Project payment - Customer_0068,REF69684254,0.0,55.46,191034.84
2023-12-30,2023-12-30,Service payment - Customer_0026,REF17667715,0.0,178.41,191213.25
2023-12-31,2023-12-31,Invoice payment - Customer_0061,REF58017101,0.0,219.11,191432.36
2023-12-31,2023-12-31,Service payment - Customer_0022,REF35125855,0.0,98.98,191531.34
2023-12-31,2023-12-31,Invoice payment - Customer_0036,REF25506660,0.0,93.05,191624.39
2023-12-31,2023-12-31,Payment from Customer_0096,REF53890790,0.0,145.38,191769.77
2023-12-31,2023-12-31,Payment from Customer_0021,REF30822825,0.0,107.33,191877.1
2023-12-31,2023-12-31,Payment from Customer_0089,REF40881030,0.0,232.24,192109.34
2023-12-31,2023-12-31,Payment from Customer_0077,REF14783924,0.0,135.03,192244.37
2024-01-01,2024-01-01,Professional Services expense,REF64538721,77.89,0.0,192166.48
2024-01-01,2024-01-01,Invoice payment - Customer_0071,REF67056953,0.0,36.47,192202.95
2024-01-01,2024-01-01,Invoice payment - Customer_0094,REF52408089,0.0,67.63,192270.58
2024-01-01,2024-01-01,Payment from Customer_0021,REF16378032,0.0,61.72,192332.3
2024-01-01,2024-01-01,Payment from Customer_0042,REF77913085,0.0,76.56,192408.86
2024-01-01,2024-01-01,Project payment - Customer_0028,REF26185596,0.0,51.18,192460.04
2024-01-01,2024-01-01,Service payment - Customer_0012,REF35118221,0.0,29.71,192489.75
2024-01-01,2024-01-01,Service payment - Customer_0052,REF29436936,0.0,34.32,192524.07
2024-01-01,2024-01-01,Project payment - Customer_0074,REF86094825,0.0,33.3,192557.37
2024-01-01,2024-01-01,Monthly office rent,REF95602379,970.8,0.0,191586.57
2024-01-02,2024-01-02,Payment from Customer_0066,REF33438028,0.0,69.03,191655.6
2024-01-02,2024-01-02,Project payment - Customer_0089,REF50557458,0.0,95.76,191751.36
2024-01-02,2024-01-02,Service payment - Customer_0049,REF15054184,0.0,66.18,191817.54
2024-01-02,2024-01-02,Project payment - Customer_0013,REF73944845,0.0,60.51,191878.05
2024-01-02,2024-01-02,Payment from Customer_0031,REF62469828,0.0,65.04,191943.09
2024-01-02,2024-01-02,Service payment - Customer_0088,REF58549693,0.0,87.86,192030.95
2024-01-02,2024-01-02,Service payment - Customer_0058,REF81297004,0.0,36.57,192067.52
2024-01-02,2024-01-02,Service payment - Customer_0078,REF78445986,0.0,88.2,192155.72
2024-01-02,2024-01-02,Project payment - Customer_0069,REF90858310,0.0,49.5,192205.22
2024-01-02,2024-01-02,Inventory purchase,REF70880633,1810.6,0.0,190394.62
2024-01-03,2024-01-03,Service payment - Customer_0018,REF48300705,0.0,56.91,190451.53
2024-01-03,2024-01-03,Invoice payment - Customer_0051,REF97623919,0.0,57.11,190508.64
2024-01-03,2024-01-03,Invoice payment - Customer_0005,REF32331311,0.0,30.04,190538.68
2024-01-03,2024-01-03,Invoice payment - Customer_0024,REF57366247,0.0,71.66,190610.34
2024-01-03,2024-01-03,Project payment - Customer_0097,REF67636084,0.0,52.45,190662.79
2024-01-03,2024-01-03,Project payment - Customer_0076,REF49366581,0.0,10.0,190672.79
2024-01-03,2024-01-03,Project payment - Customer_0056,REF87044128,0.0,19.45,190692.24
2024-01-03,2024-01-03,Project payment - Customer_0089,REF53985346,0.0,114.58,190806.82
2024-01-04,2024-01-04,Invoice payment - Customer_0088,REF95762815,0.0,89.3,190896.12
2024-01-04,2024-01-04,Invoice payment - Customer_0032,REF73332412,0.0,49.16,190945.28
2024-01-04,2024-01-04,Project payment - Customer_0008,REF29226270,0.0,50.32,190995.6
2024-01-04,2024-01-04,Payment from Customer_0003,REF55576279,0.0,52.96,191048.56
2024-01-04,2024-01-04,Service payment - Customer_0057,REF14803598,0.0,111.18,191159.74
2024-01-04,2024-01-04,Service payment - Customer_0029,REF67741998,0.0,63.54,191223.28
2024-01-04,2024-01-04,Service payment - Customer_0097,REF68157587,0.0,58.04,191281.32
2024-01-04,2024-01-04,Project payment - Customer_0015,REF54961129,0.0,84.81,191366.13
2024-01-04,2024-01-04,Service payment - Customer_0067,REF13150250,0.0,84.44,191450.57
2024-01-04,2024-01-04,Invoice payment - Customer_0030,REF92733083,0.0,29.97,191480.54
2024-01-04,2024-01-04,Service payment - Customer_0023,REF16915091,0.0,81.95,191562.49
2024-01-04,2024-01-04,Payment from Customer_0089,REF92821628,0.0,104.18,191666.67
2024-01-04,2024-01-04,Invoice payment - Customer_0055,REF42975878,0.0,67.78,191734.45
2024-01-04,2024-01-04,Payment from Customer_0058,REF54808978,0.0,34.42,191768.87
2024-01-05,2024-01-05,Project payment - Customer_0022,REF76417621,0.0,69.29,191838.16
2024-01-05,2024-01-05,Invoice payment - Customer_0016,REF82495350,0.0,23.57,191861.73
2024-01-05,2024-01-05,Project payment - Customer_0073,REF73079919,0.0,93.82,191955.55
2024-01-05,2024-01-05,Payment from Customer_0054,REF97457044,0.0,58.1,192013.65
2024-01-05,2024-01-05,Invoice payment - Customer_0009,REF98797007,0.0,64.09,192077.74
2024-01-05,2024-01-05,Project payment - Customer_0028,REF92096549,0.0,66.55,192144.29
2024-01-05,2024-01-05,Service payment - Customer_0080,REF20732880,0.0,31.85,192176.14
2024-01-05,2024-01-05,Project payment - Customer_0000,REF76188642,0.0,19.91,192196.05
2024-01-05,2024-01-05,Invoice payment - Customer_0008,REF38224459,0.0,74.4,192270.45
2024-01-05,2024-01-05,Payment from Customer_0050,REF56972154,0.0,115.12,192385.57
2024-01-05,2024-01-05,Service payment - Customer_0030,REF24211096,0.0,36.17,192421.74
2024-01-05,2024-01-05,Invoice payment - Customer_0068,REF93349012,0.0,43.17,192464.91
2024-01-06,2024-01-06,Service payment - Customer_0009,REF25034404,0.0,54.85,192519.76
2024-01-06,2024-01-06,Payment from Customer_0072,REF11830405,0.0,83.36,192603.12
2024-01-06,2024-01-06,Service payment - Customer_0092,REF48162539,0.0,58.35,192661.47
2024-01-06,2024-01-06,Payment from Customer_0007,REF38889196,0.0,108.8,192770.27
2024-01-06,2024-01-06,Project payment - Customer_0039,REF94467465,0.0,131.41,192901.68
2024-01-06,2024-01-06,Invoice payment - Customer_0004,REF92696638,0.0,38.25,192939.93
2024-01-06,2024-01-06,Project payment - Customer_0040,REF61731366,0.0,24.28,192964.21
2024-01-06,2024-01-06,Invoice payment - Customer_0099,REF28580053,0.0,27.84,192992.05
2024-01-06,2024-01-06,Invoice payment - Customer_0075,REF10345490,0.0,121.93,193113.98
2024-01-06,2024-01-06,Invoice payment - Customer_0024,REF43473632,0.0,78.03,193192.01
2024-01-06,2024-01-06,Service payment - Customer_0022,REF94090548,0.0,62.0,193254.01
2024-01-06,2024-01-06,Project payment - Customer_0008,REF67040580,0.0,90.3,193344.31
2024-01-07,2024-01-07,Payment from Customer_0072,REF96426059,0.0,126.25,193470.56
2024-01-07,2024-01-07,Service payment - Customer_0088,REF50609818,0.0,95.12,193565.68
2024-01-07,2024-01-07,Payment from Customer_0012,REF34189676,0.0,49.35,193615.03
2024-01-07,2024-01-07,Payment from Customer_0019,REF48386915,0.0,90.85,193705.88
2024-01-07,2024-01-07,Payment from Customer_0013,REF87217359,0.0,67.39,193773.27
2024-01-07,2024-01-07,Project payment - Customer_0046,REF45903014,0.0,119.56,193892.83
2024-01-07,2024-01-07,Project payment - Customer_0094,REF21001923,0.0,81.06,193973.89
2024-01-07,2024-01-07,Invoice payment - Customer_0028,REF75739284,0.0,83.13,194057.02
2024-01-07,2024-01-07,Invoice payment - Customer_0017,REF20471748,0.0,62.94,194119.96
2024-01-08,2024-01-08,Payment from Customer_0008,REF30703114,0.0,66.37,194186.33
2024-01-08,2024-01-08,Service payment - Customer_0074,REF96974973,0.0,40.51,194226.84
2024-01-08,2024-01-08,Project payment - Customer_0095,REF39961622,0.0,54.02,194280.86
2024-01-08,2024-01-08,Service payment - Customer_0044,REF45747754,0.0,35.98,194316.84
2024-01-08,2024-01-08,Service payment - Customer_0058,REF24944909,0.0,24.25,194341.09
2024-01-08,2024-01-08,Service payment - Customer_0087,REF13300202,0.0,51.64,194392.73
2024-01-08,2024-01-08,Invoice payment - Customer_0007,REF71502502,0.0,122.41,194515.14
2024-01-08,2024-01-08,Service payment - Customer_0005,REF46686052,0.0,24.81,194539.95
2024-01-08,2024-01-08,Payment from Customer_0010,REF77713565,0.0,76.26,194616.21
2024-01-08,2024-01-08,Payment from Customer_0076,REF36044752,0.0,10.0,194626.21
2024-01-08,2024-01-08,Service payment - Customer_0070,REF83675022,0.0,49.57,194675.78
2024-01-08,2024-01-08,Invoice payment - Customer_0056,REF55475879,0.0,26.52,194702.3
2024-01-09,2024-01-09,Invoice payment - Customer_0041,REF63248977,0.0,118.08,194820.38
2024-01-09,2024-01-09,Payment from Customer_0066,REF90254557,0.0,54.59,194874.97
2024-01-09,2024-01-09,Project payment - Customer_0022,REF30785268,0.0,58.21,194933.18
2024-01-09,2024-01-09,Invoice payment - Customer_0082,REF74848741,0.0,121.15,195054.33
2024-01-09,2024-01-09,Payment from Customer_0033,REF21168551,0.0,53.38,195107.71
2024-01-09,2024-01-09,Payment from Customer_0079,REF63047855,0.0,71.44,195179.15
2024-01-09,2024-01-09,Project payment - Customer_0085,REF65910968,0.0,95.87,195275.02
2024-01-09,2024-01-09,Invoice payment - Customer_0062,REF40765379,0.0,55.54,195330.56
2024-01-09,2024-01-09,Invoice payment - Customer_0065,REF79727968,0.0,47.22,195377.78
2024-01-10,2024-01-10,Invoice payment - Customer_0044,REF11429707,0.0,30.45,195408.23
2024-01-10,2024-01-10,Payment from Customer_0082,REF17456673,0.0,129.85,195538.08
2024-01-10,2024-01-10,Invoice payment - Customer_0004,REF76266685,0.0,42.75,195580.83
2024-01-10,2024-01-10,Payment from Customer_0040,REF36484342,0.0,27.07,195607.9
2024-01-10,2024-01-10,Payment from Customer_0074,REF34948043,0.0,40.06,195647.96
2024-01-10,2024-01-10,Project payment - Customer_0022,REF16482737,0.0,57.49,195705.45
2024-01-10,2024-01-10,Invoice payment - Customer_0031,REF82415980,0.0,85.56,195791.01
2024-01-10,2024-01-10,Invoice payment - Customer_0061,REF24439929,0.0,117.38,195908.39
2024-01-10,2024-01-10,Project payment - Customer_0009,REF48581685,0.0,65.31,195973.7
2024-01-10,2024-01-10,Invoice payment - Customer_0014,REF66692529,0.0,93.14,196066.84
2024-01-10,2024-01-10,Invoice payment - Customer_0066,REF14368242,0.0,38.09,196104.93
2024-01-10,2024-01-10,Project payment - Customer_0064,REF90386956,0.0,26.2,196131.13
2024-01-11,2024-01-11,Invoice payment - Customer_0053,REF74746191,0.0,121.76,196252.89
2024-01-11,2024-01-11,Payment from Customer_0045,REF67199338,0.0,90.08,196342.97
2024-01-11,2024-01-11,Invoice payment - Customer_0095,REF66939443,0.0,72.22,196415.19
2024-01-11,2024-01-11,Invoice payment - Customer_0069,REF91750637,0.0,62.9,196478.09
2024-01-11,2024-01-11,Service payment - Customer_0068,REF94964785,0.0,39.06,196517.15
2024-01-12,2024-01-12,Invoice payment - Customer_0090,REF61436857,0.0,85.13,196602.28
2024-01-12,2024-01-12,Invoice payment - Customer_0000,REF32301763,0.0,29.04,196631.32
2024-01-12,2024-01-12,Invoice payment - Customer_0067,REF81739618,0.0,73.94,196705.26
2024-01-12,2024-01-12,Project payment - Customer_0073,REF63365845,0.0,85.91,196791.17
2024-01-12,2024-01-12,Service payment - Customer_0069,REF73182286,0.0,50.53,196841.7
2024-01-12,2024-01-12,Payment from Customer_0085,REF94333618,0.0,84.97,196926.67
2024-01-12,2024-01-12,Payment from Customer_0064,REF48672524,0.0,27.05,196953.72
2024-01-12,2024-01-12,Project payment - Customer_0074,REF31511290,0.0,42.77,196996.49
2024-01-12,2024-01-12,Project payment - Customer_0080,REF65413724,0.0,33.7,197030.19
2024-01-13,2024-01-13,Payment from Customer_0061,REF83448721,0.0,92.29,197122.48
2024-01-13,2024-01-13,Invoice payment - Customer_0090,REF34978949,0.0,74.15,197196.63
2024-01-13,2024-01-13,Project payment - Customer_0023,REF13947328,0.0,62.03,197258.66
2024-01-13,2024-01-13,Project payment - Customer_0026,REF71363266,0.0,76.2,197334.86
2024-01-13,2024-01-13,Service payment - Customer_0003,REF95543657,0.0,52.87,197387.73
2024-01-13,2024-01-13,Project payment - Customer_0066,REF73799846,0.0,52.33,197440.06
2024-01-13,2024-01-13,Invoice payment - Customer_0005,REF92499160,0.0,32.84,197472.9
2024-01-13,2024-01-13,Service payment - Customer_0016,REF38377845,0.0,33.99,197506.89
2024-01-13,2024-01-13,Invoice payment - Customer_0087,REF31401507,0.0,78.0,197584.89
2024-01-13,2024-01-13,Service payment - Customer_0099,REF46113791,0.0,31.87,197616.76
2024-01-13,2024-01-13,Project payment - Customer_0029,REF36517850,0.0,68.46,197685.22
2024-01-13,2024-01-13,Service payment - Customer_0019,REF57476376,0.0,83.76,197768.98
2024-01-13,2024-01-13,Invoice payment - Customer_0082,REF29900747,0.0,118.43,197887.41
2024-01-13,2024-01-13,Project payment - Customer_0033,REF98867970,0.0,57.31,197944.72
2024-01-14,2024-01-14,Payment from Customer_0062,REF25858665,0.0,38.91,197983.63
2024-01-14,2024-01-14,Service payment - Customer_0077,REF12668310,0.0,74.36,198057.99
2024-01-14,2024-01-14,Project payment - Customer_0072,REF13122504,0.0,115.58,198173.57
2024-01-14,2024-01-14,Service payment - Customer_0003,REF13525200,0.0,65.69,198239.26
2024-01-14,2024-01-14,Invoice payment - Customer_0055,REF16902760,0.0,43.05,198282.31
2024-01-14,2024-01-14,Service payment - Customer_0034,REF36777698,0.0,63.66,198345.97
2024-01-14,2024-01-14,Payment from Customer_0020,REF76246069,0.0,86.73,198432.7
2024-01-14,2024-01-14,Invoice payment - Customer_0069,REF55033270,0.0,54.92,198487.62
2024-01-14,2024-01-14,Project payment - Customer_0054,REF45762725,0.0,58.21,198545.83
2024-01-14,2024-01-14,Project payment - Customer_0033,REF88353962,0.0,61.96,198607.79
2024-01-15,2024-01-15,Invoice payment - Customer_0077,REF22098075,0.0,73.88,198681.67
2024-01-15,2024-01-15,Project payment - Customer_0051,REF19519880,0.0,65.3,198746.97
2024-01-15,2024-01-15,Service payment - Customer_0009,REF13951974,0.0,53.85,198800.82
2024-01-15,2024-01-15,Invoice payment - Customer_0022,REF48439468,0.0,34.11,198834.93
2024-01-15,2024-01-15,Service payment - Customer_0028,REF95312316,0.0,81.06,198915.99
2024-01-15,2024-01-15,Payment from Customer_0046,REF29499654,0.0,102.84,199018.83
2024-01-15,2024-01-15,Payment from Customer_0029,REF46422833,0.0,64.3,199083.13
2024-01-15,2024-01-15,Service payment - Customer_0015,REF22574297,0.0,113.93,199197.06
2024-01-15,2024-01-15,Invoice payment - Customer_0079,REF71406100,0.0,64.96,199262.02
2024-01-15,2024-01-15,Project payment - Customer_0038,REF28288453,0.0,35.98,199298.0
2024-01-15,2024-01-15,Business insurance premium,REF96815220,140.33,0.0,199157.67
2024-01-16,2024-01-16,Pos Systems expense,REF86457974,13.35,0.0,199144.32
2024-01-16,2024-01-16,Payment from Customer_0070,REF39934222,0.0,55.65,199199.97
2024-01-16,2024-01-16,Invoice payment - Customer_0082,REF52662639,0.0,133.42,199333.39
2024-01-16,2024-01-16,Payment from Customer_0002,REF34887793,0.0,70.01,199403.4
2024-01-16,2024-01-16,Project payment - Customer_0076,REF13011732,0.0,10.0,199413.4
2024-01-16,2024-01-16,Project payment - Customer_0093,REF27082290,0.0,107.85,199521.25
2024-01-16,2024-01-16,Project payment - Customer_0071,REF63512821,0.0,31.47,199552.72
2024-01-16,2024-01-16,Payment from Customer_0006,REF87831411,0.0,68.11,199620.83
2024-01-16,2024-01-16,Invoice payment - Customer_0060,REF51445846,0.0,72.39,199693.22
2024-01-16,2024-01-16,Service payment - Customer_0010,REF91808616,0.0,55.03,199748.25
2024-01-17,2024-01-17,Service payment - Customer_0045,REF84163293,0.0,61.56,199809.81
2024-01-17,2024-01-17,Service payment - Customer_0031,REF44192355,0.0,76.62,199886.43
2024-01-17,2024-01-17,Project payment - Customer_0096,REF92485669,0.0,72.19,199958.62
2024-01-17,2024-01-17,Project payment - Customer_0003,REF97369581,0.0,50.67,200009.29
2024-01-17,2024-01-17,Service payment - Customer_0091,REF31939727,0.0,95.63,200104.92
2024-01-17,2024-01-17,Project payment - Customer_0023,REF48591516,0.0,103.03,200207.95
2024-01-17,2024-01-17,Invoice payment - Customer_0016,REF53165404,0.0,27.56,200235.51
2024-01-18,2024-01-18,Project payment - Customer_0013,REF83681650,0.0,52.91,200288.42
2024-01-18,2024-01-18,Payment from Customer_0030,REF57219650,0.0,33.92,200322.34
2024-01-18,2024-01-18,Project payment - Customer_0037,REF39672141,0.0,123.97,200446.31
2024-01-18,2024-01-18,Employee payroll,REF91612421,1739.29,0.0,198707.02
2024-01-18,2024-01-18,Project payment - Customer_0022,REF93722980,0.0,70.21,198777.23
2024-01-18,2024-01-18,Invoice payment - Customer_0068,REF93042813,0.0,42.84,198820.07
2024-01-18,2024-01-18,Payment from Customer_0072,REF95577161,0.0,87.64,198907.71
2024-01-18,2024-01-18,Payment from Customer_0075,REF20637882,0.0,97.69,199005.4
2024-01-18,2024-01-18,Project payment - Customer_0009,REF83076566,0.0,48.64,199054.04
2024-01-18,2024-01-18,Service payment - Customer_0016,REF67633045,0.0,20.26,199074.3
2024-01-19,2024-01-19,Payment from Customer_0028,REF71219829,0.0,67.09,199141.39
2024-01-19,2024-01-19,Invoice payment - Customer_0056,REF89728285,0.0,24.34,199165.73
2024-01-19,2024-01-19,Payment from Customer_0061,REF13469126,0.0,97.67,199263.4
2024-01-19,2024-01-19,Payment from Customer_0001,REF30544609,0.0,53.73,199317.13
2024-01-19,2024-01-19,Invoice payment - Customer_0069,REF85319915,0.0,76.21,199393.34
2024-01-20,2024-01-20,Payment from Customer_0078,REF60018660,0.0,103.27,199496.61
2024-01-20,2024-01-20,Invoice payment - Customer_0056,REF93746063,0.0,25.11,199521.72
2024-01-20,2024-01-20,Service payment - Customer_0067,REF43833355,0.0,80.34,199602.06
2024-01-20,2024-01-20,Invoice payment - Customer_0095,REF70018759,0.0,69.07,199671.13
2024-01-20,2024-01-20,Project payment - Customer_0025,REF17261197,0.0,106.18,199777.31
2024-01-20,2024-01-20,Service payment - Customer_0096,REF64919677,0.0,54.33,199831.64
2024-01-20,2024-01-20,Service payment - Customer_0038,REF31763721,0.0,49.29,199880.93
2024-01-20,2024-01-20,Invoice payment - Customer_0053,REF42435024,0.0,119.2,200000.13
2024-01-20,2024-01-20,Invoice payment - Customer_0032,REF73205255,0.0,59.22,200059.35
2024-01-20,2024-01-20,Payment from Customer_0087,REF55216073,0.0,53.47,200112.82
2024-01-20,2024-01-20,Service payment - Customer_0033,REF64521078,0.0,63.07,200175.89
2024-01-21,2024-01-21,Service payment - Customer_0049,REF75170184,0.0,65.59,200241.48
2024-01-21,2024-01-21,Payment from Customer_0020,REF74404042,0.0,102.94,200344.42
2024-01-21,2024-01-21,Invoice payment - Customer_0098,REF13547723,0.0,59.49,200403.91
2024-01-21,2024-01-21,Invoice payment - Customer_0022,REF45848122,0.0,42.96,200446.87
2024-01-21,2024-01-21,Service payment - Customer_0092,REF19806074,0.0,56.35,200503.22
2024-01-21,2024-01-21,Invoice payment - Customer_0030,REF97826502,0.0,44.79,200548.01
2024-01-21,2024-01-21,Project payment - Customer_0044,REF39744357,0.0,24.84,200572.85
2024-01-21,2024-01-21,Service payment - Customer_0050,REF56297090,0.0,110.82,200683.67
2024-01-21,2024-01-21,Project payment - Customer_0069,REF63109688,0.0,72.68,200756.35
2024-01-22,2024-01-22,Project payment - Customer_0089,REF17782600,0.0,138.75,200895.1
2024-01-22,2024-01-22,Project payment - Customer_0054,REF31636933,0.0,69.98,200965.08
2024-01-22,2024-01-22,Utility bill payment,REF31864487,143.45,0.0,200821.63
2024-01-22,2024-01-22,Payment from Customer_0012,REF20555120,0.0,58.11,200879.74
2024-01-22,2024-01-22,Payment from Customer_0039,REF69021576,0.0,146.56,201026.3
2024-01-22,2024-01-22,Pos Systems expense,REF50544517,46.87,0.0,200979.43
2024-01-22,2024-01-22,Service payment - Customer_0017,REF63553089,0.0,56.97,201036.4
2024-01-22,2024-01-22,Invoice payment - Customer_0003,REF31275302,0.0,62.18,201098.58
2024-01-22,2024-01-22,Payment from Customer_0092,REF50546239,0.0,54.34,201152.92
2024-01-22,2024-01-22,Payment from Customer_0084,REF15884842,0.0,66.17,201219.09
2024-01-23,2024-01-23,Project payment - Customer_0003,REF71963189,0.0,58.86,201277.95
2024-01-23,2024-01-23,Project payment - Customer_0091,REF50537946,0.0,121.28,201399.23
2024-01-23,2024-01-23,Payment from Customer_0029,REF59073257,0.0,72.88,201472.11
2024-01-23,2024-01-23,Payment from Customer_0096,REF66742143,0.0,56.85,201528.96
2024-01-23,2024-01-23,Invoice payment - Customer_0069,REF91978700,0.0,75.28,201604.24
2024-01-23,2024-01-23,Payment from Customer_0028,REF42437473,0.0,68.74,201672.98
2024-01-23,2024-01-23,Payment from Customer_0060,REF24527277,0.0,60.7,201733.68
2024-01-23,2024-01-23,Service payment - Customer_0061,REF21247538,0.0,111.4,201845.08
2024-01-23,2024-01-23,Invoice payment - Customer_0048,REF48605392,0.0,87.08,201932.16
2024-01-23,2024-01-23,Service payment - Customer_0059,REF61886141,0.0,55.23,201987.39
2024-01-23,2024-01-23,Project payment - Customer_0078,REF13704630,0.0,102.21,202089.6
2024-01-23,2024-01-23,Project payment - Customer_0022,REF26137572,0.0,50.58,202140.18
2024-01-23,2024-01-23,Invoice payment - Customer_0011,REF20529521,0.0,73.04,202213.22
2024-01-24,2024-01-24,Inventory purchase,REF51568148,1193.55,0.0,201019.67
2024-01-24,2024-01-24,Project payment - Customer_0015,REF23048639,0.0,112.26,201131.93
2024-01-24,2024-01-24,Project payment - Customer_0026,REF59690609,0.0,79.48,201211.41
2024-01-24,2024-01-24,Service payment - Customer_0083,REF16131375,0.0,50.24,201261.65
2024-01-24,2024-01-24,Project payment - Customer_0091,REF86663427,0.0,117.14,201378.79
2024-01-24,2024-01-24,Payment from Customer_0022,REF99462409,0.0,41.5,201420.29
2024-01-24,2024-01-24,Invoice payment - Customer_0064,REF89130984,0.0,29.32,201449.61
2024-01-25,2024-01-25,Project payment - Customer_0045,REF83533692,0.0,99.95,201549.56
2024-01-25,2024-01-25,Project payment - Customer_0059,REF85884206,0.0,71.87,201621.43
2024-01-25,2024-01-25,Service payment - Customer_0013,REF98330350,0.0,52.72,201674.15
2024-01-25,2024-01-25,Invoice payment - Customer_0066,REF87532413,0.0,44.68,201718.83
2024-01-25,2024-01-25,Service payment - Customer_0029,REF49675756,0.0,58.79,201777.62
2024-01-25,2024-01-25,Service payment - Customer_0098,REF48075776,0.0,50.53,201828.15
2024-01-25,2024-01-25,Project payment - Customer_0096,REF76724177,0.0,83.84,201911.99
2024-01-25,2024-01-25,Service payment - Customer_0038,REF18768390,0.0,43.11,201955.1
2024-01-25,2024-01-25,Service payment - Customer_0006,REF15036931,0.0,66.26,202021.36
2024-01-26,2024-01-26,Invoice payment - Customer_0072,REF19774926,0.0,121.71,202143.07
2024-01-26,2024-01-26,Project payment - Customer_0005,REF64807341,0.0,32.25,202175.32
2024-01-26,2024-01-26,Invoice payment - Customer_0058,REF12003933,0.0,34.0,202209.32
2024-01-26,2024-01-26,Service payment - Customer_0043,REF24209448,0.0,115.49,202324.81
2024-01-26,2024-01-26,Invoice payment - Customer_0091,REF23069821,0.0,118.1,202442.91
2024-01-27,2024-01-27,Service payment - Customer_0035,REF87083376,0.0,106.91,202549.82
2024-01-27,2024-01-27,Invoice payment - Customer_0050,REF66404591,0.0,129.57,202679.39
2024-01-27,2024-01-27,Payment from Customer_0074,REF99697187,0.0,40.51,202719.9
2024-01-27,2024-01-27,Invoice payment - Customer_0075,REF10425835,0.0,91.57,202811.47
2024-01-27,2024-01-27,Service payment - Customer_0059,REF33231905,0.0,47.48,202858.95
2024-01-27,2024-01-27,Payment from Customer_0062,REF46493571,0.0,60.83,202919.78
2024-01-27,2024-01-27,Service payment - Customer_0047,REF42189281,0.0,87.28,203007.06
2024-01-27,2024-01-27,Service payment - Customer_0043,REF61461081,0.0,110.82,203117.88
2024-01-27,2024-01-27,Invoice payment - Customer_0076,REF72100205,0.0,10.0,203127.88
2024-01-27,2024-01-27,Service payment - Customer_0012,REF53974445,0.0,62.61,203190.49
2024-01-28,2024-01-28,Service payment - Customer_0079,REF42141602,0.0,72.91,203263.4
2024-01-28,2024-01-28,Project payment - Customer_0068,REF25629261,0.0,35.53,203298.93
2024-01-28,2024-01-28,Invoice payment - Customer_0048,REF96622412,0.0,83.59,203382.52
2024-01-28,2024-01-28,Project payment - Customer_0092,REF88650290,0.0,54.99,203437.51
2024-01-28,2024-01-28,Payment from Customer_0013,REF79408868,0.0,67.64,203505.15
2024-01-28,2024-01-28,Project payment - Customer_0089,REF23543709,0.0,120.69,203625.84
2024-01-28,2024-01-28,Project payment - Customer_0014,REF26038887,0.0,60.76,203686.6
2024-01-28,2024-01-28,Invoice payment - Customer_0031,REF36204354,0.0,73.86,203760.46
2024-01-28,2024-01-28,Project payment - Customer_0036,REF84816508,0.0,39.09,203799.55
2024-01-29,2024-01-29,Project payment - Customer_0083,REF76500830,0.0,48.56,203848.11
2024-01-29,2024-01-29,Service payment - Customer_0007,REF32223015,0.0,76.29,203924.4
2024-01-29,2024-01-29,Project payment - Customer_0096,REF90067316,0.0,76.29,204000.69
2024-01-29,2024-01-29,Project payment - Customer_0054,REF40647664,0.0,44.93,204045.62
2024-01-29,2024-01-29,Project payment - Customer_0028,REF32821592,0.0,50.88,204096.5
2024-01-29,2024-01-29,Service payment - Customer_0059,REF79239701,0.0,38.59,204135.09
2024-01-29,2024-01-29,Service payment - Customer_0069,REF37677031,0.0,55.28,204190.37
2024-01-30,2024-01-30,Invoice payment - Customer_0092,REF74517971,0.0,52.63,204243.0
2024-01-30,2024-01-30,Invoice payment - Customer_0081,REF80538279,0.0,76.8,204319.8
2024-01-30,2024-01-30,Invoice payment - Customer_0041,REF71769515,0.0,116.26,204436.06
2024-01-30,2024-01-30,Invoice payment - Customer_0005,REF21152545,0.0,22.03,204458.09
2024-01-30,2024-01-30,Payment from Customer_0085,REF16595837,0.0,73.89,204531.98
2024-01-30,2024-01-30,Service payment - Customer_0010,REF48452009,0.0,74.28,204606.26
2024-01-30,2024-01-30,Project payment - Customer_0021,REF43671217,0.0,58.4,204664.66
2024-01-31,2024-01-31,Project payment - Customer_0064,REF64786934,0.0,25.89,204690.55
2024-01-31,2024-01-31,Service payment - Customer_0054,REF24031046,0.0,55.86,204746.41
2024-01-31,2024-01-31,Payment from Customer_0074,REF86297083,0.0,43.58,204789.99
2024-01-31,2024-01-31,Invoice payment - Customer_0071,REF43088048,0.0,34.3,204824.29
2024-01-31,2024-01-31,Invoice payment - Customer_0076,REF80066969,0.0,10.0,204834.29
2024-01-31,2024-01-31,Service payment - Customer_0049,REF85287694,0.0,74.09,204908.38
2024-01-31,2024-01-31,Invoice payment - Customer_0031,REF97038293,0.0,84.31,204992.69
2024-01-31,2024-01-31,Project payment - Customer_0043,REF12805719,0.0,101.66,205094.35
2024-01-31,2024-01-31,Payment from Customer_0035,REF45430972,0.0,90.59,205184.94
2024-01-31,2024-01-31,Project payment - Customer_0094,REF16380295,0.0,52.27,205237.21
2024-01-31,2024-01-31,Payment from Customer_0003,REF81219964,0.0,77.41,205314.62
2024-02-01,2024-02-01,Monthly office rent,REF94471353,1045.9,0.0,204268.72
2024-02-01,2024-02-01,Service payment - Customer_0066,REF25121196,0.0,58.97,204327.69
2024-02-01,2024-02-01,Inventory purchase,REF65337266,2159.05,0.0,202168.64
2024-02-01,2024-02-01,Service payment - Customer_0094,REF34141670,0.0,73.82,202242.46
2024-02-01,2024-02-01,Invoice payment - Customer_0053,REF59890808,0.0,107.9,202350.36
2024-02-01,2024-02-01,Payment from Customer_0015,REF95340731,0.0,123.06,202473.42
2024-02-01,2024-02-01,Payment from Customer_0085,REF23608591,0.0,77.88,202551.3
2024-02-01,2024-02-01,Invoice payment - Customer_0067,REF37899914,0.0,83.73,202635.03
2024-02-01,2024-02-01,Service payment - Customer_0065,REF66654416,0.0,46.92,202681.95
2024-02-02,2024-02-02,Invoice payment - Customer_0082,REF95654974,0.0,135.95,202817.9
2024-02-02,2024-02-02,Service payment - Customer_0002,REF87960888,0.0,78.37,202896.27
2024-02-02,2024-02-02,Service payment - Customer_0044,REF14995692,0.0,40.71,202936.98
2024-02-02,2024-02-02,Invoice payment - Customer_0011,REF66996198,0.0,96.35,203033.33
2024-02-02,2024-02-02,Project payment - Customer_0001,REF34164711,0.0,56.59,203089.92
2024-02-02,2024-02-02,Service payment - Customer_0049,REF81013445,0.0,71.9,203161.82
2024-02-02,2024-02-02,Service payment - Customer_0030,REF53127482,0.0,41.32,203203.14
2024-02-02,2024-02-02,Payment from Customer_0056,REF86538529,0.0,30.3,203233.44
2024-02-02,2024-02-02,Service payment - Customer_0003,REF32094594,0.0,77.64,203311.08
2024-02-02,2024-02-02,Payment from Customer_0046,REF69699571,0.0,101.78,203412.86
2024-02-03,2024-02-03,Service payment - Customer_0071,REF29323089,0.0,43.05,203455.91
2024-02-03,2024-02-03,Service payment - Customer_0076,REF85294390,0.0,10.0,203465.91
2024-02-03,2024-02-03,Payment from Customer_0091,REF99789429,0.0,125.91,203591.82
2024-02-04,2024-02-04,Payment from Customer_0060,REF16392688,0.0,81.33,203673.15
2024-02-04,2024-02-04,Service payment - Customer_0015,REF21932998,0.0,102.63,203775.78
2024-02-04,2024-02-04,Invoice payment - Customer_0008,REF68436098,0.0,90.88,203866.66
2024-02-04,2024-02-04,Payment from Customer_0073,REF99081311,0.0,87.87,203954.53
2024-02-04,2024-02-04,Payment from Customer_0013,REF59396342,0.0,66.75,204021.28
2024-02-04,2024-02-04,Payment from Customer_0086,REF80906682,0.0,76.3,204097.58
2024-02-04,2024-02-04,Project payment - Customer_0002,REF80464028,0.0,84.03,204181.61
2024-02-04,2024-02-04,Project payment - Customer_0074,REF17885800,0.0,52.23,204233.84
2024-02-04,2024-02-04,Invoice payment - Customer_0045,REF90976376,0.0,88.52,204322.36
2024-02-04,2024-02-04,Payment from Customer_0078,REF99771491,0.0,113.98,204436.34
2024-02-04,2024-02-04,Payment from Customer_0067,REF38752493,0.0,127.72,204564.06
2024-02-04,2024-02-04,Payment from Customer_0094,REF60243363,0.0,70.55,204634.61
2024-02-04,2024-02-04,Project payment - Customer_0019,REF79347378,0.0,102.21,204736.82
2024-02-04,2024-02-04,Service payment - Customer_0040,REF22129267,0.0,28.15,204764.97
2024-02-04,2024-02-04,Invoice payment - Customer_0027,REF49171977,0.0,79.42,204844.39
2024-02-05,2024-02-05,Payment from Customer_0044,REF25040022,0.0,31.96,204876.35
2024-02-05,2024-02-05,Project payment - Customer_0086,REF83641429,0.0,82.77,204959.12
2024-02-05,2024-02-05,Service payment - Customer_0058,REF13657201,0.0,38.57,204997.69
2024-02-05,2024-02-05,Project payment - Customer_0077,REF30353621,0.0,91.63,205089.32
2024-02-05,2024-02-05,Project payment - Customer_0021,REF56229795,0.0,56.55,205145.87
2024-02-05,2024-02-05,Professional Services expense,REF84116656,201.63,0.0,204944.24
2024-02-05,2024-02-05,Payment from Customer_0026,REF44791372,0.0,103.9,205048.14
2024-02-05,2024-02-05,Project payment - Customer_0041,REF85504837,0.0,118.47,205166.61
2024-02-05,2024-02-05,Service payment - Customer_0068,REF12731899,0.0,37.03,205203.64
2024-02-05,2024-02-05,Payment from Customer_0024,REF25821958,0.0,80.7,205284.34
2024-02-05,2024-02-05,Invoice payment - Customer_0040,REF22926016,0.0,32.81,205317.15
2024-02-05,2024-02-05,Service payment - Customer_0028,REF43370831,0.0,91.17,205408.32
2024-02-06,2024-02-06,Invoice payment - Customer_0081,REF27656343,0.0,69.37,205477.69
2024-02-06,2024-02-06,Payment from Customer_0033,REF25950215,0.0,61.2,205538.89
2024-02-06,2024-02-06,Invoice payment - Customer_0047,REF71087949,0.0,95.64,205634.53
2024-02-06,2024-02-06,Service payment - Customer_0030,REF98452780,0.0,30.59,205665.12
2024-02-06,2024-02-06,Invoice payment - Customer_0039,REF48852409,0.0,94.23,205759.35
2024-02-06,2024-02-06,Invoice payment - Customer_0003,REF20999504,0.0,72.03,205831.38
2024-02-07,2024-02-07,Invoice payment - Customer_0050,REF93688511,0.0,135.68,205967.06
2024-02-07,2024-02-07,Service payment - Customer_0081,REF13788410,0.0,58.92,206025.98
2024-02-07,2024-02-07,Invoice payment - Customer_0064,REF98073738,0.0,35.05,206061.03
2024-02-07,2024-02-07,Payment from Customer_0021,REF32979334,0.0,55.6,206116.63
2024-02-07,2024-02-07,Payment from Customer_0052,REF10835472,0.0,39.85,206156.48
2024-02-07,2024-02-07,Service payment - Customer_0099,REF44895912,0.0,44.04,206200.52
2024-02-07,2024-02-07,Project payment - Customer_0070,REF21452920,0.0,59.27,206259.79
2024-02-07,2024-02-07,Payment from Customer_0078,REF93352954,0.0,113.8,206373.59
2024-02-07,2024-02-07,Invoice payment - Customer_0011,REF45962637,0.0,72.98,206446.57
2024-02-07,2024-02-07,Project payment - Customer_0001,REF68571792,0.0,56.47,206503.04
2024-02-08,2024-02-08,Payment from Customer_0084,REF45059305,0.0,92.43,206595.47
2024-02-08,2024-02-08,Invoice payment - Customer_0011,REF61040429,0.0,90.98,206686.45
2024-02-08,2024-02-08,Payment from Customer_0022,REF46733307,0.0,77.33,206763.78
2024-02-08,2024-02-08,Project payment - Customer_0006,REF17831119,0.0,74.68,206838.46
2024-02-08,2024-02-08,Invoice payment - Customer_0061,REF99555902,0.0,86.39,206924.85
2024-02-08,2024-02-08,Payment from Customer_0072,REF46149161,0.0,106.9,207031.75
2024-02-08,2024-02-08,Service payment - Customer_0041,REF41334081,0.0,106.69,207138.44
2024-02-08,2024-02-08,Project payment - Customer_0075,REF49717016,0.0,100.79,207239.23
2024-02-08,2024-02-08,Project payment - Customer_0038,REF96218855,0.0,46.02,207285.25
2024-02-08,2024-02-08,Payment from Customer_0060,REF11865059,0.0,51.6,207336.85
2024-02-09,2024-02-09,Project payment - Customer_0099,REF33256694,0.0,40.02,207376.87
2024-02-09,2024-02-09,Payment from Customer_0083,REF81202332,0.0,67.62,207444.49
2024-02-09,2024-02-09,Service payment - Customer_0020,REF82531065,0.0,102.88,207547.37
2024-02-09,2024-02-09,Service payment - Customer_0072,REF94375675,0.0,127.05,207674.42
2024-02-09,2024-02-09,Invoice payment - Customer_0034,REF46979933,0.0,73.64,207748.06
2024-02-09,2024-02-09,Project payment - Customer_0025,REF48658569,0.0,101.45,207849.51
2024-02-09,2024-02-09,Project payment - Customer_0073,REF32974663,0.0,104.93,207954.44
2024-02-10,2024-02-10,Invoice payment - Customer_0022,REF89293926,0.0,63.08,208017.52
2024-02-10,2024-02-10,Project payment - Customer_0025,REF15561701,0.0,104.76,208122.28
2024-02-10,2024-02-10,Payment from Customer_0082,REF97055917,0.0,113.21,208235.49
2024-02-10,2024-02-10,Project payment - Customer_0084,REF70356502,0.0,45.29,208280.78
2024-02-10,2024-02-10,Project payment - Customer_0052,REF36375266,0.0,43.71,208324.49
2024-02-10,2024-02-10,Payment from Customer_0042,REF94251261,0.0,95.6,208420.09
2024-02-10,2024-02-10,Project payment - Customer_0051,REF59994015,0.0,70.71,208490.8
2024-02-10,2024-02-10,Invoice payment - Customer_0053,REF57528238,0.0,107.63,208598.43
2024-02-10,2024-02-10,Service payment - Customer_0033,REF45970047,0.0,62.32,208660.75
2024-02-10,2024-02-10,Project payment - Customer_0034,REF20756396,0.0,59.1,208719.85
2024-02-10,2024-02-10,Payment from Customer_0026,REF51081807,0.0,86.4,208806.25
2024-02-10,2024-02-10,Invoice payment - Customer_0004,REF88800616,0.0,31.91,208838.16
2024-02-11,2024-02-11,Payment from Customer_0068,REF27727998,0.0,39.1,208877.26
2024-02-11,2024-02-11,Invoice payment - Customer_0081,REF50106637,0.0,88.58,208965.84
2024-02-11,2024-02-11,Payment from Customer_0007,REF19730511,0.0,173.42,209139.26
2024-02-11,2024-02-11,Service payment - Customer_0063,REF47313362,0.0,61.26,209200.52
2024-02-11,2024-02-11,Payment from Customer_0020,REF16916975,0.0,81.88,209282.4
2024-02-11,2024-02-11,Payment from Customer_0087,REF47981015,0.0,63.72,209346.12
2024-02-11,2024-02-11,Project payment - Customer_0069,REF53773997,0.0,71.24,209417.36
2024-02-11,2024-02-11,Project payment - Customer_0073,REF34687251,0.0,95.56,209512.92
2024-02-12,2024-02-12,Project payment - Customer_0087,REF68694006,0.0,80.2,209593.12
2024-02-12,2024-02-12,Project payment - Customer_0083,REF94239606,0.0,54.49,209647.61
2024-02-12,2024-02-12,Invoice payment - Customer_0039,REF59225850,0.0,153.14,209800.75
2024-02-12,2024-02-12,Invoice payment - Customer_0048,REF24225797,0.0,75.85,209876.6
2024-02-12,2024-02-12,Service payment - Customer_0078,REF36330785,0.0,132.27,210008.87
2024-02-12,2024-02-12,Service payment - Customer_0035,REF80311715,0.0,114.23,210123.1
2024-02-13,2024-02-13,Project payment - Customer_0031,REF40166690,0.0,85.3,210208.4
2024-02-13,2024-02-13,Service payment - Customer_0030,REF17070741,0.0,41.88,210250.28
2024-02-13,2024-02-13,Invoice payment - Customer_0040,REF88401845,0.0,33.82,210284.1
2024-02-13,2024-02-13,Service payment - Customer_0045,REF23025019,0.0,59.0,210343.1
2024-02-13,2024-02-13,Project payment - Customer_0097,REF78347323,0.0,40.72,210383.82
2024-02-14,2024-02-14,Payment from Customer_0034,REF41136568,0.0,80.71,210464.53
2024-02-14,2024-02-14,Payment from Customer_0010,REF14193485,0.0,88.97,210553.5
2024-02-14,2024-02-14,Service payment - Customer_0027,REF62542888,0.0,88.39,210641.89
2024-02-14,2024-02-14,Payment from Customer_0055,REF49671562,0.0,52.16,210694.05
2024-02-14,2024-02-14,Service payment - Customer_0078,REF85812441,0.0,133.7,210827.75
2024-02-14,2024-02-14,Project payment - Customer_0020,REF37938639,0.0,104.25,210932.0
2024-02-14,2024-02-14,Project payment - Customer_0047,REF96816434,0.0,73.06,211005.06
2024-02-14,2024-02-14,Invoice payment - Customer_0056,REF33360099,0.0,27.58,211032.64
2024-02-14,2024-02-14,Payment from Customer_0040,REF13464789,0.0,38.68,211071.32
2024-02-14,2024-02-14,Payment from Customer_0058,REF55430015,0.0,39.22,211110.54
2024-02-14,2024-02-14,Invoice payment - Customer_0079,REF60739040,0.0,90.41,211200.95
2024-02-14,2024-02-14,Service payment - Customer_0068,REF90251730,0.0,48.41,211249.36
2024-02-15,2024-02-15,Business insurance premium,REF53492951,155.06,0.0,211094.3
2024-02-15,2024-02-15,Service payment - Customer_0002,REF53996149,0.0,79.71,211174.01
2024-02-15,2024-02-15,Payment from Customer_0064,REF10596526,0.0,24.22,211198.23
2024-02-15,2024-02-15,Service payment - Customer_0031,REF32503118,0.0,76.33,211274.56
2024-02-15,2024-02-15,Payment from Customer_0038,REF32600646,0.0,55.65,211330.21
2024-02-15,2024-02-15,Service payment - Customer_0021,REF11761931,0.0,74.05,211404.26
2024-02-15,2024-02-15,Invoice payment - Customer_0040,REF66938642,0.0,34.42,211438.68
2024-02-15,2024-02-15,Project payment - Customer_0071,REF70974723,0.0,45.06,211483.74
2024-02-15,2024-02-15,Project payment - Customer_0066,REF60865377,0.0,64.78,211548.52
2024-02-16,2024-02-16,Invoice payment - Customer_0030,REF34661682,0.0,46.77,211595.29
2024-02-16,2024-02-16,Project payment - Customer_0073,REF43314993,0.0,89.76,211685.05
2024-02-16,2024-02-16,Service payment - Customer_0036,REF68168131,0.0,52.96,211738.01
2024-02-16,2024-02-16,Project payment - Customer_0088,REF74197132,0.0,111.61,211849.62
2024-02-16,2024-02-16,Project payment - Customer_0056,REF93214762,0.0,27.88,211877.5
2024-02-16,2024-02-16,Service payment - Customer_0016,REF86693969,0.0,24.97,211902.47
2024-02-16,2024-02-16,Payment from Customer_0011,REF25414617,0.0,85.29,211987.76
2024-02-16,2024-02-16,Invoice payment - Customer_0063,REF94075078,0.0,60.59,212048.35
2024-02-16,2024-02-16,Project payment - Customer_0001,REF86491066,0.0,58.43,212106.78
2024-02-17,2024-02-17,Service payment - Customer_0006,REF79683303,0.0,63.35,212170.13
2024-02-17,2024-02-17,Service payment - Customer_0012,REF12912424,0.0,76.46,212246.59
2024-02-17,2024-02-17,Invoice payment - Customer_0025,REF14666616,0.0,118.19,212364.78
2024-02-17,2024-02-17,Invoice payment - Customer_0026,REF38688401,0.0,88.08,212452.86
2024-02-17,2024-02-17,Project payment - Customer_0034,REF79726678,0.0,88.07,212540.93
2024-02-17,2024-02-17,Payment from Customer_0000,REF91987808,0.0,39.59,212580.52
2024-02-17,2024-02-17,Project payment - Customer_0057,REF14317675,0.0,130.04,212710.56
2024-02-17,2024-02-17,Service payment - Customer_0047,REF42487691,0.0,88.03,212798.59
2024-02-18,2024-02-18,Service payment - Customer_0019,REF47522476,0.0,94.83,212893.42
2024-02-18,2024-02-18,Service payment - Customer_0061,REF64237659,0.0,103.8,212997.22
2024-02-18,2024-02-18,Service payment - Customer_0096,REF52660739,0.0,85.76,213082.98
2024-02-18,2024-02-18,Service payment - Customer_0062,REF20786597,0.0,76.95,213159.93
2024-02-18,2024-02-18,Service payment - Customer_0023,REF64363594,0.0,89.79,213249.72
2024-02-18,2024-02-18,Payment from Customer_0078,REF31708113,0.0,114.0,213363.72
2024-02-18,2024-02-18,Invoice payment - Customer_0080,REF47512269,0.0,26.69,213390.41
2024-02-18,2024-02-18,Service payment - Customer_0020,REF43547433,0.0,99.71,213490.12
2024-02-19,2024-02-19,Service payment - Customer_0053,REF53933799,0.0,80.52,213570.64
2024-02-19,2024-02-19,Service payment - Customer_0019,REF96622322,0.0,103.89,213674.53
2024-02-19,2024-02-19,Service payment - Customer_0039,REF72111663,0.0,82.16,213756.69
2024-02-19,2024-02-19,Service payment - Customer_0010,REF77920024,0.0,99.69,213856.38
2024-02-19,2024-02-19,Project payment - Customer_0064,REF13619703,0.0,37.88,213894.26
2024-02-19,2024-02-19,Payment from Customer_0032,REF54030065,0.0,53.74,213948.0
2024-02-19,2024-02-19,Invoice payment - Customer_0099,REF71755547,0.0,50.56,213998.56
2024-02-19,2024-02-19,Service payment - Customer_0057,REF31381686,0.0,99.26,214097.82
2024-02-19,2024-02-19,Invoice payment - Customer_0000,REF89404203,0.0,38.83,214136.65
2024-02-20,2024-02-20,Payment from Customer_0045,REF24835163,0.0,95.14,214231.79
2024-02-20,2024-02-20,Invoice payment - Customer_0072,REF98793928,0.0,90.37,214322.16
2024-02-20,2024-02-20,Project payment - Customer_0038,REF37001955,0.0,52.34,214374.5
2024-02-20,2024-02-20,Service payment - Customer_0008,REF37376338,0.0,106.55,214481.05
2024-02-20,2024-02-20,Service payment - Customer_0087,REF97486957,0.0,65.78,214546.83
2024-02-20,2024-02-20,Payment from Customer_0030,REF25962933,0.0,34.78,214581.61
2024-02-21,2024-02-21,Payment from Customer_0061,REF67207180,0.0,111.59,214693.2
2024-02-21,2024-02-21,Service payment - Customer_0097,REF54008723,0.0,53.46,214746.66
2024-02-21,2024-02-21,Payment from Customer_0024,REF14061426,0.0,99.25,214845.91
2024-02-21,2024-02-21,Invoice payment - Customer_0048,REF79140717,0.0,75.15,214921.06
2024-02-21,2024-02-21,Invoice payment - Customer_0011,REF77079014,0.0,73.68,214994.74
2024-02-21,2024-02-21,Professional Services expense,REF79545010,86.21,0.0,214908.53
2024-02-22,2024-02-22,Invoice payment - Customer_0072,REF49357360,0.0,99.01,215007.54
2024-02-22,2024-02-22,Payment from Customer_0080,REF34372389,0.0,23.52,215031.06
2024-02-22,2024-02-22,Invoice payment - Customer_0014,REF62237742,0.0,67.54,215098.6
2024-02-22,2024-02-22,Service payment - Customer_0006,REF97129630,0.0,76.02,215174.62
2024-02-22,2024-02-22,Invoice payment - Customer_0089,REF88511995,0.0,80.44,215255.06
2024-02-22,2024-02-22,Service payment - Customer_0016,REF24088689,0.0,22.77,215277.83
2024-02-22,2024-02-22,Project payment - Customer_0031,REF58957016,0.0,74.42,215352.25
2024-02-22,2024-02-22,Service payment - Customer_0090,REF91368667,0.0,101.89,215454.14
2024-02-22,2024-02-22,Project payment - Customer_0057,REF85790907,0.0,112.38,215566.52
2024-02-22,2024-02-22,Payment from Customer_0068,REF74087435,0.0,35.61,215602.13
2024-02-22,2024-02-22,Invoice payment - Customer_0040,REF32650091,0.0,29.99,215632.12
2024-02-22,2024-02-22,Invoice payment - Customer_0013,REF57011146,0.0,82.45,215714.57
2024-02-22,2024-02-22,Utility bill payment,REF63331165,122.35,0.0,215592.22
2024-02-22,2024-02-22,Payment from Customer_0039,REF21000735,0.0,77.52,215669.74
2024-02-22,2024-02-22,Payment from Customer_0007,REF97264204,0.0,138.47,215808.21
2024-02-22,2024-02-22,Project payment - Customer_0082,REF22312476,0.0,99.97,215908.18
2024-02-22,2024-02-22,Service payment - Customer_0076,REF70462901,0.0,10.0,215918.18
2024-02-23,2024-02-23,Professional Services expense,REF41577959,152.13,0.0,215766.05
2024-02-23,2024-02-23,Project payment - Customer_0096,REF33515377,0.0,76.51,215842.56
2024-02-23,2024-02-23,Packaging Shipping expense,REF31499784,251.4,0.0,215591.16
2024-02-23,2024-02-23,Service payment - Customer_0039,REF55592253,0.0,102.25,215693.41
2024-02-23,2024-02-23,Project payment - Customer_0083,REF48240483,0.0,65.73,215759.14
2024-02-23,2024-02-23,Service payment - Customer_0075,REF96800108,0.0,68.99,215828.13
2024-02-23,2024-02-23,Service payment - Customer_0099,REF87994157,0.0,52.33,215880.46
2024-02-23,2024-02-23,Project payment - Customer_0072,REF98872150,0.0,126.45,216006.91
2024-02-23,2024-02-23,Invoice payment - Customer_0028,REF95359360,0.0,57.7,216064.61
2024-02-23,2024-02-23,Marketing expenses,REF48561809,209.93,0.0,215854.68
2024-02-23,2024-02-23,Invoice payment - Customer_0056,REF21276179,0.0,25.68,215880.36
2024-02-23,2024-02-23,Service payment - Customer_0024,REF95877720,0.0,68.73,215949.09
2024-02-23,2024-02-23,Invoice payment - Customer_0097,REF64221648,0.0,74.28,216023.37
2024-02-24,2024-02-24,Payment from Customer_0088,REF81763425,0.0,99.8,216123.17
2024-02-24,2024-02-24,Payment from Customer_0067,REF97201394,0.0,120.5,216243.67
2024-02-24,2024-02-24,Professional Services expense,REF91760362,92.63,0.0,216151.04
2024-02-24,2024-02-24,Project payment - Customer_0012,REF35277370,0.0,50.17,216201.21
2024-02-24,2024-02-24,Service payment - Customer_0009,REF73698954,0.0,68.3,216269.51
2024-02-24,2024-02-24,Service payment - Customer_0042,REF81614334,0.0,79.09,216348.6
2024-02-24,2024-02-24,Service payment - Customer_0070,REF47384756,0.0,51.3,216399.9
2024-02-24,2024-02-24,Payment from Customer_0053,REF71904742,0.0,109.24,216509.14
2024-02-24,2024-02-24,Invoice payment - Customer_0092,REF97692657,0.0,60.38,216569.52
2024-02-24,2024-02-24,Payment from Customer_0004,REF60635684,0.0,56.27,216625.79
2024-02-24,2024-02-24,Invoice payment - Customer_0000,REF70529669,0.0,26.79,216652.58
2024-02-24,2024-02-24,Invoice payment - Customer_0044,REF58145051,0.0,33.15,216685.73
2024-02-24,2024-02-24,Payment from Customer_0040,REF43632770,0.0,28.04,216713.77
2024-02-25,2024-02-25,Project payment - Customer_0087,REF10073045,0.0,84.22,216797.99
2024-02-25,2024-02-25,Invoice payment - Customer_0058,REF81438140,0.0,43.97,216841.96
2024-02-25,2024-02-25,Service payment - Customer_0092,REF23421383,0.0,69.11,216911.07
2024-02-25,2024-02-25,Service payment - Customer_0090,REF19593416,0.0,89.56,217000.63
2024-02-25,2024-02-25,Project payment - Customer_0018,REF39686685,0.0,69.17,217069.8
2024-02-25,2024-02-25,Project payment - Customer_0028,REF78473284,0.0,66.34,217136.14
2024-02-25,2024-02-25,Payment from Customer_0031,REF74905685,0.0,72.92,217209.06
2024-02-25,2024-02-25,Invoice payment - Customer_0029,REF83223750,0.0,64.09,217273.15
2024-02-25,2024-02-25,Payment from Customer_0042,REF81702473,0.0,83.26,217356.41
2024-02-25,2024-02-25,Invoice payment - Customer_0002,REF20354276,0.0,64.27,217420.68
2024-02-25,2024-02-25,Invoice payment - Customer_0048,REF45876741,0.0,87.33,217508.01
2024-02-25,2024-02-25,Service payment - Customer_0080,REF29899258,0.0,32.92,217540.93
2024-02-26,2024-02-26,Project payment - Customer_0002,REF59003182,0.0,86.75,217627.68
2024-02-26,2024-02-26,Project payment - Customer_0022,REF45184656,0.0,73.31,217700.99
2024-02-26,2024-02-26,Payment from Customer_0015,REF22368064,0.0,103.91,217804.9
2024-02-26,2024-02-26,Payment from Customer_0037,REF27347943,0.0,137.33,217942.23
2024-02-26,2024-02-26,Payment from Customer_0019,REF22338250,0.0,78.55,218020.78
2024-02-26,2024-02-26,Payment from Customer_0077,REF42061623,0.0,108.36,218129.14
2024-02-26,2024-02-26,Service payment - Customer_0087,REF27814687,0.0,86.11,218215.25
2024-02-26,2024-02-26,Invoice payment - Customer_0070,REF17546576,0.0,58.55,218273.8
2024-02-26,2024-02-26,Payment from Customer_0005,REF20887330,0.0,32.17,218305.97
2024-02-26,2024-02-26,Project payment - Customer_0039,REF15063513,0.0,132.61,218438.58
2024-02-26,2024-02-26,Payment from Customer_0036,REF74912072,0.0,48.5,218487.08
2024-02-26,2024-02-26,Service payment - Customer_0016,REF96435369,0.0,24.26,218511.34
2024-02-26,2024-02-26,Payment from Customer_0004,REF72184234,0.0,40.65,218551.99
2024-02-27,2024-02-27,Invoice payment - Customer_0085,REF39925280,0.0,112.07,218664.06
2024-02-27,2024-02-27,Invoice payment - Customer_0074,REF14917416,0.0,56.32,218720.38
2024-02-27,2024-02-27,Payment from Customer_0061,REF86753180,0.0,121.65,218842.03
2024-02-27,2024-02-27,Project payment - Customer_0053,REF19524558,0.0,145.05,218987.08
2024-02-27,2024-02-27,Invoice payment - Customer_0051,REF79317358,0.0,72.06,219059.14
2024-02-27,2024-02-27,Invoice payment - Customer_0049,REF97697069,0.0,96.44,219155.58
2024-02-27,2024-02-27,Project payment - Customer_0090,REF25536423,0.0,79.66,219235.24
2024-02-28,2024-02-28,Service payment - Customer_0013,REF58879356,0.0,68.33,219303.57
2024-02-28,2024-02-28,Service payment - Customer_0074,REF32516171,0.0,43.37,219346.94
2024-02-28,2024-02-28,Project payment - Customer_0089,REF39651045,0.0,139.78,219486.72
2024-02-28,2024-02-28,Invoice payment - Customer_0068,REF72527429,0.0,43.73,219530.45
2024-02-28,2024-02-28,Service payment - Customer_0010,REF79997197,0.0,72.02,219602.47
2024-02-28,2024-02-28,Payment from Customer_0047,REF20548103,0.0,125.44,219727.91
2024-02-28,2024-02-28,Project payment - Customer_0040,REF35304985,0.0,36.2,219764.11
2024-02-28,2024-02-28,Service payment - Customer_0004,REF96320912,0.0,49.26,219813.37
2024-02-28,2024-02-28,Service payment - Customer_0058,REF89681496,0.0,41.0,219854.37
2024-02-29,2024-02-29,Invoice payment - Customer_0084,REF65356696,0.0,83.28,219937.65
2024-02-29,2024-02-29,Project payment - Customer_0097,REF15425224,0.0,43.11,219980.76
2024-02-29,2024-02-29,Service payment - Customer_0075,REF33505560,0.0,125.95,220106.71
2024-02-29,2024-02-29,Payment from Customer_0028,REF44902963,0.0,83.46,220190.17
2024-02-29,2024-02-29,Project payment - Customer_0011,REF62823980,0.0,84.76,220274.93
2024-02-29,2024-02-29,Project payment - Customer_0059,REF34714022,0.0,67.46,220342.39
2024-02-29,2024-02-29,Service payment - Customer_0070,REF99916910,0.0,49.43,220391.82
2024-03-01,2024-03-01,Invoice payment - Customer_0073,REF95125378,0.0,132.48,220524.3
2024-03-01,2024-03-01,Service payment - Customer_0079,REF48648340,0.0,86.54,220610.84
2024-03-01,2024-03-01,Invoice payment - Customer_0037,REF57740503,0.0,121.37,220732.21
2024-03-01,2024-03-01,Project payment - Customer_0007,REF30537727,0.0,155.6,220887.81
2024-03-01,2024-03-01,Service payment - Customer_0032,REF90023869,0.0,70.93,220958.74
2024-03-01,2024-03-01,Service payment - Customer_0018,REF60852113,0.0,78.49,221037.23
2024-03-01,2024-03-01,Project payment - Customer_0027,REF24377181,0.0,115.0,221152.23
2024-03-01,2024-03-01,Invoice payment - Customer_0067,REF24259006,0.0,118.32,221270.55
2024-03-01,2024-03-01,Project payment - Customer_0065,REF15188119,0.0,55.06,221325.61
2024-03-01,2024-03-01,Invoice payment - Customer_0020,REF95366613,0.0,90.95,221416.56
2024-03-01,2024-03-01,Monthly office rent,REF26951374,1163.49,0.0,220253.07
2024-03-01,2024-03-01,Inventory purchase,REF33119956,3049.47,0.0,217203.6
2024-03-02,2024-03-02,Invoice payment - Customer_0054,REF61378728,0.0,78.31,217281.91
2024-03-02,2024-03-02,Payment from Customer_0085,REF74974148,0.0,113.01,217394.92
2024-03-02,2024-03-02,Project payment - Customer_0021,REF30563614,0.0,69.67,217464.59
2024-03-02,2024-03-02,Service payment - Customer_0039,REF88740017,0.0,159.75,217624.34
2024-03-02,2024-03-02,Invoice payment - Customer_0020,REF26142327,0.0,125.16,217749.5
2024-03-02,2024-03-02,Payment from Customer_0070,REF95217107,0.0,58.75,217808.25
2024-03-02,2024-03-02,Invoice payment - Customer_0014,REF90926471,0.0,78.86,217887.11
2024-03-02,2024-03-02,Invoice payment - Customer_0007,REF68132504,0.0,127.64,218014.75
2024-03-03,2024-03-03,Service payment - Customer_0087,REF37599106,0.0,85.04,218099.79
2024-03-03,2024-03-03,Payment from Customer_0054,REF91682306,0.0,72.97,218172.76
2024-03-03,2024-03-03,Project payment - Customer_0012,REF43015880,0.0,81.55,218254.31
2024-03-03,2024-03-03,Service payment - Customer_0075,REF88597028,0.0,108.65,218362.96
2024-03-03,2024-03-03,Payment from Customer_0031,REF78843726,0.0,94.04,218457.0
2024-03-03,2024-03-03,Invoice payment - Customer_0055,REF34602225,0.0,71.59,218528.59
2024-03-03,2024-03-03,Invoice payment - Customer_0048,REF28554707,0.0,92.02,218620.61
2024-03-03,2024-03-03,Invoice payment - Customer_0035,REF49945166,0.0,110.59,218731.2
2024-03-03,2024-03-03,Service payment - Customer_0017,REF51164861,0.0,71.73,218802.93
2024-03-03,2024-03-03,Project payment - Customer_0021,REF29256403,0.0,60.85,218863.78
2024-03-03,2024-03-03,Service payment - Customer_0018,REF58953224,0.0,86.07,218949.85
2024-03-04,2024-03-04,Service payment - Customer_0028,REF89557856,0.0,110.02,219059.87
2024-03-04,2024-03-04,Payment from Customer_0026,REF26602914,0.0,110.21,219170.08
2024-03-04,2024-03-04,Service payment - Customer_0013,REF66609710,0.0,80.84,219250.92
2024-03-04,2024-03-04,Service payment - Customer_0027,REF33336276,0.0,74.31,219325.23
2024-03-04,2024-03-04,Service payment - Customer_0083,REF41619851,0.0,73.13,219398.36
2024-03-04,2024-03-04,Project payment - Customer_0044,REF91670423,0.0,43.36,219441.72
2024-03-04,2024-03-04,Project payment - Customer_0094,REF98976212,0.0,98.35,219540.07
2024-03-04,2024-03-04,Invoice payment - Customer_0040,REF23408782,0.0,41.16,219581.23
2024-03-04,2024-03-04,Project payment - Customer_0021,REF67796654,0.0,54.45,219635.68
2024-03-04,2024-03-04,Payment from Customer_0075,REF79494031,0.0,138.88,219774.56
2024-03-04,2024-03-04,Service payment - Customer_0092,REF97694831,0.0,64.26,219838.82
2024-03-04,2024-03-04,Invoice payment - Customer_0060,REF45415861,0.0,89.87,219928.69
2024-03-04,2024-03-04,Service payment - Customer_0042,REF31632932,0.0,88.89,220017.58
2024-03-04,2024-03-04,Service payment - Customer_0089,REF57517041,0.0,138.96,220156.54
2024-03-05,2024-03-05,Invoice payment - Customer_0063,REF67704758,0.0,63.4,220219.94
2024-03-05,2024-03-05,Project payment - Customer_0049,REF55483571,0.0,92.69,220312.63
2024-03-05,2024-03-05,Project payment - Customer_0010,REF32072887,0.0,70.49,220383.12
2024-03-05,2024-03-05,Payment from Customer_0002,REF42790444,0.0,99.68,220482.8
2024-03-05,2024-03-05,Payment from Customer_0052,REF36099418,0.0,45.33,220528.13
2024-03-05,2024-03-05,Service payment - Customer_0012,REF72841627,0.0,94.66,220622.79
2024-03-05,2024-03-05,Inventory purchase,REF79456692,2318.72,0.0,218304.07
2024-03-06,2024-03-06,Project payment - Customer_0018,REF85124998,0.0,73.79,218377.86
2024-03-06,2024-03-06,Service payment - Customer_0044,REF97184618,0.0,28.01,218405.87
2024-03-06,2024-03-06,Invoice payment - Customer_0086,REF45657102,0.0,46.3,218452.17
2024-03-06,2024-03-06,Invoice payment - Customer_0085,REF61960630,0.0,120.31,218572.48
2024-03-06,2024-03-06,Invoice payment - Customer_0067,REF96786291,0.0,109.14,218681.62
2024-03-06,2024-03-06,Payment from Customer_0061,REF66244711,0.0,122.58,218804.2
2024-03-06,2024-03-06,Invoice payment - Customer_0027,REF63213066,0.0,97.64,218901.84
2024-03-06,2024-03-06,Payment from Customer_0002,REF85847030,0.0,76.64,218978.48
2024-03-06,2024-03-06,Payment from Customer_0063,REF41040241,0.0,58.64,219037.12
2024-03-07,2024-03-07,Service payment - Customer_0084,REF63931908,0.0,77.11,219114.23
2024-03-07,2024-03-07,Payment from Customer_0022,REF80612833,0.0,86.37,219200.6
2024-03-07,2024-03-07,Service payment - Customer_0092,REF62082130,0.0,61.37,219261.97
2024-03-07,2024-03-07,Invoice payment - Customer_0089,REF23044865,0.0,124.6,219386.57
2024-03-07,2024-03-07,Payment from Customer_0046,REF83516112,0.0,137.73,219524.3
2024-03-07,2024-03-07,Payment from Customer_0053,REF88256089,0.0,105.78,219630.08
2024-03-07,2024-03-07,Service payment - Customer_0047,REF23716863,0.0,114.5,219744.58
2024-03-07,2024-03-07,Project payment - Customer_0037,REF48401067,0.0,178.04,219922.62
2024-03-07,2024-03-07,Service payment - Customer_0073,REF27411797,0.0,120.25,220042.87
2024-03-07,2024-03-07,Service payment - Customer_0055,REF88057060,0.0,45.28,220088.15
2024-03-07,2024-03-07,Project payment - Customer_0090,REF88708174,0.0,111.82,220199.97
2024-03-07,2024-03-07,Service payment - Customer_0061,REF82434425,0.0,98.43,220298.4
2024-03-07,2024-03-07,Project payment - Customer_0083,REF44204567,0.0,75.53,220373.93
2024-03-07,2024-03-07,Invoice payment - Customer_0077,REF74155248,0.0,105.85,220479.78
2024-03-07,2024-03-07,Payment from Customer_0070,REF36575788,0.0,48.0,220527.78
2024-03-08,2024-03-08,Invoice payment - Customer_0047,REF91586148,0.0,97.38,220625.16
2024-03-08,2024-03-08,Invoice payment - Customer_0058,REF76355299,0.0,33.29,220658.45
2024-03-08,2024-03-08,Project payment - Customer_0035,REF17706259,0.0,121.54,220779.99
2024-03-08,2024-03-08,Payment from Customer_0086,REF43964932,0.0,88.24,220868.23
2024-03-08,2024-03-08,Payment from Customer_0054,REF61825035,0.0,82.28,220950.51
2024-03-08,2024-03-08,Payment from Customer_0053,REF47644719,0.0,150.27,221100.78
2024-03-08,2024-03-08,Inventory purchase,REF17405401,3365.12,0.0,217735.66
2024-03-08,2024-03-08,Invoice payment - Customer_0027,REF62121505,0.0,84.56,217820.22
2024-03-08,2024-03-08,Invoice payment - Customer_0038,REF43102625,0.0,66.92,217887.14
2024-03-08,2024-03-08,Project payment - Customer_0033,REF31820751,0.0,72.09,217959.23
2024-03-08,2024-03-08,Payment from Customer_0031,REF36399266,0.0,99.9,218059.13
2024-03-08,2024-03-08,Service payment - Customer_0017,REF35464022,0.0,73.86,218132.99
2024-03-08,2024-03-08,Service payment - Customer_0022,REF79602702,0.0,85.06,218218.05
2024-03-09,2024-03-09,Payment from Customer_0009,REF90413016,0.0,90.68,218308.73
2024-03-09,2024-03-09,Service payment - Customer_0072,REF54411375,0.0,142.28,218451.01
2024-03-09,2024-03-09,Project payment - Customer_0079,REF90352312,0.0,84.69,218535.7
2024-03-09,2024-03-09,Invoice payment - Customer_0057,REF96983923,0.0,121.73,218657.43
2024-03-09,2024-03-09,Service payment - Customer_0020,REF40624424,0.0,155.87,218813.3
2024-03-09,2024-03-09,Project payment - Customer_0001,REF24530337,0.0,87.08,218900.38
2024-03-10,2024-03-10,Employee payroll,REF79147618,3540.94,0.0,215359.44
2024-03-10,2024-03-10,Professional Services expense,REF47905026,156.39,0.0,215203.05
2024-03-10,2024-03-10,Project payment - Customer_0021,REF86579541,0.0,63.53,215266.58
2024-03-10,2024-03-10,Project payment - Customer_0060,REF47431426,0.0,95.59,215362.17
2024-03-10,2024-03-10,Service payment - Customer_0079,REF84378195,0.0,85.41,215447.58
2024-03-10,2024-03-10,Payment from Customer_0080,REF38387933,0.0,38.17,215485.75
2024-03-10,2024-03-10,Payment from Customer_0077,REF47008361,0.0,86.56,215572.31
2024-03-10,2024-03-10,Payment from Customer_0015,REF91900219,0.0,93.03,215665.34
2024-03-10,2024-03-10,Service payment - Customer_0072,REF91912721,0.0,126.46,215791.8
2024-03-11,2024-03-11,Project payment - Customer_0050,REF82057316,0.0,138.91,215930.71
2024-03-11,2024-03-11,Service payment - Customer_0049,REF14642836,0.0,90.2,216020.91
2024-03-11,2024-03-11,Project payment - Customer_0033,REF26072830,0.0,75.78,216096.69
2024-03-11,2024-03-11,Payment from Customer_0008,REF59395567,0.0,78.95,216175.64
2024-03-11,2024-03-11,Payment from Customer_0091,REF20352313,0.0,142.67,216318.31
2024-03-11,2024-03-11,Payment from Customer_0005,REF43836476,0.0,41.95,216360.26
2024-03-11,2024-03-11,Payment from Customer_0073,REF90698342,0.0,151.4,216511.66
2024-03-12,2024-03-12,Invoice payment - Customer_0064,REF24411707,0.0,42.89,216554.55
2024-03-12,2024-03-12,Invoice payment - Customer_0001,REF30640739,0.0,79.88,216634.43
2024-03-12,2024-03-12,Project payment - Customer_0028,REF53531192,0.0,80.91,216715.34
2024-03-12,2024-03-12,Invoice payment - Customer_0062,REF73913880,0.0,77.28,216792.62
2024-03-12,2024-03-12,Project payment - Customer_0080,REF14965424,0.0,38.82,216831.44
2024-03-12,2024-03-12,Invoice payment - Customer_0071,REF55654736,0.0,42.47,216873.91
2024-03-12,2024-03-12,Payment from Customer_0077,REF55826691,0.0,93.12,216967.03
2024-03-12,2024-03-12,Invoice payment - Customer_0040,REF28415592,0.0,36.36,217003.39
2024-03-12,2024-03-12,Invoice payment - Customer_0045,REF40599952,0.0,85.49,217088.88
2024-03-12,2024-03-12,Service payment - Customer_0023,REF63694180,0.0,121.29,217210.17
2024-03-12,2024-03-12,Project payment - Customer_0075,REF39996701,0.0,132.98,217343.15
2024-03-13,2024-03-13,Invoice payment - Customer_0010,REF11579911,0.0,108.03,217451.18
2024-03-13,2024-03-13,Payment from Customer_0081,REF52968800,0.0,88.59,217539.77
2024-03-13,2024-03-13,Project payment - Customer_0079,REF80476152,0.0,62.75,217602.52
2024-03-13,2024-03-13,Project payment - Customer_0068,REF41437776,0.0,43.78,217646.3
2024-03-13,2024-03-13,Service payment - Customer_0063,REF48748579,0.0,74.83,217721.13
2024-03-13,2024-03-13,Invoice payment - Customer_0047,REF32555433,0.0,108.86,217829.99
2024-03-13,2024-03-13,Project payment - Customer_0041,REF94048749,0.0,135.0,217964.99
2024-03-13,2024-03-13,Project payment - Customer_0074,REF75352356,0.0,55.28,218020.27
2024-03-14,2024-03-14,Invoice payment - Customer_0050,REF33669460,0.0,181.97,218202.24
2024-03-14,2024-03-14,Service payment - Customer_0058,REF61637173,0.0,37.26,218239.5
2024-03-14,2024-03-14,Service payment - Customer_0066,REF49199841,0.0,61.41,218300.91
2024-03-14,2024-03-14,Service payment - Customer_0051,REF94305998,0.0,87.11,218388.02
2024-03-14,2024-03-14,Invoice payment - Customer_0005,REF83705715,0.0,31.17,218419.19
2024-03-14,2024-03-14,Project payment - Customer_0091,REF52993937,0.0,179.25,218598.44
2024-03-15,2024-03-15,Invoice payment - Customer_0079,REF75453788,0.0,80.85,218679.29
2024-03-15,2024-03-15,Service payment - Customer_0042,REF89269001,0.0,87.45,218766.74
2024-03-15,2024-03-15,Invoice payment - Customer_0061,REF42819973,0.0,141.12,218907.86
2024-03-15,2024-03-15,Business insurance premium,REF90978084,169.66,0.0,218738.2
2024-03-15,2024-03-15,Project payment - Customer_0073,REF45869632,0.0,92.0,218830.2
2024-03-15,2024-03-15,Service payment - Customer_0092,REF17629172,0.0,73.6,218903.8
2024-03-15,2024-03-15,Project payment - Customer_0033,REF74408026,0.0,80.61,218984.41
2024-03-15,2024-03-15,Payment from Customer_0044,REF86320550,0.0,38.62,219023.03
2024-03-15,2024-03-15,Payment from Customer_0072,REF61410938,0.0,116.14,219139.17
2024-03-15,2024-03-15,Service payment - Customer_0034,REF58755910,0.0,86.72,219225.89
2024-03-16,2024-03-16,Service payment - Customer_0029,REF68048910,0.0,79.82,219305.71
2024-03-16,2024-03-16,Invoice payment - Customer_0048,REF28495109,0.0,94.16,219399.87
2024-03-16,2024-03-16,Payment from Customer_0095,REF94754187,0.0,72.08,219471.95
2024-03-16,2024-03-16,Pos Systems expense,REF30611080,65.1,0.0,219406.85
2024-03-16,2024-03-16,Project payment - Customer_0087,REF61132276,0.0,103.62,219510.47
2024-03-16,2024-03-16,Invoice payment - Customer_0037,REF41272353,0.0,152.54,219663.01
2024-03-16,2024-03-16,Invoice payment - Customer_0052,REF68166919,0.0,46.53,219709.54
2024-03-16,2024-03-16,Packaging Shipping expense,REF99891903,227.7,0.0,219481.84
2024-03-16,2024-03-16,Service payment - Customer_0051,REF43694582,0.0,82.04,219563.88
2024-03-17,2024-03-17,Project payment - Customer_0010,REF82903019,0.0,99.32,219663.2
2024-03-17,2024-03-17,Invoice payment - Customer_0011,REF49084947,0.0,128.88,219792.08
2024-03-17,2024-03-17,Service payment - Customer_0036,REF63904013,0.0,50.7,219842.78
2024-03-17,2024-03-17,Invoice payment - Customer_0028,REF51677030,0.0,110.6,219953.38
2024-03-17,2024-03-17,Project payment - Customer_0081,REF80517764,0.0,79.52,220032.9
2024-03-17,2024-03-17,Service payment - Customer_0024,REF16970586,0.0,89.21,220122.11
2024-03-17,2024-03-17,Payment from Customer_0084,REF27766719,0.0,89.16,220211.27
2024-03-17,2024-03-17,Project payment - Customer_0070,REF26695781,0.0,58.16,220269.43
2024-03-17,2024-03-17,Project payment - Customer_0013,REF53210055,0.0,79.22,220348.65
2024-03-17,2024-03-17,Invoice payment - Customer_0007,REF40492148,0.0,149.96,220498.61
2024-03-17,2024-03-17,Service payment - Customer_0091,REF92302782,0.0,144.47,220643.08
2024-03-18,2024-03-18,Service payment - Customer_0058,REF58699762,0.0,52.96,220696.04
2024-03-18,2024-03-18,Project payment - Customer_0091,REF18374367,0.0,117.99,220814.03
2024-03-18,2024-03-18,Payment from Customer_0090,REF65014882,0.0,75.11,220889.14
2024-03-18,2024-03-18,Service payment - Customer_0071,REF66422816,0.0,50.55,220939.69
2024-03-18,2024-03-18,Invoice payment - Customer_0045,REF36019971,0.0,92.48,221032.17
2024-03-18,2024-03-18,Payment from Customer_0070,REF57504710,0.0,60.51,221092.68
2024-03-19,2024-03-19,Invoice payment - Customer_0047,REF53550746,0.0,122.22,221214.9
2024-03-19,2024-03-19,Service payment - Customer_0013,REF55321975,0.0,60.44,221275.34
2024-03-19,2024-03-19,Invoice payment - Customer_0004,REF12795717,0.0,55.69,221331.03
2024-03-19,2024-03-19,Project payment - Customer_0028,REF81473872,0.0,98.43,221429.46
2024-03-19,2024-03-19,Service payment - Customer_0057,REF93916848,0.0,112.29,221541.75
2024-03-20,2024-03-20,Payment from Customer_0093,REF42577849,0.0,127.41,221669.16
2024-03-20,2024-03-20,Project payment - Customer_0018,REF83098253,0.0,89.12,221758.28
2024-03-20,2024-03-20,Project payment - Customer_0006,REF99153512,0.0,81.6,221839.88
2024-03-20,2024-03-20,Invoice payment - Customer_0047,REF59595282,0.0,102.3,221942.18
2024-03-20,2024-03-20,Project payment - Customer_0065,REF96197770,0.0,48.63,221990.81
2024-03-20,2024-03-20,Service payment - Customer_0044,REF83741647,0.0,38.42,222029.23
2024-03-20,2024-03-20,Service payment - Customer_0068,REF71542653,0.0,40.96,222070.19
2024-03-20,2024-03-20,Project payment - Customer_0098,REF40966874,0.0,74.26,222144.45
2024-03-20,2024-03-20,Invoice payment - Customer_0001,REF55232352,0.0,58.21,222202.66
2024-03-20,2024-03-20,Service payment - Customer_0071,REF64050315,0.0,29.33,222231.99
2024-03-20,2024-03-20,Pos Systems expense,REF44156543,94.93,0.0,222137.06
2024-03-21,2024-03-21,Invoice payment - Customer_0022,REF33822038,0.0,74.4,222211.46
2024-03-21,2024-03-21,Payment from Customer_0011,REF35637393,0.0,124.0,222335.46
2024-03-21,2024-03-21,Payment from Customer_0019,REF10203313,0.0,92.11,222427.57
2024-03-21,2024-03-21,Project payment - Customer_0018,REF75251013,0.0,60.09,222487.66
2024-03-22,2024-03-22,Project payment - Customer_0015,REF20779612,0.0,124.3,222611.96
2024-03-22,2024-03-22,Payment from Customer_0081,REF24221657,0.0,105.55,222717.51
2024-03-22,2024-03-22,Service payment - Customer_0061,REF38317856,0.0,109.9,222827.41
2024-03-22,2024-03-22,Payment from Customer_0043,REF13578881,0.0,119.0,222946.41
2024-03-22,2024-03-22,Utility bill payment,REF46240017,132.45,0.0,222813.96
2024-03-22,2024-03-22,Invoice payment - Customer_0035,REF56066619,0.0,117.22,222931.18
2024-03-22,2024-03-22,Invoice payment - Customer_0006,REF40877253,0.0,84.83,223016.01
2024-03-22,2024-03-22,Payment from Customer_0034,REF28773239,0.0,65.55,223081.56
2024-03-22,2024-03-22,Payment from Customer_0027,REF16936092,0.0,100.48,223182.04
2024-03-22,2024-03-22,Project payment - Customer_0003,REF53560979,0.0,72.14,223254.18
2024-03-22,2024-03-22,Project payment - Customer_0047,REF31524878,0.0,110.15,223364.33
2024-03-22,2024-03-22,Payment from Customer_0083,REF93535753,0.0,57.13,223421.46
2024-03-22,2024-03-22,Payment from Customer_0062,REF32333375,0.0,74.55,223496.01
2024-03-22,2024-03-22,Project payment - Customer_0012,REF73723418,0.0,64.2,223560.21
2024-03-22,2024-03-22,Project payment - Customer_0057,REF68694956,0.0,115.26,223675.47
2024-03-22,2024-03-22,Payment from Customer_0040,REF18984898,0.0,33.7,223709.17
2024-03-23,2024-03-23,Employee payroll,REF95730845,2241.95,0.0,221467.22
2024-03-23,2024-03-23,Project payment - Customer_0072,REF15199136,0.0,129.94,221597.16
2024-03-23,2024-03-23,Payment from Customer_0015,REF74363495,0.0,107.05,221704.21
2024-03-23,2024-03-23,Invoice payment - Customer_0046,REF60147531,0.0,114.42,221818.63
2024-03-23,2024-03-23,Invoice payment - Customer_0005,REF45437222,0.0,35.91,221854.54
2024-03-23,2024-03-23,Invoice payment - Customer_0075,REF32957843,0.0,128.43,221982.97
2024-03-24,2024-03-24,Project payment - Customer_0087,REF98775271,0.0,71.4,222054.37
2024-03-24,2024-03-24,Invoice payment - Customer_0004,REF23342314,0.0,51.42,222105.79
2024-03-24,2024-03-24,Service payment - Customer_0002,REF45639761,0.0,92.76,222198.55
2024-03-24,2024-03-24,Project payment - Customer_0037,REF75362406,0.0,169.6,222368.15
2024-03-24,2024-03-24,Project payment - Customer_0062,REF94744773,0.0,61.35,222429.5
2024-03-24,2024-03-24,Project payment - Customer_0093,REF22338940,0.0,83.68,222513.18
2024-03-24,2024-03-24,Project payment - Customer_0034,REF53674339,0.0,114.22,222627.4
2024-03-24,2024-03-24,Project payment - Customer_0016,REF87345188,0.0,28.46,222655.86
2024-03-24,2024-03-24,Payment from Customer_0042,REF28632511,0.0,94.95,222750.81
2024-03-25,2024-03-25,Invoice payment - Customer_0005,REF81714915,0.0,27.16,222777.97
2024-03-25,2024-03-25,Project payment - Customer_0061,REF99181062,0.0,127.19,222905.16
2024-03-25,2024-03-25,Payment from Customer_0055,REF77686953,0.0,63.21,222968.37
2024-03-25,2024-03-25,Service payment - Customer_0071,REF89197339,0.0,42.62,223010.99
2024-03-25,2024-03-25,Invoice payment - Customer_0067,REF27951466,0.0,119.76,223130.75
2024-03-25,2024-03-25,Payment from Customer_0045,REF41584872,0.0,106.63,223237.38
2024-03-26,2024-03-26,Invoice payment - Customer_0012,REF37378151,0.0,59.27,223296.65
2024-03-26,2024-03-26,Payment from Customer_0075,REF35504291,0.0,97.68,223394.33
2024-03-26,2024-03-26,Service payment - Customer_0024,REF31407654,0.0,58.86,223453.19
2024-03-26,2024-03-26,Payment from Customer_0085,REF13154728,0.0,89.39,223542.58
2024-03-26,2024-03-26,Invoice payment - Customer_0074,REF82407170,0.0,51.23,223593.81
2024-03-26,2024-03-26,Service payment - Customer_0027,REF23630887,0.0,94.72,223688.53
2024-03-26,2024-03-26,Project payment - Customer_0049,REF33383775,0.0,117.37,223805.9
2024-03-26,2024-03-26,Invoice payment - Customer_0014,REF65909906,0.0,102.7,223908.6
2024-03-26,2024-03-26,Invoice payment - Customer_0071,REF95033527,0.0,37.49,223946.09
2024-03-27,2024-03-27,Service payment - Customer_0085,REF84331120,0.0,89.39,224035.48
2024-03-27,2024-03-27,Project payment - Customer_0018,REF38763355,0.0,52.89,224088.37
2024-03-27,2024-03-27,Service payment - Customer_0096,REF42897567,0.0,94.73,224183.1
2024-03-27,2024-03-27,Project payment - Customer_0073,REF87353425,0.0,141.38,224324.48
2024-03-27,2024-03-27,Service payment - Customer_0093,REF47047868,0.0,110.05,224434.53
2024-03-27,2024-03-27,Project payment - Customer_0080,REF60661299,0.0,27.98,224462.51
2024-03-27,2024-03-27,Service payment - Customer_0036,REF50906023,0.0,50.6,224513.11
2024-03-27,2024-03-27,Invoice payment - Customer_0016,REF34735228,0.0,27.27,224540.38
2024-03-28,2024-03-28,Invoice payment - Customer_0078,REF95944087,0.0,110.35,224650.73
2024-03-28,2024-03-28,Service payment - Customer_0064,REF63555795,0.0,37.51,224688.24
2024-03-28,2024-03-28,Payment from Customer_0008,REF63953897,0.0,99.66,224787.9
2024-03-28,2024-03-28,Service payment - Customer_0027,REF10201260,0.0,79.35,224867.25
2024-03-29,2024-03-29,Payment from Customer_0046,REF56094211,0.0,128.14,224995.39
2024-03-29,2024-03-29,Payment from Customer_0052,REF13765982,0.0,46.56,225041.95
2024-03-29,2024-03-29,Invoice payment - Customer_0000,REF85309956,0.0,41.8,225083.75
2024-03-29,2024-03-29,Invoice payment - Customer_0024,REF92249730,0.0,84.45,225168.2
2024-03-29,2024-03-29,Payment from Customer_0003,REF54127911,0.0,75.01,225243.21
2024-03-29,2024-03-29,Project payment - Customer_0097,REF82337505,0.0,51.85,225295.06
2024-03-30,2024-03-30,Invoice payment - Customer_0058,REF95485440,0.0,42.15,225337.21
2024-03-30,2024-03-30,Project payment - Customer_0010,REF52620235,0.0,102.71,225439.92
2024-03-30,2024-03-30,Payment from Customer_0075,REF91073210,0.0,119.78,225559.7
2024-03-30,2024-03-30,Project payment - Customer_0084,REF17748448,0.0,89.09,225648.79
2024-03-30,2024-03-30,Invoice payment - Customer_0007,REF27067780,0.0,120.26,225769.05
2024-03-30,2024-03-30,Service payment - Customer_0068,REF96004436,0.0,46.19,225815.24
2024-03-30,2024-03-30,Project payment - Customer_0004,REF73576476,0.0,50.7,225865.94
2024-03-30,2024-03-30,Project payment - Customer_0073,REF67278865,0.0,111.76,225977.7
2024-03-30,2024-03-30,Marketing expenses,REF70295029,306.32,0.0,225671.38
2024-03-30,2024-03-30,Invoice payment - Customer_0039,REF37929661,0.0,121.79,225793.17
2024-03-30,2024-03-30,Service payment - Customer_0045,REF32194383,0.0,86.22,225879.39
2024-03-30,2024-03-30,Invoice payment - Customer_0060,REF88446827,0.0,100.62,225980.01
2024-03-30,2024-03-30,Payment from Customer_0082,REF42051016,0.0,153.36,226133.37
2024-03-30,2024-03-30,Payment from Customer_0053,REF76934353,0.0,156.85,226290.22
2024-03-31,2024-03-31,Payment from Customer_0036,REF59942446,0.0,51.06,226341.28
2024-03-31,2024-03-31,Service payment - Customer_0035,REF24570943,0.0,144.87,226486.15
2024-03-31,2024-03-31,Payment from Customer_0029,REF11446959,0.0,87.38,226573.53
2024-03-31,2024-03-31,Project payment - Customer_0011,REF25907761,0.0,98.12,226671.65
2024-03-31,2024-03-31,Payment from Customer_0067,REF30109293,0.0,165.16,226836.81
2024-03-31,2024-03-31,Service payment - Customer_0088,REF63824352,0.0,130.77,226967.58
2024-03-31,2024-03-31,Project payment - Customer_0032,REF68088250,0.0,80.53,227048.11
2024-03-31,2024-03-31,Project payment - Customer_0031,REF30962487,0.0,119.48,227167.59
2024-03-31,2024-03-31,Payment from Customer_0010,REF33751059,0.0,112.39,227279.98
2024-04-01,2024-04-01,Monthly office rent,REF65976480,1185.03,0.0,226094.95
2024-04-01,2024-04-01,Service payment - Customer_0059,REF19283745,0.0,80.45,226175.4
2024-04-01,2024-04-01,Invoice payment - Customer_0073,REF48350368,0.0,112.06,226287.46
2024-04-01,2024-04-01,Project payment - Customer_0041,REF53680766,0.0,183.09,226470.55
2024-04-01,2024-04-01,Invoice payment - Customer_0053,REF26231257,0.0,137.24,226607.79
2024-04-01,2024-04-01,Service payment - Customer_0054,REF32639492,0.0,60.25,226668.04
2024-04-01,2024-04-01,Project payment - Customer_0012,REF38073888,0.0,59.66,226727.7
2024-04-01,2024-04-01,Service payment - Customer_0052,REF53436724,0.0,32.37,226760.07
2024-04-01,2024-04-01,Service payment - Customer_0068,REF50857259,0.0,43.68,226803.75
2024-04-02,2024-04-02,Invoice payment - Customer_0085,REF11596035,0.0,106.12,226909.87
2024-04-02,2024-04-02,Service payment - Customer_0071,REF27790602,0.0,52.26,226962.13
2024-04-02,2024-04-02,Service payment - Customer_0020,REF12260080,0.0,142.49,227104.62
2024-04-02,2024-04-02,Payment from Customer_0072,REF30905517,0.0,153.03,227257.65
2024-04-02,2024-04-02,Invoice payment - Customer_0003,REF25479613,0.0,96.13,227353.78
2024-04-02,2024-04-02,Service payment - Customer_0053,REF71166008,0.0,154.82,227508.6
2024-04-02,2024-04-02,Invoice payment - Customer_0014,REF10099667,0.0,96.13,227604.73
2024-04-03,2024-04-03,Service payment - Customer_0083,REF54583620,0.0,65.25,227669.98
2024-04-03,2024-04-03,Service payment - Customer_0077,REF60099929,0.0,107.35,227777.33
2024-04-03,2024-04-03,Project payment - Customer_0026,REF90194961,0.0,97.88,227875.21
2024-04-03,2024-04-03,Invoice payment - Customer_0049,REF10715971,0.0,84.86,227960.07
2024-04-03,2024-04-03,Project payment - Customer_0004,REF74091225,0.0,49.96,228010.03
2024-04-03,2024-04-03,Invoice payment - Customer_0078,REF51665844,0.0,128.68,228138.71
2024-04-03,2024-04-03,Project payment - Customer_0010,REF89192879,0.0,91.31,228230.02
2024-04-03,2024-04-03,Project payment - Customer_0044,REF73003322,0.0,45.56,228275.58
2024-04-03,2024-04-03,Invoice payment - Customer_0053,REF51239685,0.0,111.54,228387.12
2024-04-04,2024-04-04,Project payment - Customer_0084,REF81359286,0.0,66.81,228453.93
2024-04-04,2024-04-04,Payment from Customer_0037,REF58520887,0.0,136.33,228590.26
2024-04-04,2024-04-04,Service payment - Customer_0014,REF77650999,0.0,78.12,228668.38
2024-04-04,2024-04-04,Service payment - Customer_0044,REF87239300,0.0,41.68,228710.06
2024-04-04,2024-04-04,Invoice payment - Customer_0004,REF45230566,0.0,56.71,228766.77
2024-04-04,2024-04-04,Payment from Customer_0042,REF81491867,0.0,128.37,228895.14
2024-04-04,2024-04-04,Invoice payment - Customer_0098,REF39304226,0.0,72.46,228967.6
2024-04-04,2024-04-04,Service payment - Customer_0086,REF15942042,0.0,62.78,229030.38
2024-04-05,2024-04-05,Project payment - Customer_0082,REF81783865,0.0,162.24,229192.62
2024-04-05,2024-04-05,Invoice payment - Customer_0037,REF93698929,0.0,147.53,229340.15
2024-04-05,2024-04-05,Employee payroll,REF77086811,2661.42,0.0,226678.73
2024-04-05,2024-04-05,Project payment - Customer_0095,REF69325452,0.0,75.4,226754.13
2024-04-05,2024-04-05,Project payment - Customer_0092,REF75449196,0.0,60.01,226814.14
2024-04-05,2024-04-05,Invoice payment - Customer_0058,REF95302138,0.0,47.17,226861.31
2024-04-05,2024-04-05,Payment from Customer_0047,REF87184311,0.0,101.58,226962.89
2024-04-06,2024-04-06,Invoice payment - Customer_0070,REF68522367,0.0,48.3,227011.19
2024-04-06,2024-04-06,Service payment - Customer_0087,REF66520686,0.0,82.94,227094.13
2024-04-06,2024-04-06,Payment from Customer_0083,REF66299790,0.0,72.07,227166.2
2024-04-06,2024-04-06,Project payment - Customer_0013,REF57882010,0.0,70.13,227236.33
2024-04-07,2024-04-07,Project payment - Customer_0055,REF50181099,0.0,64.81,227301.14
2024-04-07,2024-04-07,Project payment - Customer_0094,REF34435430,0.0,80.5,227381.64
2024-04-07,2024-04-07,Payment from Customer_0058,REF68593538,0.0,49.8,227431.44
2024-04-07,2024-04-07,Project payment - Customer_0047,REF52574639,0.0,126.38,227557.82
2024-04-07,2024-04-07,Project payment - Customer_0002,REF71863609,0.0,93.16,227650.98
2024-04-07,2024-04-07,Payment from Customer_0068,REF74637406,0.0,38.69,227689.67
2024-04-07,2024-04-07,Payment from Customer_0061,REF38076455,0.0,126.42,227816.09
2024-04-07,2024-04-07,Service payment - Customer_0096,REF24812958,0.0,89.53,227905.62
2024-04-07,2024-04-07,Payment from Customer_0020,REF96075085,0.0,116.59,228022.21
2024-04-08,2024-04-08,Invoice payment - Customer_0006,REF24006210,0.0,63.04,228085.25
2024-04-08,2024-04-08,Payment from Customer_0037,REF58444052,0.0,144.23,228229.48
2024-04-08,2024-04-08,Service payment - Customer_0028,REF11007360,0.0,124.67,228354.15
2024-04-08,2024-04-08,Invoice payment - Customer_0082,REF82159379,0.0,138.2,228492.35
2024-04-08,2024-04-08,Project payment - Customer_0076,REF85563625,0.0,11.98,228504.33
2024-04-08,2024-04-08,Service payment - Customer_0002,REF68272271,0.0,55.69,228560.02
2024-04-08,2024-04-08,Service payment - Customer_0092,REF47556841,0.0,50.82,228610.84
2024-04-08,2024-04-08,Invoice payment - Customer_0068,REF65691708,0.0,67.99,228678.83
2024-04-08,2024-04-08,Service payment - Customer_0039,REF51462094,0.0,139.05,228817.88
2024-04-08,2024-04-08,Service payment - Customer_0003,REF57309711,0.0,78.41,228896.29
2024-04-09,2024-04-09,Service payment - Customer_0071,REF58614224,0.0,40.67,228936.96
2024-04-09,2024-04-09,Project payment - Customer_0004,REF45912743,0.0,51.52,228988.48
2024-04-09,2024-04-09,Payment from Customer_0027,REF92484609,0.0,81.78,229070.26
2024-04-09,2024-04-09,Payment from Customer_0081,REF87488870,0.0,77.31,229147.57
2024-04-09,2024-04-09,Payment from Customer_0008,REF60757555,0.0,103.71,229251.28
2024-04-09,2024-04-09,Payment from Customer_0094,REF30608889,0.0,82.41,229333.69
2024-04-09,2024-04-09,Payment from Customer_0051,REF32034521,0.0,69.4,229403.09
2024-04-09,2024-04-09,Project payment - Customer_0053,REF78553926,0.0,112.86,229515.95
2024-04-09,2024-04-09,Payment from Customer_0075,REF28233369,0.0,168.0,229683.95
2024-04-09,2024-04-09,Project payment - Customer_0090,REF68785850,0.0,98.54,229782.49
2024-04-10,2024-04-10,Service payment - Customer_0057,REF12819753,0.0,145.5,229927.99
2024-04-10,2024-04-10,Payment from Customer_0084,REF54009383,0.0,70.03,229998.02
2024-04-10,2024-04-10,Invoice payment - Customer_0018,REF88466609,0.0,84.48,230082.5
2024-04-10,2024-04-10,Project payment - Customer_0076,REF89633936,0.0,10.0,230092.5
2024-04-10,2024-04-10,Invoice payment - Customer_0073,REF33907412,0.0,121.24,230213.74
2024-04-10,2024-04-10,Invoice payment - Customer_0035,REF54471662,0.0,163.59,230377.33
2024-04-10,2024-04-10,Project payment - Customer_0019,REF37246551,0.0,79.18,230456.51
2024-04-10,2024-04-10,Invoice payment - Customer_0090,REF99982480,0.0,96.27,230552.78
2024-04-11,2024-04-11,Service payment - Customer_0058,REF41195180,0.0,63.41,230616.19
2024-04-11,2024-04-11,Invoice payment - Customer_0026,REF80863451,0.0,100.67,230716.86
2024-04-11,2024-04-11,Invoice payment - Customer_0094,REF19592011,0.0,74.98,230791.84
2024-04-11,2024-04-11,Service payment - Customer_0045,REF20205363,0.0,101.23,230893.07
2024-04-11,2024-04-11,Invoice payment - Customer_0077,REF10615294,0.0,135.37,231028.44
2024-04-11,2024-04-11,Project payment - Customer_0054,REF44666137,0.0,84.29,231112.73
2024-04-11,2024-04-11,Invoice payment - Customer_0028,REF28938919,0.0,111.12,231223.85
2024-04-11,2024-04-11,Project payment - Customer_0075,REF47171460,0.0,121.57,231345.42
2024-04-11,2024-04-11,Payment from Customer_0036,REF43934344,0.0,63.53,231408.95
2024-04-12,2024-04-12,Project payment - Customer_0076,REF39249945,0.0,10.21,231419.16
2024-04-12,2024-04-12,Invoice payment - Customer_0091,REF31638963,0.0,118.85,231538.01
2024-04-12,2024-04-12,Invoice payment - Customer_0063,REF73317584,0.0,82.4,231620.41
2024-04-12,2024-04-12,Invoice payment - Customer_0020,REF74932716,0.0,99.87,231720.28
2024-04-12,2024-04-12,Payment from Customer_0033,REF45278437,0.0,79.15,231799.43
2024-04-12,2024-04-12,Service payment - Customer_0080,REF78418164,0.0,38.55,231837.98
2024-04-12,2024-04-12,Invoice payment - Customer_0067,REF79312446,0.0,122.97,231960.95
2024-04-13,2024-04-13,Service payment - Customer_0090,REF16150455,0.0,90.21,232051.16
2024-04-13,2024-04-13,Invoice payment - Customer_0055,REF82839089,0.0,90.1,232141.26
2024-04-13,2024-04-13,Service payment - Customer_0080,REF49888210,0.0,36.49,232177.75
2024-04-13,2024-04-13,Service payment - Customer_0047,REF54523819,0.0,127.47,232305.22
2024-04-13,2024-04-13,Invoice payment - Customer_0092,REF36017532,0.0,74.94,232380.16
2024-04-13,2024-04-13,Project payment - Customer_0088,REF92154204,0.0,148.71,232528.87
2024-04-13,2024-04-13,Service payment - Customer_0094,REF83644441,0.0,82.08,232610.95
2024-04-13,2024-04-13,Project payment - Customer_0012,REF43604439,0.0,83.04,232693.99
2024-04-13,2024-04-13,Service payment - Customer_0032,REF16274179,0.0,69.86,232763.85
2024-04-14,2024-04-14,Payment from Customer_0088,REF97425166,0.0,157.06,232920.91
2024-04-14,2024-04-14,Payment from Customer_0071,REF70323500,0.0,45.26,232966.17
2024-04-14,2024-04-14,Project payment - Customer_0020,REF39071327,0.0,93.79,233059.96
2024-04-14,2024-04-14,Project payment - Customer_0017,REF96492800,0.0,81.71,233141.67
2024-04-14,2024-04-14,Project payment - Customer_0031,REF54167098,0.0,94.65,233236.32
2024-04-14,2024-04-14,Payment from Customer_0037,REF37287941,0.0,107.95,233344.27
2024-04-14,2024-04-14,Invoice payment - Customer_0052,REF47879096,0.0,33.49,233377.76
2024-04-14,2024-04-14,Payment from Customer_0024,REF97497819,0.0,100.91,233478.67
2024-04-15,2024-04-15,Service payment - Customer_0032,REF62093607,0.0,77.08,233555.75
2024-04-15,2024-04-15,Payment from Customer_0056,REF30547395,0.0,33.73,233589.48
2024-04-15,2024-04-15,Payment from Customer_0030,REF73932463,0.0,38.0,233627.48
2024-04-15,2024-04-15,Payment from Customer_0084,REF14042098,0.0,98.72,233726.2
2024-04-15,2024-04-15,Business insurance premium,REF98619766,165.8,0.0,233560.4
2024-04-15,2024-04-15,Project payment - Customer_0079,REF28473789,0.0,66.39,233626.79
2024-04-15,2024-04-15,Payment from Customer_0031,REF41942882,0.0,81.09,233707.88
2024-04-15,2024-04-15,Project payment - Customer_0049,REF91146899,0.0,122.49,233830.37
2024-04-15,2024-04-15,Project payment - Customer_0018,REF65999234,0.0,79.6,233909.97
2024-04-15,2024-04-15,Payment from Customer_0076,REF58765853,0.0,10.0,233919.97
2024-04-16,2024-04-16,Project payment - Customer_0041,REF47065962,0.0,136.04,234056.01
2024-04-16,2024-04-16,Project payment - Customer_0090,REF46156642,0.0,72.5,234128.51
2024-04-16,2024-04-16,Payment from Customer_0039,REF27290246,0.0,102.09,234230.6
2024-04-17,2024-04-17,Payment from Customer_0032,REF10192919,0.0,51.25,234281.85
2024-04-17,2024-04-17,Employee payroll,REF65553855,2468.71,0.0,231813.14
2024-04-17,2024-04-17,Inventory purchase,REF20470200,3373.78,0.0,228439.36
2024-04-17,2024-04-17,Invoice payment - Customer_0028,REF15549783,0.0,74.58,228513.94
2024-04-17,2024-04-17,Project payment - Customer_0041,REF19308559,0.0,176.35,228690.29
2024-04-17,2024-04-17,Service payment - Customer_0097,REF59905329,0.0,67.53,228757.82
2024-04-17,2024-04-17,Payment from Customer_0053,REF21627213,0.0,149.53,228907.35
2024-04-17,2024-04-17,Service payment - Customer_0045,REF28129776,0.0,92.25,228999.6
2024-04-17,2024-04-17,Project payment - Customer_0063,REF71506163,0.0,88.51,229088.11
2024-04-17,2024-04-17,Payment from Customer_0084,REF81600453,0.0,76.92,229165.03
2024-04-17,2024-04-17,Invoice payment - Customer_0016,REF24744097,0.0,31.58,229196.61
2024-04-17,2024-04-17,Service payment - Customer_0072,REF93556417,0.0,136.02,229332.63
2024-04-18,2024-04-18,Service payment - Customer_0042,REF39661063,0.0,100.7,229433.33
2024-04-18,2024-04-18,Invoice payment - Customer_0006,REF58030028,0.0,80.25,229513.58
2024-04-18,2024-04-18,Service payment - Customer_0031,REF44418681,0.0,114.87,229628.45
2024-04-18,2024-04-18,Invoice payment - Customer_0038,REF64152547,0.0,54.93,229683.38
2024-04-18,2024-04-18,Payment from Customer_0057,REF85528173,0.0,117.13,229800.51
2024-04-18,2024-04-18,Service payment - Customer_0002,REF43588979,0.0,71.98,229872.49
2024-04-18,2024-04-18,Project payment - Customer_0007,REF78131762,0.0,141.79,230014.28
2024-04-18,2024-04-18,Project payment - Customer_0015,REF82421312,0.0,112.22,230126.5
2024-04-18,2024-04-18,Payment from Customer_0080,REF27182426,0.0,43.41,230169.91
2024-04-18,2024-04-18,Payment from Customer_0044,REF86847749,0.0,25.35,230195.26
2024-04-18,2024-04-18,Service payment - Customer_0020,REF14116503,0.0,83.27,230278.53
2024-04-18,2024-04-18,Service payment - Customer_0060,REF50557647,0.0,99.63,230378.16
2024-04-18,2024-04-18,Invoice payment - Customer_0068,REF88970069,0.0,47.17,230425.33
2024-04-18,2024-04-18,Service payment - Customer_0087,REF64341042,0.0,88.93,230514.26
2024-04-18,2024-04-18,Payment from Customer_0046,REF55219705,0.0,128.44,230642.7
2024-04-18,2024-04-18,Service payment - Customer_0014,REF95599946,0.0,107.96,230750.66
2024-04-19,2024-04-19,Pos Systems expense,REF90220103,46.8,0.0,230703.86
2024-04-19,2024-04-19,Project payment - Customer_0024,REF30743853,0.0,78.07,230781.93
2024-04-19,2024-04-19,Payment from Customer_0062,REF54145633,0.0,64.16,230846.09
2024-04-19,2024-04-19,Invoice payment - Customer_0097,REF86999834,0.0,64.74,230910.83
2024-04-19,2024-04-19,Invoice payment - Customer_0059,REF22331809,0.0,74.65,230985.48
2024-04-19,2024-04-19,Service payment - Customer_0056,REF92553249,0.0,31.14,231016.62
2024-04-19,2024-04-19,Invoice payment - Customer_0063,REF20011036,0.0,72.46,231089.08
2024-04-19,2024-04-19,Invoice payment - Customer_0096,REF45724798,0.0,101.09,231190.17
2024-04-19,2024-04-19,Project payment - Customer_0009,REF91805854,0.0,68.97,231259.14
2024-04-19,2024-04-19,Project payment - Customer_0025,REF23251390,0.0,87.14,231346.28
2024-04-19,2024-04-19,Inventory purchase,REF56343293,3342.32,0.0,228003.96
2024-04-19,2024-04-19,Project payment - Customer_0057,REF97059820,0.0,115.33,228119.29
2024-04-19,2024-04-19,Service payment - Customer_0060,REF92998571,0.0,109.74,228229.03
2024-04-19,2024-04-19,Project payment - Customer_0085,REF70544948,0.0,93.66,228322.69
2024-04-20,2024-04-20,Payment from Customer_0025,REF28883472,0.0,113.05,228435.74
2024-04-20,2024-04-20,Project payment - Customer_0078,REF54871536,0.0,136.07,228571.81
2024-04-20,2024-04-20,Project payment - Customer_0004,REF73156863,0.0,48.35,228620.16
2024-04-20,2024-04-20,Invoice payment - Customer_0011,REF21059787,0.0,88.36,228708.52
2024-04-20,2024-04-20,Payment from Customer_0050,REF97148748,0.0,138.48,228847.0
2024-04-21,2024-04-21,Project payment - Customer_0012,REF78300987,0.0,66.27,228913.27
2024-04-21,2024-04-21,Project payment - Customer_0000,REF21286840,0.0,46.21,228959.48
2024-04-21,2024-04-21,Service payment - Customer_0063,REF10568429,0.0,56.22,229015.7
2024-04-21,2024-04-21,Project payment - Customer_0035,REF20116938,0.0,110.87,229126.57
2024-04-21,2024-04-21,Invoice payment - Customer_0027,REF34683163,0.0,87.26,229213.83
2024-04-21,2024-04-21,Service payment - Customer_0025,REF32403055,0.0,141.85,229355.68
2024-04-21,2024-04-21,Invoice payment - Customer_0084,REF49706019,0.0,68.96,229424.64
2024-04-21,2024-04-21,Service payment - Customer_0030,REF75405651,0.0,36.51,229461.15
2024-04-21,2024-04-21,Project payment - Customer_0018,REF44464472,0.0,68.8,229529.95
2024-04-21,2024-04-21,Service payment - Customer_0041,REF30469385,0.0,113.09,229643.04
2024-04-22,2024-04-22,Project payment - Customer_0082,REF40292494,0.0,143.51,229786.55
2024-04-22,2024-04-22,Project payment - Customer_0057,REF19685993,0.0,132.66,229919.21
2024-04-22,2024-04-22,Service payment - Customer_0020,REF33021144,0.0,121.42,230040.63
2024-04-22,2024-04-22,Invoice payment - Customer_0073,REF74162910,0.0,113.27,230153.9
2024-04-22,2024-04-22,Project payment - Customer_0024,REF42284462,0.0,101.7,230255.6
2024-04-22,2024-04-22,Invoice payment - Customer_0072,REF88955657,0.0,126.04,230381.64
2024-04-22,2024-04-22,Utility bill payment,REF57026732,151.07,0.0,230230.57
2024-04-22,2024-04-22,Service payment - Customer_0058,REF81144282,0.0,38.76,230269.33
2024-04-23,2024-04-23,Invoice payment - Customer_0058,REF18005975,0.0,37.54,230306.87
2024-04-23,2024-04-23,Service payment - Customer_0067,REF31219542,0.0,119.39,230426.26
2024-04-23,2024-04-23,Service payment - Customer_0068,REF27014856,0.0,42.57,230468.83
2024-04-23,2024-04-23,Service payment - Customer_0093,REF40031556,0.0,94.22,230563.05
2024-04-23,2024-04-23,Service payment - Customer_0099,REF27819424,0.0,33.27,230596.32
2024-04-23,2024-04-23,Project payment - Customer_0049,REF16223830,0.0,100.93,230697.25
2024-04-23,2024-04-23,Service payment - Customer_0042,REF16417831,0.0,90.07,230787.32
2024-04-23,2024-04-23,Project payment - Customer_0040,REF21863909,0.0,36.96,230824.28
2024-04-23,2024-04-23,Invoice payment - Customer_0023,REF34061250,0.0,105.53,230929.81
2024-04-24,2024-04-24,Project payment - Customer_0005,REF95042085,0.0,34.91,230964.72
2024-04-24,2024-04-24,Payment from Customer_0054,REF38796135,0.0,80.62,231045.34
2024-04-24,2024-04-24,Payment from Customer_0095,REF74114176,0.0,83.14,231128.48
2024-04-24,2024-04-24,Invoice payment - Customer_0039,REF37789610,0.0,101.45,231229.93
2024-04-24,2024-04-24,Invoice payment - Customer_0085,REF15899278,0.0,94.32,231324.25
2024-04-24,2024-04-24,Project payment - Customer_0043,REF79117382,0.0,104.35,231428.6
2024-04-24,2024-04-24,Payment from Customer_0067,REF94316622,0.0,115.08,231543.68
2024-04-24,2024-04-24,Project payment - Customer_0092,REF88436149,0.0,69.95,231613.63
2024-04-24,2024-04-24,Service payment - Customer_0007,REF83505896,0.0,117.63,231731.26
2024-04-24,2024-04-24,Invoice payment - Customer_0036,REF28090251,0.0,67.17,231798.43
2024-04-24,2024-04-24,Project payment - Customer_0078,REF73747203,0.0,164.56,231962.99
2024-04-24,2024-04-24,Invoice payment - Customer_0024,REF12872154,0.0,105.0,232067.99
2024-04-25,2024-04-25,Service payment - Customer_0084,REF77201862,0.0,87.67,232155.66
2024-04-25,2024-04-25,Invoice payment - Customer_0020,REF84281164,0.0,90.23,232245.89
2024-04-25,2024-04-25,Payment from Customer_0010,REF30258852,0.0,65.72,232311.61
2024-04-25,2024-04-25,Payment from Customer_0088,REF98412505,0.0,88.17,232399.78
2024-04-25,2024-04-25,Project payment - Customer_0017,REF21474691,0.0,52.45,232452.23
2024-04-26,2024-04-26,Service payment - Customer_0054,REF15119466,0.0,77.73,232529.96
2024-04-26,2024-04-26,Service payment - Customer_0036,REF96164311,0.0,54.69,232584.65
2024-04-26,2024-04-26,Service payment - Customer_0099,REF96324086,0.0,51.83,232636.48
2024-04-26,2024-04-26,Professional Services expense,REF67654446,125.96,0.0,232510.52
2024-04-26,2024-04-26,Payment from Customer_0020,REF84717612,0.0,106.62,232617.14
2024-04-26,2024-04-26,Service payment - Customer_0093,REF63700210,0.0,125.04,232742.18
2024-04-27,2024-04-27,Payment from Customer_0088,REF44277461,0.0,143.3,232885.48
2024-04-27,2024-04-27,Invoice payment - Customer_0092,REF83291680,0.0,60.51,232945.99
2024-04-27,2024-04-27,Service payment - Customer_0051,REF56893844,0.0,97.7,233043.69
2024-04-27,2024-04-27,Service payment - Customer_0041,REF84069138,0.0,144.71,233188.4
2024-04-27,2024-04-27,Service payment - Customer_0040,REF89146099,0.0,28.19,233216.59
2024-04-27,2024-04-27,Invoice payment - Customer_0024,REF90494291,0.0,53.69,233270.28
2024-04-27,2024-04-27,Project payment - Customer_0093,REF20370542,0.0,138.28,233408.56
2024-04-27,2024-04-27,Service payment - Customer_0004,REF37148950,0.0,45.94,233454.5
2024-04-28,2024-04-28,Invoice payment - Customer_0098,REF31592254,0.0,96.69,233551.19
2024-04-28,2024-04-28,Payment from Customer_0029,REF51575555,0.0,70.19,233621.38
2024-04-28,2024-04-28,Service payment - Customer_0048,REF39736694,0.0,72.72,233694.1
2024-04-28,2024-04-28,Invoice payment - Customer_0038,REF27483552,0.0,48.8,233742.9
2024-04-28,2024-04-28,Project payment - Customer_0066,REF32620358,0.0,56.6,233799.5
2024-04-28,2024-04-28,Project payment - Customer_0022,REF85296415,0.0,65.62,233865.12
2024-04-28,2024-04-28,Invoice payment - Customer_0031,REF80998834,0.0,110.43,233975.55
2024-04-28,2024-04-28,Project payment - Customer_0020,REF17896224,0.0,116.65,234092.2
2024-04-28,2024-04-28,Service payment - Customer_0043,REF37163372,0.0,144.12,234236.32
2024-04-29,2024-04-29,Payment from Customer_0022,REF97576582,0.0,57.45,234293.77
2024-04-29,2024-04-29,Service payment - Customer_0064,REF25795210,0.0,41.0,234334.77
2024-04-29,2024-04-29,Project payment - Customer_0073,REF83960141,0.0,98.2,234432.97
2024-04-29,2024-04-29,Invoice payment - Customer_0006,REF71752252,0.0,88.48,234521.45
2024-04-29,2024-04-29,Invoice payment - Customer_0048,REF63823726,0.0,91.59,234613.04
2024-04-29,2024-04-29,Project payment - Customer_0081,REF63771425,0.0,87.92,234700.96
2024-04-29,2024-04-29,Service payment - Customer_0062,REF17954603,0.0,67.87,234768.83
2024-04-29,2024-04-29,Service payment - Customer_0072,REF47750668,0.0,120.33,234889.16
2024-04-29,2024-04-29,Invoice payment - Customer_0065,REF19679416,0.0,62.77,234951.93
2024-04-30,2024-04-30,Payment from Customer_0008,REF98362028,0.0,96.32,235048.25
2024-04-30,2024-04-30,Project payment - Customer_0009,REF12846418,0.0,78.23,235126.48
2024-04-30,2024-04-30,Project payment - Customer_0020,REF14819761,0.0,113.31,235239.79
2024-04-30,2024-04-30,Invoice payment - Customer_0035,REF18300228,0.0,154.79,235394.58
2024-04-30,2024-04-30,Payment from Customer_0055,REF16871044,0.0,70.15,235464.73
2024-04-30,2024-04-30,Invoice payment - Customer_0065,REF35566886,0.0,64.93,235529.66
2024-04-30,2024-04-30,Invoice payment - Customer_0031,REF48039853,0.0,89.54,235619.2
2024-04-30,2024-04-30,Payment from Customer_0028,REF81619242,0.0,93.04,235712.24
2024-04-30,2024-04-30,Service payment - Customer_0014,REF23591508,0.0,81.29,235793.53
2024-04-30,2024-04-30,Project payment - Customer_0099,REF45217737,0.0,58.01,235851.54
2024-05-01,2024-05-01,Payment from Customer_0062,REF17373601,0.0,71.09,235922.63
2024-05-01,2024-05-01,Invoice payment - Customer_0031,REF32228413,0.0,113.6,236036.23
2024-05-01,2024-05-01,Service payment - Customer_0017,REF57512715,0.0,87.9,236124.13
2024-05-01,2024-05-01,Project payment - Customer_0050,REF34480592,0.0,102.94,236227.07
2024-05-01,2024-05-01,Payment from Customer_0063,REF72836986,0.0,91.73,236318.8
2024-05-01,2024-05-01,Invoice payment - Customer_0078,REF45949348,0.0,128.54,236447.34
2024-05-01,2024-05-01,Payment from Customer_0024,REF92538066,0.0,111.78,236559.12
2024-05-01,2024-05-01,Project payment - Customer_0056,REF94196926,0.0,27.89,236587.01
2024-05-01,2024-05-01,Monthly office rent,REF71836922,1451.44,0.0,235135.57
2024-05-01,2024-05-01,Invoice payment - Customer_0015,REF86314588,0.0,128.99,235264.56
2024-05-01,2024-05-01,Payment from Customer_0030,REF61560695,0.0,43.97,235308.53
2024-05-02,2024-05-02,Invoice payment - Customer_0061,REF74037133,0.0,125.92,235434.45
2024-05-02,2024-05-02,Payment from Customer_0079,REF83498047,0.0,95.28,235529.73
2024-05-02,2024-05-02,Payment from Customer_0009,REF28523379,0.0,63.95,235593.68
2024-05-02,2024-05-02,Invoice payment - Customer_0048,REF83505152,0.0,102.48,235696.16
2024-05-02,2024-05-02,Project payment - Customer_0004,REF93831620,0.0,64.6,235760.76
2024-05-02,2024-05-02,Service payment - Customer_0058,REF91833274,0.0,54.8,235815.56
2024-05-02,2024-05-02,Invoice payment - Customer_0059,REF89054498,0.0,91.92,235907.48
2024-05-02,2024-05-02,Project payment - Customer_0035,REF59762936,0.0,125.16,236032.64
2024-05-02,2024-05-02,Payment from Customer_0049,REF68220276,0.0,92.35,236124.99
2024-05-02,2024-05-02,Payment from Customer_0096,REF49629027,0.0,111.55,236236.54
2024-05-03,2024-05-03,Service payment - Customer_0033,REF91133234,0.0,77.89,236314.43
2024-05-03,2024-05-03,Payment from Customer_0007,REF77570021,0.0,170.8,236485.23
2024-05-03,2024-05-03,Project payment - Customer_0003,REF87340759,0.0,73.19,236558.42
2024-05-03,2024-05-03,Payment from Customer_0049,REF59932955,0.0,110.58,236669.0
2024-05-03,2024-05-03,Service payment - Customer_0018,REF58552519,0.0,77.2,236746.2
2024-05-03,2024-05-03,Invoice payment - Customer_0030,REF57721033,0.0,51.61,236797.81
2024-05-03,2024-05-03,Project payment - Customer_0043,REF63449580,0.0,144.95,236942.76
2024-05-03,2024-05-03,Payment from Customer_0035,REF30518884,0.0,140.37,237083.13
2024-05-04,2024-05-04,Service payment - Customer_0072,REF65554158,0.0,134.63,237217.76
2024-05-04,2024-05-04,Payment from Customer_0005,REF77189833,0.0,39.65,237257.41
2024-05-04,2024-05-04,Employee payroll,REF44942222,2427.83,0.0,234829.58
2024-05-04,2024-05-04,Payment from Customer_0099,REF34592984,0.0,50.3,234879.88
2024-05-04,2024-05-04,Payment from Customer_0041,REF95257347,0.0,112.93,234992.81
2024-05-04,2024-05-04,Payment from Customer_0007,REF99925901,0.0,149.97,235142.78
2024-05-04,2024-05-04,Project payment - Customer_0008,REF88767942,0.0,115.06,235257.84
2024-05-04,2024-05-04,Service payment - Customer_0082,REF52235991,0.0,137.95,235395.79
2024-05-04,2024-05-04,Payment from Customer_0087,REF52978437,0.0,93.73,235489.52
2024-05-04,2024-05-04,Payment from Customer_0091,REF53614047,0.0,166.35,235655.87
2024-05-04,2024-05-04,Project payment - Customer_0023,REF46212209,0.0,140.31,235796.18
2024-05-05,2024-05-05,Payment from Customer_0083,REF29150491,0.0,84.56,235880.74
2024-05-05,2024-05-05,Service payment - Customer_0028,REF30485512,0.0,104.23,235984.97
2024-05-05,2024-05-05,Invoice payment - Customer_0089,REF56509693,0.0,159.99,236144.96
2024-05-05,2024-05-05,Invoice payment - Customer_0063,REF31866520,0.0,74.81,236219.77
2024-05-05,2024-05-05,Payment from Customer_0058,REF71409687,0.0,51.8,236271.57
2024-05-05,2024-05-05,Payment from Customer_0000,REF36516770,0.0,45.38,236316.95
2024-05-05,2024-05-05,Payment from Customer_0013,REF21262778,0.0,88.85,236405.8
2024-05-05,2024-05-05,Invoice payment - Customer_0091,REF34770630,0.0,179.33,236585.13
2024-05-05,2024-05-05,Project payment - Customer_0078,REF34864681,0.0,165.93,236751.06
2024-05-05,2024-05-05,Project payment - Customer_0011,REF93691507,0.0,114.26,236865.32
2024-05-05,2024-05-05,Service payment - Customer_0035,REF20096066,0.0,128.55,236993.87
2024-05-06,2024-05-06,Project payment - Customer_0087,REF39743820,0.0,95.27,237089.14
2024-05-06,2024-05-06,Project payment - Customer_0028,REF57610251,0.0,120.69,237209.83
2024-05-06,2024-05-06,Service payment - Customer_0049,REF39898097,0.0,103.4,237313.23
2024-05-06,2024-05-06,Service payment - Customer_0058,REF56413935,0.0,51.4,237364.63
2024-05-06,2024-05-06,Payment from Customer_0068,REF54032445,0.0,57.75,237422.38
2024-05-06,2024-05-06,Project payment - Customer_0063,REF59497361,0.0,75.12,237497.5
2024-05-06,2024-05-06,Service payment - Customer_0082,REF53163479,0.0,148.15,237645.65
2024-05-06,2024-05-06,Project payment - Customer_0081,REF58900959,0.0,89.62,237735.27
2024-05-06,2024-05-06,Project payment - Customer_0080,REF25927183,0.0,45.66,237780.93
2024-05-07,2024-05-07,Invoice payment - Customer_0004,REF64217079,0.0,57.63,237838.56
2024-05-07,2024-05-07,Invoice payment - Customer_0009,REF70330155,0.0,79.67,237918.23
2024-05-07,2024-05-07,Service payment - Customer_0005,REF97297348,0.0,32.79,237951.02
2024-05-07,2024-05-07,Invoice payment - Customer_0001,REF92219372,0.0,77.88,238028.9
2024-05-07,2024-05-07,Invoice payment - Customer_0073,REF44474061,0.0,134.81,238163.71
2024-05-07,2024-05-07,Payment from Customer_0075,REF33097802,0.0,84.82,238248.53
2024-05-07,2024-05-07,Payment from Customer_0087,REF51167707,0.0,95.22,238343.75
2024-05-07,2024-05-07,Payment from Customer_0021,REF14537697,0.0,67.41,238411.16
2024-05-07,2024-05-07,Project payment - Customer_0084,REF29904936,0.0,80.17,238491.33
2024-05-07,2024-05-07,Payment from Customer_0083,REF91606365,0.0,61.59,238552.92
2024-05-07,2024-05-07,Project payment - Customer_0080,REF53688955,0.0,42.08,238595.0
2024-05-07,2024-05-07,Inventory purchase,REF12725580,3997.69,0.0,234597.31
2024-05-08,2024-05-08,Invoice payment - Customer_0089,REF38484103,0.0,162.4,234759.71
2024-05-08,2024-05-08,Service payment - Customer_0028,REF96524860,0.0,87.44,234847.15
2024-05-08,2024-05-08,Payment from Customer_0076,REF95855570,0.0,11.59,234858.74
2024-05-08,2024-05-08,Service payment - Customer_0038,REF68982442,0.0,63.07,234921.81
2024-05-08,2024-05-08,Service payment - Customer_0070,REF10885023,0.0,48.93,234970.74
2024-05-08,2024-05-08,Project payment - Customer_0095,REF68326520,0.0,75.66,235046.4
2024-05-08,2024-05-08,Payment from Customer_0005,REF72890208,0.0,31.19,235077.59
2024-05-08,2024-05-08,Project payment - Customer_0025,REF72056326,0.0,171.55,235249.14
2024-05-08,2024-05-08,Service payment - Customer_0077,REF23601973,0.0,114.02,235363.16
2024-05-08,2024-05-08,Invoice payment - Customer_0080,REF71450032,0.0,43.55,235406.71
2024-05-08,2024-05-08,Invoice payment - Customer_0044,REF66919603,0.0,42.13,235448.84
2024-05-09,2024-05-09,Project payment - Customer_0089,REF21580729,0.0,200.09,235648.93
2024-05-09,2024-05-09,Payment from Customer_0063,REF75421430,0.0,90.48,235739.41
2024-05-09,2024-05-09,Invoice payment - Customer_0011,REF79046578,0.0,103.12,235842.53
2024-05-09,2024-05-09,Service payment - Customer_0023,REF20537363,0.0,145.62,235988.15
2024-05-09,2024-05-09,Payment from Customer_0021,REF79624951,0.0,83.93,236072.08
2024-05-10,2024-05-10,Service payment - Customer_0097,REF71403860,0.0,76.56,236148.64
2024-05-10,2024-05-10,Payment from Customer_0033,REF66378661,0.0,100.1,236248.74
2024-05-10,2024-05-10,Service payment - Customer_0078,REF54295462,0.0,138.76,236387.5
2024-05-10,2024-05-10,Invoice payment - Customer_0061,REF65204494,0.0,114.42,236501.92
2024-05-10,2024-05-10,Service payment - Customer_0073,REF94925453,0.0,124.06,236625.98
2024-05-10,2024-05-10,Project payment - Customer_0065,REF13644312,0.0,61.97,236687.95
2024-05-10,2024-05-10,Invoice payment - Customer_0015,REF15959474,0.0,125.96,236813.91
2024-05-10,2024-05-10,Project payment - Customer_0060,REF11685621,0.0,96.02,236909.93
2024-05-10,2024-05-10,Service payment - Customer_0091,REF40055038,0.0,142.28,237052.21
2024-05-10,2024-05-10,Invoice payment - Customer_0047,REF40597224,0.0,142.93,237195.14
2024-05-11,2024-05-11,Project payment - Customer_0090,REF38180165,0.0,90.97,237286.11
2024-05-11,2024-05-11,Project payment - Customer_0080,REF95754783,0.0,49.87,237335.98
2024-05-11,2024-05-11,Invoice payment - Customer_0092,REF94637871,0.0,76.18,237412.16
2024-05-11,2024-05-11,Project payment - Customer_0008,REF33700835,0.0,130.66,237542.82
2024-05-11,2024-05-11,Invoice payment - Customer_0041,REF25851245,0.0,193.92,237736.74
2024-05-11,2024-05-11,Project payment - Customer_0030,REF95608091,0.0,59.36,237796.1
2024-05-11,2024-05-11,Service payment - Customer_0023,REF66808576,0.0,123.13,237919.23
2024-05-12,2024-05-12,Project payment - Customer_0068,REF45176018,0.0,36.64,237955.87
2024-05-12,2024-05-12,Project payment - Customer_0079,REF93857917,0.0,84.27,238040.14
2024-05-12,2024-05-12,Payment from Customer_0080,REF26398218,0.0,36.85,238076.99
2024-05-12,2024-05-12,Project payment - Customer_0028,REF81685630,0.0,61.77,238138.76
2024-05-12,2024-05-12,Service payment - Customer_0001,REF26218176,0.0,69.2,238207.96
2024-05-12,2024-05-12,Project payment - Customer_0092,REF31566822,0.0,89.27,238297.23
2024-05-12,2024-05-12,Service payment - Customer_0056,REF74879340,0.0,35.74,238332.97
2024-05-12,2024-05-12,Payment from Customer_0035,REF72196941,0.0,158.7,238491.67
2024-05-12,2024-05-12,Invoice payment - Customer_0043,REF60316874,0.0,112.25,238603.92
2024-05-12,2024-05-12,Service payment - Customer_0078,REF64621141,0.0,152.98,238756.9
2024-05-12,2024-05-12,Inventory purchase,REF62757411,3218.96,0.0,235537.94
2024-05-13,2024-05-13,Service payment - Customer_0002,REF36673575,0.0,86.76,235624.7
2024-05-13,2024-05-13,Payment from Customer_0077,REF81631296,0.0,111.42,235736.12
2024-05-13,2024-05-13,Service payment - Customer_0039,REF28481456,0.0,198.62,235934.74
2024-05-13,2024-05-13,Invoice payment - Customer_0089,REF84431106,0.0,146.34,236081.08
2024-05-13,2024-05-13,Service payment - Customer_0054,REF30232294,0.0,60.1,236141.18
2024-05-13,2024-05-13,Service payment - Customer_0010,REF10998809,0.0,100.77,236241.95
2024-05-13,2024-05-13,Payment from Customer_0007,REF10508515,0.0,168.75,236410.7
2024-05-13,2024-05-13,Service payment - Customer_0022,REF72381522,0.0,84.7,236495.4
2024-05-13,2024-05-13,Service payment - Customer_0066,REF53587182,0.0,61.79,236557.19
2024-05-13,2024-05-13,Project payment - Customer_0004,REF80408064,0.0,77.0,236634.19
2024-05-13,2024-05-13,Payment from Customer_0041,REF32367842,0.0,187.95,236822.14
2024-05-13,2024-05-13,Project payment - Customer_0045,REF63758260,0.0,108.03,236930.17
2024-05-13,2024-05-13,Payment from Customer_0003,REF73774188,0.0,88.94,237019.11
2024-05-14,2024-05-14,Invoice payment - Customer_0056,REF95525845,0.0,41.53,237060.64
2024-05-14,2024-05-14,Project payment - Customer_0048,REF21266069,0.0,144.95,237205.59
2024-05-14,2024-05-14,Project payment - Customer_0070,REF50607740,0.0,51.88,237257.47
2024-05-14,2024-05-14,Service payment - Customer_0090,REF57608901,0.0,112.87,237370.34
2024-05-14,2024-05-14,Service payment - Customer_0017,REF11024600,0.0,100.02,237470.36
2024-05-14,2024-05-14,Payment from Customer_0039,REF84405619,0.0,143.9,237614.26
2024-05-14,2024-05-14,Project payment - Customer_0035,REF83963635,0.0,144.1,237758.36
2024-05-14,2024-05-14,Project payment - Customer_0061,REF13619580,0.0,130.01,237888.37
2024-05-14,2024-05-14,Invoice payment - Customer_0003,REF90970769,0.0,109.07,237997.44
2024-05-15,2024-05-15,Business insurance premium,REF74459733,191.79,0.0,237805.65
2024-05-15,2024-05-15,Project payment - Customer_0015,REF93142767,0.0,163.86,237969.51
2024-05-15,2024-05-15,Invoice payment - Customer_0023,REF31411716,0.0,95.69,238065.2
2024-05-15,2024-05-15,Project payment - Customer_0071,REF41036580,0.0,46.24,238111.44
2024-05-15,2024-05-15,Payment from Customer_0013,REF97926479,0.0,71.92,238183.36
2024-05-15,2024-05-15,Payment from Customer_0006,REF78352005,0.0,76.36,238259.72
2024-05-15,2024-05-15,Project payment - Customer_0072,REF42964409,0.0,149.69,238409.41
2024-05-15,2024-05-15,Invoice payment - Customer_0064,REF55473520,0.0,49.25,238458.66
2024-05-15,2024-05-15,Project payment - Customer_0084,REF40106469,0.0,86.02,238544.68
2024-05-15,2024-05-15,Payment from Customer_0075,REF26595705,0.0,138.0,238682.68
2024-05-15,2024-05-15,Project payment - Customer_0051,REF22327167,0.0,82.48,238765.16
2024-05-15,2024-05-15,Project payment - Customer_0029,REF43425559,0.0,92.9,238858.06
2024-05-16,2024-05-16,Payment from Customer_0057,REF24777483,0.0,102.48,238960.54
2024-05-16,2024-05-16,Project payment - Customer_0007,REF21798840,0.0,140.84,239101.38
2024-05-16,2024-05-16,Payment from Customer_0097,REF75752673,0.0,87.16,239188.54
2024-05-16,2024-05-16,Invoice payment - Customer_0004,REF32182717,0.0,67.72,239256.26
2024-05-16,2024-05-16,Invoice payment - Customer_0003,REF24094646,0.0,82.31,239338.57
2024-05-16,2024-05-16,Invoice payment - Customer_0068,REF65389503,0.0,45.0,239383.57
2024-05-16,2024-05-16,Invoice payment - Customer_0054,REF44751450,0.0,70.43,239454.0
2024-05-16,2024-05-16,Payment from Customer_0035,REF40195185,0.0,119.91,239573.91
2024-05-16,2024-05-16,Project payment - Customer_0094,REF51912696,0.0,94.48,239668.39
2024-05-17,2024-05-17,Payment from Customer_0030,REF84444734,0.0,39.59,239707.98
2024-05-17,2024-05-17,Project payment - Customer_0019,REF34658137,0.0,128.88,239836.86
2024-05-17,2024-05-17,Project payment - Customer_0066,REF48251207,0.0,73.15,239910.01
2024-05-17,2024-05-17,Service payment - Customer_0051,REF76779222,0.0,89.48,239999.49
2024-05-17,2024-05-17,Service payment - Customer_0039,REF52826842,0.0,173.39,240172.88
2024-05-17,2024-05-17,Service payment - Customer_0017,REF72021369,0.0,84.57,240257.45
2024-05-17,2024-05-17,Payment from Customer_0078,REF40330977,0.0,180.43,240437.88
2024-05-17,2024-05-17,Payment from Customer_0053,REF50381547,0.0,145.28,240583.16
2024-05-17,2024-05-17,Service payment - Customer_0059,REF42730840,0.0,110.31,240693.47
2024-05-17,2024-05-17,Service payment - Customer_0063,REF38509035,0.0,61.86,240755.33
2024-05-17,2024-05-17,Invoice payment - Customer_0073,REF89584080,0.0,117.3,240872.63
2024-05-17,2024-05-17,Project payment - Customer_0007,REF54091944,0.0,196.15,241068.78
2024-05-17,2024-05-17,Invoice payment - Customer_0077,REF15004467,0.0,86.54,241155.32
2024-05-17,2024-05-17,Invoice payment - Customer_0004,REF26556205,0.0,69.28,241224.6
2024-05-17,2024-05-17,Payment from Customer_0094,REF11762315,0.0,70.44,241295.04
2024-05-18,2024-05-18,Service payment - Customer_0002,REF15530728,0.0,97.3,241392.34
2024-05-18,2024-05-18,Invoice payment - Customer_0007,REF54798163,0.0,166.98,241559.32
2024-05-18,2024-05-18,Payment from Customer_0031,REF70538337,0.0,125.85,241685.17
2024-05-18,2024-05-18,Payment from Customer_0001,REF69675648,0.0,64.84,241750.01
2024-05-18,2024-05-18,Invoice payment - Customer_0000,REF80271579,0.0,46.55,241796.56
2024-05-18,2024-05-18,Payment from Customer_0026,REF61992748,0.0,95.47,241892.03
2024-05-18,2024-05-18,Payment from Customer_0063,REF20042771,0.0,88.43,241980.46
2024-05-18,2024-05-18,Service payment - Customer_0008,REF46109690,0.0,86.5,242066.96
2024-05-18,2024-05-18,Invoice payment - Customer_0028,REF73914891,0.0,95.74,242162.7
2024-05-19,2024-05-19,Invoice payment - Customer_0089,REF36275931,0.0,114.0,242276.7
2024-05-19,2024-05-19,Service payment - Customer_0032,REF22994356,0.0,84.07,242360.77
2024-05-19,2024-05-19,Project payment - Customer_0072,REF10170313,0.0,156.23,242517.0
2024-05-19,2024-05-19,Project payment - Customer_0036,REF60806812,0.0,87.69,242604.69
2024-05-19,2024-05-19,Project payment - Customer_0083,REF96524555,0.0,88.91,242693.6
2024-05-19,2024-05-19,Service payment - Customer_0031,REF32036000,0.0,113.17,242806.77
2024-05-19,2024-05-19,Project payment - Customer_0020,REF87582917,0.0,132.57,242939.34
2024-05-19,2024-05-19,Invoice payment - Customer_0030,REF11134688,0.0,37.66,242977.0
2024-05-20,2024-05-20,Payment from Customer_0024,REF68498687,0.0,90.14,243067.14
2024-05-20,2024-05-20,Project payment - Customer_0036,REF55940038,0.0,54.56,243121.7
2024-05-20,2024-05-20,Invoice payment - Customer_0034,REF55821581,0.0,95.25,243216.95
2024-05-20,2024-05-20,Invoice payment - Customer_0050,REF51913973,0.0,140.13,243357.08
2024-05-20,2024-05-20,Service payment - Customer_0075,REF72476764,0.0,94.25,243451.33
2024-05-20,2024-05-20,Invoice payment - Customer_0074,REF80422854,0.0,45.01,243496.34
2024-05-20,2024-05-20,Payment from Customer_0030,REF37756129,0.0,44.26,243540.6
2024-05-20,2024-05-20,Payment from Customer_0093,REF59953505,0.0,113.23,243653.83
2024-05-20,2024-05-20,Service payment - Customer_0029,REF33108613,0.0,84.04,243737.87
2024-05-20,2024-05-20,Project payment - Customer_0092,REF46079328,0.0,66.49,243804.36
2024-05-20,2024-05-20,Payment from Customer_0006,REF99638850,0.0,84.19,243888.55
2024-05-21,2024-05-21,Invoice payment - Customer_0061,REF34801754,0.0,151.01,244039.56
2024-05-21,2024-05-21,Payment from Customer_0095,REF69317620,0.0,101.07,244140.63
2024-05-21,2024-05-21,Payment from Customer_0035,REF22634489,0.0,129.52,244270.15
2024-05-21,2024-05-21,Payment from Customer_0084,REF48039929,0.0,74.66,244344.81
2024-05-21,2024-05-21,Service payment - Customer_0027,REF50539381,0.0,89.25,244434.06
2024-05-21,2024-05-21,Invoice payment - Customer_0045,REF50053289,0.0,108.99,244543.05
2024-05-21,2024-05-21,Payment from Customer_0031,REF26732574,0.0,111.08,244654.13
2024-05-21,2024-05-21,Invoice payment - Customer_0065,REF79970136,0.0,67.42,244721.55
2024-05-22,2024-05-22,Utility bill payment,REF31292960,178.78,0.0,244542.77
2024-05-22,2024-05-22,Payment from Customer_0052,REF47977292,0.0,42.57,244585.34
2024-05-22,2024-05-22,Invoice payment - Customer_0024,REF62674859,0.0,94.79,244680.13
2024-05-22,2024-05-22,Service payment - Customer_0010,REF80140859,0.0,104.21,244784.34
2024-05-22,2024-05-22,Payment from Customer_0020,REF69005696,0.0,131.88,244916.22
2024-05-22,2024-05-22,Service payment - Customer_0021,REF76726556,0.0,82.23,244998.45
2024-05-22,2024-05-22,Service payment - Customer_0000,REF71747862,0.0,45.66,245044.11
2024-05-22,2024-05-22,Invoice payment - Customer_0008,REF49756421,0.0,125.55,245169.66
2024-05-22,2024-05-22,Invoice payment - Customer_0009,REF81314361,0.0,81.02,245250.68
2024-05-23,2024-05-23,Payment from Customer_0036,REF33848727,0.0,56.06,245306.74
2024-05-23,2024-05-23,Service payment - Customer_0030,REF72462595,0.0,39.82,245346.56
2024-05-23,2024-05-23,Payment from Customer_0027,REF72716887,0.0,100.82,245447.38
2024-05-23,2024-05-23,Project payment - Customer_0047,REF86239887,0.0,127.04,245574.42
2024-05-23,2024-05-23,Invoice payment - Customer_0033,REF36418821,0.0,87.1,245661.52
2024-05-23,2024-05-23,Project payment - Customer_0087,REF41521116,0.0,89.35,245750.87
2024-05-23,2024-05-23,Project payment - Customer_0031,REF97089122,0.0,131.13,245882.0
2024-05-23,2024-05-23,Project payment - Customer_0018,REF85811488,0.0,81.0,245963.0
2024-05-23,2024-05-23,Payment from Customer_0099,REF62880681,0.0,46.56,246009.56
2024-05-23,2024-05-23,Project payment - Customer_0054,REF26517641,0.0,83.65,246093.21
2024-05-23,2024-05-23,Service payment - Customer_0096,REF77115339,0.0,113.82,246207.03
2024-05-23,2024-05-23,Project payment - Customer_0022,REF90296685,0.0,82.52,246289.55
2024-05-23,2024-05-23,Service payment - Customer_0002,REF44667523,0.0,102.33,246391.88
2024-05-24,2024-05-24,Service payment - Customer_0048,REF33915181,0.0,131.63,246523.51
2024-05-24,2024-05-24,Payment from Customer_0024,REF55619997,0.0,94.28,246617.79
2024-05-24,2024-05-24,Payment from Customer_0058,REF25229946,0.0,55.95,246673.74
2024-05-24,2024-05-24,Service payment - Customer_0036,REF62690202,0.0,72.17,246745.91
2024-05-24,2024-05-24,Payment from Customer_0039,REF98296792,0.0,156.42,246902.33
2024-05-24,2024-05-24,Project payment - Customer_0055,REF72022676,0.0,74.13,246976.46
2024-05-24,2024-05-24,Payment from Customer_0082,REF95866887,0.0,143.66,247120.12
2024-05-24,2024-05-24,Service payment - Customer_0044,REF66944867,0.0,41.44,247161.56
2024-05-24,2024-05-24,Service payment - Customer_0077,REF56773222,0.0,101.59,247263.15
2024-05-24,2024-05-24,Service payment - Customer_0043,REF34368392,0.0,156.28,247419.43
2024-05-24,2024-05-24,Invoice payment - Customer_0041,REF57980084,0.0,127.39,247546.82
2024-05-24,2024-05-24,Service payment - Customer_0068,REF68904932,0.0,50.68,247597.5
2024-05-25,2024-05-25,Payment from Customer_0049,REF81961746,0.0,106.91,247704.41
2024-05-25,2024-05-25,Invoice payment - Customer_0097,REF84536596,0.0,66.74,247771.15
2024-05-25,2024-05-25,Packaging Shipping expense,REF38620714,369.48,0.0,247401.67
2024-05-25,2024-05-25,Invoice payment - Customer_0023,REF16914304,0.0,114.48,247516.15
2024-05-25,2024-05-25,Project payment - Customer_0091,REF78667110,0.0,150.71,247666.86
2024-05-25,2024-05-25,Payment from Customer_0031,REF26071480,0.0,134.46,247801.32
2024-05-25,2024-05-25,Payment from Customer_0068,REF90556826,0.0,54.46,247855.78
2024-05-25,2024-05-25,Payment from Customer_0077,REF86648594,0.0,62.77,247918.55
2024-05-26,2024-05-26,Employee payroll,REF93782410,2193.02,0.0,245725.53
2024-05-26,2024-05-26,Service payment - Customer_0051,REF51641897,0.0,80.39,245805.92
2024-05-26,2024-05-26,Project payment - Customer_0033,REF87359508,0.0,58.82,245864.74
2024-05-26,2024-05-26,Invoice payment - Customer_0004,REF44804523,0.0,51.31,245916.05
2024-05-26,2024-05-26,Payment from Customer_0009,REF60758805,0.0,82.28,245998.33
2024-05-26,2024-05-26,Service payment - Customer_0042,REF24231219,0.0,111.73,246110.06
2024-05-26,2024-05-26,Project payment - Customer_0097,REF22706254,0.0,57.43,246167.49
2024-05-26,2024-05-26,Invoice payment - Customer_0057,REF67295748,0.0,124.84,246292.33
2024-05-27,2024-05-27,Service payment - Customer_0086,REF83585756,0.0,64.58,246356.91
2024-05-27,2024-05-27,Invoice payment - Customer_0043,REF24165992,0.0,115.42,246472.33
2024-05-27,2024-05-27,Service payment - Customer_0018,REF61811988,0.0,69.26,246541.59
2024-05-27,2024-05-27,Payment from Customer_0025,REF52490460,0.0,106.97,246648.56
2024-05-27,2024-05-27,Invoice payment - Customer_0023,REF89676061,0.0,112.07,246760.63
2024-05-27,2024-05-27,Employee payroll,REF86036256,2317.25,0.0,244443.38
2024-05-27,2024-05-27,Project payment - Customer_0036,REF52878451,0.0,65.32,244508.7
2024-05-27,2024-05-27,Invoice payment - Customer_0057,REF26777420,0.0,152.94,244661.64
2024-05-28,2024-05-28,Inventory purchase,REF98306473,5512.57,0.0,239149.07
2024-05-28,2024-05-28,Project payment - Customer_0069,REF93773320,0.0,77.68,239226.75
2024-05-28,2024-05-28,Payment from Customer_0063,REF21225801,0.0,75.93,239302.68
2024-05-28,2024-05-28,Invoice payment - Customer_0072,REF46030049,0.0,123.27,239425.95
2024-05-28,2024-05-28,Service payment - Customer_0013,REF92673855,0.0,53.73,239479.68
2024-05-28,2024-05-28,Service payment - Customer_0082,REF49066389,0.0,178.63,239658.31
2024-05-28,2024-05-28,Payment from Customer_0029,REF42397957,0.0,96.63,239754.94
2024-05-28,2024-05-28,Payment from Customer_0039,REF60288817,0.0,123.07,239878.01
2024-05-29,2024-05-29,Payment from Customer_0032,REF93906433,0.0,99.42,239977.43
2024-05-29,2024-05-29,Invoice payment - Customer_0099,REF55744852,0.0,48.42,240025.85
2024-05-29,2024-05-29,Payment from Customer_0041,REF61279376,0.0,135.3,240161.15
2024-05-29,2024-05-29,Payment from Customer_0058,REF36925913,0.0,30.95,240192.1
2024-05-29,2024-05-29,Service payment - Customer_0076,REF64338042,0.0,11.96,240204.06
2024-05-29,2024-05-29,Service payment - Customer_0066,REF63581483,0.0,74.06,240278.12
2024-05-29,2024-05-29,Payment from Customer_0075,REF10210692,0.0,162.24,240440.36
2024-05-30,2024-05-30,Invoice payment - Customer_0007,REF39763764,0.0,181.24,240621.6
2024-05-30,2024-05-30,Project payment - Customer_0042,REF35919501,0.0,85.26,240706.86
2024-05-30,2024-05-30,Invoice payment - Customer_0097,REF87216176,0.0,60.33,240767.19
2024-05-30,2024-05-30,Payment from Customer_0052,REF53401924,0.0,46.68,240813.87
2024-05-30,2024-05-30,Project payment - Customer_0004,REF83524016,0.0,59.06,240872.93
2024-05-30,2024-05-30,Service payment - Customer_0073,REF20267845,0.0,157.78,241030.71
2024-05-30,2024-05-30,Project payment - Customer_0041,REF50449357,0.0,112.77,241143.48
2024-05-30,2024-05-30,Payment from Customer_0038,REF62728460,0.0,61.77,241205.25
2024-05-30,2024-05-30,Payment from Customer_0022,REF36791438,0.0,84.65,241289.9
2024-05-30,2024-05-30,Project payment - Customer_0080,REF78519508,0.0,41.77,241331.67
2024-05-30,2024-05-30,Invoice payment - Customer_0058,REF37840286,0.0,44.25,241375.92
2024-05-30,2024-05-30,Payment from Customer_0096,REF17298635,0.0,108.26,241484.18
2024-05-30,2024-05-30,Invoice payment - Customer_0040,REF63464266,0.0,40.63,241524.81
2024-05-30,2024-05-30,Payment from Customer_0077,REF11516205,0.0,140.17,241664.98
2024-05-30,2024-05-30,Invoice payment - Customer_0057,REF95321317,0.0,126.61,241791.59
2024-05-31,2024-05-31,Service payment - Customer_0036,REF68042962,0.0,67.96,241859.55
2024-05-31,2024-05-31,Project payment - Customer_0080,REF73807337,0.0,40.0,241899.55
2024-05-31,2024-05-31,Project payment - Customer_0028,REF69951103,0.0,95.01,241994.56
2024-05-31,2024-05-31,Payment from Customer_0047,REF15699297,0.0,109.73,242104.29
2024-05-31,2024-05-31,Payment from Customer_0030,REF68939004,0.0,51.9,242156.19
2024-05-31,2024-05-31,Payment from Customer_0058,REF59752892,0.0,57.3,242213.49
2024-05-31,2024-05-31,Payment from Customer_0081,REF90280584,0.0,100.52,242314.01
2024-05-31,2024-05-31,Project payment - Customer_0023,REF87067269,0.0,124.79,242438.8
2024-05-31,2024-05-31,Project payment - Customer_0046,REF57135073,0.0,144.75,242583.55
2024-05-31,2024-05-31,Project payment - Customer_0063,REF81651620,0.0,86.13,242669.68
2024-05-31,2024-05-31,Payment from Customer_0001,REF17191211,0.0,72.21,242741.89
2024-05-31,2024-05-31,Invoice payment - Customer_0022,REF54532573,0.0,75.41,242817.3
2024-06-01,2024-06-01,Monthly office rent,REF20854840,1140.49,0.0,241676.81
2024-06-01,2024-06-01,Payment from Customer_0049,REF80346450,0.0,87.94,241764.75
2024-06-01,2024-06-01,Project payment - Customer_0044,REF23094141,0.0,35.98,241800.73
2024-06-01,2024-06-01,Project payment - Customer_0084,REF98250675,0.0,87.5,241888.23
2024-06-01,2024-06-01,Service payment - Customer_0009,REF10204026,0.0,71.63,241959.86
2024-06-01,2024-06-01,Invoice payment - Customer_0056,REF10595968,0.0,33.01,241992.87
2024-06-01,2024-06-01,Payment from Customer_0082,REF16842503,0.0,119.6,242112.47
2024-06-01,2024-06-01,Payment from Customer_0039,REF68383955,0.0,122.34,242234.81
2024-06-01,2024-06-01,Service payment - Customer_0078,REF58153632,0.0,143.46,242378.27
2024-06-01,2024-06-01,Service payment - Customer_0047,REF72202614,0.0,74.55,242452.82
2024-06-01,2024-06-01,Invoice payment - Customer_0042,REF85163966,0.0,99.49,242552.31
2024-06-01,2024-06-01,Invoice payment - Customer_0002,REF32385888,0.0,99.8,242652.11
2024-06-02,2024-06-02,Project payment - Customer_0089,REF39314722,0.0,128.68,242780.79
2024-06-02,2024-06-02,Project payment - Customer_0046,REF16581417,0.0,107.77,242888.56
2024-06-02,2024-06-02,Invoice payment - Customer_0084,REF11867085,0.0,83.53,242972.09
2024-06-02,2024-06-02,Service payment - Customer_0012,REF77001539,0.0,68.08,243040.17
2024-06-02,2024-06-02,Invoice payment - Customer_0016,REF77497701,0.0,32.99,243073.16
2024-06-02,2024-06-02,Service payment - Customer_0052,REF88148708,0.0,44.0,243117.16
2024-06-02,2024-06-02,Invoice payment - Customer_0013,REF67032580,0.0,61.12,243178.28
2024-06-02,2024-06-02,Service payment - Customer_0078,REF53747281,0.0,122.98,243301.26
2024-06-02,2024-06-02,Service payment - Customer_0048,REF47064582,0.0,63.7,243364.96
2024-06-02,2024-06-02,Service payment - Customer_0043,REF75732988,0.0,103.07,243468.03
2024-06-02,2024-06-02,Payment from Customer_0029,REF18686713,0.0,77.7,243545.73
2024-06-03,2024-06-03,Invoice payment - Customer_0001,REF29965551,0.0,77.61,243623.34
2024-06-03,2024-06-03,Invoice payment - Customer_0018,REF22692950,0.0,78.1,243701.44
2024-06-03,2024-06-03,Project payment - Customer_0094,REF10756323,0.0,94.67,243796.11
2024-06-03,2024-06-03,Payment from Customer_0038,REF63110313,0.0,54.3,243850.41
2024-06-03,2024-06-03,Service payment - Customer_0062,REF80004056,0.0,61.32,243911.73
2024-06-03,2024-06-03,Service payment - Customer_0080,REF63814189,0.0,36.29,243948.02
2024-06-03,2024-06-03,Payment from Customer_0066,REF93855973,0.0,61.41,244009.43
2024-06-03,2024-06-03,Invoice payment - Customer_0008,REF50298568,0.0,123.15,244132.58
2024-06-03,2024-06-03,Invoice payment - Customer_0057,REF75169648,0.0,115.85,244248.43
2024-06-03,2024-06-03,Service payment - Customer_0051,REF18042195,0.0,63.41,244311.84
2024-06-03,2024-06-03,Payment from Customer_0081,REF16482126,0.0,114.53,244426.37
2024-06-03,2024-06-03,Project payment - Customer_0056,REF36645822,0.0,30.54,244456.91
2024-06-03,2024-06-03,Project payment - Customer_0090,REF87865562,0.0,95.3,244552.21
2024-06-03,2024-06-03,Service payment - Customer_0050,REF23225909,0.0,102.86,244655.07
2024-06-04,2024-06-04,Service payment - Customer_0067,REF33584136,0.0,139.0,244794.07
2024-06-04,2024-06-04,Payment from Customer_0075,REF43000122,0.0,110.55,244904.62
2024-06-04,2024-06-04,Service payment - Customer_0001,REF74122909,0.0,59.07,244963.69
2024-06-04,2024-06-04,Service payment - Customer_0041,REF44676451,0.0,126.38,245090.07
2024-06-04,2024-06-04,Invoice payment - Customer_0045,REF25449996,0.0,80.98,245171.05
2024-06-04,2024-06-04,Invoice payment - Customer_0054,REF48905749,0.0,62.34,245233.39
2024-06-05,2024-06-05,Service payment - Customer_0029,REF29756540,0.0,68.15,245301.54
2024-06-05,2024-06-05,Payment from Customer_0004,REF68583930,0.0,54.78,245356.32
2024-06-05,2024-06-05,Payment from Customer_0013,REF91553633,0.0,85.65,245441.97
2024-06-05,2024-06-05,Payment from Customer_0092,REF24179482,0.0,72.61,245514.58
2024-06-05,2024-06-05,Payment from Customer_0039,REF46953641,0.0,113.83,245628.41
2024-06-05,2024-06-05,Invoice payment - Customer_0086,REF94323611,0.0,104.36,245732.77
2024-06-06,2024-06-06,Service payment - Customer_0016,REF61488494,0.0,33.96,245766.73
2024-06-06,2024-06-06,Payment from Customer_0033,REF37779547,0.0,88.02,245854.75
2024-06-06,2024-06-06,Service payment - Customer_0041,REF31429944,0.0,146.0,246000.75
2024-06-06,2024-06-06,Payment from Customer_0064,REF10526602,0.0,28.45,246029.2
2024-06-06,2024-06-06,Service payment - Customer_0048,REF38667534,0.0,102.83,246132.03
2024-06-06,2024-06-06,Payment from Customer_0044,REF71914558,0.0,26.53,246158.56
2024-06-07,2024-06-07,Inventory purchase,REF27506985,1551.26,0.0,244607.3
2024-06-07,2024-06-07,Invoice payment - Customer_0034,REF73487584,0.0,89.53,244696.83
2024-06-07,2024-06-07,Invoice payment - Customer_0091,REF65168471,0.0,169.23,244866.06
2024-06-07,2024-06-07,Payment from Customer_0016,REF72386555,0.0,36.74,244902.8
2024-06-07,2024-06-07,Service payment - Customer_0052,REF98643909,0.0,42.52,244945.32
2024-06-07,2024-06-07,Payment from Customer_0062,REF90147774,0.0,70.09,245015.41
2024-06-07,2024-06-07,Invoice payment - Customer_0004,REF84463215,0.0,47.7,245063.11
2024-06-07,2024-06-07,Project payment - Customer_0046,REF38576141,0.0,144.67,245207.78
2024-06-07,2024-06-07,Service payment - Customer_0051,REF67672332,0.0,60.79,245268.57
2024-06-07,2024-06-07,Service payment - Customer_0005,REF79728218,0.0,31.48,245300.05
2024-06-07,2024-06-07,Project payment - Customer_0057,REF20663572,0.0,122.57,245422.62
2024-06-07,2024-06-07,Payment from Customer_0084,REF64607731,0.0,92.75,245515.37
2024-06-08,2024-06-08,Service payment - Customer_0011,REF59111301,0.0,95.42,245610.79
2024-06-08,2024-06-08,Project payment - Customer_0070,REF55449792,0.0,56.88,245667.67
2024-06-08,2024-06-08,Service payment - Customer_0063,REF24549676,0.0,68.01,245735.68
2024-06-08,2024-06-08,Payment from Customer_0098,REF53472462,0.0,65.94,245801.62
2024-06-08,2024-06-08,Invoice payment - Customer_0077,REF93158935,0.0,93.99,245895.61
2024-06-08,2024-06-08,Project payment - Customer_0029,REF55492277,0.0,81.86,245977.47
2024-06-08,2024-06-08,Invoice payment - Customer_0071,REF46853595,0.0,38.15,246015.62
2024-06-08,2024-06-08,Payment from Customer_0036,REF80618791,0.0,59.95,246075.57
2024-06-08,2024-06-08,Payment from Customer_0066,REF44725713,0.0,48.33,246123.9
2024-06-08,2024-06-08,Invoice payment - Customer_0091,REF10450000,0.0,137.44,246261.34
2024-06-08,2024-06-08,Payment from Customer_0064,REF37547150,0.0,30.65,246291.99
2024-06-09,2024-06-09,Service payment - Customer_0015,REF44845300,0.0,114.33,246406.32
2024-06-09,2024-06-09,Employee payroll,REF40486437,2174.61,0.0,244231.71
2024-06-09,2024-06-09,Service payment - Customer_0018,REF97649613,0.0,71.06,244302.77
2024-06-09,2024-06-09,Invoice payment - Customer_0093,REF66183737,0.0,87.32,244390.09
2024-06-09,2024-06-09,Service payment - Customer_0056,REF32983868,0.0,33.82,244423.91
2024-06-09,2024-06-09,Project payment - Customer_0097,REF91648481,0.0,63.45,244487.36
2024-06-09,2024-06-09,Service payment - Customer_0087,REF83214301,0.0,98.2,244585.56
2024-06-09,2024-06-09,Invoice payment - Customer_0086,REF31815542,0.0,90.15,244675.71
2024-06-10,2024-06-10,Invoice payment - Customer_0055,REF98313956,0.0,70.51,244746.22
2024-06-10,2024-06-10,Project payment - Customer_0006,REF23646728,0.0,68.72,244814.94
2024-06-10,2024-06-10,Project payment - Customer_0020,REF65678350,0.0,123.01,244937.95
2024-06-10,2024-06-10,Payment from Customer_0051,REF38781632,0.0,80.81,245018.76
2024-06-10,2024-06-10,Service payment - Customer_0095,REF51055639,0.0,86.42,245105.18
2024-06-10,2024-06-10,Employee payroll,REF65811626,2236.65,0.0,242868.53
2024-06-10,2024-06-10,Inventory purchase,REF94525502,2382.2,0.0,240486.33
2024-06-11,2024-06-11,Invoice payment - Customer_0021,REF93956190,0.0,66.91,240553.24
2024-06-11,2024-06-11,Service payment - Customer_0040,REF63748030,0.0,43.35,240596.59
2024-06-11,2024-06-11,Invoice payment - Customer_0096,REF74452351,0.0,78.67,240675.26
2024-06-11,2024-06-11,Payment from Customer_0045,REF54831079,0.0,111.83,240787.09
2024-06-11,2024-06-11,Project payment - Customer_0054,REF13418311,0.0,80.96,240868.05
2024-06-11,2024-06-11,Invoice payment - Customer_0094,REF72078255,0.0,77.78,240945.83
2024-06-11,2024-06-11,Service payment - Customer_0033,REF38623269,0.0,70.57,241016.4
2024-06-11,2024-06-11,Project payment - Customer_0009,REF41453450,0.0,66.86,241083.26
2024-06-11,2024-06-11,Service payment - Customer_0037,REF83465733,0.0,156.53,241239.79
2024-06-11,2024-06-11,Project payment - Customer_0088,REF15313800,0.0,90.1,241329.89
2024-06-12,2024-06-12,Project payment - Customer_0085,REF85917417,0.0,103.02,241432.91
2024-06-12,2024-06-12,Invoice payment - Customer_0076,REF45221989,0.0,10.0,241442.91
2024-06-12,2024-06-12,Service payment - Customer_0058,REF55643956,0.0,38.93,241481.84
2024-06-12,2024-06-12,Project payment - Customer_0026,REF53480714,0.0,99.51,241581.35
2024-06-12,2024-06-12,Inventory purchase,REF61944550,2215.79,0.0,239365.56
2024-06-12,2024-06-12,Service payment - Customer_0038,REF61545651,0.0,50.73,239416.29
2024-06-12,2024-06-12,Project payment - Customer_0079,REF44573479,0.0,87.87,239504.16
2024-06-12,2024-06-12,Invoice payment - Customer_0045,REF41868843,0.0,96.82,239600.98
2024-06-12,2024-06-12,Payment from Customer_0098,REF94360364,0.0,89.56,239690.54
2024-06-13,2024-06-13,Payment from Customer_0027,REF27207510,0.0,85.96,239776.5
2024-06-13,2024-06-13,Service payment - Customer_0018,REF53316635,0.0,53.53,239830.03
2024-06-13,2024-06-13,Invoice payment - Customer_0046,REF19338110,0.0,116.82,239946.85
2024-06-13,2024-06-13,Invoice payment - Customer_0044,REF82414672,0.0,42.26,239989.11
2024-06-13,2024-06-13,Project payment - Customer_0082,REF92882736,0.0,159.63,240148.74
2024-06-14,2024-06-14,Invoice payment - Customer_0056,REF41743733,0.0,21.58,240170.32
2024-06-14,2024-06-14,Project payment - Customer_0012,REF17791333,0.0,77.15,240247.47
2024-06-14,2024-06-14,Service payment - Customer_0064,REF54921111,0.0,42.45,240289.92
2024-06-14,2024-06-14,Service payment - Customer_0037,REF87889410,0.0,154.58,240444.5
2024-06-14,2024-06-14,Service payment - Customer_0088,REF35339598,0.0,118.52,240563.02
2024-06-14,2024-06-14,Service payment - Customer_0098,REF66727140,0.0,87.03,240650.05
2024-06-14,2024-06-14,Invoice payment - Customer_0076,REF33885345,0.0,11.24,240661.29
2024-06-14,2024-06-14,Marketing expenses,REF91498221,368.9,0.0,240292.39
2024-06-15,2024-06-15,Project payment - Customer_0026,REF83034249,0.0,99.05,240391.44
2024-06-15,2024-06-15,Payment from Customer_0096,REF71137361,0.0,81.01,240472.45
2024-06-15,2024-06-15,Project payment - Customer_0063,REF64283948,0.0,73.74,240546.19
2024-06-15,2024-06-15,Project payment - Customer_0083,REF40049522,0.0,69.84,240616.03
2024-06-15,2024-06-15,Service payment - Customer_0029,REF99997976,0.0,76.05,240692.08
2024-06-15,2024-06-15,Project payment - Customer_0049,REF15451746,0.0,81.1,240773.18
2024-06-15,2024-06-15,Payment from Customer_0055,REF12069826,0.0,71.43,240844.61
2024-06-15,2024-06-15,Project payment - Customer_0028,REF69980789,0.0,110.66,240955.27
2024-06-15,2024-06-15,Business insurance premium,REF19060791,203.35,0.0,240751.92
2024-06-16,2024-06-16,Project payment - Customer_0091,REF59763596,0.0,117.67,240869.59
2024-06-16,2024-06-16,Service payment - Customer_0002,REF82101733,0.0,93.58,240963.17
2024-06-16,2024-06-16,Invoice payment - Customer_0035,REF89506163,0.0,118.56,241081.73
2024-06-16,2024-06-16,Service payment - Customer_0034,REF24769493,0.0,84.79,241166.52
2024-06-16,2024-06-16,Project payment - Customer_0098,REF90458882,0.0,71.81,241238.33
2024-06-16,2024-06-16,Project payment - Customer_0014,REF19153204,0.0,93.34,241331.67
2024-06-16,2024-06-16,Project payment - Customer_0084,REF50977756,0.0,71.13,241402.8
2024-06-16,2024-06-16,Project payment - Customer_0010,REF83914638,0.0,90.28,241493.08
2024-06-16,2024-06-16,Project payment - Customer_0052,REF19758521,0.0,40.24,241533.32
2024-06-16,2024-06-16,Invoice payment - Customer_0037,REF11991034,0.0,114.01,241647.33
2024-06-16,2024-06-16,Project payment - Customer_0073,REF17162530,0.0,143.83,241791.16
2024-06-17,2024-06-17,Invoice payment - Customer_0085,REF40419496,0.0,104.88,241896.04
2024-06-17,2024-06-17,Invoice payment - Customer_0066,REF78683550,0.0,64.59,241960.63
2024-06-17,2024-06-17,Project payment - Customer_0037,REF24630118,0.0,125.68,242086.31
2024-06-17,2024-06-17,Invoice payment - Customer_0074,REF65214091,0.0,56.85,242143.16
2024-06-17,2024-06-17,Service payment - Customer_0002,REF73192867,0.0,82.75,242225.91
2024-06-17,2024-06-17,Payment from Customer_0022,REF92873306,0.0,71.12,242297.03
2024-06-17,2024-06-17,Project payment - Customer_0012,REF78708826,0.0,65.98,242363.01
2024-06-17,2024-06-17,Invoice payment - Customer_0070,REF15627024,0.0,64.25,242427.26
2024-06-17,2024-06-17,Service payment - Customer_0095,REF39848050,0.0,87.42,242514.68
2024-06-17,2024-06-17,Service payment - Customer_0020,REF54181855,0.0,121.37,242636.05
2024-06-17,2024-06-17,Payment from Customer_0082,REF44688997,0.0,149.66,242785.71
2024-06-17,2024-06-17,Invoice payment - Customer_0094,REF65421364,0.0,90.03,242875.74
2024-06-17,2024-06-17,Invoice payment - Customer_0052,REF74159113,0.0,42.77,242918.51
2024-06-17,2024-06-17,Project payment - Customer_0035,REF60898144,0.0,125.26,243043.77
2024-06-18,2024-06-18,Project payment - Customer_0030,REF16271281,0.0,26.61,243070.38
2024-06-18,2024-06-18,Invoice payment - Customer_0045,REF74510114,0.0,95.34,243165.72
2024-06-18,2024-06-18,Invoice payment - Customer_0020,REF26644167,0.0,83.41,243249.13
2024-06-18,2024-06-18,Invoice payment - Customer_0011,REF36357095,0.0,123.4,243372.53
2024-06-18,2024-06-18,Invoice payment - Customer_0082,REF48156715,0.0,145.18,243517.71
2024-06-18,2024-06-18,Service payment - Customer_0091,REF47449565,0.0,175.55,243693.26
2024-06-18,2024-06-18,Payment from Customer_0097,REF46286250,0.0,56.1,243749.36
2024-06-18,2024-06-18,Service payment - Customer_0046,REF11987892,0.0,149.15,243898.51
2024-06-19,2024-06-19,Project payment - Customer_0077,REF27677830,0.0,92.44,243990.95
2024-06-19,2024-06-19,Invoice payment - Customer_0037,REF70635945,0.0,103.83,244094.78
2024-06-19,2024-06-19,Payment from Customer_0006,REF85383020,0.0,65.8,244160.58
2024-06-19,2024-06-19,Service payment - Customer_0071,REF87763610,0.0,36.28,244196.86
2024-06-19,2024-06-19,Service payment - Customer_0044,REF15462124,0.0,46.08,244242.94
2024-06-19,2024-06-19,Service payment - Customer_0065,REF64804326,0.0,49.37,244292.31
2024-06-19,2024-06-19,Service payment - Customer_0040,REF76774856,0.0,37.12,244329.43
2024-06-19,2024-06-19,Service payment - Customer_0004,REF36167818,0.0,65.3,244394.73
2024-06-19,2024-06-19,Project payment - Customer_0096,REF79118214,0.0,98.84,244493.57
2024-06-19,2024-06-19,Payment from Customer_0062,REF75979060,0.0,65.11,244558.68
2024-06-19,2024-06-19,Invoice payment - Customer_0009,REF73291178,0.0,75.37,244634.05
2024-06-19,2024-06-19,Packaging Shipping expense,REF16535437,155.47,0.0,244478.58
2024-06-19,2024-06-19,Service payment - Customer_0002,REF15662235,0.0,81.48,244560.06
2024-06-19,2024-06-19,Project payment - Customer_0027,REF36141580,0.0,97.0,244657.06
2024-06-19,2024-06-19,Service payment - Customer_0068,REF53359518,0.0,42.91,244699.97
2024-06-19,2024-06-19,Service payment - Customer_0066,REF47364631,0.0,55.67,244755.64
2024-06-19,2024-06-19,Project payment - Customer_0015,REF52316535,0.0,153.58,244909.22
2024-06-19,2024-06-19,Invoice payment - Customer_0032,REF96456037,0.0,59.31,244968.53
2024-06-19,2024-06-19,Invoice payment - Customer_0078,REF17366522,0.0,116.87,245085.4
2024-06-20,2024-06-20,Invoice payment - Customer_0015,REF58394982,0.0,106.17,245191.57
2024-06-20,2024-06-20,Service payment - Customer_0035,REF44535254,0.0,123.62,245315.19
2024-06-20,2024-06-20,Service payment - Customer_0045,REF30717027,0.0,66.23,245381.42
2024-06-20,2024-06-20,Service payment - Customer_0055,REF31328018,0.0,60.58,245442.0
2024-06-20,2024-06-20,Invoice payment - Customer_0079,REF50234817,0.0,77.38,245519.38
2024-06-20,2024-06-20,Project payment - Customer_0018,REF40169626,0.0,73.18,245592.56
2024-06-20,2024-06-20,Project payment - Customer_0037,REF19972686,0.0,121.14,245713.7
2024-06-20,2024-06-20,Payment from Customer_0092,REF16981752,0.0,74.51,245788.21
2024-06-20,2024-06-20,Invoice payment - Customer_0022,REF76040314,0.0,54.6,245842.81
2024-06-20,2024-06-20,Service payment - Customer_0090,REF74497468,0.0,88.54,245931.35
2024-06-21,2024-06-21,Service payment - Customer_0005,REF50355237,0.0,39.64,245970.99
2024-06-21,2024-06-21,Project payment - Customer_0008,REF19040473,0.0,127.15,246098.14
2024-06-21,2024-06-21,Payment from Customer_0014,REF67531463,0.0,90.5,246188.64
2024-06-21,2024-06-21,Invoice payment - Customer_0056,REF99623992,0.0,32.74,246221.38
2024-06-21,2024-06-21,Payment from Customer_0003,REF38314694,0.0,77.59,246298.97
2024-06-21,2024-06-21,Service payment - Customer_0091,REF78969719,0.0,133.3,246432.27
2024-06-21,2024-06-21,Invoice payment - Customer_0055,REF11859028,0.0,62.57,246494.84
2024-06-21,2024-06-21,Payment from Customer_0006,REF17530490,0.0,60.74,246555.58
2024-06-21,2024-06-21,Project payment - Customer_0080,REF14659916,0.0,38.24,246593.82
2024-06-21,2024-06-21,Service payment - Customer_0068,REF93359409,0.0,59.66,246653.48
2024-06-22,2024-06-22,Utility bill payment,REF80496874,155.83,0.0,246497.65
2024-06-22,2024-06-22,Invoice payment - Customer_0092,REF67744474,0.0,80.28,246577.93
2024-06-22,2024-06-22,Project payment - Customer_0031,REF22443278,0.0,97.59,246675.52
2024-06-22,2024-06-22,Project payment - Customer_0005,REF50899939,0.0,33.64,246709.16
2024-06-22,2024-06-22,Service payment - Customer_0090,REF79048308,0.0,120.58,246829.74
2024-06-22,2024-06-22,Service payment - Customer_0066,REF23370638,0.0,61.88,246891.62
2024-06-22,2024-06-22,Service payment - Customer_0077,REF68275424,0.0,77.79,246969.41
2024-06-22,2024-06-22,Service payment - Customer_0034,REF25528453,0.0,79.52,247048.93
2024-06-22,2024-06-22,Payment from Customer_0084,REF93473820,0.0,80.28,247129.21
2024-06-22,2024-06-22,Payment from Customer_0002,REF68099309,0.0,69.46,247198.67
2024-06-22,2024-06-22,Inventory purchase,REF93485648,4258.58,0.0,242940.09
2024-06-23,2024-06-23,Payment from Customer_0047,REF33692871,0.0,104.58,243044.67
2024-06-23,2024-06-23,Invoice payment - Customer_0063,REF38458808,0.0,81.41,243126.08
2024-06-23,2024-06-23,Service payment - Customer_0049,REF50525769,0.0,68.48,243194.56
2024-06-23,2024-06-23,Payment from Customer_0092,REF58429533,0.0,67.27,243261.83
2024-06-23,2024-06-23,Invoice payment - Customer_0050,REF44099076,0.0,163.86,243425.69
2024-06-23,2024-06-23,Service payment - Customer_0033,REF65352679,0.0,71.64,243497.33
2024-06-23,2024-06-23,Payment from Customer_0067,REF97206324,0.0,141.54,243638.87
2024-06-24,2024-06-24,Project payment - Customer_0073,REF89574289,0.0,101.21,243740.08
2024-06-24,2024-06-24,Invoice payment - Customer_0018,REF78458043,0.0,76.27,243816.35
2024-06-24,2024-06-24,Invoice payment - Customer_0077,REF40745701,0.0,63.33,243879.68
2024-06-24,2024-06-24,Invoice payment - Customer_0071,REF27464541,0.0,42.71,243922.39
2024-06-24,2024-06-24,Service payment - Customer_0031,REF85363871,0.0,104.82,244027.21
2024-06-24,2024-06-24,Service payment - Customer_0080,REF54839194,0.0,36.95,244064.16
2024-06-24,2024-06-24,Project payment - Customer_0021,REF80293293,0.0,73.56,244137.72
2024-06-24,2024-06-24,Project payment - Customer_0051,REF95569684,0.0,91.1,244228.82
2024-06-24,2024-06-24,Payment from Customer_0092,REF43957102,0.0,58.59,244287.41
2024-06-24,2024-06-24,Project payment - Customer_0086,REF71260975,0.0,100.29,244387.7
2024-06-25,2024-06-25,Service payment - Customer_0038,REF69402870,0.0,68.38,244456.08
2024-06-25,2024-06-25,Payment from Customer_0077,REF33031946,0.0,102.9,244558.98
2024-06-25,2024-06-25,Payment from Customer_0097,REF17016581,0.0,49.43,244608.41
2024-06-25,2024-06-25,Project payment - Customer_0094,REF68405115,0.0,84.27,244692.68
2024-06-25,2024-06-25,Invoice payment - Customer_0016,REF91202669,0.0,36.08,244728.76
2024-06-25,2024-06-25,Payment from Customer_0021,REF44854607,0.0,70.92,244799.68
2024-06-25,2024-06-25,Invoice payment - Customer_0002,REF89903577,0.0,78.72,244878.4
2024-06-25,2024-06-25,Service payment - Customer_0055,REF68954934,0.0,60.37,244938.77
2024-06-25,2024-06-25,Invoice payment - Customer_0052,REF66512753,0.0,40.06,244978.83
2024-06-26,2024-06-26,Payment from Customer_0033,REF99431303,0.0,69.58,245048.41
2024-06-26,2024-06-26,Invoice payment - Customer_0059,REF22703599,0.0,76.11,245124.52
2024-06-26,2024-06-26,Service payment - Customer_0036,REF48774355,0.0,54.84,245179.36
2024-06-26,2024-06-26,Project payment - Customer_0000,REF74942233,0.0,42.59,245221.95
2024-06-26,2024-06-26,Invoice payment - Customer_0041,REF83043667,0.0,107.33,245329.28
2024-06-26,2024-06-26,Payment from Customer_0098,REF27739903,0.0,70.37,245399.65
2024-06-27,2024-06-27,Service payment - Customer_0028,REF62331139,0.0,94.98,245494.63
2024-06-27,2024-06-27,Invoice payment - Customer_0023,REF48098012,0.0,93.13,245587.76
2024-06-27,2024-06-27,Project payment - Customer_0089,REF87245503,0.0,117.39,245705.15
2024-06-27,2024-06-27,Project payment - Customer_0051,REF19974187,0.0,97.51,245802.66
2024-06-27,2024-06-27,Service payment - Customer_0093,REF51644563,0.0,123.29,245925.95
2024-06-27,2024-06-27,Payment from Customer_0067,REF16589097,0.0,125.91,246051.86
2024-06-27,2024-06-27,Invoice payment - Customer_0009,REF38601793,0.0,59.89,246111.75
2024-06-27,2024-06-27,Service payment - Customer_0050,REF18120496,0.0,161.86,246273.61
2024-06-27,2024-06-27,Project payment - Customer_0098,REF92866069,0.0,62.1,246335.71
2024-06-27,2024-06-27,Service payment - Customer_0084,REF26804060,0.0,92.59,246428.3
2024-06-28,2024-06-28,Project payment - Customer_0044,REF96361379,0.0,31.84,246460.14
2024-06-28,2024-06-28,Inventory purchase,REF12170415,3783.32,0.0,242676.82
2024-06-28,2024-06-28,Invoice payment - Customer_0098,REF69144507,0.0,67.5,242744.32
2024-06-28,2024-06-28,Payment from Customer_0047,REF85609865,0.0,126.65,242870.97
2024-06-28,2024-06-28,Project payment - Customer_0092,REF57171431,0.0,66.6,242937.57
2024-06-29,2024-06-29,Invoice payment - Customer_0042,REF26690610,0.0,94.68,243032.25
2024-06-29,2024-06-29,Payment from Customer_0089,REF79608127,0.0,147.01,243179.26
2024-06-29,2024-06-29,Project payment - Customer_0052,REF70753421,0.0,47.44,243226.7
2024-06-29,2024-06-29,Project payment - Customer_0022,REF74723045,0.0,72.9,243299.6
2024-06-29,2024-06-29,Service payment - Customer_0041,REF22860747,0.0,166.57,243466.17
2024-06-29,2024-06-29,Invoice payment - Customer_0071,REF62397091,0.0,44.79,243510.96
2024-06-29,2024-06-29,Service payment - Customer_0050,REF54243546,0.0,154.11,243665.07
2024-06-29,2024-06-29,Project payment - Customer_0005,REF31740064,0.0,31.46,243696.53
2024-06-29,2024-06-29,Project payment - Customer_0087,REF99526139,0.0,105.97,243802.5
2024-06-29,2024-06-29,Project payment - Customer_0078,REF75911167,0.0,180.45,243982.95
2024-06-29,2024-06-29,Payment from Customer_0076,REF16252975,0.0,10.0,243992.95
2024-06-29,2024-06-29,Project payment - Customer_0029,REF78878697,0.0,90.55,244083.5
2024-06-29,2024-06-29,Project payment - Customer_0074,REF36403467,0.0,45.46,244128.96
2024-06-29,2024-06-29,Packaging Shipping expense,REF10669345,331.19,0.0,243797.77
2024-06-30,2024-06-30,Packaging Shipping expense,REF75801034,203.59,0.0,243594.18
2024-06-30,2024-06-30,Service payment - Customer_0030,REF75091687,0.0,50.14,243644.32
2024-06-30,2024-06-30,Project payment - Customer_0001,REF93909299,0.0,50.68,243695.0
2024-06-30,2024-06-30,Service payment - Customer_0060,REF75710342,0.0,94.65,243789.65
2024-06-30,2024-06-30,Payment from Customer_0032,REF25058803,0.0,68.8,243858.45
2024-06-30,2024-06-30,Payment from Customer_0066,REF67230022,0.0,51.41,243909.86
2024-06-30,2024-06-30,Payment from Customer_0007,REF41624695,0.0,112.74,244022.6
2024-06-30,2024-06-30,Payment from Customer_0063,REF45279831,0.0,46.31,244068.91
2024-06-30,2024-06-30,Invoice payment - Customer_0050,REF48130918,0.0,110.66,244179.57
2024-06-30,2024-06-30,Payment from Customer_0038,REF83043859,0.0,56.75,244236.32
2024-06-30,2024-06-30,Payment from Customer_0000,REF63464755,0.0,45.82,244282.14
2024-06-30,2024-06-30,Payment from Customer_0062,REF74758263,0.0,58.67,244340.81
2024-06-30,2024-06-30,Invoice payment - Customer_0042,REF53792819,0.0,108.77,244449.58
2024-06-30,2024-06-30,Invoice payment - Customer_0095,REF27637568,0.0,61.16,244510.74
2024-06-30,2024-06-30,Service payment - Customer_0031,REF81968253,0.0,110.29,244621.03
2024-06-30,2024-06-30,Invoice payment - Customer_0054,REF34521079,0.0,73.67,244694.7
2024-06-30,2024-06-30,Project payment - Customer_0052,REF42741851,0.0,41.82,244736.52
2024-07-01,2024-07-01,Monthly office rent,REF71899969,1134.37,0.0,243602.15
2024-07-01,2024-07-01,Invoice payment - Customer_0084,REF50424470,0.0,96.54,243698.69
2024-07-01,2024-07-01,Invoice payment - Customer_0008,REF32394569,0.0,105.02,243803.71
2024-07-01,2024-07-01,Invoice payment - Customer_0077,REF40413375,0.0,120.06,243923.77
2024-07-01,2024-07-01,Service payment - Customer_0095,REF35325259,0.0,69.62,243993.39
2024-07-01,2024-07-01,Service payment - Customer_0046,REF98917451,0.0,139.24,244132.63
2024-07-01,2024-07-01,Project payment - Customer_0047,REF49921079,0.0,121.15,244253.78
2024-07-01,2024-07-01,Payment from Customer_0085,REF90061857,0.0,126.26,244380.04
2024-07-01,2024-07-01,Payment from Customer_0013,REF67120691,0.0,85.45,244465.49
2024-07-01,2024-07-01,Project payment - Customer_0042,REF95295937,0.0,65.24,244530.73
2024-07-01,2024-07-01,Project payment - Customer_0076,REF43259091,0.0,10.0,244540.73
2024-07-01,2024-07-01,Service payment - Customer_0010,REF54998277,0.0,73.89,244614.62
2024-07-01,2024-07-01,Service payment - Customer_0083,REF92845145,0.0,75.0,244689.62
2024-07-01,2024-07-01,Project payment - Customer_0015,REF17488887,0.0,128.48,244818.1
2024-07-02,2024-07-02,Employee payroll,REF60073354,2413.84,0.0,242404.26
2024-07-02,2024-07-02,Invoice payment - Customer_0039,REF34751500,0.0,147.26,242551.52
2024-07-02,2024-07-02,Project payment - Customer_0001,REF25117786,0.0,68.2,242619.72
2024-07-02,2024-07-02,Invoice payment - Customer_0040,REF20192095,0.0,36.43,242656.15
2024-07-02,2024-07-02,Payment from Customer_0003,REF63097097,0.0,79.9,242736.05
2024-07-02,2024-07-02,Payment from Customer_0008,REF53055954,0.0,113.55,242849.6
2024-07-02,2024-07-02,Payment from Customer_0038,REF68988707,0.0,61.56,242911.16
2024-07-02,2024-07-02,Service payment - Customer_0088,REF97068401,0.0,113.76,243024.92
2024-07-02,2024-07-02,Payment from Customer_0035,REF44081752,0.0,111.54,243136.46
2024-07-02,2024-07-02,Service payment - Customer_0087,REF23144073,0.0,81.87,243218.33
2024-07-03,2024-07-03,Invoice payment - Customer_0093,REF26114080,0.0,116.0,243334.33
2024-07-03,2024-07-03,Project payment - Customer_0068,REF58950370,0.0,34.33,243368.66
2024-07-03,2024-07-03,Inventory purchase,REF25194274,4066.25,0.0,239302.41
2024-07-03,2024-07-03,Invoice payment - Customer_0092,REF59115364,0.0,68.92,239371.33
2024-07-03,2024-07-03,Service payment - Customer_0002,REF27069755,0.0,101.11,239472.44
2024-07-03,2024-07-03,Service payment - Customer_0012,REF97282832,0.0,74.92,239547.36
2024-07-03,2024-07-03,Project payment - Customer_0053,REF32732568,0.0,128.66,239676.02
2024-07-03,2024-07-03,Project payment - Customer_0016,REF83732639,0.0,29.77,239705.79
2024-07-03,2024-07-03,Project payment - Customer_0019,REF91823964,0.0,85.03,239790.82
2024-07-03,2024-07-03,Service payment - Customer_0083,REF18978007,0.0,54.93,239845.75
2024-07-04,2024-07-04,Payment from Customer_0098,REF19170097,0.0,50.48,239896.23
2024-07-04,2024-07-04,Payment from Customer_0013,REF61986229,0.0,63.03,239959.26
2024-07-04,2024-07-04,Payment from Customer_0014,REF72131048,0.0,110.75,240070.01
2024-07-04,2024-07-04,Invoice payment - Customer_0073,REF86119972,0.0,145.52,240215.53
2024-07-04,2024-07-04,Project payment - Customer_0005,REF57267406,0.0,37.54,240253.07
2024-07-04,2024-07-04,Invoice payment - Customer_0032,REF35877870,0.0,60.39,240313.46
2024-07-04,2024-07-04,Service payment - Customer_0055,REF52427766,0.0,69.1,240382.56
2024-07-04,2024-07-04,Payment from Customer_0026,REF79389750,0.0,122.58,240505.14
2024-07-05,2024-07-05,Invoice payment - Customer_0072,REF74876057,0.0,121.08,240626.22
2024-07-05,2024-07-05,Payment from Customer_0056,REF51339343,0.0,28.77,240654.99
2024-07-05,2024-07-05,Payment from Customer_0078,REF60730109,0.0,99.97,240754.96
2024-07-05,2024-07-05,Payment from Customer_0019,REF59991349,0.0,102.31,240857.27
2024-07-05,2024-07-05,Payment from Customer_0092,REF77727404,0.0,51.22,240908.49
2024-07-05,2024-07-05,Service payment - Customer_0004,REF69298621,0.0,70.87,240979.36
2024-07-05,2024-07-05,Service payment - Customer_0093,REF96277959,0.0,123.95,241103.31
2024-07-05,2024-07-05,Project payment - Customer_0067,REF73910035,0.0,144.56,241247.87
2024-07-06,2024-07-06,Service payment - Customer_0028,REF74663645,0.0,86.13,241334.0
2024-07-06,2024-07-06,Payment from Customer_0037,REF90448711,0.0,156.92,241490.92
2024-07-06,2024-07-06,Payment from Customer_0026,REF90277516,0.0,116.39,241607.31
2024-07-06,2024-07-06,Invoice payment - Customer_0027,REF81921158,0.0,88.41,241695.72
2024-07-06,2024-07-06,Project payment - Customer_0062,REF90917677,0.0,65.99,241761.71
2024-07-06,2024-07-06,Project payment - Customer_0077,REF35104611,0.0,116.12,241877.83
2024-07-06,2024-07-06,Project payment - Customer_0083,REF95375900,0.0,66.21,241944.04
2024-07-06,2024-07-06,Project payment - Customer_0036,REF89964208,0.0,55.41,241999.45
2024-07-07,2024-07-07,Service payment - Customer_0074,REF89682215,0.0,44.35,242043.8
2024-07-07,2024-07-07,Project payment - Customer_0066,REF94185356,0.0,68.66,242112.46
2024-07-07,2024-07-07,Project payment - Customer_0082,REF11198795,0.0,146.22,242258.68
2024-07-07,2024-07-07,Service payment - Customer_0050,REF88545982,0.0,145.5,242404.18
2024-07-07,2024-07-07,Service payment - Customer_0029,REF10173558,0.0,68.84,242473.02
2024-07-07,2024-07-07,Invoice payment - Customer_0024,REF11470059,0.0,74.07,242547.09
2024-07-07,2024-07-07,Payment from Customer_0032,REF55381050,0.0,71.48,242618.57
2024-07-07,2024-07-07,Payment from Customer_0064,REF45329514,0.0,50.74,242669.31
2024-07-07,2024-07-07,Invoice payment - Customer_0014,REF72548376,0.0,124.02,242793.33
2024-07-07,2024-07-07,Payment from Customer_0000,REF50730588,0.0,45.18,242838.51
2024-07-07,2024-07-07,Payment from Customer_0027,REF12581480,0.0,85.92,242924.43
2024-07-07,2024-07-07,Payment from Customer_0019,REF79429917,0.0,79.02,243003.45
2024-07-07,2024-07-07,Payment from Customer_0063,REF65777252,0.0,77.28,243080.73
2024-07-07,2024-07-07,Payment from Customer_0046,REF90649756,0.0,151.62,243232.35
2024-07-07,2024-07-07,Service payment - Customer_0045,REF86626197,0.0,92.63,243324.98
2024-07-07,2024-07-07,Invoice payment - Customer_0058,REF93739268,0.0,50.8,243375.78
2024-07-08,2024-07-08,Project payment - Customer_0028,REF64033221,0.0,100.25,243476.03
2024-07-08,2024-07-08,Invoice payment - Customer_0019,REF93808358,0.0,71.61,243547.64
2024-07-08,2024-07-08,Invoice payment - Customer_0010,REF11941630,0.0,76.35,243623.99
2024-07-08,2024-07-08,Project payment - Customer_0077,REF48596215,0.0,122.89,243746.88
2024-07-08,2024-07-08,Project payment - Customer_0018,REF17260097,0.0,79.78,243826.66
2024-07-08,2024-07-08,Invoice payment - Customer_0061,REF93453013,0.0,125.32,243951.98
2024-07-08,2024-07-08,Project payment - Customer_0014,REF42481830,0.0,82.26,244034.24
2024-07-08,2024-07-08,Project payment - Customer_0052,REF68306422,0.0,47.38,244081.62
2024-07-09,2024-07-09,Payment from Customer_0070,REF87844730,0.0,47.94,244129.56
2024-07-09,2024-07-09,Invoice payment - Customer_0002,REF51296611,0.0,74.44,244204.0
2024-07-09,2024-07-09,Service payment - Customer_0084,REF42092967,0.0,83.68,244287.68
2024-07-09,2024-07-09,Service payment - Customer_0001,REF30586636,0.0,75.27,244362.95
2024-07-09,2024-07-09,Service payment - Customer_0073,REF76051838,0.0,105.75,244468.7
2024-07-09,2024-07-09,Project payment - Customer_0043,REF73645543,0.0,141.25,244609.95
2024-07-09,2024-07-09,Project payment - Customer_0078,REF64818375,0.0,163.07,244773.02
2024-07-09,2024-07-09,Service payment - Customer_0076,REF35971896,0.0,10.03,244783.05
2024-07-09,2024-07-09,Project payment - Customer_0065,REF23305878,0.0,59.37,244842.42
2024-07-09,2024-07-09,Service payment - Customer_0087,REF95004553,0.0,89.27,244931.69
2024-07-10,2024-07-10,Service payment - Customer_0062,REF29630942,0.0,71.56,245003.25
2024-07-10,2024-07-10,Service payment - Customer_0005,REF58494420,0.0,41.4,245044.65
2024-07-10,2024-07-10,Project payment - Customer_0044,REF33669345,0.0,34.81,245079.46
2024-07-10,2024-07-10,Invoice payment - Customer_0096,REF65579995,0.0,65.61,245145.07
2024-07-10,2024-07-10,Project payment - Customer_0078,REF11542700,0.0,127.82,245272.89
2024-07-10,2024-07-10,Payment from Customer_0081,REF10964851,0.0,87.04,245359.93
2024-07-10,2024-07-10,Project payment - Customer_0018,REF35726105,0.0,49.0,245408.93
2024-07-10,2024-07-10,Service payment - Customer_0051,REF28957565,0.0,81.84,245490.77
2024-07-11,2024-07-11,Service payment - Customer_0050,REF68019817,0.0,164.63,245655.4
2024-07-11,2024-07-11,Service payment - Customer_0069,REF13351124,0.0,46.58,245701.98
2024-07-11,2024-07-11,Payment from Customer_0062,REF84620421,0.0,44.33,245746.31
2024-07-11,2024-07-11,Payment from Customer_0084,REF23188978,0.0,84.07,245830.38
2024-07-11,2024-07-11,Service payment - Customer_0000,REF33822362,0.0,40.3,245870.68
2024-07-11,2024-07-11,Payment from Customer_0029,REF13343390,0.0,65.07,245935.75
2024-07-11,2024-07-11,Service payment - Customer_0018,REF68827985,0.0,60.24,245995.99
2024-07-11,2024-07-11,Project payment - Customer_0023,REF25230693,0.0,127.38,246123.37
2024-07-11,2024-07-11,Payment from Customer_0025,REF17300234,0.0,102.95,246226.32
2024-07-11,2024-07-11,Project payment - Customer_0086,REF93081222,0.0,56.49,246282.81
2024-07-12,2024-07-12,Service payment - Customer_0027,REF62203858,0.0,63.05,246345.86
2024-07-12,2024-07-12,Inventory purchase,REF42151408,3706.5,0.0,242639.36
2024-07-12,2024-07-12,Project payment - Customer_0097,REF93792254,0.0,59.62,242698.98
2024-07-12,2024-07-12,Payment from Customer_0036,REF98757181,0.0,75.42,242774.4
2024-07-12,2024-07-12,Invoice payment - Customer_0080,REF69797393,0.0,44.69,242819.09
2024-07-12,2024-07-12,Payment from Customer_0072,REF80756958,0.0,131.31,242950.4
2024-07-12,2024-07-12,Invoice payment - Customer_0071,REF28071953,0.0,43.55,242993.95
2024-07-12,2024-07-12,Payment from Customer_0077,REF39772185,0.0,107.37,243101.32
2024-07-12,2024-07-12,Service payment - Customer_0073,REF61455039,0.0,127.82,243229.14
2024-07-12,2024-07-12,Invoice payment - Customer_0044,REF72273650,0.0,33.88,243263.02
2024-07-13,2024-07-13,Payment from Customer_0042,REF66824495,0.0,97.06,243360.08
2024-07-13,2024-07-13,Project payment - Customer_0054,REF14123723,0.0,71.25,243431.33
2024-07-13,2024-07-13,Service payment - Customer_0098,REF37656120,0.0,76.36,243507.69
2024-07-13,2024-07-13,Payment from Customer_0062,REF19689656,0.0,61.49,243569.18
2024-07-13,2024-07-13,Project payment - Customer_0036,REF62002087,0.0,71.79,243640.97
2024-07-13,2024-07-13,Payment from Customer_0058,REF56866837,0.0,53.3,243694.27
2024-07-13,2024-07-13,Invoice payment - Customer_0072,REF49165654,0.0,108.71,243802.98
2024-07-13,2024-07-13,Project payment - Customer_0005,REF59802545,0.0,36.77,243839.75
2024-07-13,2024-07-13,Project payment - Customer_0011,REF75923964,0.0,116.44,243956.19
2024-07-14,2024-07-14,Invoice payment - Customer_0048,REF23276925,0.0,93.57,244049.76
2024-07-14,2024-07-14,Payment from Customer_0074,REF65043707,0.0,32.83,244082.59
2024-07-14,2024-07-14,Project payment - Customer_0042,REF42100946,0.0,107.89,244190.48
2024-07-14,2024-07-14,Packaging Shipping expense,REF83121481,268.22,0.0,243922.26
2024-07-14,2024-07-14,Service payment - Customer_0079,REF73761527,0.0,89.47,244011.73
2024-07-14,2024-07-14,Payment from Customer_0076,REF82294602,0.0,10.0,244021.73
2024-07-15,2024-07-15,Service payment - Customer_0051,REF67405743,0.0,69.41,244091.14
2024-07-15,2024-07-15,Business insurance premium,REF98682500,181.15,0.0,243909.99
2024-07-15,2024-07-15,Payment from Customer_0027,REF23886259,0.0,86.75,243996.74
2024-07-15,2024-07-15,Project payment - Customer_0006,REF71496393,0.0,61.16,244057.9
2024-07-15,2024-07-15,Project payment - Customer_0062,REF22319665,0.0,73.16,244131.06
2024-07-15,2024-07-15,Service payment - Customer_0050,REF86981586,0.0,120.76,244251.82
2024-07-15,2024-07-15,Payment from Customer_0057,REF36140142,0.0,139.64,244391.46
2024-07-16,2024-07-16,Payment from Customer_0021,REF90448365,0.0,75.65,244467.11
2024-07-16,2024-07-16,Service payment - Customer_0096,REF87563213,0.0,89.56,244556.67
2024-07-16,2024-07-16,Inventory purchase,REF62773936,2276.65,0.0,242280.02
2024-07-16,2024-07-16,Invoice payment - Customer_0028,REF15178835,0.0,105.14,242385.16
2024-07-16,2024-07-16,Project payment - Customer_0060,REF95219011,0.0,83.45,242468.61
2024-07-16,2024-07-16,Project payment - Customer_0085,REF34049223,0.0,135.43,242604.04
2024-07-16,2024-07-16,Project payment - Customer_0005,REF42368918,0.0,33.89,242637.93
2024-07-16,2024-07-16,Payment from Customer_0062,REF92330523,0.0,70.54,242708.47
2024-07-16,2024-07-16,Payment from Customer_0068,REF52813500,0.0,40.51,242748.98
2024-07-16,2024-07-16,Project payment - Customer_0074,REF32162115,0.0,51.09,242800.07
2024-07-16,2024-07-16,Project payment - Customer_0012,REF95903908,0.0,66.97,242867.04
2024-07-17,2024-07-17,Invoice payment - Customer_0070,REF97909340,0.0,55.19,242922.23
2024-07-17,2024-07-17,Payment from Customer_0037,REF14105874,0.0,170.02,243092.25
2024-07-17,2024-07-17,Project payment - Customer_0084,REF83728927,0.0,94.97,243187.22
2024-07-17,2024-07-17,Payment from Customer_0077,REF20337414,0.0,104.28,243291.5
2024-07-17,2024-07-17,Service payment - Customer_0094,REF49626093,0.0,73.27,243364.77
2024-07-17,2024-07-17,Service payment - Customer_0067,REF30268478,0.0,115.75,243480.52
2024-07-17,2024-07-17,Payment from Customer_0082,REF67999249,0.0,133.96,243614.48
2024-07-18,2024-07-18,Service payment - Customer_0081,REF24923291,0.0,92.06,243706.54
2024-07-18,2024-07-18,Payment from Customer_0035,REF94508285,0.0,124.66,243831.2
2024-07-18,2024-07-18,Payment from Customer_0053,REF17270504,0.0,135.36,243966.56
2024-07-18,2024-07-18,Inventory purchase,REF12268258,3792.47,0.0,240174.09
2024-07-18,2024-07-18,Service payment - Customer_0014,REF24399618,0.0,79.07,240253.16
2024-07-18,2024-07-18,Payment from Customer_0096,REF14537408,0.0,106.36,240359.52
2024-07-18,2024-07-18,Payment from Customer_0098,REF70011608,0.0,84.9,240444.42
2024-07-18,2024-07-18,Service payment - Customer_0085,REF39140803,0.0,112.0,240556.42
2024-07-18,2024-07-18,Invoice payment - Customer_0018,REF88746815,0.0,58.54,240614.96
2024-07-18,2024-07-18,Payment from Customer_0062,REF27418672,0.0,61.16,240676.12
2024-07-19,2024-07-19,Invoice payment - Customer_0073,REF40098201,0.0,141.36,240817.48
2024-07-19,2024-07-19,Service payment - Customer_0062,REF83724368,0.0,72.68,240890.16
2024-07-19,2024-07-19,Invoice payment - Customer_0098,REF92187025,0.0,62.5,240952.66
2024-07-19,2024-07-19,Project payment - Customer_0042,REF75544953,0.0,108.9,241061.56
2024-07-19,2024-07-19,Project payment - Customer_0007,REF95576471,0.0,174.31,241235.87
2024-07-19,2024-07-19,Invoice payment - Customer_0069,REF94915037,0.0,63.24,241299.11
2024-07-19,2024-07-19,Project payment - Customer_0031,REF92359542,0.0,110.7,241409.81
2024-07-19,2024-07-19,Service payment - Customer_0094,REF80534343,0.0,85.71,241495.52
2024-07-20,2024-07-20,Invoice payment - Customer_0042,REF37744360,0.0,84.23,241579.75
2024-07-20,2024-07-20,Invoice payment - Customer_0076,REF40988336,0.0,10.37,241590.12
2024-07-20,2024-07-20,Project payment - Customer_0002,REF13225051,0.0,77.49,241667.61
2024-07-20,2024-07-20,Service payment - Customer_0053,REF43913307,0.0,139.78,241807.39
2024-07-20,2024-07-20,Project payment - Customer_0070,REF57755378,0.0,50.18,241857.57
2024-07-20,2024-07-20,Payment from Customer_0043,REF96498468,0.0,132.67,241990.24
2024-07-21,2024-07-21,Service payment - Customer_0066,REF63440848,0.0,69.54,242059.78
2024-07-21,2024-07-21,Payment from Customer_0026,REF12746304,0.0,109.32,242169.1
2024-07-21,2024-07-21,Project payment - Customer_0054,REF27029568,0.0,52.23,242221.33
2024-07-21,2024-07-21,Payment from Customer_0085,REF98343402,0.0,95.65,242316.98
2024-07-21,2024-07-21,Payment from Customer_0025,REF45819242,0.0,117.81,242434.79
2024-07-21,2024-07-21,Invoice payment - Customer_0095,REF82603334,0.0,93.53,242528.32
2024-07-21,2024-07-21,Project payment - Customer_0012,REF42360551,0.0,72.59,242600.91
2024-07-21,2024-07-21,Invoice payment - Customer_0094,REF32830429,0.0,61.36,242662.27
2024-07-21,2024-07-21,Service payment - Customer_0073,REF76163688,0.0,128.46,242790.73
2024-07-21,2024-07-21,Project payment - Customer_0082,REF26479886,0.0,136.94,242927.67
2024-07-21,2024-07-21,Project payment - Customer_0003,REF82683471,0.0,95.13,243022.8
2024-07-21,2024-07-21,Payment from Customer_0002,REF52552700,0.0,80.51,243103.31
2024-07-21,2024-07-21,Project payment - Customer_0086,REF16146092,0.0,96.43,243199.74
2024-07-21,2024-07-21,Payment from Customer_0014,REF50579519,0.0,89.78,243289.52
2024-07-22,2024-07-22,Project payment - Customer_0099,REF14221699,0.0,44.61,243334.13
2024-07-22,2024-07-22,Project payment - Customer_0008,REF53471981,0.0,91.4,243425.53
2024-07-22,2024-07-22,Utility bill payment,REF31481875,153.15,0.0,243272.38
2024-07-22,2024-07-22,Project payment - Customer_0060,REF44896360,0.0,79.14,243351.52
2024-07-22,2024-07-22,Payment from Customer_0054,REF79533371,0.0,66.52,243418.04
2024-07-22,2024-07-22,Service payment - Customer_0020,REF67864138,0.0,119.03,243537.07
2024-07-22,2024-07-22,Payment from Customer_0058,REF12273024,0.0,57.63,243594.7
2024-07-22,2024-07-22,Service payment - Customer_0024,REF44476909,0.0,93.89,243688.59
2024-07-22,2024-07-22,Payment from Customer_0036,REF14360175,0.0,60.16,243748.75
2024-07-22,2024-07-22,Service payment - Customer_0055,REF86790101,0.0,64.35,243813.1
2024-07-23,2024-07-23,Project payment - Customer_0065,REF27217343,0.0,47.27,243860.37
2024-07-23,2024-07-23,Service payment - Customer_0017,REF10524296,0.0,95.7,243956.07
2024-07-23,2024-07-23,Invoice payment - Customer_0014,REF32453469,0.0,67.81,244023.88
2024-07-23,2024-07-23,Invoice payment - Customer_0063,REF92328834,0.0,60.33,244084.21
2024-07-23,2024-07-23,Invoice payment - Customer_0000,REF85895994,0.0,44.8,244129.01
2024-07-23,2024-07-23,Project payment - Customer_0051,REF59990964,0.0,74.0,244203.01
2024-07-23,2024-07-23,Invoice payment - Customer_0022,REF80901004,0.0,74.06,244277.07
2024-07-23,2024-07-23,Payment from Customer_0044,REF37634604,0.0,39.74,244316.81
2024-07-23,2024-07-23,Payment from Customer_0005,REF16585897,0.0,32.86,244349.67
2024-07-23,2024-07-23,Invoice payment - Customer_0046,REF79888018,0.0,117.87,244467.54
2024-07-24,2024-07-24,Inventory purchase,REF52039263,3173.91,0.0,241293.63
2024-07-24,2024-07-24,Payment from Customer_0029,REF71948740,0.0,77.32,241370.95
2024-07-24,2024-07-24,Invoice payment - Customer_0046,REF17353709,0.0,110.51,241481.46
2024-07-24,2024-07-24,Payment from Customer_0065,REF74412732,0.0,40.12,241521.58
2024-07-24,2024-07-24,Service payment - Customer_0034,REF70493691,0.0,87.9,241609.48
2024-07-24,2024-07-24,Payment from Customer_0053,REF35452992,0.0,123.39,241732.87
2024-07-24,2024-07-24,Service payment - Customer_0031,REF55572493,0.0,82.35,241815.22
2024-07-24,2024-07-24,Service payment - Customer_0056,REF66000023,0.0,25.71,241840.93
2024-07-24,2024-07-24,Invoice payment - Customer_0040,REF54222677,0.0,36.23,241877.16
2024-07-25,2024-07-25,Project payment - Customer_0095,REF46236804,0.0,85.04,241962.2
2024-07-25,2024-07-25,Service payment - Customer_0017,REF39248932,0.0,74.64,242036.84
2024-07-25,2024-07-25,Payment from Customer_0049,REF81937974,0.0,97.21,242134.05
2024-07-26,2024-07-26,Project payment - Customer_0094,REF94048333,0.0,84.95,242219.0
2024-07-26,2024-07-26,Project payment - Customer_0078,REF63828007,0.0,129.62,242348.62
2024-07-26,2024-07-26,Project payment - Customer_0025,REF21583989,0.0,120.51,242469.13
2024-07-26,2024-07-26,Payment from Customer_0068,REF11411338,0.0,56.2,242525.33
2024-07-26,2024-07-26,Project payment - Customer_0045,REF39142139,0.0,97.14,242622.47
2024-07-26,2024-07-26,Project payment - Customer_0070,REF17542242,0.0,63.61,242686.08
2024-07-27,2024-07-27,Inventory purchase,REF28254224,2723.83,0.0,239962.25
2024-07-27,2024-07-27,Project payment - Customer_0078,REF66397422,0.0,184.09,240146.34
2024-07-27,2024-07-27,Service payment - Customer_0097,REF83197874,0.0,70.37,240216.71
2024-07-27,2024-07-27,Payment from Customer_0067,REF86984278,0.0,151.02,240367.73
2024-07-27,2024-07-27,Project payment - Customer_0071,REF88981500,0.0,36.34,240404.07
2024-07-27,2024-07-27,Payment from Customer_0089,REF40309349,0.0,133.28,240537.35
2024-07-27,2024-07-27,Invoice payment - Customer_0002,REF53086232,0.0,63.59,240600.94
2024-07-27,2024-07-27,Payment from Customer_0018,REF38079906,0.0,75.49,240676.43
2024-07-27,2024-07-27,Service payment - Customer_0020,REF68222591,0.0,117.77,240794.2
2024-07-27,2024-07-27,Payment from Customer_0073,REF58755175,0.0,150.75,240944.95
2024-07-27,2024-07-27,Invoice payment - Customer_0090,REF37121084,0.0,66.51,241011.46
2024-07-27,2024-07-27,Payment from Customer_0031,REF57107760,0.0,111.26,241122.72
2024-07-28,2024-07-28,Project payment - Customer_0083,REF25722392,0.0,58.85,241181.57
2024-07-28,2024-07-28,Payment from Customer_0022,REF54511255,0.0,60.9,241242.47
2024-07-28,2024-07-28,Project payment - Customer_0003,REF74204151,0.0,64.87,241307.34
2024-07-28,2024-07-28,Invoice payment - Customer_0025,REF78044676,0.0,115.15,241422.49
2024-07-28,2024-07-28,Project payment - Customer_0082,REF61289585,0.0,119.77,241542.26
2024-07-28,2024-07-28,Payment from Customer_0042,REF31271521,0.0,117.97,241660.23
2024-07-28,2024-07-28,Service payment - Customer_0095,REF95741325,0.0,64.02,241724.25
2024-07-28,2024-07-28,Project payment - Customer_0007,REF71798388,0.0,119.57,241843.82
2024-07-28,2024-07-28,Payment from Customer_0032,REF38002000,0.0,87.31,241931.13
2024-07-29,2024-07-29,Invoice payment - Customer_0044,REF30392248,0.0,40.08,241971.21
2024-07-29,2024-07-29,Project payment - Customer_0038,REF40811797,0.0,64.04,242035.25
2024-07-29,2024-07-29,Invoice payment - Customer_0043,REF68292472,0.0,136.84,242172.09
2024-07-29,2024-07-29,Service payment - Customer_0050,REF61753729,0.0,116.84,242288.93
2024-07-29,2024-07-29,Invoice payment - Customer_0091,REF88900146,0.0,115.93,242404.86
2024-07-29,2024-07-29,Invoice payment - Customer_0049,REF33528601,0.0,104.45,242509.31
2024-07-29,2024-07-29,Invoice payment - Customer_0086,REF75173297,0.0,86.01,242595.32
2024-07-29,2024-07-29,Service payment - Customer_0061,REF62997607,0.0,119.35,242714.67
2024-07-29,2024-07-29,Payment from Customer_0048,REF48644621,0.0,105.88,242820.55
2024-07-29,2024-07-29,Invoice payment - Customer_0051,REF51006160,0.0,85.59,242906.14
2024-07-29,2024-07-29,Payment from Customer_0092,REF63536025,0.0,67.38,242973.52
2024-07-29,2024-07-29,Service payment - Customer_0084,REF51293852,0.0,81.98,243055.5
2024-07-30,2024-07-30,Service payment - Customer_0031,REF37014406,0.0,112.15,243167.65
2024-07-30,2024-07-30,Payment from Customer_0083,REF30624049,0.0,61.83,243229.48
2024-07-30,2024-07-30,Project payment - Customer_0017,REF53948415,0.0,88.79,243318.27
2024-07-30,2024-07-30,Payment from Customer_0047,REF65972474,0.0,84.98,243403.25
2024-07-30,2024-07-30,Project payment - Customer_0082,REF91850694,0.0,168.89,243572.14
2024-07-30,2024-07-30,Invoice payment - Customer_0043,REF15398519,0.0,117.89,243690.03
2024-07-30,2024-07-30,Service payment - Customer_0058,REF24193839,0.0,35.04,243725.07
2024-07-30,2024-07-30,Project payment - Customer_0019,REF73115956,0.0,94.83,243819.9
2024-07-30,2024-07-30,Invoice payment - Customer_0005,REF77157424,0.0,35.44,243855.34
2024-07-30,2024-07-30,Invoice payment - Customer_0023,REF57818242,0.0,112.38,243967.72
2024-07-30,2024-07-30,Invoice payment - Customer_0063,REF18188231,0.0,58.19,244025.91
2024-07-31,2024-07-31,Pos Systems expense,REF63069052,57.08,0.0,243968.83
2024-07-31,2024-07-31,Payment from Customer_0010,REF82072959,0.0,61.6,244030.43
2024-07-31,2024-07-31,Project payment - Customer_0065,REF87273875,0.0,41.95,244072.38
2024-07-31,2024-07-31,Project payment - Customer_0003,REF25078968,0.0,61.8,244134.18
2024-07-31,2024-07-31,Payment from Customer_0032,REF87111663,0.0,68.79,244202.97
2024-07-31,2024-07-31,Project payment - Customer_0086,REF75475295,0.0,78.05,244281.02
2024-08-01,2024-08-01,Packaging Shipping expense,REF89944396,286.94,0.0,243994.08
2024-08-01,2024-08-01,Monthly office rent,REF10869905,1264.12,0.0,242729.96
2024-08-01,2024-08-01,Payment from Customer_0091,REF89302170,0.0,107.06,242837.02
2024-08-01,2024-08-01,Project payment - Customer_0024,REF32251195,0.0,105.78,242942.8
2024-08-01,2024-08-01,Service payment - Customer_0094,REF63036799,0.0,80.98,243023.78
2024-08-01,2024-08-01,Service payment - Customer_0003,REF21379955,0.0,93.3,243117.08
2024-08-01,2024-08-01,Service payment - Customer_0058,REF84030459,0.0,30.34,243147.42
2024-08-01,2024-08-01,Project payment - Customer_0082,REF48925926,0.0,134.71,243282.13
2024-08-01,2024-08-01,Invoice payment - Customer_0072,REF38667293,0.0,138.67,243420.8
2024-08-02,2024-08-02,Invoice payment - Customer_0079,REF46315553,0.0,100.74,243521.54
2024-08-02,2024-08-02,Invoice payment - Customer_0011,REF42184131,0.0,74.44,243595.98
2024-08-02,2024-08-02,Service payment - Customer_0001,REF90301687,0.0,88.79,243684.77
2024-08-02,2024-08-02,Payment from Customer_0012,REF95994290,0.0,71.36,243756.13
2024-08-02,2024-08-02,Project payment - Customer_0046,REF91059139,0.0,126.77,243882.9
2024-08-02,2024-08-02,Service payment - Customer_0098,REF45139729,0.0,87.8,243970.7
2024-08-02,2024-08-02,Invoice payment - Customer_0081,REF95198102,0.0,65.62,244036.32
2024-08-02,2024-08-02,Service payment - Customer_0051,REF72744146,0.0,79.21,244115.53
2024-08-02,2024-08-02,Service payment - Customer_0042,REF58975065,0.0,103.3,244218.83
2024-08-02,2024-08-02,Service payment - Customer_0083,REF95687468,0.0,74.76,244293.59
2024-08-03,2024-08-03,Service payment - Customer_0031,REF16816168,0.0,98.22,244391.81
2024-08-03,2024-08-03,Payment from Customer_0033,REF82272795,0.0,70.53,244462.34
2024-08-03,2024-08-03,Service payment - Customer_0076,REF54896678,0.0,10.0,244472.34
2024-08-03,2024-08-03,Invoice payment - Customer_0085,REF49425626,0.0,103.15,244575.49
2024-08-03,2024-08-03,Invoice payment - Customer_0074,REF64818366,0.0,46.7,244622.19
2024-08-03,2024-08-03,Payment from Customer_0066,REF95059550,0.0,55.29,244677.48
2024-08-03,2024-08-03,Invoice payment - Customer_0084,REF82177536,0.0,73.39,244750.87
2024-08-03,2024-08-03,Service payment - Customer_0060,REF94685358,0.0,72.0,244822.87
2024-08-03,2024-08-03,Service payment - Customer_0024,REF59377650,0.0,92.54,244915.41
2024-08-03,2024-08-03,Invoice payment - Customer_0071,REF53965461,0.0,38.64,244954.05
2024-08-03,2024-08-03,Project payment - Customer_0088,REF35389348,0.0,120.82,245074.87
2024-08-03,2024-08-03,Invoice payment - Customer_0081,REF92515585,0.0,58.71,245133.58
2024-08-03,2024-08-03,Inventory purchase,REF90823218,2706.21,0.0,242427.37
2024-08-04,2024-08-04,Project payment - Customer_0093,REF93338894,0.0,124.7,242552.07
2024-08-04,2024-08-04,Payment from Customer_0007,REF13166821,0.0,180.66,242732.73
2024-08-04,2024-08-04,Project payment - Customer_0047,REF51123343,0.0,91.52,242824.25
2024-08-04,2024-08-04,Project payment - Customer_0098,REF14922455,0.0,68.55,242892.8
2024-08-04,2024-08-04,Payment from Customer_0032,REF27153646,0.0,74.18,242966.98
2024-08-05,2024-08-05,Service payment - Customer_0000,REF68265353,0.0,44.81,243011.79
2024-08-05,2024-08-05,Invoice payment - Customer_0071,REF34931966,0.0,35.37,243047.16
2024-08-05,2024-08-05,Service payment - Customer_0003,REF11954557,0.0,74.59,243121.75
2024-08-05,2024-08-05,Payment from Customer_0077,REF99951463,0.0,107.64,243229.39
2024-08-05,2024-08-05,Service payment - Customer_0079,REF82913157,0.0,77.38,243306.77
2024-08-05,2024-08-05,Project payment - Customer_0017,REF56489015,0.0,70.18,243376.95
2024-08-05,2024-08-05,Service payment - Customer_0082,REF32616334,0.0,186.04,243562.99
2024-08-05,2024-08-05,Invoice payment - Customer_0094,REF56214793,0.0,79.1,243642.09
2024-08-06,2024-08-06,Invoice payment - Customer_0071,REF23667600,0.0,56.57,243698.66
2024-08-06,2024-08-06,Payment from Customer_0091,REF68515441,0.0,105.68,243804.34
2024-08-06,2024-08-06,Service payment - Customer_0019,REF42448417,0.0,70.1,243874.44
2024-08-06,2024-08-06,Invoice payment - Customer_0052,REF84217315,0.0,45.47,243919.91
2024-08-06,2024-08-06,Invoice payment - Customer_0089,REF36196362,0.0,155.28,244075.19
2024-08-06,2024-08-06,Service payment - Customer_0063,REF97288760,0.0,92.53,244167.72
2024-08-06,2024-08-06,Invoice payment - Customer_0041,REF94880092,0.0,131.43,244299.15
2024-08-06,2024-08-06,Payment from Customer_0068,REF27210520,0.0,48.82,244347.97
2024-08-06,2024-08-06,Payment from Customer_0018,REF83176707,0.0,81.31,244429.28
2024-08-06,2024-08-06,Payment from Customer_0022,REF30715627,0.0,70.28,244499.56
2024-08-06,2024-08-06,Service payment - Customer_0031,REF29644072,0.0,93.58,244593.14
2024-08-07,2024-08-07,Invoice payment - Customer_0092,REF97439001,0.0,83.22,244676.36
2024-08-07,2024-08-07,Service payment - Customer_0058,REF80988047,0.0,45.47,244721.83
2024-08-07,2024-08-07,Invoice payment - Customer_0014,REF34712254,0.0,96.74,244818.57
2024-08-07,2024-08-07,Project payment - Customer_0029,REF15315704,0.0,82.16,244900.73
2024-08-07,2024-08-07,Project payment - Customer_0046,REF86321237,0.0,134.73,245035.46
2024-08-07,2024-08-07,Service payment - Customer_0094,REF61070953,0.0,72.44,245107.9
2024-08-07,2024-08-07,Invoice payment - Customer_0004,REF47741549,0.0,56.74,245164.64
2024-08-07,2024-08-07,Service payment - Customer_0082,REF76764844,0.0,152.31,245316.95
2024-08-07,2024-08-07,Payment from Customer_0078,REF37661036,0.0,131.28,245448.23
2024-08-07,2024-08-07,Invoice payment - Customer_0025,REF26512032,0.0,116.4,245564.63
2024-08-07,2024-08-07,Invoice payment - Customer_0059,REF45594453,0.0,62.62,245627.25
2024-08-07,2024-08-07,Inventory purchase,REF71658652,3392.18,0.0,242235.07
2024-08-08,2024-08-08,Payment from Customer_0058,REF65305785,0.0,47.98,242283.05
2024-08-08,2024-08-08,Project payment - Customer_0084,REF50244106,0.0,70.74,242353.79
2024-08-08,2024-08-08,Invoice payment - Customer_0032,REF29699421,0.0,80.66,242434.45
2024-08-08,2024-08-08,Service payment - Customer_0059,REF81899507,0.0,81.94,242516.39
2024-08-08,2024-08-08,Project payment - Customer_0013,REF57716128,0.0,61.35,242577.74
2024-08-08,2024-08-08,Service payment - Customer_0015,REF65142384,0.0,132.54,242710.28
2024-08-08,2024-08-08,Payment from Customer_0067,REF74488588,0.0,132.73,242843.01
2024-08-08,2024-08-08,Project payment - Customer_0068,REF97784699,0.0,47.42,242890.43
2024-08-09,2024-08-09,Invoice payment - Customer_0099,REF88949758,0.0,41.63,242932.06
2024-08-09,2024-08-09,Payment from Customer_0084,REF35530327,0.0,76.73,243008.79
2024-08-09,2024-08-09,Service payment - Customer_0024,REF14006623,0.0,79.3,243088.09
2024-08-09,2024-08-09,Project payment - Customer_0066,REF90306820,0.0,53.17,243141.26
2024-08-09,2024-08-09,Service payment - Customer_0053,REF20407684,0.0,106.9,243248.16
2024-08-09,2024-08-09,Payment from Customer_0087,REF46109474,0.0,79.76,243327.92
2024-08-09,2024-08-09,Service payment - Customer_0029,REF20902008,0.0,79.19,243407.11
2024-08-09,2024-08-09,Payment from Customer_0037,REF66520453,0.0,135.41,243542.52
2024-08-10,2024-08-10,Professional Services expense,REF71513227,212.67,0.0,243329.85
2024-08-10,2024-08-10,Invoice payment - Customer_0014,REF26259947,0.0,91.83,243421.68
2024-08-10,2024-08-10,Service payment - Customer_0083,REF18722293,0.0,60.2,243481.88
2024-08-10,2024-08-10,Payment from Customer_0064,REF59235352,0.0,36.18,243518.06
2024-08-10,2024-08-10,Invoice payment - Customer_0034,REF20917672,0.0,70.44,243588.5
2024-08-10,2024-08-10,Invoice payment - Customer_0059,REF53494747,0.0,90.33,243678.83
2024-08-10,2024-08-10,Project payment - Customer_0012,REF33987912,0.0,87.23,243766.06
2024-08-10,2024-08-10,Project payment - Customer_0004,REF95589107,0.0,52.87,243818.93
2024-08-10,2024-08-10,Invoice payment - Customer_0026,REF24859036,0.0,133.25,243952.18
2024-08-11,2024-08-11,Payment from Customer_0024,REF42250949,0.0,104.58,244056.76
2024-08-11,2024-08-11,Project payment - Customer_0027,REF68503692,0.0,98.93,244155.69
2024-08-11,2024-08-11,Service payment - Customer_0094,REF85971983,0.0,90.23,244245.92
2024-08-11,2024-08-11,Invoice payment - Customer_0051,REF63000384,0.0,75.89,244321.81
2024-08-11,2024-08-11,Invoice payment - Customer_0068,REF66224083,0.0,43.97,244365.78
2024-08-11,2024-08-11,Payment from Customer_0039,REF88622268,0.0,130.61,244496.39
2024-08-11,2024-08-11,Project payment - Customer_0047,REF42548083,0.0,96.56,244592.95
2024-08-11,2024-08-11,Payment from Customer_0050,REF91655624,0.0,209.06,244802.01
2024-08-11,2024-08-11,Payment from Customer_0069,REF83228771,0.0,49.06,244851.07
2024-08-11,2024-08-11,Invoice payment - Customer_0096,REF45567884,0.0,97.39,244948.46
2024-08-12,2024-08-12,Project payment - Customer_0052,REF56124205,0.0,38.1,244986.56
2024-08-12,2024-08-12,Project payment - Customer_0089,REF45961566,0.0,192.71,245179.27
2024-08-12,2024-08-12,Payment from Customer_0066,REF45446167,0.0,63.28,245242.55
2024-08-12,2024-08-12,Project payment - Customer_0074,REF17551189,0.0,34.56,245277.11
2024-08-12,2024-08-12,Project payment - Customer_0056,REF33202485,0.0,31.1,245308.21
2024-08-13,2024-08-13,Payment from Customer_0009,REF42226726,0.0,83.3,245391.51
2024-08-13,2024-08-13,Service payment - Customer_0074,REF95136198,0.0,44.27,245435.78
2024-08-13,2024-08-13,Service payment - Customer_0034,REF21533637,0.0,76.47,245512.25
2024-08-13,2024-08-13,Inventory purchase,REF44137359,2852.26,0.0,242659.99
2024-08-13,2024-08-13,Service payment - Customer_0089,REF26650661,0.0,153.67,242813.66
2024-08-13,2024-08-13,Invoice payment - Customer_0002,REF54716274,0.0,87.86,242901.52
2024-08-13,2024-08-13,Invoice payment - Customer_0013,REF71858743,0.0,65.3,242966.82
2024-08-13,2024-08-13,Invoice payment - Customer_0025,REF17757048,0.0,115.27,243082.09
2024-08-13,2024-08-13,Payment from Customer_0097,REF41802656,0.0,66.71,243148.8
2024-08-13,2024-08-13,Service payment - Customer_0051,REF57755853,0.0,93.18,243241.98
2024-08-13,2024-08-13,Invoice payment - Customer_0030,REF74315400,0.0,37.21,243279.19
2024-08-14,2024-08-14,Service payment - Customer_0085,REF69398990,0.0,128.24,243407.43
2024-08-14,2024-08-14,Invoice payment - Customer_0022,REF58269981,0.0,78.06,243485.49
2024-08-14,2024-08-14,Payment from Customer_0024,REF29737116,0.0,61.35,243546.84
2024-08-14,2024-08-14,Project payment - Customer_0092,REF80451746,0.0,74.57,243621.41
2024-08-14,2024-08-14,Service payment - Customer_0031,REF54067292,0.0,84.45,243705.86
2024-08-14,2024-08-14,Project payment - Customer_0002,REF50766798,0.0,99.05,243804.91
2024-08-14,2024-08-14,Invoice payment - Customer_0079,REF98801545,0.0,83.27,243888.18
2024-08-14,2024-08-14,Invoice payment - Customer_0034,REF40180759,0.0,101.82,243990.0
2024-08-14,2024-08-14,Service payment - Customer_0042,REF70528822,0.0,106.95,244096.95
2024-08-15,2024-08-15,Project payment - Customer_0060,REF58350536,0.0,109.45,244206.4
2024-08-15,2024-08-15,Project payment - Customer_0039,REF31543844,0.0,118.68,244325.08
2024-08-15,2024-08-15,Service payment - Customer_0049,REF34427671,0.0,90.36,244415.44
2024-08-15,2024-08-15,Payment from Customer_0062,REF79527661,0.0,53.02,244468.46
2024-08-15,2024-08-15,Payment from Customer_0089,REF90814495,0.0,105.66,244574.12
2024-08-15,2024-08-15,Business insurance premium,REF15237025,186.9,0.0,244387.22
2024-08-16,2024-08-16,Employee payroll,REF77891768,1913.3,0.0,242473.92
2024-08-16,2024-08-16,Project payment - Customer_0007,REF43754295,0.0,109.08,242583.0
2024-08-16,2024-08-16,Payment from Customer_0003,REF73156434,0.0,59.6,242642.6
2024-08-16,2024-08-16,Service payment - Customer_0002,REF97596685,0.0,85.48,242728.08
2024-08-16,2024-08-16,Payment from Customer_0019,REF12620358,0.0,93.19,242821.27
2024-08-16,2024-08-16,Payment from Customer_0079,REF22121083,0.0,106.96,242928.23
2024-08-16,2024-08-16,Invoice payment - Customer_0032,REF14097876,0.0,94.66,243022.89
2024-08-16,2024-08-16,Invoice payment - Customer_0066,REF89233980,0.0,69.09,243091.98
2024-08-16,2024-08-16,Service payment - Customer_0054,REF68670422,0.0,84.19,243176.17
2024-08-16,2024-08-16,Project payment - Customer_0081,REF97846126,0.0,100.02,243276.19
2024-08-17,2024-08-17,Service payment - Customer_0086,REF48380332,0.0,82.41,243358.6
2024-08-17,2024-08-17,Payment from Customer_0097,REF89576496,0.0,50.96,243409.56
2024-08-17,2024-08-17,Payment from Customer_0022,REF73669503,0.0,76.21,243485.77
2024-08-17,2024-08-17,Packaging Shipping expense,REF59436719,174.41,0.0,243311.36
2024-08-17,2024-08-17,Invoice payment - Customer_0054,REF26703117,0.0,64.44,243375.8
2024-08-17,2024-08-17,Payment from Customer_0013,REF12730258,0.0,65.76,243441.56
2024-08-17,2024-08-17,Payment from Customer_0025,REF84908781,0.0,111.89,243553.45
2024-08-17,2024-08-17,Invoice payment - Customer_0088,REF44761297,0.0,139.77,243693.22
2024-08-17,2024-08-17,Invoice payment - Customer_0062,REF47553258,0.0,56.36,243749.58
2024-08-17,2024-08-17,Project payment - Customer_0093,REF19767199,0.0,112.26,243861.84
2024-08-17,2024-08-17,Project payment - Customer_0004,REF14992717,0.0,54.92,243916.76
2024-08-17,2024-08-17,Project payment - Customer_0034,REF41409046,0.0,78.17,243994.93
2023-08-18,2023-08-18,Inventory purchase,REF34919366,4403.4,0.0,1292.88
2023-08-18,2023-08-18,Payment from Customer_0006,REF46479759,0.0,14.78,1307.66
2023-08-18,2023-08-18,Service payment - Customer_0039,REF87359932,0.0,146.22,1453.88
2023-08-18,2023-08-18,Project payment - Customer_0067,REF45088294,0.0,48.93,1502.81
2023-08-18,2023-08-18,Service payment - Customer_0094,REF53009480,0.0,27.78,1530.59
2023-08-18,2023-08-18,Payment from Customer_0024,REF77846753,0.0,103.9,1634.49
2023-08-18,2023-08-18,Invoice payment - Customer_0012,REF36623694,0.0,88.59,1723.08
2023-08-19,2023-08-19,Payment from Customer_0000,REF75164681,0.0,61.04,1784.12
2023-08-19,2023-08-19,Service payment - Customer_0029,REF96387390,0.0,63.63,1847.75
2023-08-19,2023-08-19,Service payment - Customer_0092,REF71888906,0.0,110.72,1958.47
2023-08-19,2023-08-19,Invoice payment - Customer_0083,REF44751376,0.0,35.2,1993.67
2023-08-19,2023-08-19,Payment from Customer_0091,REF47783501,0.0,120.0,2113.67
2023-08-19,2023-08-19,Invoice payment - Customer_0025,REF49244117,0.0,94.78,2208.45
2023-08-19,2023-08-19,Service payment - Customer_0044,REF81136704,0.0,97.48,2305.93
2023-08-19,2023-08-19,Service payment - Customer_0090,REF49657097,0.0,65.78,2371.71
2023-08-19,2023-08-19,Project payment - Customer_0023,REF35753511,0.0,48.93,2420.64
2023-08-19,2023-08-19,Project payment - Customer_0060,REF77718709,0.0,63.47,2484.11
2023-08-20,2023-08-20,Project payment - Customer_0041,REF14283003,0.0,48.97,2533.08
2023-08-20,2023-08-20,Invoice payment - Customer_0085,REF36589737,0.0,80.1,2613.18
2023-08-20,2023-08-20,Invoice payment - Customer_0088,REF77490624,0.0,16.12,2629.3
2023-08-20,2023-08-20,Service payment - Customer_0053,REF76842704,0.0,203.84,2833.14
2023-08-20,2023-08-20,Payment from Customer_0071,REF94068667,0.0,59.95,2893.09
2023-08-20,2023-08-20,Project payment - Customer_0022,REF87922106,0.0,72.21,2965.3
2023-08-20,2023-08-20,Invoice payment - Customer_0062,REF42443093,0.0,146.64,3111.94
2023-08-20,2023-08-20,Project payment - Customer_0016,REF21619004,0.0,30.87,3142.81
2023-08-20,2023-08-20,Service payment - Customer_0010,REF95227558,0.0,110.39,3253.2
2023-08-21,2023-08-21,Invoice payment - Customer_0035,REF42545251,0.0,69.23,3322.43
2023-08-21,2023-08-21,Project payment - Customer_0066,REF33443526,0.0,105.28,3427.71
2023-08-21,2023-08-21,Invoice payment - Customer_0001,REF33151266,0.0,69.21,3496.92
2023-08-21,2023-08-21,Invoice payment - Customer_0037,REF70804460,0.0,124.18,3621.1
2023-08-21,2023-08-21,Invoice payment - Customer_0014,REF16944737,0.0,66.73,3687.83
2023-08-21,2023-08-21,Project payment - Customer_0083,REF85095343,0.0,32.13,3719.96
2023-08-21,2023-08-21,Payment from Customer_0028,REF82069544,0.0,94.0,3813.96
2023-08-21,2023-08-21,Invoice payment - Customer_0046,REF16570447,0.0,69.13,3883.09
2023-08-21,2023-08-21,Invoice payment - Customer_0050,REF77985830,0.0,65.23,3948.32
2023-08-21,2023-08-21,Invoice payment - Customer_0085,REF14088441,0.0,62.57,4010.89
2023-08-22,2023-08-22,Utility bill payment,REF21726046,152.67,0.0,3858.22
2023-08-22,2023-08-22,Project payment - Customer_0038,REF85340029,0.0,25.13,3883.35
2023-08-22,2023-08-22,Invoice payment - Customer_0050,REF11586131,0.0,62.91,3946.26
2023-08-22,2023-08-22,Payment from Customer_0030,REF41537282,0.0,61.22,4007.48
2023-08-22,2023-08-22,Project payment - Customer_0072,REF24463105,0.0,72.35,4079.83
2023-08-22,2023-08-22,Payment from Customer_0014,REF62799166,0.0,102.01,4181.84
2023-08-22,2023-08-22,Service payment - Customer_0075,REF94060302,0.0,59.42,4241.26
2023-08-22,2023-08-22,Invoice payment - Customer_0004,REF70190326,0.0,45.32,4286.58
2023-08-22,2023-08-22,Invoice payment - Customer_0064,REF29247541,0.0,44.21,4330.79
2023-08-22,2023-08-22,Service payment - Customer_0087,REF58331056,0.0,92.59,4423.38
2023-08-22,2023-08-22,Service payment - Customer_0022,REF87728989,0.0,73.8,4497.18
2023-08-22,2023-08-22,Service payment - Customer_0082,REF10725668,0.0,46.8,4543.98
2023-08-22,2023-08-22,Project payment - Customer_0083,REF99596450,0.0,36.95,4580.93
2023-08-23,2023-08-23,Invoice payment - Customer_0050,REF83908050,0.0,71.65,4652.58
2023-08-23,2023-08-23,Marketing expenses,REF43791403,329.64,0.0,4322.94
2023-08-23,2023-08-23,Project payment - Customer_0071,REF86123296,0.0,59.23,4382.17
2023-08-23,2023-08-23,Service payment - Customer_0047,REF52250543,0.0,57.2,4439.37
2023-08-23,2023-08-23,Service payment - Customer_0093,REF96702507,0.0,43.37,4482.74
2023-08-23,2023-08-23,Service payment - Customer_0084,REF10532617,0.0,48.76,4531.5
2023-08-23,2023-08-23,Service payment - Customer_0015,REF98107145,0.0,69.37,4600.87
2023-08-23,2023-08-23,Service payment - Customer_0041,REF58129715,0.0,48.15,4649.02
2023-08-23,2023-08-23,Invoice payment - Customer_0068,REF45526474,0.0,80.96,4729.98
2023-08-23,2023-08-23,Invoice payment - Customer_0090,REF42539050,0.0,68.74,4798.72
2023-08-23,2023-08-23,Service payment - Customer_0022,REF18374478,0.0,74.88,4873.6
2023-08-23,2023-08-23,Project payment - Customer_0066,REF29063716,0.0,113.94,4987.54
2023-08-23,2023-08-23,Pos Systems expense,REF45510215,52.45,0.0,4935.09
2023-08-24,2023-08-24,Inventory purchase,REF46069688,5358.18,0.0,-423.09
2023-08-24,2023-08-24,Payment from Customer_0033,REF73987106,0.0,74.62,-348.47
2023-08-24,2023-08-24,Invoice payment - Customer_0084,REF53377452,0.0,45.72,-302.75
2023-08-24,2023-08-24,Project payment - Customer_0018,REF33901286,0.0,39.43,-263.32
2023-08-24,2023-08-24,Service payment - Customer_0088,REF25738408,0.0,11.97,-251.35
2023-08-24,2023-08-24,Payment from Customer_0070,REF88489037,0.0,55.62,-195.73
2023-08-24,2023-08-24,Project payment - Customer_0019,REF87515355,0.0,75.05,-120.68
2023-08-24,2023-08-24,Payment from Customer_0011,REF85891308,0.0,44.56,-76.12
2023-08-24,2023-08-24,Service payment - Customer_0028,REF21056226,0.0,96.5,20.38
2023-08-24,2023-08-24,Invoice payment - Customer_0041,REF67025051,0.0,56.8,77.18
2023-08-24,2023-08-24,Invoice payment - Customer_0024,REF18901267,0.0,121.64,198.82
2023-08-24,2023-08-24,Payment from Customer_0017,REF62698583,0.0,119.72,318.54
2023-08-24,2023-08-24,Service payment - Customer_0021,REF34209765,0.0,43.2,361.74
2023-08-24,2023-08-24,Invoice payment - Customer_0085,REF85932527,0.0,77.74,439.48
2023-08-25,2023-08-25,Invoice payment - Customer_0032,REF19240744,0.0,131.16,570.64
2023-08-25,2023-08-25,Payment from Customer_0090,REF80836450,0.0,69.8,640.44
2023-08-25,2023-08-25,Service payment - Customer_0001,REF64035210,0.0,66.25,706.69
2023-08-25,2023-08-25,Payment from Customer_0029,REF90178001,0.0,70.08,776.77
2023-08-25,2023-08-25,Payment from Customer_0095,REF67778515,0.0,123.68,900.45
2023-08-25,2023-08-25,Service payment - Customer_0067,REF30095434,0.0,43.0,943.45
2023-08-25,2023-08-25,Project payment - Customer_0053,REF85476389,0.0,141.29,1084.74
2023-08-25,2023-08-25,Payment from Customer_0098,REF73044976,0.0,68.85,1153.59
2023-08-26,2023-08-26,Service payment - Customer_0096,REF66614439,0.0,35.76,1189.35
2023-08-26,2023-08-26,Payment from Customer_0052,REF88129326,0.0,93.79,1283.14
2023-08-26,2023-08-26,Invoice payment - Customer_0022,REF31960279,0.0,69.81,1352.95
2023-08-26,2023-08-26,Invoice payment - Customer_0018,REF53059015,0.0,52.18,1405.13
2023-08-26,2023-08-26,Invoice payment - Customer_0013,REF47140527,0.0,53.1,1458.23
2023-08-26,2023-08-26,Pos Systems expense,REF58880834,41.43,0.0,1416.8
2023-08-26,2023-08-26,Project payment - Customer_0041,REF28765743,0.0,32.17,1448.97
2023-08-26,2023-08-26,Payment from Customer_0060,REF97007429,0.0,80.23,1529.2
2023-08-26,2023-08-26,Packaging Shipping expense,REF91269892,159.98,0.0,1369.22
2023-08-27,2023-08-27,Service payment - Customer_0063,REF51586855,0.0,91.15,1460.37
2023-08-27,2023-08-27,Service payment - Customer_0056,REF13662165,0.0,12.24,1472.61
2023-08-27,2023-08-27,Invoice payment - Customer_0016,REF65103083,0.0,24.31,1496.92
2023-08-27,2023-08-27,Service payment - Customer_0022,REF80473880,0.0,80.22,1577.14
2023-08-27,2023-08-27,Payment from Customer_0086,REF26759176,0.0,102.65,1679.79
2023-08-27,2023-08-27,Payment from Customer_0078,REF80213052,0.0,62.15,1741.94
2023-08-27,2023-08-27,Service payment - Customer_0075,REF30193262,0.0,67.07,1809.01
2023-08-28,2023-08-28,Invoice payment - Customer_0024,REF15224813,0.0,149.82,1958.83
2023-08-28,2023-08-28,Service payment - Customer_0007,REF16596560,0.0,22.97,1981.8
2023-08-28,2023-08-28,Service payment - Customer_0050,REF33419636,0.0,62.85,2044.65
2023-08-28,2023-08-28,Invoice payment - Customer_0082,REF85199096,0.0,49.01,2093.66
2023-08-28,2023-08-28,Payment from Customer_0081,REF66666926,0.0,84.52,2178.18
2023-08-28,2023-08-28,Project payment - Customer_0069,REF11820414,0.0,172.23,2350.41
2023-08-28,2023-08-28,Payment from Customer_0011,REF59941465,0.0,50.17,2400.58
2023-08-28,2023-08-28,Project payment - Customer_0073,REF64960534,0.0,45.21,2445.79
2023-08-28,2023-08-28,Invoice payment - Customer_0003,REF83505216,0.0,134.45,2580.24
2023-08-28,2023-08-28,Service payment - Customer_0053,REF51714632,0.0,115.65,2695.89
2023-08-28,2023-08-28,Invoice payment - Customer_0061,REF26959271,0.0,68.98,2764.87
2023-08-29,2023-08-29,Project payment - Customer_0012,REF63171311,0.0,110.3,2875.17
2023-08-29,2023-08-29,Payment from Customer_0024,REF71296273,0.0,91.27,2966.44
2023-08-29,2023-08-29,Service payment - Customer_0000,REF10788583,0.0,104.41,3070.85
2023-08-29,2023-08-29,Payment from Customer_0010,REF84366584,0.0,134.04,3204.89
2023-08-29,2023-08-29,Payment from Customer_0026,REF27900284,0.0,82.29,3287.18
2023-08-29,2023-08-29,Project payment - Customer_0080,REF21725637,0.0,111.23,3398.41
2023-08-29,2023-08-29,Invoice payment - Customer_0066,REF77974581,0.0,117.05,3515.46
2023-08-29,2023-08-29,Payment from Customer_0028,REF44654976,0.0,77.13,3592.59
2023-08-29,2023-08-29,Invoice payment - Customer_0089,REF59683966,0.0,73.36,3665.95
2023-08-30,2023-08-30,Project payment - Customer_0042,REF50858817,0.0,129.16,3795.11
2023-08-30,2023-08-30,Service payment - Customer_0056,REF32726492,0.0,11.3,3806.41
2023-08-30,2023-08-30,Project payment - Customer_0076,REF36682754,0.0,72.81,3879.22
2023-08-30,2023-08-30,Invoice payment - Customer_0095,REF72929959,0.0,93.99,3973.21
2023-08-30,2023-08-30,Payment from Customer_0099,REF27622527,0.0,26.86,4000.07
2023-08-30,2023-08-30,Invoice payment - Customer_0048,REF96138831,0.0,104.71,4104.78
2023-08-30,2023-08-30,Invoice payment - Customer_0080,REF98292424,0.0,144.87,4249.65
2023-08-30,2023-08-30,Invoice payment - Customer_0044,REF65841086,0.0,118.46,4368.11
2023-08-30,2023-08-30,Payment from Customer_0070,REF28225317,0.0,67.0,4435.11
2023-08-30,2023-08-30,Project payment - Customer_0073,REF38011112,0.0,45.27,4480.38
2023-08-30,2023-08-30,Project payment - Customer_0007,REF88669288,0.0,23.37,4503.75
2023-08-30,2023-08-30,Inventory purchase,REF42417015,2031.03,0.0,2472.72
2023-08-31,2023-08-31,Project payment - Customer_0081,REF37216774,0.0,104.48,2577.2
2023-08-31,2023-08-31,Payment from Customer_0022,REF68093335,0.0,57.33,2634.53
2023-08-31,2023-08-31,Service payment - Customer_0071,REF19775653,0.0,63.47,2698.0
2023-08-31,2023-08-31,Invoice payment - Customer_0072,REF26143194,0.0,71.08,2769.08
2023-08-31,2023-08-31,Invoice payment - Customer_0066,REF52546620,0.0,99.31,2868.39
2023-08-31,2023-08-31,Project payment - Customer_0014,REF88865521,0.0,94.82,2963.21
2023-08-31,2023-08-31,Invoice payment - Customer_0095,REF30381566,0.0,79.98,3043.19
2023-08-31,2023-08-31,Payment from Customer_0033,REF44029373,0.0,87.09,3130.28
2023-08-31,2023-08-31,Payment from Customer_0060,REF58227120,0.0,91.45,3221.73
2023-08-31,2023-08-31,Payment from Customer_0052,REF58151640,0.0,105.04,3326.77
2023-09-01,2023-09-01,Monthly office rent,REF19914144,1098.22,0.0,2228.55
2023-09-01,2023-09-01,Invoice payment - Customer_0050,REF57195298,0.0,83.39,2311.94
2023-09-01,2023-09-01,Payment from Customer_0073,REF28020344,0.0,51.11,2363.05
2023-09-01,2023-09-01,Service payment - Customer_0089,REF42067298,0.0,62.19,2425.24
2023-09-01,2023-09-01,Payment from Customer_0062,REF42472740,0.0,97.58,2522.82
2023-09-01,2023-09-01,Service payment - Customer_0045,REF60589970,0.0,101.3,2624.12
2023-09-01,2023-09-01,Service payment - Customer_0083,REF57482308,0.0,31.17,2655.29
2023-09-01,2023-09-01,Project payment - Customer_0026,REF29171599,0.0,83.97,2739.26
2023-09-01,2023-09-01,Service payment - Customer_0064,REF53127854,0.0,38.49,2777.75
2023-09-01,2023-09-01,Invoice payment - Customer_0072,REF58200032,0.0,79.79,2857.54
2023-09-01,2023-09-01,Marketing expenses,REF58105893,237.46,0.0,2620.08
2023-09-02,2023-09-02,Invoice payment - Customer_0066,REF36384553,0.0,109.84,2729.92
2023-09-02,2023-09-02,Invoice payment - Customer_0055,REF21549934,0.0,94.18,2824.1
2023-09-02,2023-09-02,Project payment - Customer_0041,REF61097985,0.0,35.91,2860.01
2023-09-02,2023-09-02,Project payment - Customer_0005,REF74488016,0.0,61.63,2921.64
2023-09-02,2023-09-02,Payment from Customer_0017,REF74907553,0.0,145.72,3067.36
2023-09-02,2023-09-02,Payment from Customer_0071,REF58879662,0.0,48.81,3116.17
2023-09-02,2023-09-02,Service payment - Customer_0050,REF56807760,0.0,64.61,3180.78
2023-09-02,2023-09-02,Project payment - Customer_0051,REF38364117,0.0,102.8,3283.58
2023-09-03,2023-09-03,Pos Systems expense,REF82628840,63.18,0.0,3220.4
2023-09-03,2023-09-03,Project payment - Customer_0078,REF57072403,0.0,56.26,3276.66
2023-09-03,2023-09-03,Invoice payment - Customer_0015,REF67010894,0.0,100.64,3377.3
2023-09-03,2023-09-03,Project payment - Customer_0085,REF61460261,0.0,69.75,3447.05
2023-09-03,2023-09-03,Service payment - Customer_0040,REF78913145,0.0,91.22,3538.27
2023-09-03,2023-09-03,Project payment - Customer_0069,REF17258914,0.0,149.35,3687.62
2023-09-03,2023-09-03,Service payment - Customer_0017,REF50930601,0.0,95.32,3782.94
2023-09-03,2023-09-03,Project payment - Customer_0048,REF54624898,0.0,84.9,3867.84
2023-09-03,2023-09-03,Service payment - Customer_0023,REF43810547,0.0,50.1,3917.94
2023-09-03,2023-09-03,Project payment - Customer_0029,REF52166627,0.0,67.33,3985.27
2023-09-03,2023-09-03,Payment from Customer_0066,REF66447634,0.0,107.48,4092.75
2023-09-03,2023-09-03,Project payment - Customer_0042,REF80411670,0.0,94.8,4187.55
2023-09-04,2023-09-04,Inventory purchase,REF31069395,3655.2,0.0,532.35
2023-09-04,2023-09-04,Project payment - Customer_0074,REF27410581,0.0,102.31,634.66
2023-09-04,2023-09-04,Project payment - Customer_0058,REF96361174,0.0,98.09,732.75
2023-09-04,2023-09-04,Service payment - Customer_0097,REF10552235,0.0,35.3,768.05
2023-09-04,2023-09-04,Service payment - Customer_0032,REF76331210,0.0,144.21,912.26
2023-09-04,2023-09-04,Service payment - Customer_0014,REF66401406,0.0,70.11,982.37
2023-09-04,2023-09-04,Service payment - Customer_0004,REF82730727,0.0,49.67,1032.04
2023-09-04,2023-09-04,Invoice payment - Customer_0082,REF90290952,0.0,54.93,1086.97
2023-09-04,2023-09-04,Invoice payment - Customer_0033,REF85137774,0.0,96.46,1183.43
2023-09-04,2023-09-04,Invoice payment - Customer_0062,REF86938671,0.0,116.89,1300.32
2023-09-05,2023-09-05,Service payment - Customer_0031,REF38167487,0.0,31.21,1331.53
2023-09-05,2023-09-05,Project payment - Customer_0087,REF83729268,0.0,81.44,1412.97
2023-09-05,2023-09-05,Project payment - Customer_0070,REF67862140,0.0,63.26,1476.23
2023-09-05,2023-09-05,Payment from Customer_0036,REF53569889,0.0,54.03,1530.26
2023-09-05,2023-09-05,Service payment - Customer_0013,REF75554607,0.0,32.65,1562.91
2023-09-06,2023-09-06,Project payment - Customer_0018,REF97916733,0.0,53.36,1616.27
2023-09-06,2023-09-06,Project payment - Customer_0070,REF92285423,0.0,55.03,1671.3
2023-09-06,2023-09-06,Project payment - Customer_0055,REF29422796,0.0,83.17,1754.47
2023-09-06,2023-09-06,Invoice payment - Customer_0096,REF49757787,0.0,32.43,1786.9
2023-09-06,2023-09-06,Service payment - Customer_0097,REF21806545,0.0,53.19,1840.09
2023-09-06,2023-09-06,Payment from Customer_0043,REF70328747,0.0,53.79,1893.88
2023-09-06,2023-09-06,Service payment - Customer_0028,REF24461437,0.0,113.45,2007.33
2023-09-06,2023-09-06,Project payment - Customer_0013,REF15647955,0.0,42.98,2050.31
2023-09-06,2023-09-06,Service payment - Customer_0092,REF34056179,0.0,130.44,2180.75
2023-09-06,2023-09-06,Invoice payment - Customer_0064,REF32846732,0.0,48.37,2229.12
2023-09-06,2023-09-06,Invoice payment - Customer_0025,REF17331082,0.0,83.63,2312.75
2023-09-07,2023-09-07,Invoice payment - Customer_0069,REF76108239,0.0,172.67,2485.42
2023-09-07,2023-09-07,Invoice payment - Customer_0015,REF98177519,0.0,93.63,2579.05
2023-09-07,2023-09-07,Invoice payment - Customer_0010,REF31386831,0.0,135.64,2714.69
2023-09-07,2023-09-07,Project payment - Customer_0099,REF64810254,0.0,55.08,2769.77
2023-09-08,2023-09-08,Invoice payment - Customer_0044,REF19260118,0.0,114.95,2884.72
2023-09-08,2023-09-08,Service payment - Customer_0068,REF43680962,0.0,101.67,2986.39
2023-09-08,2023-09-08,Service payment - Customer_0082,REF85046402,0.0,59.89,3046.28
2023-09-08,2023-09-08,Project payment - Customer_0031,REF69153618,0.0,32.04,3078.32
2023-09-08,2023-09-08,Service payment - Customer_0000,REF32169508,0.0,96.58,3174.9
2023-09-08,2023-09-08,Invoice payment - Customer_0035,REF68716147,0.0,61.18,3236.08
2023-09-08,2023-09-08,Invoice payment - Customer_0023,REF33847603,0.0,51.32,3287.4
2023-09-09,2023-09-09,Project payment - Customer_0009,REF66217442,0.0,122.31,3409.71
2023-09-09,2023-09-09,Service payment - Customer_0056,REF27702464,0.0,10.0,3419.71
2023-09-09,2023-09-09,Project payment - Customer_0041,REF69519966,0.0,47.44,3467.15
2023-09-09,2023-09-09,Project payment - Customer_0012,REF23771145,0.0,111.57,3578.72
2023-09-09,2023-09-09,Service payment - Customer_0017,REF68120210,0.0,172.93,3751.65
2023-09-09,2023-09-09,Project payment - Customer_0007,REF11903799,0.0,23.19,3774.84
2023-09-09,2023-09-09,Project payment - Customer_0010,REF52607781,0.0,115.26,3890.1
2023-09-09,2023-09-09,Invoice payment - Customer_0088,REF86131711,0.0,11.77,3901.87
2023-09-09,2023-09-09,Service payment - Customer_0063,REF73437921,0.0,94.65,3996.52
2023-09-09,2023-09-09,Service payment - Customer_0013,REF72249823,0.0,43.0,4039.52
2023-09-10,2023-09-10,Inventory purchase,REF31408160,2688.9,0.0,1350.62
2023-09-10,2023-09-10,Invoice payment - Customer_0099,REF80398760,0.0,43.96,1394.58
2023-09-10,2023-09-10,Service payment - Customer_0059,REF71573668,0.0,145.95,1540.53
2023-09-10,2023-09-10,Payment from Customer_0018,REF93906750,0.0,62.8,1603.33
2023-09-10,2023-09-10,Invoice payment - Customer_0017,REF58156633,0.0,158.95,1762.28
2023-09-10,2023-09-10,Payment from Customer_0047,REF69480171,0.0,63.99,1826.27
2023-09-10,2023-09-10,Invoice payment - Customer_0091,REF40496968,0.0,106.14,1932.41
2023-09-11,2023-09-11,Invoice payment - Customer_0027,REF68626046,0.0,92.3,2024.71
2023-09-11,2023-09-11,Payment from Customer_0060,REF80912811,0.0,78.79,2103.5
2023-09-11,2023-09-11,Project payment - Customer_0056,REF75559162,0.0,10.09,2113.59
2023-09-11,2023-09-11,Invoice payment - Customer_0015,REF68988232,0.0,73.12,2186.71
2023-09-11,2023-09-11,Invoice payment - Customer_0057,REF67100284,0.0,37.89,2224.6
2023-09-11,2023-09-11,Project payment - Customer_0066,REF12342079,0.0,137.92,2362.52
2023-09-11,2023-09-11,Invoice payment - Customer_0063,REF42996379,0.0,126.75,2489.27
2023-09-12,2023-09-12,Invoice payment - Customer_0038,REF55479607,0.0,64.09,2553.36
2023-09-12,2023-09-12,Service payment - Customer_0003,REF56155219,0.0,114.39,2667.75
2023-09-12,2023-09-12,Project payment - Customer_0095,REF73545547,0.0,94.61,2762.36
2023-09-12,2023-09-12,Payment from Customer_0007,REF27802480,0.0,25.6,2787.96
2023-09-12,2023-09-12,Invoice payment - Customer_0088,REF74375256,0.0,10.83,2798.79
2023-09-12,2023-09-12,Service payment - Customer_0041,REF17100989,0.0,35.38,2834.17
2023-09-12,2023-09-12,Project payment - Customer_0061,REF93733567,0.0,91.27,2925.44
2023-09-12,2023-09-12,Invoice payment - Customer_0006,REF27139462,0.0,15.14,2940.58
2023-09-12,2023-09-12,Invoice payment - Customer_0082,REF73227444,0.0,71.51,3012.09
2023-09-13,2023-09-13,Project payment - Customer_0081,REF41524825,0.0,114.33,3126.42
2023-09-13,2023-09-13,Payment from Customer_0083,REF43630041,0.0,32.63,3159.05
2023-09-13,2023-09-13,Invoice payment - Customer_0002,REF83322649,0.0,40.7,3199.75
2023-09-13,2023-09-13,Invoice payment - Customer_0021,REF11470297,0.0,77.35,3277.1
2023-09-13,2023-09-13,Invoice payment - Customer_0068,REF79704095,0.0,98.46,3375.56
2023-09-13,2023-09-13,Project payment - Customer_0090,REF95577997,0.0,73.53,3449.09
2023-09-13,2023-09-13,Service payment - Customer_0046,REF50381342,0.0,48.87,3497.96
2023-09-13,2023-09-13,Invoice payment - Customer_0040,REF10097242,0.0,98.45,3596.41
2023-09-13,2023-09-13,Service payment - Customer_0057,REF88854111,0.0,28.95,3625.36
2023-09-13,2023-09-13,Project payment - Customer_0054,REF59325944,0.0,18.7,3644.06
2023-09-13,2023-09-13,Service payment - Customer_0051,REF39504539,0.0,67.27,3711.33
2023-09-14,2023-09-14,Service payment - Customer_0078,REF43715199,0.0,47.78,3759.11
2023-09-14,2023-09-14,Invoice payment - Customer_0066,REF74837279,0.0,118.27,3877.38
2023-09-14,2023-09-14,Payment from Customer_0084,REF74011344,0.0,30.5,3907.88
2023-09-14,2023-09-14,Invoice payment - Customer_0089,REF50920987,0.0,68.55,3976.43
2023-09-14,2023-09-14,Invoice payment - Customer_0096,REF91512817,0.0,40.83,4017.26
2023-09-14,2023-09-14,Project payment - Customer_0058,REF99861487,0.0,92.22,4109.48
2023-09-14,2023-09-14,Payment from Customer_0004,REF26889456,0.0,50.49,4159.97
2023-09-14,2023-09-14,Project payment - Customer_0091,REF24079136,0.0,84.5,4244.47
2023-09-14,2023-09-14,Payment from Customer_0006,REF17456315,0.0,13.21,4257.68
2023-09-14,2023-09-14,Invoice payment - Customer_0052,REF77251674,0.0,102.12,4359.8
2023-09-14,2023-09-14,Project payment - Customer_0060,REF85388136,0.0,63.96,4423.76
2023-09-14,2023-09-14,Payment from Customer_0088,REF49167130,0.0,12.36,4436.12
2023-09-15,2023-09-15,Business insurance premium,REF22964852,186.15,0.0,4249.97
2023-09-15,2023-09-15,Project payment - Customer_0040,REF31254272,0.0,94.66,4344.63
2023-09-15,2023-09-15,Payment from Customer_0011,REF19083839,0.0,36.41,4381.04
2023-09-15,2023-09-15,Payment from Customer_0087,REF28185745,0.0,84.95,4465.99
2023-09-15,2023-09-15,Service payment - Customer_0037,REF76361055,0.0,109.46,4575.45
2023-09-15,2023-09-15,Service payment - Customer_0027,REF88491021,0.0,78.45,4653.9
2023-09-15,2023-09-15,Payment from Customer_0004,REF31846016,0.0,41.21,4695.11
2023-09-15,2023-09-15,Service payment - Customer_0073,REF39413988,0.0,48.65,4743.76
2023-09-15,2023-09-15,Invoice payment - Customer_0010,REF40227636,0.0,99.8,4843.56
2023-09-16,2023-09-16,Invoice payment - Customer_0063,REF15774561,0.0,110.65,4954.21
2023-09-16,2023-09-16,Payment from Customer_0036,REF23485568,0.0,46.22,5000.43
2023-09-16,2023-09-16,Project payment - Customer_0043,REF19564829,0.0,83.26,5083.69
2023-09-16,2023-09-16,Inventory purchase,REF88575534,3696.2,0.0,1387.49
2023-09-16,2023-09-16,Service payment - Customer_0044,REF63810353,0.0,147.92,1535.41
2023-09-16,2023-09-16,Project payment - Customer_0058,REF43502987,0.0,76.71,1612.12
2023-09-16,2023-09-16,Invoice payment - Customer_0072,REF41490717,0.0,83.87,1695.99
2023-09-16,2023-09-16,Payment from Customer_0067,REF84469227,0.0,43.91,1739.9
2023-09-16,2023-09-16,Payment from Customer_0004,REF77322364,0.0,52.26,1792.16
2023-09-16,2023-09-16,Project payment - Customer_0023,REF20543033,0.0,59.46,1851.62
2023-09-16,2023-09-16,Payment from Customer_0069,REF74326992,0.0,148.83,2000.45
2023-09-16,2023-09-16,Payment from Customer_0051,REF30025479,0.0,62.06,2062.51
2023-09-16,2023-09-16,Professional Services expense,REF21503662,201.97,0.0,1860.54
2023-09-16,2023-09-16,Payment from Customer_0085,REF81797072,0.0,87.92,1948.46
2023-09-17,2023-09-17,Payment from Customer_0025,REF35458851,0.0,86.95,2035.41
2023-09-17,2023-09-17,Service payment - Customer_0093,REF35055897,0.0,43.93,2079.34
2023-09-17,2023-09-17,Invoice payment - Customer_0061,REF66799804,0.0,75.19,2154.53
2023-09-17,2023-09-17,Project payment - Customer_0092,REF96928311,0.0,103.61,2258.14
2023-09-17,2023-09-17,Project payment - Customer_0055,REF53150794,0.0,66.92,2325.06
2023-09-17,2023-09-17,Project payment - Customer_0019,REF96810541,0.0,60.01,2385.07
2023-09-18,2023-09-18,Project payment - Customer_0064,REF73659968,0.0,45.21,2430.28
2023-09-18,2023-09-18,Payment from Customer_0057,REF28871010,0.0,35.76,2466.04
2023-09-18,2023-09-18,Payment from Customer_0047,REF39419156,0.0,66.65,2532.69
2023-09-18,2023-09-18,Payment from Customer_0086,REF47513763,0.0,91.41,2624.1
2023-09-18,2023-09-18,Payment from Customer_0075,REF65118628,0.0,59.8,2683.9
2023-09-18,2023-09-18,Service payment - Customer_0004,REF99657811,0.0,39.29,2723.19
2023-09-18,2023-09-18,Invoice payment - Customer_0068,REF99292475,0.0,117.21,2840.4
2023-09-19,2023-09-19,Project payment - Customer_0026,REF94587598,0.0,58.87,2899.27
2023-09-19,2023-09-19,Project payment - Customer_0090,REF60691920,0.0,83.4,2982.67
2023-09-19,2023-09-19,Project payment - Customer_0039,REF58716645,0.0,85.72,3068.39
2023-09-19,2023-09-19,Invoice payment - Customer_0025,REF43862872,0.0,74.41,3142.8
2023-09-19,2023-09-19,Invoice payment - Customer_0087,REF18368148,0.0,99.59,3242.39
2023-09-19,2023-09-19,Project payment - Customer_0012,REF34149846,0.0,134.58,3376.97
2023-09-19,2023-09-19,Project payment - Customer_0041,REF76499624,0.0,57.04,3434.01
2023-09-19,2023-09-19,Invoice payment - Customer_0047,REF33247217,0.0,65.74,3499.75
2023-09-19,2023-09-19,Payment from Customer_0033,REF27153981,0.0,71.35,3571.1
2023-09-19,2023-09-19,Project payment - Customer_0015,REF77477494,0.0,72.64,3643.74
2023-09-19,2023-09-19,Service payment - Customer_0098,REF14454520,0.0,71.16,3714.9
2023-09-19,2023-09-19,Invoice payment - Customer_0083,REF67550091,0.0,36.98,3751.88
2023-09-20,2023-09-20,Service payment - Customer_0000,REF79753078,0.0,117.9,3869.78
2023-09-20,2023-09-20,Project payment - Customer_0026,REF37687860,0.0,87.25,3957.03
2023-09-20,2023-09-20,Payment from Customer_0007,REF42824207,0.0,31.95,3988.98
2023-09-20,2023-09-20,Invoice payment - Customer_0085,REF31162887,0.0,78.99,4067.97
2023-09-20,2023-09-20,Inventory purchase,REF35429184,2644.07,0.0,1423.9
2023-09-20,2023-09-20,Payment from Customer_0042,REF75971034,0.0,117.97,1541.87
2023-09-20,2023-09-20,Payment from Customer_0063,REF98985422,0.0,110.05,1651.92
2023-09-20,2023-09-20,Invoice payment - Customer_0078,REF22101742,0.0,54.78,1706.7
2023-09-20,2023-09-20,Service payment - Customer_0017,REF52733840,0.0,151.81,1858.51
2023-09-21,2023-09-21,Invoice payment - Customer_0065,REF84174234,0.0,37.3,1895.81
2023-09-21,2023-09-21,Project payment - Customer_0070,REF28522655,0.0,47.13,1942.94
2023-09-21,2023-09-21,Payment from Customer_0086,REF88260055,0.0,81.21,2024.15
2023-09-21,2023-09-21,Invoice payment - Customer_0059,REF98303349,0.0,148.07,2172.22
2023-09-21,2023-09-21,Service payment - Customer_0000,REF62827717,0.0,83.59,2255.81
2023-09-21,2023-09-21,Project payment - Customer_0053,REF85832113,0.0,116.7,2372.51
2023-09-21,2023-09-21,Project payment - Customer_0016,REF92280669,0.0,23.91,2396.42
2023-09-21,2023-09-21,Payment from Customer_0024,REF83329980,0.0,124.8,2521.22
2023-09-22,2023-09-22,Invoice payment - Customer_0080,REF64947537,0.0,127.06,2648.28
2023-09-22,2023-09-22,Service payment - Customer_0031,REF80996884,0.0,31.73,2680.01
2023-09-22,2023-09-22,Service payment - Customer_0012,REF56593683,0.0,123.19,2803.2
2023-09-22,2023-09-22,Invoice payment - Customer_0010,REF56630302,0.0,78.4,2881.6
2023-09-22,2023-09-22,Utility bill payment,REF22061908,135.11,0.0,2746.49
2023-09-22,2023-09-22,Invoice payment - Customer_0018,REF21147895,0.0,75.87,2822.36
2023-09-22,2023-09-22,Invoice payment - Customer_0029,REF63757000,0.0,64.44,2886.8
2023-09-22,2023-09-22,Service payment - Customer_0041,REF19450622,0.0,52.59,2939.39
2023-09-22,2023-09-22,Project payment - Customer_0087,REF65025652,0.0,90.09,3029.48
2023-09-22,2023-09-22,Payment from Customer_0046,REF31568152,0.0,53.53,3083.01
2023-09-22,2023-09-22,Service payment - Customer_0076,REF87640086,0.0,74.45,3157.46
2023-09-23,2023-09-23,Payment from Customer_0042,REF15925027,0.0,120.26,3277.72
2023-09-23,2023-09-23,Invoice payment - Customer_0008,REF62345419,0.0,54.75,3332.47
2023-09-23,2023-09-23,Payment from Customer_0035,REF58646414,0.0,74.1,3406.57
2023-09-23,2023-09-23,Service payment - Customer_0031,REF96507779,0.0,23.57,3430.14
2023-09-23,2023-09-23,Project payment - Customer_0049,REF23505349,0.0,44.71,3474.85
2023-09-23,2023-09-23,Project payment - Customer_0019,REF23863629,0.0,63.13,3537.98
2023-09-23,2023-09-23,Payment from Customer_0009,REF21263761,0.0,164.61,3702.59
2023-09-23,2023-09-23,Payment from Customer_0022,REF80009134,0.0,64.55,3767.14
2023-09-23,2023-09-23,Invoice payment - Customer_0081,REF86946312,0.0,77.31,3844.45
2023-09-23,2023-09-23,Project payment - Customer_0093,REF29548781,0.0,39.72,3884.17
2023-09-23,2023-09-23,Invoice payment - Customer_0026,REF12709062,0.0,88.72,3972.89
2023-09-24,2023-09-24,Invoice payment - Customer_0024,REF28066638,0.0,150.61,4123.5
2023-09-24,2023-09-24,Project payment - Customer_0077,REF32144647,0.0,67.78,4191.28
2023-09-24,2023-09-24,Service payment - Customer_0053,REF88641477,0.0,160.49,4351.77
2023-09-24,2023-09-24,Invoice payment - Customer_0011,REF64834774,0.0,38.71,4390.48
2023-09-24,2023-09-24,Payment from Customer_0066,REF35460173,0.0,91.19,4481.67
2023-09-24,2023-09-24,Payment from Customer_0095,REF54006968,0.0,60.01,4541.68
2023-09-24,2023-09-24,Project payment - Customer_0028,REF86223559,0.0,69.98,4611.66
2023-09-24,2023-09-24,Invoice payment - Customer_0006,REF31038600,0.0,11.36,4623.02
2023-09-24,2023-09-24,Payment from Customer_0040,REF41509747,0.0,108.66,4731.68
2023-09-25,2023-09-25,Project payment - Customer_0080,REF17013369,0.0,147.75,4879.43
2023-09-25,2023-09-25,Invoice payment - Customer_0077,REF86781659,0.0,74.26,4953.69
2023-09-25,2023-09-25,Project payment - Customer_0045,REF69511283,0.0,92.39,5046.08
2023-09-25,2023-09-25,Service payment - Customer_0066,REF77131625,0.0,114.51,5160.59
2023-09-25,2023-09-25,Professional Services expense,REF45111937,201.7,0.0,4958.89
2023-09-25,2023-09-25,Project payment - Customer_0061,REF90924584,0.0,66.26,5025.15
2023-09-25,2023-09-25,Service payment - Customer_0082,REF61632067,0.0,53.0,5078.15
2023-09-25,2023-09-25,Project payment - Customer_0050,REF38053723,0.0,77.85,5156.0
2023-09-25,2023-09-25,Invoice payment - Customer_0030,REF26869639,0.0,68.94,5224.94
2023-09-26,2023-09-26,Invoice payment - Customer_0026,REF46021779,0.0,85.45,5310.39
2023-09-26,2023-09-26,Invoice payment - Customer_0093,REF46794304,0.0,44.96,5355.35
2023-09-26,2023-09-26,Invoice payment - Customer_0027,REF97597813,0.0,117.0,5472.35
2023-09-26,2023-09-26,Invoice payment - Customer_0076,REF98202474,0.0,71.39,5543.74
2023-09-26,2023-09-26,Project payment - Customer_0007,REF86064942,0.0,27.95,5571.69
2023-09-26,2023-09-26,Invoice payment - Customer_0011,REF67399981,0.0,27.28,5598.97
2023-09-26,2023-09-26,Service payment - Customer_0003,REF98760452,0.0,143.79,5742.76
2023-09-26,2023-09-26,Project payment - Customer_0065,REF72930601,0.0,43.14,5785.9
2023-09-26,2023-09-26,Payment from Customer_0089,REF51380418,0.0,55.33,5841.23
2023-09-27,2023-09-27,Project payment - Customer_0019,REF74835755,0.0,45.92,5887.15
2023-09-27,2023-09-27,Service payment - Customer_0092,REF89560915,0.0,82.03,5969.18
2023-09-27,2023-09-27,Service payment - Customer_0061,REF24409898,0.0,77.92,6047.1
2023-09-27,2023-09-27,Invoice payment - Customer_0053,REF22609070,0.0,137.93,6185.03
2023-09-27,2023-09-27,Invoice payment - Customer_0049,REF58536565,0.0,58.82,6243.85
2023-09-27,2023-09-27,Project payment - Customer_0078,REF54489769,0.0,55.2,6299.05
2023-09-27,2023-09-27,Invoice payment - Customer_0059,REF22067205,0.0,129.19,6428.24
2023-09-27,2023-09-27,Service payment - Customer_0066,REF29818486,0.0,70.88,6499.12
2023-09-27,2023-09-27,Project payment - Customer_0074,REF85409222,0.0,90.26,6589.38
2023-09-27,2023-09-27,Payment from Customer_0040,REF28673087,0.0,99.46,6688.84
2023-09-27,2023-09-27,Pos Systems expense,REF87982372,63.48,0.0,6625.36
2023-09-28,2023-09-28,Packaging Shipping expense,REF98164362,199.86,0.0,6425.5
2023-09-28,2023-09-28,Invoice payment - Customer_0031,REF43686754,0.0,36.6,6462.1
2023-09-28,2023-09-28,Project payment - Customer_0049,REF21252132,0.0,38.77,6500.87
2023-09-28,2023-09-28,Payment from Customer_0034,REF68246822,0.0,12.11,6512.98
2023-09-28,2023-09-28,Invoice payment - Customer_0053,REF44365722,0.0,167.03,6680.01
2023-09-28,2023-09-28,Invoice payment - Customer_0079,REF60360929,0.0,112.16,6792.17
2023-09-28,2023-09-28,Project payment - Customer_0051,REF69741626,0.0,83.08,6875.25
2023-09-29,2023-09-29,Project payment - Customer_0057,REF94067280,0.0,44.52,6919.77
2023-09-29,2023-09-29,Project payment - Customer_0013,REF67361790,0.0,52.37,6972.14
2023-09-29,2023-09-29,Project payment - Customer_0006,REF41094768,0.0,14.53,6986.67
2023-09-29,2023-09-29,Invoice payment - Customer_0019,REF13273815,0.0,49.75,7036.42
2023-09-30,2023-09-30,Service payment - Customer_0078,REF12364023,0.0,60.63,7097.05
2023-09-30,2023-09-30,Payment from Customer_0007,REF84493146,0.0,24.07,7121.12
2023-09-30,2023-09-30,Project payment - Customer_0027,REF96579173,0.0,104.29,7225.41
2023-09-30,2023-09-30,Payment from Customer_0055,REF78926660,0.0,81.66,7307.07
2023-09-30,2023-09-30,Payment from Customer_0096,REF84854557,0.0,38.77,7345.84
2023-09-30,2023-09-30,Service payment - Customer_0071,REF74114610,0.0,60.41,7406.25
2023-09-30,2023-09-30,Service payment - Customer_0036,REF83421072,0.0,35.63,7441.88
2023-10-01,2023-10-01,Project payment - Customer_0098,REF71025322,0.0,69.27,7511.15
2023-10-01,2023-10-01,Invoice payment - Customer_0049,REF26669166,0.0,49.51,7560.66
2023-10-01,2023-10-01,Service payment - Customer_0034,REF21802190,0.0,10.45,7571.11
2023-10-01,2023-10-01,Payment from Customer_0086,REF83890376,0.0,76.63,7647.74
2023-10-01,2023-10-01,Service payment - Customer_0028,REF62696650,0.0,77.6,7725.34
2023-10-01,2023-10-01,Project payment - Customer_0006,REF99198144,0.0,14.91,7740.25
2023-10-01,2023-10-01,Invoice payment - Customer_0077,REF43798550,0.0,92.73,7832.98
2023-10-01,2023-10-01,Monthly office rent,REF91106801,1299.9,0.0,6533.08
2023-10-01,2023-10-01,Service payment - Customer_0061,REF67333517,0.0,70.6,6603.68
2023-10-02,2023-10-02,Invoice payment - Customer_0084,REF32842479,0.0,49.66,6653.34
2023-10-02,2023-10-02,Invoice payment - Customer_0010,REF60520951,0.0,125.42,6778.76
2023-10-02,2023-10-02,Invoice payment - Customer_0011,REF19680619,0.0,44.6,6823.36
2023-10-02,2023-10-02,Payment from Customer_0038,REF65769255,0.0,70.79,6894.15
2023-10-02,2023-10-02,Payment from Customer_0086,REF24235739,0.0,98.75,6992.9
2023-10-02,2023-10-02,Payment from Customer_0044,REF86286575,0.0,143.7,7136.6
2023-10-02,2023-10-02,Project payment - Customer_0034,REF28538268,0.0,11.05,7147.65
2023-10-03,2023-10-03,Inventory purchase,REF28169731,2806.5,0.0,4341.15
2023-10-03,2023-10-03,Payment from Customer_0056,REF63079505,0.0,10.36,4351.51
2023-10-03,2023-10-03,Service payment - Customer_0062,REF92928501,0.0,141.58,4493.09
2023-10-03,2023-10-03,Project payment - Customer_0028,REF65675228,0.0,82.47,4575.56
2023-10-03,2023-10-03,Invoice payment - Customer_0011,REF44187817,0.0,32.94,4608.5
2023-10-03,2023-10-03,Project payment - Customer_0006,REF12366246,0.0,18.12,4626.62
2023-10-03,2023-10-03,Project payment - Customer_0007,REF22589011,0.0,34.33,4660.95
2023-10-03,2023-10-03,Payment from Customer_0046,REF66641125,0.0,59.75,4720.7
2023-10-03,2023-10-03,Invoice payment - Customer_0095,REF23934052,0.0,143.16,4863.86
2023-10-03,2023-10-03,Invoice payment - Customer_0043,REF61925222,0.0,79.77,4943.63
2023-10-04,2023-10-04,Service payment - Customer_0098,REF40549092,0.0,100.03,5043.66
2023-10-04,2023-10-04,Service payment - Customer_0023,REF17691993,0.0,66.06,5109.72
2023-10-04,2023-10-04,Payment from Customer_0091,REF28421366,0.0,105.01,5214.73
2023-10-04,2023-10-04,Invoice payment - Customer_0055,REF61152063,0.0,77.53,5292.26
2023-10-04,2023-10-04,Service payment - Customer_0009,REF30544104,0.0,118.24,5410.5
2023-10-04,2023-10-04,Service payment - Customer_0096,REF50304354,0.0,34.18,5444.68
2023-10-04,2023-10-04,Project payment - Customer_0059,REF76110954,0.0,170.57,5615.25
2023-10-04,2023-10-04,Service payment - Customer_0037,REF22395366,0.0,142.75,5758.0
2023-10-05,2023-10-05,Professional Services expense,REF31011519,86.19,0.0,5671.81
2023-10-05,2023-10-05,Invoice payment - Customer_0033,REF82344714,0.0,116.59,5788.4
2023-10-05,2023-10-05,Invoice payment - Customer_0003,REF86695137,0.0,130.33,5918.73
2023-10-05,2023-10-05,Payment from Customer_0067,REF56989091,0.0,49.27,5968.0
2023-10-05,2023-10-05,Project payment - Customer_0099,REF20124487,0.0,43.16,6011.16
2023-10-05,2023-10-05,Service payment - Customer_0009,REF29231419,0.0,118.45,6129.61
2023-10-05,2023-10-05,Service payment - Customer_0062,REF83227176,0.0,135.89,6265.5
2023-10-05,2023-10-05,Service payment - Customer_0025,REF24446120,0.0,107.18,6372.68
2023-10-05,2023-10-05,Service payment - Customer_0023,REF75954041,0.0,66.66,6439.34
2023-10-05,2023-10-05,Invoice payment - Customer_0068,REF28187355,0.0,104.96,6544.3
2023-10-05,2023-10-05,Project payment - Customer_0075,REF50472380,0.0,77.39,6621.69
2023-10-05,2023-10-05,Payment from Customer_0024,REF28457712,0.0,145.73,6767.42
2023-10-05,2023-10-05,Invoice payment - Customer_0052,REF69923808,0.0,103.2,6870.62
2023-10-06,2023-10-06,Project payment - Customer_0086,REF45117384,0.0,65.29,6935.91
2023-10-06,2023-10-06,Invoice payment - Customer_0023,REF68438091,0.0,63.31,6999.22
2023-10-06,2023-10-06,Invoice payment - Customer_0071,REF19764614,0.0,61.47,7060.69
2023-10-06,2023-10-06,Payment from Customer_0062,REF34179379,0.0,155.65,7216.34
2023-10-06,2023-10-06,Invoice payment - Customer_0091,REF83898544,0.0,92.78,7309.12
2023-10-06,2023-10-06,Invoice payment - Customer_0077,REF59972419,0.0,97.87,7406.99
2023-10-06,2023-10-06,Project payment - Customer_0039,REF42545899,0.0,149.33,7556.32
2023-10-06,2023-10-06,Payment from Customer_0017,REF95158809,0.0,167.3,7723.62
2023-10-06,2023-10-06,Project payment - Customer_0028,REF40710443,0.0,101.07,7824.69
2023-10-06,2023-10-06,Project payment - Customer_0031,REF39947283,0.0,40.23,7864.92
2023-10-06,2023-10-06,Invoice payment - Customer_0041,REF75730790,0.0,56.22,7921.14
2023-10-06,2023-10-06,Project payment - Customer_0003,REF57755800,0.0,108.46,8029.6
2023-10-06,2023-10-06,Service payment - Customer_0044,REF63079194,0.0,142.87,8172.47
2023-10-06,2023-10-06,Invoice payment - Customer_0021,REF84090283,0.0,89.52,8261.99
2023-10-06,2023-10-06,Service payment - Customer_0047,REF46960547,0.0,83.11,8345.1
2023-10-07,2023-10-07,Project payment - Customer_0016,REF56288098,0.0,27.94,8373.04
2023-10-07,2023-10-07,Invoice payment - Customer_0005,REF54442720,0.0,67.96,8441.0
2023-10-07,2023-10-07,Service payment - Customer_0037,REF33584023,0.0,112.89,8553.89
2023-10-07,2023-10-07,Project payment - Customer_0036,REF66868072,0.0,53.65,8607.54
2023-10-07,2023-10-07,Service payment - Customer_0062,REF66014174,0.0,149.15,8756.69
2023-10-07,2023-10-07,Payment from Customer_0082,REF85921198,0.0,58.1,8814.79
2023-10-08,2023-10-08,Payment from Customer_0059,REF84805806,0.0,148.44,8963.23
2023-10-08,2023-10-08,Project payment - Customer_0088,REF50325698,0.0,16.28,8979.51
2023-10-08,2023-10-08,Service payment - Customer_0056,REF46544686,0.0,12.16,8991.67
2023-10-08,2023-10-08,Payment from Customer_0096,REF42324276,0.0,52.5,9044.17
2023-10-08,2023-10-08,Project payment - Customer_0025,REF16338122,0.0,100.74,9144.91
2023-10-08,2023-10-08,Service payment - Customer_0090,REF63100466,0.0,102.1,9247.01
2023-10-08,2023-10-08,Invoice payment - Customer_0089,REF31592907,0.0,59.43,9306.44
2023-10-08,2023-10-08,Project payment - Customer_0058,REF38276181,0.0,115.42,9421.86
2023-10-08,2023-10-08,Project payment - Customer_0084,REF88280959,0.0,43.16,9465.02
2023-10-08,2023-10-08,Payment from Customer_0049,REF87808005,0.0,49.24,9514.26
2023-10-08,2023-10-08,Service payment - Customer_0002,REF74382376,0.0,55.12,9569.38
2023-10-09,2023-10-09,Payment from Customer_0092,REF76158217,0.0,139.06,9708.44
2023-10-09,2023-10-09,Project payment - Customer_0023,REF13943930,0.0,66.96,9775.4
2023-10-09,2023-10-09,Invoice payment - Customer_0086,REF78323812,0.0,74.18,9849.58
2023-10-09,2023-10-09,Service payment - Customer_0007,REF47099245,0.0,21.51,9871.09
2023-10-09,2023-10-09,Payment from Customer_0027,REF45077514,0.0,107.12,9978.21
2023-10-09,2023-10-09,Service payment - Customer_0036,REF24407675,0.0,53.59,10031.8
2023-10-09,2023-10-09,Project payment - Customer_0010,REF35658971,0.0,120.38,10152.18
2023-10-10,2023-10-10,Service payment - Customer_0023,REF97320647,0.0,71.39,10223.57
2023-10-10,2023-10-10,Payment from Customer_0080,REF78954093,0.0,132.79,10356.36
2023-10-10,2023-10-10,Service payment - Customer_0073,REF15394189,0.0,57.11,10413.47
2023-10-10,2023-10-10,Invoice payment - Customer_0002,REF33721960,0.0,56.4,10469.87
2023-10-10,2023-10-10,Service payment - Customer_0024,REF60870959,0.0,163.55,10633.42
2023-10-10,2023-10-10,Service payment - Customer_0095,REF65588729,0.0,91.32,10724.74
2023-10-10,2023-10-10,Payment from Customer_0096,REF46868520,0.0,45.43,10770.17
2023-10-10,2023-10-10,Service payment - Customer_0065,REF16309890,0.0,49.31,10819.48
2023-10-10,2023-10-10,Invoice payment - Customer_0053,REF28862455,0.0,169.03,10988.51
2023-10-10,2023-10-10,Payment from Customer_0069,REF45221911,0.0,147.65,11136.16
2023-10-10,2023-10-10,Invoice payment - Customer_0098,REF73776638,0.0,79.65,11215.81
2023-10-11,2023-10-11,Service payment - Customer_0053,REF61211091,0.0,179.24,11395.05
2023-10-11,2023-10-11,Project payment - Customer_0023,REF95582274,0.0,55.05,11450.1
2023-10-11,2023-10-11,Invoice payment - Customer_0063,REF65430168,0.0,137.91,11588.01
2023-10-11,2023-10-11,Project payment - Customer_0070,REF17009697,0.0,59.68,11647.69
2023-10-11,2023-10-11,Service payment - Customer_0079,REF78375209,0.0,140.36,11788.05
2023-10-11,2023-10-11,Invoice payment - Customer_0032,REF37948004,0.0,99.53,11887.58
2023-10-11,2023-10-11,Invoice payment - Customer_0064,REF25954890,0.0,55.58,11943.16
2023-10-11,2023-10-11,Payment from Customer_0046,REF16838707,0.0,58.44,12001.6
2023-10-11,2023-10-11,Project payment - Customer_0087,REF72392498,0.0,95.7,12097.3
2023-10-11,2023-10-11,Project payment - Customer_0035,REF92694371,0.0,79.0,12176.3
2023-10-11,2023-10-11,Payment from Customer_0010,REF26260562,0.0,86.67,12262.97
2023-10-12,2023-10-12,Service payment - Customer_0010,REF95038894,0.0,135.28,12398.25
2023-10-12,2023-10-12,Invoice payment - Customer_0070,REF28711111,0.0,47.28,12445.53
2023-10-12,2023-10-12,Invoice payment - Customer_0047,REF39738276,0.0,75.83,12521.36
2023-10-12,2023-10-12,Project payment - Customer_0037,REF61687370,0.0,143.53,12664.89
2023-10-12,2023-10-12,Payment from Customer_0092,REF98042013,0.0,128.19,12793.08
2023-10-12,2023-10-12,Payment from Customer_0056,REF75001975,0.0,13.42,12806.5
2023-10-12,2023-10-12,Project payment - Customer_0018,REF96802952,0.0,65.28,12871.78
2023-10-12,2023-10-12,Service payment - Customer_0020,REF71371812,0.0,73.32,12945.1
2023-10-12,2023-10-12,Payment from Customer_0042,REF76175246,0.0,100.59,13045.69
2023-10-12,2023-10-12,Invoice payment - Customer_0049,REF44230636,0.0,45.73,13091.42
2023-10-12,2023-10-12,Project payment - Customer_0002,REF20588568,0.0,40.6,13132.02
2023-10-12,2023-10-12,Payment from Customer_0089,REF63543515,0.0,62.45,13194.47
2023-10-13,2023-10-13,Service payment - Customer_0085,REF96323815,0.0,95.62,13290.09
2023-10-13,2023-10-13,Service payment - Customer_0021,REF53469922,0.0,62.32,13352.41
2023-10-13,2023-10-13,Project payment - Customer_0020,REF82227609,0.0,67.0,13419.41
2023-10-13,2023-10-13,Project payment - Customer_0076,REF78013117,0.0,103.55,13522.96
2023-10-13,2023-10-13,Payment from Customer_0040,REF18657695,0.0,93.42,13616.38
2023-10-13,2023-10-13,Project payment - Customer_0026,REF29477946,0.0,110.23,13726.61
2023-10-14,2023-10-14,Payment from Customer_0059,REF87021791,0.0,155.73,13882.34
2023-10-14,2023-10-14,Project payment - Customer_0067,REF10534380,0.0,50.47,13932.81
2023-10-14,2023-10-14,Invoice payment - Customer_0078,REF82867603,0.0,58.6,13991.41
2023-10-14,2023-10-14,Payment from Customer_0006,REF43681890,0.0,13.31,14004.72
2023-10-14,2023-10-14,Project payment - Customer_0096,REF71251388,0.0,45.57,14050.29
2023-10-14,2023-10-14,Service payment - Customer_0000,REF70404921,0.0,105.78,14156.07
2023-10-15,2023-10-15,Invoice payment - Customer_0089,REF27455446,0.0,67.5,14223.57
2023-10-15,2023-10-15,Business insurance premium,REF67597740,195.08,0.0,14028.49
2023-10-15,2023-10-15,Project payment - Customer_0051,REF11098483,0.0,76.01,14104.5
2023-10-15,2023-10-15,Project payment - Customer_0030,REF69039542,0.0,71.62,14176.12
2023-10-15,2023-10-15,Payment from Customer_0080,REF71473653,0.0,137.47,14313.59
2023-10-15,2023-10-15,Payment from Customer_0009,REF94794508,0.0,155.66,14469.25
2023-10-15,2023-10-15,Service payment - Customer_0044,REF17302865,0.0,157.59,14626.84
2023-10-15,2023-10-15,Project payment - Customer_0022,REF72904860,0.0,92.89,14719.73
2023-10-15,2023-10-15,Invoice payment - Customer_0074,REF11719435,0.0,110.98,14830.71
2023-10-15,2023-10-15,Invoice payment - Customer_0047,REF53134698,0.0,64.19,14894.9
2023-10-16,2023-10-16,Payment from Customer_0040,REF13208436,0.0,75.1,14970.0
2023-10-16,2023-10-16,Invoice payment - Customer_0057,REF84427507,0.0,39.06,15009.06
2023-10-16,2023-10-16,Invoice payment - Customer_0039,REF60347605,0.0,152.39,15161.45
2023-10-16,2023-10-16,Service payment - Customer_0097,REF96802040,0.0,57.65,15219.1
2023-10-16,2023-10-16,Project payment - Customer_0079,REF75081112,0.0,101.66,15320.76
2023-10-16,2023-10-16,Payment from Customer_0063,REF49327307,0.0,100.77,15421.53
2023-10-16,2023-10-16,Project payment - Customer_0092,REF41465050,0.0,124.65,15546.18
2023-10-16,2023-10-16,Service payment - Customer_0025,REF40298672,0.0,104.54,15650.72
2023-10-16,2023-10-16,Project payment - Customer_0022,REF53304268,0.0,70.68,15721.4
2023-10-16,2023-10-16,Service payment - Customer_0065,REF33324915,0.0,62.05,15783.45
2023-10-16,2023-10-16,Payment from Customer_0034,REF18396137,0.0,11.7,15795.15
2023-10-17,2023-10-17,Service payment - Customer_0058,REF39620909,0.0,124.56,15919.71
2023-10-17,2023-10-17,Inventory purchase,REF45072377,3639.53,0.0,12280.18
2023-10-17,2023-10-17,Project payment - Customer_0023,REF63773843,0.0,59.62,12339.8
2023-10-17,2023-10-17,Payment from Customer_0020,REF62546924,0.0,46.55,12386.35
2023-10-17,2023-10-17,Service payment - Customer_0031,REF89613793,0.0,48.56,12434.91
2023-10-17,2023-10-17,Payment from Customer_0052,REF60215738,0.0,115.08,12549.99
2023-10-17,2023-10-17,Project payment - Customer_0095,REF27043851,0.0,104.92,12654.91
2023-10-17,2023-10-17,Project payment - Customer_0053,REF52347834,0.0,172.35,12827.26
2023-10-17,2023-10-17,Project payment - Customer_0055,REF86392962,0.0,103.56,12930.82
2023-10-17,2023-10-17,Payment from Customer_0087,REF94704141,0.0,93.38,13024.2
2023-10-18,2023-10-18,Invoice payment - Customer_0003,REF26346270,0.0,110.07,13134.27
2023-10-18,2023-10-18,Invoice payment - Customer_0034,REF83100136,0.0,10.73,13145.0
2023-10-18,2023-10-18,Invoice payment - Customer_0097,REF65078204,0.0,73.42,13218.42
2023-10-18,2023-10-18,Payment from Customer_0042,REF54521318,0.0,107.14,13325.56
2023-10-18,2023-10-18,Payment from Customer_0004,REF98546494,0.0,50.44,13376.0
2023-10-18,2023-10-18,Project payment - Customer_0041,REF87821271,0.0,67.89,13443.89
2023-10-18,2023-10-18,Payment from Customer_0014,REF28140272,0.0,86.91,13530.8
2023-10-19,2023-10-19,Invoice payment - Customer_0026,REF80584330,0.0,95.12,13625.92
2023-10-19,2023-10-19,Payment from Customer_0009,REF91037683,0.0,147.25,13773.17
2023-10-19,2023-10-19,Project payment - Customer_0068,REF90292094,0.0,114.55,13887.72
2023-10-19,2023-10-19,Service payment - Customer_0025,REF79040872,0.0,77.66,13965.38
2023-10-19,2023-10-19,Project payment - Customer_0006,REF58207498,0.0,13.8,13979.18
2023-10-19,2023-10-19,Invoice payment - Customer_0047,REF23110082,0.0,72.15,14051.33
2023-10-19,2023-10-19,Payment from Customer_0092,REF97025708,0.0,107.97,14159.3
2023-10-19,2023-10-19,Payment from Customer_0040,REF38408609,0.0,111.1,14270.4
2023-10-20,2023-10-20,Payment from Customer_0056,REF44429378,0.0,10.08,14280.48
2023-10-20,2023-10-20,Project payment - Customer_0065,REF12875635,0.0,48.5,14328.98
2023-10-20,2023-10-20,Payment from Customer_0025,REF69802915,0.0,93.68,14422.66
2023-10-20,2023-10-20,Project payment - Customer_0079,REF12944041,0.0,131.45,14554.11
2023-10-20,2023-10-20,Payment from Customer_0018,REF46341704,0.0,63.03,14617.14
2023-10-20,2023-10-20,Invoice payment - Customer_0060,REF65338821,0.0,108.22,14725.36
2023-10-20,2023-10-20,Service payment - Customer_0061,REF65814696,0.0,95.75,14821.11
2023-10-20,2023-10-20,Invoice payment - Customer_0071,REF96322362,0.0,62.3,14883.41
2023-10-20,2023-10-20,Payment from Customer_0087,REF44038488,0.0,122.43,15005.84
2023-10-20,2023-10-20,Invoice payment - Customer_0077,REF37626278,0.0,103.87,15109.71
2023-10-21,2023-10-21,Payment from Customer_0073,REF39658130,0.0,43.42,15153.13
2023-10-21,2023-10-21,Project payment - Customer_0075,REF39602219,0.0,90.26,15243.39
2023-10-21,2023-10-21,Service payment - Customer_0080,REF33800958,0.0,164.1,15407.49
2023-10-21,2023-10-21,Service payment - Customer_0013,REF76582667,0.0,60.43,15467.92
2023-10-21,2023-10-21,Project payment - Customer_0014,REF11859470,0.0,114.42,15582.34
2023-10-21,2023-10-21,Invoice payment - Customer_0020,REF39120326,0.0,60.13,15642.47
2023-10-21,2023-10-21,Project payment - Customer_0064,REF36392555,0.0,47.26,15689.73
2023-10-21,2023-10-21,Payment from Customer_0082,REF17759145,0.0,55.16,15744.89
2023-10-21,2023-10-21,Project payment - Customer_0027,REF81945192,0.0,119.75,15864.64
2023-10-21,2023-10-21,Invoice payment - Customer_0053,REF16099434,0.0,179.2,16043.84
2023-10-21,2023-10-21,Project payment - Customer_0087,REF84261185,0.0,78.53,16122.37
2023-10-22,2023-10-22,Invoice payment - Customer_0090,REF84092253,0.0,91.27,16213.64
2023-10-22,2023-10-22,Service payment - Customer_0041,REF54275214,0.0,54.17,16267.81
2023-10-22,2023-10-22,Invoice payment - Customer_0085,REF55782763,0.0,64.42,16332.23
2023-10-22,2023-10-22,Invoice payment - Customer_0020,REF78652936,0.0,54.03,16386.26
2023-10-22,2023-10-22,Utility bill payment,REF50331370,209.06,0.0,16177.2
2023-10-22,2023-10-22,Invoice payment - Customer_0094,REF44211824,0.0,25.3,16202.5
2023-10-22,2023-10-22,Service payment - Customer_0014,REF80958679,0.0,98.9,16301.4
2023-10-22,2023-10-22,Payment from Customer_0026,REF32814544,0.0,103.56,16404.96
2023-10-22,2023-10-22,Service payment - Customer_0064,REF28317203,0.0,59.18,16464.14
2023-10-22,2023-10-22,Project payment - Customer_0008,REF85908604,0.0,64.89,16529.03
2023-10-23,2023-10-23,Invoice payment - Customer_0085,REF48436229,0.0,87.55,16616.58
2023-10-23,2023-10-23,Project payment - Customer_0094,REF54937805,0.0,28.32,16644.9
2023-10-23,2023-10-23,Project payment - Customer_0052,REF56840531,0.0,112.39,16757.29
2023-10-23,2023-10-23,Marketing expenses,REF80672377,309.6,0.0,16447.69
2023-10-23,2023-10-23,Project payment - Customer_0077,REF16107988,0.0,101.39,16549.08
2023-10-23,2023-10-23,Pos Systems expense,REF55880025,27.16,0.0,16521.92
2023-10-23,2023-10-23,Service payment - Customer_0026,REF40541960,0.0,115.09,16637.01
2023-10-23,2023-10-23,Project payment - Customer_0088,REF76713647,0.0,17.38,16654.39
2023-10-23,2023-10-23,Invoice payment - Customer_0090,REF33092224,0.0,68.22,16722.61
2023-10-23,2023-10-23,Project payment - Customer_0028,REF41807027,0.0,119.74,16842.35
2023-10-23,2023-10-23,Invoice payment - Customer_0002,REF91823649,0.0,56.21,16898.56
2023-10-23,2023-10-23,Project payment - Customer_0047,REF66976107,0.0,62.48,16961.04
2023-10-23,2023-10-23,Payment from Customer_0015,REF85902202,0.0,112.88,17073.92
2023-10-23,2023-10-23,Payment from Customer_0048,REF85432303,0.0,101.25,17175.17
2023-10-23,2023-10-23,Project payment - Customer_0039,REF65816696,0.0,127.8,17302.97
2023-10-24,2023-10-24,Payment from Customer_0037,REF68575624,0.0,108.94,17411.91
2023-10-24,2023-10-24,Project payment - Customer_0090,REF70934153,0.0,84.67,17496.58
2023-10-24,2023-10-24,Service payment - Customer_0002,REF44505598,0.0,50.53,17547.11
2023-10-24,2023-10-24,Invoice payment - Customer_0049,REF10216904,0.0,56.13,17603.24
2023-10-24,2023-10-24,Service payment - Customer_0053,REF27034263,0.0,129.57,17732.81
2023-10-24,2023-10-24,Invoice payment - Customer_0098,REF30773542,0.0,66.59,17799.4
2023-10-24,2023-10-24,Invoice payment - Customer_0077,REF72443722,0.0,104.93,17904.33
2023-10-24,2023-10-24,Payment from Customer_0038,REF99901601,0.0,49.88,17954.21
2023-10-24,2023-10-24,Service payment - Customer_0012,REF11715417,0.0,102.0,18056.21
2023-10-24,2023-10-24,Invoice payment - Customer_0092,REF82648516,0.0,128.91,18185.12
2023-10-24,2023-10-24,Payment from Customer_0025,REF35523130,0.0,100.42,18285.54
2023-10-24,2023-10-24,Project payment - Customer_0076,REF20192847,0.0,65.3,18350.84
2023-10-24,2023-10-24,Payment from Customer_0030,REF14761906,0.0,69.63,18420.47
2023-10-24,2023-10-24,Project payment - Customer_0052,REF79887705,0.0,105.24,18525.71
2023-10-24,2023-10-24,Service payment - Customer_0057,REF66153241,0.0,44.68,18570.39
2023-10-25,2023-10-25,Invoice payment - Customer_0085,REF44411553,0.0,89.49,18659.88
2023-10-25,2023-10-25,Invoice payment - Customer_0043,REF65564273,0.0,60.76,18720.64
2023-10-25,2023-10-25,Project payment - Customer_0010,REF94226530,0.0,126.13,18846.77
2023-10-25,2023-10-25,Service payment - Customer_0036,REF65822642,0.0,53.93,18900.7
2023-10-25,2023-10-25,Project payment - Customer_0044,REF81079376,0.0,85.33,18986.03
2023-10-25,2023-10-25,Payment from Customer_0052,REF30432824,0.0,86.88,19072.91
2023-10-25,2023-10-25,Service payment - Customer_0008,REF55017535,0.0,41.96,19114.87
2023-10-26,2023-10-26,Project payment - Customer_0042,REF73538727,0.0,93.95,19208.82
2023-10-26,2023-10-26,Service payment - Customer_0029,REF32818173,0.0,69.03,19277.85
2023-10-26,2023-10-26,Project payment - Customer_0078,REF95171127,0.0,65.27,19343.12
2023-10-26,2023-10-26,Project payment - Customer_0011,REF80308213,0.0,39.83,19382.95
2023-10-26,2023-10-26,Project payment - Customer_0016,REF26427360,0.0,35.72,19418.67
2023-10-26,2023-10-26,Payment from Customer_0066,REF37670762,0.0,112.55,19531.22
2023-10-26,2023-10-26,Project payment - Customer_0006,REF53475487,0.0,16.99,19548.21
2023-10-26,2023-10-26,Invoice payment - Customer_0041,REF47190930,0.0,65.75,19613.96
2023-10-26,2023-10-26,Service payment - Customer_0049,REF95820504,0.0,36.91,19650.87
2023-10-26,2023-10-26,Project payment - Customer_0004,REF13711026,0.0,52.0,19702.87
2023-10-27,2023-10-27,Service payment - Customer_0062,REF23673492,0.0,132.6,19835.47
2023-10-27,2023-10-27,Invoice payment - Customer_0090,REF17226930,0.0,88.58,19924.05
2023-10-27,2023-10-27,Invoice payment - Customer_0080,REF10825454,0.0,131.64,20055.69
2023-10-27,2023-10-27,Service payment - Customer_0069,REF88259547,0.0,176.09,20231.78
2023-10-27,2023-10-27,Service payment - Customer_0077,REF20236266,0.0,87.75,20319.53
2023-10-27,2023-10-27,Payment from Customer_0089,REF73780116,0.0,64.16,20383.69
2023-10-27,2023-10-27,Payment from Customer_0046,REF20897698,0.0,59.04,20442.73
2023-10-27,2023-10-27,Payment from Customer_0049,REF56443748,0.0,47.39,20490.12
2023-10-27,2023-10-27,Project payment - Customer_0063,REF83553862,0.0,106.82,20596.94
2023-10-28,2023-10-28,Service payment - Customer_0044,REF93285903,0.0,145.44,20742.38
2023-10-28,2023-10-28,Invoice payment - Customer_0074,REF81595762,0.0,106.73,20849.11
2023-10-28,2023-10-28,Payment from Customer_0067,REF74238726,0.0,45.17,20894.28
2023-10-28,2023-10-28,Project payment - Customer_0066,REF93229169,0.0,112.22,21006.5
2023-10-28,2023-10-28,Payment from Customer_0004,REF97053289,0.0,59.19,21065.69
2023-10-28,2023-10-28,Service payment - Customer_0043,REF93725245,0.0,59.84,21125.53
2023-10-28,2023-10-28,Payment from Customer_0020,REF23459736,0.0,52.26,21177.79
2023-10-28,2023-10-28,Payment from Customer_0040,REF83289760,0.0,116.01,21293.8
2023-10-28,2023-10-28,Invoice payment - Customer_0061,REF39418933,0.0,80.42,21374.22
2023-10-28,2023-10-28,Invoice payment - Customer_0053,REF78388062,0.0,137.44,21511.66
2023-10-29,2023-10-29,Service payment - Customer_0097,REF30235312,0.0,66.66,21578.32
2023-10-29,2023-10-29,Payment from Customer_0058,REF47670811,0.0,93.7,21672.02
2023-10-29,2023-10-29,Project payment - Customer_0091,REF97341694,0.0,103.76,21775.78
2023-10-29,2023-10-29,Payment from Customer_0081,REF46185544,0.0,92.74,21868.52
2023-10-29,2023-10-29,Invoice payment - Customer_0010,REF37699099,0.0,121.12,21989.64
2023-10-29,2023-10-29,Service payment - Customer_0041,REF15615798,0.0,56.19,22045.83
2023-10-29,2023-10-29,Payment from Customer_0037,REF63494886,0.0,141.3,22187.13
2023-10-30,2023-10-30,Invoice payment - Customer_0040,REF21637893,0.0,115.62,22302.75
2023-10-30,2023-10-30,Invoice payment - Customer_0014,REF39264543,0.0,127.12,22429.87
2023-10-31,2023-10-31,Invoice payment - Customer_0098,REF44492943,0.0,108.99,22538.86
2023-10-31,2023-10-31,Project payment - Customer_0002,REF49907801,0.0,48.82,22587.68
2023-10-31,2023-10-31,Project payment - Customer_0062,REF10261140,0.0,129.75,22717.43
2023-10-31,2023-10-31,Service payment - Customer_0052,REF23962762,0.0,105.08,22822.51
2023-10-31,2023-10-31,Project payment - Customer_0042,REF75700927,0.0,87.17,22909.68
2023-10-31,2023-10-31,Invoice payment - Customer_0075,REF75574139,0.0,66.01,22975.69
2023-10-31,2023-10-31,Payment from Customer_0014,REF22859735,0.0,113.49,23089.18
2023-10-31,2023-10-31,Payment from Customer_0038,REF83874863,0.0,57.15,23146.33
2023-11-01,2023-11-01,Monthly office rent,REF19228908,1723.34,0.0,21422.99
2023-11-01,2023-11-01,Service payment - Customer_0045,REF72263401,0.0,120.49,21543.48
2023-11-01,2023-11-01,Project payment - Customer_0042,REF27250715,0.0,124.12,21667.6
2023-11-01,2023-11-01,Service payment - Customer_0074,REF58427901,0.0,97.44,21765.04
2023-11-02,2023-11-02,Payment from Customer_0057,REF83525396,0.0,60.05,21825.09
2023-11-02,2023-11-02,Project payment - Customer_0014,REF23347198,0.0,142.24,21967.33
2023-11-02,2023-11-02,Project payment - Customer_0084,REF54568292,0.0,55.79,22023.12
2023-11-02,2023-11-02,Invoice payment - Customer_0071,REF50107173,0.0,69.91,22093.03
2023-11-02,2023-11-02,Payment from Customer_0009,REF17328834,0.0,211.87,22304.9
2023-11-02,2023-11-02,Project payment - Customer_0091,REF37405799,0.0,147.0,22451.9
2023-11-02,2023-11-02,Project payment - Customer_0004,REF52925649,0.0,64.89,22516.79
2023-11-03,2023-11-03,Service payment - Customer_0071,REF50132532,0.0,83.95,22600.74
2023-11-03,2023-11-03,Invoice payment - Customer_0016,REF80166342,0.0,44.28,22645.02
2023-11-03,2023-11-03,Service payment - Customer_0010,REF20487117,0.0,86.81,22731.83
2023-11-03,2023-11-03,Inventory purchase,REF98005623,2377.23,0.0,20354.6
2023-11-03,2023-11-03,Project payment - Customer_0017,REF78548030,0.0,184.95,20539.55
2023-11-03,2023-11-03,Project payment - Customer_0073,REF43630001,0.0,73.71,20613.26
2023-11-03,2023-11-03,Invoice payment - Customer_0021,REF26008163,0.0,76.2,20689.46
2023-11-03,2023-11-03,Service payment - Customer_0009,REF29602629,0.0,191.89,20881.35
2023-11-03,2023-11-03,Service payment - Customer_0024,REF89055553,0.0,174.1,21055.45
2023-11-03,2023-11-03,Project payment - Customer_0041,REF20549537,0.0,76.81,21132.26
2023-11-03,2023-11-03,Payment from Customer_0045,REF45167023,0.0,102.68,21234.94
2023-11-03,2023-11-03,Payment from Customer_0035,REF40393708,0.0,103.12,21338.06
2023-11-04,2023-11-04,Service payment - Customer_0081,REF85300316,0.0,143.17,21481.23
2023-11-04,2023-11-04,Service payment - Customer_0033,REF46948422,0.0,148.84,21630.07
2023-11-04,2023-11-04,Payment from Customer_0084,REF51378494,0.0,59.06,21689.13
2023-11-04,2023-11-04,Service payment - Customer_0069,REF20022436,0.0,198.08,21887.21
2023-11-04,2023-11-04,Payment from Customer_0057,REF44743424,0.0,47.22,21934.43
2023-11-04,2023-11-04,Invoice payment - Customer_0023,REF28226884,0.0,77.47,22011.9
2023-11-04,2023-11-04,Service payment - Customer_0001,REF61370518,0.0,84.5,22096.4
2023-11-04,2023-11-04,Service payment - Customer_0042,REF23150280,0.0,109.73,22206.13
2023-11-05,2023-11-05,Payment from Customer_0071,REF41179031,0.0,80.97,22287.1
2023-11-05,2023-11-05,Project payment - Customer_0094,REF57298508,0.0,25.42,22312.52
2023-11-05,2023-11-05,Payment from Customer_0085,REF32172562,0.0,112.07,22424.59
2023-11-05,2023-11-05,Project payment - Customer_0039,REF24689371,0.0,212.6,22637.19
2023-11-05,2023-11-05,Project payment - Customer_0046,REF49977059,0.0,66.5,22703.69
2023-11-05,2023-11-05,Project payment - Customer_0029,REF85682313,0.0,112.26,22815.95
2023-11-06,2023-11-06,Service payment - Customer_0032,REF17742614,0.0,183.72,22999.67
2023-11-06,2023-11-06,Invoice payment - Customer_0082,REF27253938,0.0,63.77,23063.44
2023-11-06,2023-11-06,Payment from Customer_0065,REF63707940,0.0,61.59,23125.03
2023-11-06,2023-11-06,Payment from Customer_0074,REF59020704,0.0,125.12,23250.15
2023-11-06,2023-11-06,Payment from Customer_0007,REF37284363,0.0,34.35,23284.5
2023-11-06,2023-11-06,Service payment - Customer_0080,REF98506701,0.0,152.64,23437.14
2023-11-06,2023-11-06,Invoice payment - Customer_0062,REF82088485,0.0,163.13,23600.27
2023-11-06,2023-11-06,Invoice payment - Customer_0044,REF70228428,0.0,166.68,23766.95
2023-11-06,2023-11-06,Project payment - Customer_0051,REF16888273,0.0,105.62,23872.57
2023-11-06,2023-11-06,Payment from Customer_0071,REF21416359,0.0,82.53,23955.1
2023-11-07,2023-11-07,Project payment - Customer_0013,REF70911488,0.0,71.09,24026.19
2023-11-07,2023-11-07,Project payment - Customer_0021,REF69557695,0.0,127.14,24153.33
2023-11-07,2023-11-07,Project payment - Customer_0090,REF88891135,0.0,77.36,24230.69
2023-11-07,2023-11-07,Payment from Customer_0072,REF23171281,0.0,74.14,24304.83
2023-11-07,2023-11-07,Service payment - Customer_0065,REF92649867,0.0,52.43,24357.26
2023-11-07,2023-11-07,Invoice payment - Customer_0074,REF29808409,0.0,143.83,24501.09
2023-11-07,2023-11-07,Payment from Customer_0062,REF20296975,0.0,201.95,24703.04
2023-11-07,2023-11-07,Project payment - Customer_0014,REF27369086,0.0,121.59,24824.63
2023-11-07,2023-11-07,Invoice payment - Customer_0048,REF66462132,0.0,87.18,24911.81
2023-11-08,2023-11-08,Payment from Customer_0094,REF21784747,0.0,26.31,24938.12
2023-11-08,2023-11-08,Invoice payment - Customer_0073,REF80400035,0.0,56.1,24994.22
2023-11-08,2023-11-08,Project payment - Customer_0090,REF48623165,0.0,114.86,25109.08
2023-11-08,2023-11-08,Project payment - Customer_0080,REF45935575,0.0,217.8,25326.88
2023-11-08,2023-11-08,Invoice payment - Customer_0053,REF70661826,0.0,173.96,25500.84
2023-11-08,2023-11-08,Project payment - Customer_0066,REF66116708,0.0,142.21,25643.05
2023-11-08,2023-11-08,Service payment - Customer_0016,REF98519595,0.0,40.09,25683.14
2023-11-08,2023-11-08,Invoice payment - Customer_0032,REF83841217,0.0,217.89,25901.03
2023-11-09,2023-11-09,Invoice payment - Customer_0008,REF17857245,0.0,95.8,25996.83
2023-11-09,2023-11-09,Service payment - Customer_0049,REF40518610,0.0,55.63,26052.46
2023-11-09,2023-11-09,Project payment - Customer_0016,REF78265887,0.0,47.65,26100.11
2023-11-09,2023-11-09,Invoice payment - Customer_0081,REF98900175,0.0,140.34,26240.45
2023-11-09,2023-11-09,Payment from Customer_0072,REF25978162,0.0,95.21,26335.66
2023-11-09,2023-11-09,Service payment - Customer_0021,REF45490546,0.0,78.88,26414.54
2023-11-09,2023-11-09,Service payment - Customer_0079,REF68300664,0.0,206.09,26620.63
2023-11-09,2023-11-09,Project payment - Customer_0075,REF45601848,0.0,97.86,26718.49
2023-11-10,2023-11-10,Project payment - Customer_0027,REF25817365,0.0,137.71,26856.2
2023-11-10,2023-11-10,Service payment - Customer_0069,REF96439856,0.0,254.41,27110.61
2023-11-10,2023-11-10,Payment from Customer_0040,REF29371716,0.0,127.34,27237.95
2023-11-10,2023-11-10,Service payment - Customer_0036,REF12352174,0.0,62.69,27300.64
2023-11-10,2023-11-10,Payment from Customer_0064,REF76360708,0.0,65.3,27365.94
2023-11-10,2023-11-10,Invoice payment - Customer_0010,REF12188633,0.0,136.65,27502.59
2023-11-10,2023-11-10,Service payment - Customer_0088,REF24280927,0.0,15.69,27518.28
2023-11-11,2023-11-11,Payment from Customer_0031,REF53986852,0.0,33.13,27551.41
2023-11-11,2023-11-11,Project payment - Customer_0088,REF11546878,0.0,20.86,27572.27
2023-11-11,2023-11-11,Invoice payment - Customer_0075,REF76405413,0.0,87.83,27660.1
2023-11-11,2023-11-11,Payment from Customer_0002,REF12698483,0.0,85.7,27745.8
2023-11-11,2023-11-11,Invoice payment - Customer_0003,REF62808882,0.0,163.49,27909.29
2023-11-11,2023-11-11,Payment from Customer_0084,REF41790970,0.0,45.61,27954.9
2023-11-11,2023-11-11,Payment from Customer_0096,REF62170021,0.0,76.33,28031.23
2023-11-11,2023-11-11,Service payment - Customer_0030,REF81430956,0.0,123.34,28154.57
2023-11-11,2023-11-11,Project payment - Customer_0074,REF54362320,0.0,138.71,28293.28
2023-11-12,2023-11-12,Invoice payment - Customer_0088,REF67247189,0.0,16.69,28309.97
2023-11-12,2023-11-12,Project payment - Customer_0054,REF71031457,0.0,34.77,28344.74
2023-11-12,2023-11-12,Employee payroll,REF42098041,2511.9,0.0,25832.84
2023-11-12,2023-11-12,Payment from Customer_0094,REF53301665,0.0,36.37,25869.21
2023-11-12,2023-11-12,Invoice payment - Customer_0071,REF33439464,0.0,54.21,25923.42
2023-11-12,2023-11-12,Project payment - Customer_0017,REF95810201,0.0,253.69,26177.11
2023-11-12,2023-11-12,Payment from Customer_0057,REF72450320,0.0,25.57,26202.68
2023-11-12,2023-11-12,Service payment - Customer_0022,REF41568514,0.0,87.63,26290.31
2023-11-12,2023-11-12,Project payment - Customer_0092,REF87992858,0.0,190.26,26480.57
2023-11-12,2023-11-12,Invoice payment - Customer_0062,REF91734819,0.0,151.23,26631.8
2023-11-12,2023-11-12,Service payment - Customer_0095,REF23248068,0.0,136.54,26768.34
2023-11-12,2023-11-12,Payment from Customer_0084,REF39881142,0.0,42.66,26811.0
2023-11-12,2023-11-12,Inventory purchase,REF36162203,4416.43,0.0,22394.57
2023-11-13,2023-11-13,Inventory purchase,REF87322620,4965.66,0.0,17428.91
2023-11-13,2023-11-13,Payment from Customer_0020,REF68693765,0.0,75.67,17504.58
2023-11-13,2023-11-13,Invoice payment - Customer_0085,REF38818715,0.0,106.13,17610.71
2023-11-13,2023-11-13,Invoice payment - Customer_0022,REF20054571,0.0,105.3,17716.01
2023-11-13,2023-11-13,Project payment - Customer_0019,REF56612879,0.0,73.32,17789.33
2023-11-13,2023-11-13,Service payment - Customer_0065,REF36197541,0.0,72.55,17861.88
2023-11-13,2023-11-13,Project payment - Customer_0004,REF93855447,0.0,63.31,17925.19
2023-11-13,2023-11-13,Service payment - Customer_0059,REF35045655,0.0,152.83,18078.02
2023-11-13,2023-11-13,Invoice payment - Customer_0009,REF49367134,0.0,144.59,18222.61
2023-11-13,2023-11-13,Service payment - Customer_0006,REF32360168,0.0,16.8,18239.41
2023-11-14,2023-11-14,Invoice payment - Customer_0027,REF12004457,0.0,101.12,18340.53
2023-11-14,2023-11-14,Service payment - Customer_0071,REF54739214,0.0,76.1,18416.63
2023-11-14,2023-11-14,Payment from Customer_0084,REF96425535,0.0,61.27,18477.9
2023-11-14,2023-11-14,Invoice payment - Customer_0016,REF88162096,0.0,48.54,18526.44
2023-11-14,2023-11-14,Project payment - Customer_0081,REF30563126,0.0,111.74,18638.18
2023-11-14,2023-11-14,Invoice payment - Customer_0051,REF53061776,0.0,111.39,18749.57
2023-11-14,2023-11-14,Service payment - Customer_0006,REF30172228,0.0,20.59,18770.16
2023-11-14,2023-11-14,Service payment - Customer_0021,REF46702154,0.0,79.77,18849.93
2023-11-14,2023-11-14,Payment from Customer_0050,REF85799798,0.0,84.59,18934.52
2023-11-14,2023-11-14,Payment from Customer_0037,REF77682938,0.0,125.55,19060.07
2023-11-14,2023-11-14,Payment from Customer_0022,REF95947916,0.0,100.21,19160.28
2023-11-14,2023-11-14,Payment from Customer_0096,REF54594767,0.0,51.53,19211.81
2023-11-14,2023-11-14,Payment from Customer_0001,REF45831017,0.0,98.47,19310.28
2023-11-14,2023-11-14,Project payment - Customer_0024,REF80310151,0.0,184.53,19494.81
2023-11-15,2023-11-15,Payment from Customer_0050,REF13835727,0.0,81.85,19576.66
2023-11-15,2023-11-15,Invoice payment - Customer_0095,REF10732445,0.0,97.9,19674.56
2023-11-15,2023-11-15,Payment from Customer_0072,REF72850955,0.0,104.26,19778.82
2023-11-15,2023-11-15,Payment from Customer_0092,REF63590532,0.0,118.05,19896.87
2023-11-15,2023-11-15,Service payment - Customer_0052,REF63110962,0.0,132.56,20029.43
2023-11-15,2023-11-15,Business insurance premium,REF37464995,255.61,0.0,19773.82
2023-11-15,2023-11-15,Invoice payment - Customer_0048,REF62146207,0.0,132.27,19906.09
2023-11-15,2023-11-15,Payment from Customer_0002,REF72760386,0.0,93.7,19999.79
2023-11-15,2023-11-15,Invoice payment - Customer_0085,REF76452254,0.0,111.31,20111.1
2023-11-16,2023-11-16,Payment from Customer_0094,REF16251149,0.0,34.41,20145.51
2023-11-16,2023-11-16,Invoice payment - Customer_0067,REF35423095,0.0,77.98,20223.49
2023-11-16,2023-11-16,Payment from Customer_0043,REF16630731,0.0,109.18,20332.67
2023-11-16,2023-11-16,Payment from Customer_0005,REF26976825,0.0,85.52,20418.19
2023-11-16,2023-11-16,Invoice payment - Customer_0017,REF87613405,0.0,191.2,20609.39
2023-11-16,2023-11-16,Service payment - Customer_0021,REF95977502,0.0,114.79,20724.18
2023-11-16,2023-11-16,Service payment - Customer_0052,REF24912058,0.0,124.22,20848.4
2023-11-16,2023-11-16,Project payment - Customer_0064,REF69164372,0.0,66.15,20914.55
2023-11-16,2023-11-16,Service payment - Customer_0016,REF64806527,0.0,40.37,20954.92
2023-11-16,2023-11-16,Project payment - Customer_0007,REF90983275,0.0,37.84,20992.76
2023-11-17,2023-11-17,Service payment - Customer_0048,REF63276747,0.0,167.0,21159.76
2023-11-17,2023-11-17,Service payment - Customer_0049,REF37962734,0.0,85.21,21244.97
2023-11-17,2023-11-17,Project payment - Customer_0047,REF24751945,0.0,124.77,21369.74
2023-11-17,2023-11-17,Project payment - Customer_0099,REF40370100,0.0,65.18,21434.92
2023-11-17,2023-11-17,Payment from Customer_0028,REF20333172,0.0,98.93,21533.85
2023-11-17,2023-11-17,Packaging Shipping expense,REF94010287,288.62,0.0,21245.23
2023-11-18,2023-11-18,Service payment - Customer_0001,REF42065018,0.0,128.53,21373.76
2023-11-18,2023-11-18,Invoice payment - Customer_0034,REF94054692,0.0,11.77,21385.53
2023-11-18,2023-11-18,Service payment - Customer_0005,REF63471155,0.0,87.41,21472.94
2023-11-18,2023-11-18,Invoice payment - Customer_0041,REF65932066,0.0,66.16,21539.1
2023-11-18,2023-11-18,Invoice payment - Customer_0030,REF51376041,0.0,119.23,21658.33
2023-11-18,2023-11-18,Payment from Customer_0018,REF50242102,0.0,54.79,21713.12
2023-11-18,2023-11-18,Payment from Customer_0010,REF67833374,0.0,127.35,21840.47
2023-11-18,2023-11-18,Project payment - Customer_0073,REF60224887,0.0,70.08,21910.55
2023-11-18,2023-11-18,Project payment - Customer_0053,REF96401342,0.0,187.21,22097.76
2023-11-18,2023-11-18,Inventory purchase,REF78932324,3945.32,0.0,18152.44
2023-11-19,2023-11-19,Invoice payment - Customer_0000,REF63994711,0.0,152.23,18304.67
2023-11-19,2023-11-19,Payment from Customer_0022,REF61068243,0.0,111.63,18416.3
2023-11-19,2023-11-19,Invoice payment - Customer_0017,REF54329557,0.0,219.5,18635.8
2023-11-19,2023-11-19,Service payment - Customer_0015,REF57617693,0.0,116.88,18752.68
2023-11-19,2023-11-19,Invoice payment - Customer_0056,REF29607998,0.0,14.0,18766.68
2023-11-19,2023-11-19,Project payment - Customer_0080,REF19300134,0.0,157.04,18923.72
2023-11-19,2023-11-19,Service payment - Customer_0052,REF51308653,0.0,152.9,19076.62
2023-11-19,2023-11-19,Project payment - Customer_0011,REF86511321,0.0,60.13,19136.75
2023-11-19,2023-11-19,Project payment - Customer_0018,REF23644134,0.0,67.35,19204.1
2023-11-19,2023-11-19,Invoice payment - Customer_0047,REF56481516,0.0,88.71,19292.81
2023-11-19,2023-11-19,Invoice payment - Customer_0085,REF17964149,0.0,91.03,19383.84
2023-11-20,2023-11-20,Payment from Customer_0091,REF76727559,0.0,162.27,19546.11
2023-11-20,2023-11-20,Pos Systems expense,REF76820222,24.35,0.0,19521.76
2023-11-20,2023-11-20,Service payment - Customer_0026,REF86697930,0.0,101.79,19623.55
2023-11-20,2023-11-20,Project payment - Customer_0047,REF68328053,0.0,94.9,19718.45
2023-11-20,2023-11-20,Invoice payment - Customer_0034,REF58741198,0.0,15.33,19733.78
2023-11-20,2023-11-20,Project payment - Customer_0096,REF76468439,0.0,58.36,19792.14
2023-11-20,2023-11-20,Project payment - Customer_0011,REF50796712,0.0,55.55,19847.69
2023-11-20,2023-11-20,Project payment - Customer_0079,REF32158723,0.0,195.64,20043.33
2023-11-20,2023-11-20,Payment from Customer_0035,REF61829031,0.0,133.35,20176.68
2023-11-21,2023-11-21,Invoice payment - Customer_0053,REF71797652,0.0,256.04,20432.72
2023-11-21,2023-11-21,Service payment - Customer_0050,REF85525396,0.0,94.28,20527.0
2023-11-21,2023-11-21,Invoice payment - Customer_0003,REF65128727,0.0,194.44,20721.44
2023-11-21,2023-11-21,Service payment - Customer_0018,REF41494781,0.0,87.68,20809.12
2023-11-21,2023-11-21,Payment from Customer_0080,REF14821186,0.0,144.03,20953.15
2023-11-21,2023-11-21,Invoice payment - Customer_0012,REF36325544,0.0,231.01,21184.16
2023-11-21,2023-11-21,Payment from Customer_0008,REF22018784,0.0,64.76,21248.92
2023-11-21,2023-11-21,Payment from Customer_0004,REF80238029,0.0,65.24,21314.16
2023-11-21,2023-11-21,Invoice payment - Customer_0054,REF51659805,0.0,39.07,21353.23
2023-11-21,2023-11-21,Invoice payment - Customer_0092,REF96891483,0.0,177.74,21530.97
2023-11-21,2023-11-21,Service payment - Customer_0047,REF89198186,0.0,115.38,21646.35
2023-11-22,2023-11-22,Invoice payment - Customer_0013,REF70361592,0.0,75.03,21721.38
2023-11-22,2023-11-22,Invoice payment - Customer_0059,REF70045280,0.0,271.35,21992.73
2023-11-22,2023-11-22,Utility bill payment,REF17569100,233.92,0.0,21758.81
2023-11-22,2023-11-22,Invoice payment - Customer_0079,REF40099356,0.0,167.9,21926.71
2023-11-22,2023-11-22,Service payment - Customer_0014,REF52289362,0.0,94.55,22021.26
2023-11-22,2023-11-22,Invoice payment - Customer_0004,REF90108442,0.0,89.92,22111.18
2023-11-22,2023-11-22,Invoice payment - Customer_0072,REF84857828,0.0,104.39,22215.57
2023-11-22,2023-11-22,Invoice payment - Customer_0016,REF40406496,0.0,43.81,22259.38
2023-11-22,2023-11-22,Project payment - Customer_0045,REF26743239,0.0,118.56,22377.94
2023-11-22,2023-11-22,Invoice payment - Customer_0005,REF30055093,0.0,67.15,22445.09
2023-11-22,2023-11-22,Project payment - Customer_0027,REF72538900,0.0,127.53,22572.62
2023-11-22,2023-11-22,Payment from Customer_0085,REF21250529,0.0,89.62,22662.24
2023-11-22,2023-11-22,Invoice payment - Customer_0031,REF91135989,0.0,45.08,22707.32
2023-11-22,2023-11-22,Invoice payment - Customer_0069,REF79580629,0.0,155.6,22862.92
2023-11-23,2023-11-23,Payment from Customer_0048,REF13749705,0.0,118.41,22981.33
2023-11-23,2023-11-23,Project payment - Customer_0070,REF45468422,0.0,75.95,23057.28
2023-11-23,2023-11-23,Invoice payment - Customer_0039,REF38413903,0.0,129.84,23187.12
2023-11-23,2023-11-23,Invoice payment - Customer_0041,REF22891561,0.0,66.73,23253.85
2023-11-23,2023-11-23,Payment from Customer_0003,REF70228389,0.0,193.12,23446.97
2023-11-23,2023-11-23,Invoice payment - Customer_0058,REF43197019,0.0,106.67,23553.64
2023-11-23,2023-11-23,Payment from Customer_0004,REF52884261,0.0,68.81,23622.45
2023-11-23,2023-11-23,Service payment - Customer_0034,REF92103465,0.0,10.65,23633.1
2023-11-23,2023-11-23,Project payment - Customer_0093,REF84377947,0.0,49.99,23683.09
2023-11-24,2023-11-24,Project payment - Customer_0088,REF62299927,0.0,15.54,23698.63
2023-11-24,2023-11-24,Project payment - Customer_0048,REF15284639,0.0,120.4,23819.03
2023-11-24,2023-11-24,Invoice payment - Customer_0090,REF58456895,0.0,115.79,23934.82
2023-11-24,2023-11-24,Invoice payment - Customer_0002,REF85348304,0.0,59.3,23994.12
2023-11-24,2023-11-24,Service payment - Customer_0014,REF55178921,0.0,149.45,24143.57
2023-11-24,2023-11-24,Invoice payment - Customer_0053,REF18897762,0.0,224.09,24367.66
2023-11-24,2023-11-24,Payment from Customer_0038,REF18996745,0.0,61.32,24428.98
2023-11-24,2023-11-24,Payment from Customer_0081,REF62180685,0.0,152.06,24581.04
2023-11-24,2023-11-24,Service payment - Customer_0042,REF69442963,0.0,118.74,24699.78
2023-11-24,2023-11-24,Payment from Customer_0077,REF33434692,0.0,138.2,24837.98
2023-11-25,2023-11-25,Payment from Customer_0079,REF55003603,0.0,214.67,25052.65
2023-11-25,2023-11-25,Service payment - Customer_0085,REF79723460,0.0,110.26,25162.91
2023-11-25,2023-11-25,Service payment - Customer_0022,REF14143147,0.0,112.4,25275.31
2023-11-25,2023-11-25,Project payment - Customer_0038,REF11494056,0.0,83.4,25358.71
2023-11-25,2023-11-25,Marketing expenses,REF19552454,333.71,0.0,25025.0
2023-11-25,2023-11-25,Invoice payment - Customer_0049,REF97003945,0.0,57.57,25082.57
2023-11-25,2023-11-25,Service payment - Customer_0015,REF78619556,0.0,108.96,25191.53
2023-11-25,2023-11-25,Invoice payment - Customer_0041,REF25880926,0.0,85.31,25276.84
2023-11-25,2023-11-25,Payment from Customer_0068,REF75640037,0.0,102.11,25378.95
2023-11-25,2023-11-25,Service payment - Customer_0069,REF79425360,0.0,235.9,25614.85
2023-11-25,2023-11-25,Invoice payment - Customer_0080,REF67826608,0.0,120.67,25735.52
2023-11-25,2023-11-25,Service payment - Customer_0067,REF95891912,0.0,63.71,25799.23
2023-11-26,2023-11-26,Payment from Customer_0089,REF97474409,0.0,84.6,25883.83
2023-11-26,2023-11-26,Invoice payment - Customer_0033,REF94138796,0.0,142.08,26025.91
2023-11-26,2023-11-26,Invoice payment - Customer_0027,REF23172439,0.0,146.82,26172.73
2023-11-26,2023-11-26,Service payment - Customer_0058,REF81053455,0.0,125.61,26298.34
2023-11-26,2023-11-26,Service payment - Customer_0004,REF52707790,0.0,65.68,26364.02
2023-11-26,2023-11-26,Invoice payment - Customer_0028,REF90736234,0.0,138.78,26502.8
2023-11-26,2023-11-26,Invoice payment - Customer_0008,REF11077694,0.0,70.37,26573.17
2023-11-27,2023-11-27,Payment from Customer_0014,REF43664300,0.0,121.2,26694.37
2023-11-27,2023-11-27,Service payment - Customer_0043,REF83361664,0.0,86.38,26780.75
2023-11-27,2023-11-27,Payment from Customer_0022,REF15836516,0.0,82.91,26863.66
2023-11-27,2023-11-27,Service payment - Customer_0003,REF48834641,0.0,177.36,27041.02
2023-11-27,2023-11-27,Project payment - Customer_0040,REF43634838,0.0,149.54,27190.56
2023-11-27,2023-11-27,Project payment - Customer_0072,REF21336040,0.0,86.4,27276.96
2023-11-27,2023-11-27,Project payment - Customer_0069,REF35728579,0.0,292.42,27569.38
2023-11-27,2023-11-27,Payment from Customer_0085,REF99186634,0.0,89.4,27658.78
2023-11-27,2023-11-27,Project payment - Customer_0045,REF81542955,0.0,110.16,27768.94
2023-11-27,2023-11-27,Project payment - Customer_0029,REF96610329,0.0,108.78,27877.72
2023-11-27,2023-11-27,Service payment - Customer_0038,REF36347281,0.0,61.19,27938.91
2023-11-27,2023-11-27,Payment from Customer_0064,REF83511989,0.0,56.63,27995.54
2023-11-27,2023-11-27,Inventory purchase,REF74739379,4392.67,0.0,23602.87
2023-11-28,2023-11-28,Payment from Customer_0099,REF39211603,0.0,59.33,23662.2
2023-11-28,2023-11-28,Payment from Customer_0025,REF16256023,0.0,140.28,23802.48
2023-11-28,2023-11-28,Invoice payment - Customer_0037,REF35142522,0.0,201.99,24004.47
2023-11-28,2023-11-28,Payment from Customer_0076,REF54659127,0.0,120.24,24124.71
2023-11-28,2023-11-28,Service payment - Customer_0080,REF47933384,0.0,151.03,24275.74
2023-11-28,2023-11-28,Payment from Customer_0055,REF41411949,0.0,112.74,24388.48
2023-11-28,2023-11-28,Service payment - Customer_0010,REF60289076,0.0,126.56,24515.04
2023-11-28,2023-11-28,Project payment - Customer_0073,REF68847527,0.0,70.93,24585.97
2023-11-28,2023-11-28,Payment from Customer_0071,REF15043114,0.0,84.01,24669.98
2023-11-28,2023-11-28,Project payment - Customer_0019,REF40356826,0.0,71.01,24740.99
2023-11-29,2023-11-29,Service payment - Customer_0053,REF11709028,0.0,206.55,24947.54
2023-11-29,2023-11-29,Project payment - Customer_0080,REF34713121,0.0,149.97,25097.51
2023-11-29,2023-11-29,Project payment - Customer_0009,REF14275874,0.0,158.96,25256.47
2023-11-29,2023-11-29,Payment from Customer_0083,REF12144399,0.0,47.68,25304.15
2023-11-29,2023-11-29,Payment from Customer_0034,REF73894438,0.0,14.43,25318.58
2023-11-30,2023-11-30,Inventory purchase,REF20105448,5308.66,0.0,20009.92
2023-11-30,2023-11-30,Invoice payment - Customer_0004,REF54011959,0.0,78.47,20088.39
2023-11-30,2023-11-30,Payment from Customer_0063,REF86575622,0.0,140.86,20229.25
2023-11-30,2023-11-30,Service payment - Customer_0041,REF72333501,0.0,82.12,20311.37
2023-11-30,2023-11-30,Service payment - Customer_0033,REF74834611,0.0,170.94,20482.31
2023-11-30,2023-11-30,Service payment - Customer_0077,REF61261936,0.0,99.67,20581.98
2023-11-30,2023-11-30,Service payment - Customer_0096,REF54174537,0.0,63.12,20645.1
2023-11-30,2023-11-30,Service payment - Customer_0035,REF54744833,0.0,116.66,20761.76
2023-11-30,2023-11-30,Project payment - Customer_0083,REF57736231,0.0,52.89,20814.65
2023-11-30,2023-11-30,Project payment - Customer_0009,REF17575682,0.0,174.25,20988.9
2023-12-01,2023-12-01,Monthly office rent,REF29408061,2021.89,0.0,18967.01
2023-12-01,2023-12-01,Project payment - Customer_0000,REF79565217,0.0,160.26,19127.27
2023-12-01,2023-12-01,Invoice payment - Customer_0053,REF93337973,0.0,286.93,19414.2
2023-12-01,2023-12-01,Invoice payment - Customer_0077,REF15668327,0.0,174.73,19588.93
2023-12-01,2023-12-01,Invoice payment - Customer_0073,REF78231317,0.0,83.57,19672.5
2023-12-01,2023-12-01,Invoice payment - Customer_0019,REF66874447,0.0,93.34,19765.84
2023-12-01,2023-12-01,Invoice payment - Customer_0002,REF38675596,0.0,74.79,19840.63
2023-12-01,2023-12-01,Project payment - Customer_0008,REF64763895,0.0,96.79,19937.42
2023-12-01,2023-12-01,Payment from Customer_0046,REF72665646,0.0,91.1,20028.52
2023-12-01,2023-12-01,Service payment - Customer_0070,REF71887849,0.0,73.52,20102.04
2023-12-01,2023-12-01,Project payment - Customer_0024,REF37569859,0.0,191.43,20293.47
2023-12-01,2023-12-01,Invoice payment - Customer_0027,REF88737051,0.0,193.68,20487.15
2023-12-01,2023-12-01,Invoice payment - Customer_0012,REF35750243,0.0,191.38,20678.53
2023-12-02,2023-12-02,Project payment - Customer_0005,REF99208158,0.0,73.47,20752.0
2023-12-02,2023-12-02,Project payment - Customer_0039,REF52535697,0.0,193.69,20945.69
2023-12-02,2023-12-02,Invoice payment - Customer_0042,REF98039391,0.0,182.19,21127.88
2023-12-02,2023-12-02,Service payment - Customer_0094,REF81121537,0.0,44.33,21172.21
2023-12-02,2023-12-02,Payment from Customer_0043,REF47515614,0.0,103.8,21276.01
2023-12-02,2023-12-02,Invoice payment - Customer_0019,REF33119772,0.0,99.5,21375.51
2023-12-03,2023-12-03,Service payment - Customer_0048,REF16636765,0.0,162.04,21537.55
2023-12-03,2023-12-03,Project payment - Customer_0044,REF42665492,0.0,169.89,21707.44
2023-12-03,2023-12-03,Service payment - Customer_0086,REF18964328,0.0,109.38,21816.82
2023-12-03,2023-12-03,Service payment - Customer_0004,REF47485868,0.0,83.94,21900.76
2023-12-03,2023-12-03,Payment from Customer_0076,REF27080532,0.0,130.25,22031.01
2023-12-03,2023-12-03,Project payment - Customer_0011,REF74872472,0.0,67.12,22098.13
2023-12-03,2023-12-03,Invoice payment - Customer_0036,REF52166121,0.0,69.33,22167.46
2023-12-03,2023-12-03,Invoice payment - Customer_0022,REF92288097,0.0,137.45,22304.91
2023-12-04,2023-12-04,Project payment - Customer_0087,REF94219639,0.0,145.87,22450.78
2023-12-04,2023-12-04,Project payment - Customer_0041,REF76121926,0.0,73.21,22523.99
2023-12-04,2023-12-04,Payment from Customer_0048,REF23856625,0.0,180.65,22704.64
2023-12-04,2023-12-04,Invoice payment - Customer_0035,REF48061724,0.0,129.3,22833.94
2023-12-04,2023-12-04,Payment from Customer_0082,REF40098407,0.0,102.4,22936.34
2023-12-04,2023-12-04,Invoice payment - Customer_0066,REF93717347,0.0,132.79,23069.13
2023-12-04,2023-12-04,Payment from Customer_0076,REF89376595,0.0,119.46,23188.59
2023-12-04,2023-12-04,Service payment - Customer_0036,REF67444529,0.0,88.22,23276.81
2023-12-05,2023-12-05,Service payment - Customer_0037,REF46503882,0.0,163.35,23440.16
2023-12-05,2023-12-05,Payment from Customer_0038,REF82952810,0.0,70.37,23510.53
2023-12-05,2023-12-05,Service payment - Customer_0015,REF18301610,0.0,161.57,23672.1
2023-12-05,2023-12-05,Service payment - Customer_0068,REF19007766,0.0,176.15,23848.25
2023-12-05,2023-12-05,Invoice payment - Customer_0060,REF36549507,0.0,94.55,23942.8
2023-12-05,2023-12-05,Payment from Customer_0027,REF34792433,0.0,165.16,24107.96
2023-12-05,2023-12-05,Invoice payment - Customer_0030,REF80545912,0.0,145.06,24253.02
2023-12-05,2023-12-05,Invoice payment - Customer_0069,REF50266803,0.0,227.0,24480.02
2023-12-05,2023-12-05,Payment from Customer_0035,REF20104722,0.0,142.01,24622.03
2023-12-06,2023-12-06,Service payment - Customer_0040,REF48348546,0.0,138.94,24760.97
2023-12-06,2023-12-06,Payment from Customer_0015,REF58771186,0.0,160.77,24921.74
2023-12-06,2023-12-06,Payment from Customer_0042,REF64824805,0.0,157.22,25078.96
2023-12-06,2023-12-06,Service payment - Customer_0075,REF93400951,0.0,96.49,25175.45
2023-12-06,2023-12-06,Service payment - Customer_0082,REF18797238,0.0,96.08,25271.53
2023-12-06,2023-12-06,Payment from Customer_0041,REF78622419,0.0,86.25,25357.78
2023-12-07,2023-12-07,Service payment - Customer_0055,REF59387782,0.0,129.49,25487.27
2023-12-07,2023-12-07,Invoice payment - Customer_0020,REF62543885,0.0,68.8,25556.07
2023-12-07,2023-12-07,Payment from Customer_0037,REF21277840,0.0,158.73,25714.8
2023-12-07,2023-12-07,Project payment - Customer_0072,REF29327052,0.0,112.05,25826.85
2023-12-07,2023-12-07,Project payment - Customer_0012,REF50921604,0.0,175.88,26002.73
2023-12-07,2023-12-07,Payment from Customer_0001,REF44313333,0.0,110.48,26113.21
2023-12-07,2023-12-07,Service payment - Customer_0095,REF62588745,0.0,153.35,26266.56
2023-12-08,2023-12-08,Service payment - Customer_0082,REF32002308,0.0,76.31,26342.87
2023-12-08,2023-12-08,Project payment - Customer_0017,REF24298004,0.0,273.0,26615.87
2023-12-08,2023-12-08,Invoice payment - Customer_0063,REF20644398,0.0,172.33,26788.2
2023-12-08,2023-12-08,Invoice payment - Customer_0027,REF33906812,0.0,199.06,26987.26
2023-12-08,2023-12-08,Service payment - Customer_0083,REF31644488,0.0,51.23,27038.49
2023-12-08,2023-12-08,Invoice payment - Customer_0009,REF95436890,0.0,201.84,27240.33
2023-12-08,2023-12-08,Project payment - Customer_0015,REF69778814,0.0,166.24,27406.57
2023-12-08,2023-12-08,Project payment - Customer_0047,REF22528683,0.0,101.92,27508.49
2023-12-08,2023-12-08,Payment from Customer_0025,REF60658513,0.0,144.47,27652.96
2023-12-09,2023-12-09,Service payment - Customer_0027,REF98342258,0.0,178.44,27831.4
2023-12-09,2023-12-09,Payment from Customer_0052,REF37469832,0.0,95.91,27927.31
2023-12-09,2023-12-09,Service payment - Customer_0093,REF94181761,0.0,83.09,28010.4
2023-12-09,2023-12-09,Invoice payment - Customer_0046,REF35276688,0.0,81.37,28091.77
2023-12-09,2023-12-09,Payment from Customer_0040,REF90512118,0.0,149.13,28240.9
2023-12-09,2023-12-09,Project payment - Customer_0063,REF70009508,0.0,184.07,28424.97
2023-12-09,2023-12-09,Service payment - Customer_0037,REF72754768,0.0,204.46,28629.43
2023-12-09,2023-12-09,Invoice payment - Customer_0068,REF24637300,0.0,166.33,28795.76
2023-12-09,2023-12-09,Payment from Customer_0030,REF88160765,0.0,165.2,28960.96
2023-12-09,2023-12-09,Payment from Customer_0088,REF16827477,0.0,21.6,28982.56
2023-12-09,2023-12-09,Service payment - Customer_0053,REF33693882,0.0,257.55,29240.11
2023-12-09,2023-12-09,Payment from Customer_0059,REF93946095,0.0,232.85,29472.96
2023-12-09,2023-12-09,Packaging Shipping expense,REF47434030,331.93,0.0,29141.03
2023-12-10,2023-12-10,Invoice payment - Customer_0036,REF72880885,0.0,86.42,29227.45
2023-12-10,2023-12-10,Project payment - Customer_0012,REF33292796,0.0,173.97,29401.42
2023-12-10,2023-12-10,Service payment - Customer_0016,REF52735759,0.0,52.51,29453.93
2023-12-10,2023-12-10,Service payment - Customer_0031,REF97934763,0.0,50.48,29504.41
2023-12-10,2023-12-10,Project payment - Customer_0044,REF69837721,0.0,217.07,29721.48
2023-12-11,2023-12-11,Service payment - Customer_0026,REF93517898,0.0,111.83,29833.31
2023-12-11,2023-12-11,Invoice payment - Customer_0020,REF16013361,0.0,76.81,29910.12
2023-12-11,2023-12-11,Payment from Customer_0077,REF81330656,0.0,144.78,30054.9
2023-12-11,2023-12-11,Invoice payment - Customer_0068,REF88066975,0.0,201.72,30256.62
2023-12-11,2023-12-11,Invoice payment - Customer_0055,REF63864264,0.0,104.83,30361.45
2023-12-11,2023-12-11,Invoice payment - Customer_0038,REF48646460,0.0,90.6,30452.05
2023-12-11,2023-12-11,Project payment - Customer_0066,REF27607665,0.0,152.43,30604.48
2023-12-11,2023-12-11,Invoice payment - Customer_0063,REF35202012,0.0,167.25,30771.73
2023-12-11,2023-12-11,Payment from Customer_0034,REF38198802,0.0,16.97,30788.7
2023-12-11,2023-12-11,Payment from Customer_0007,REF15617069,0.0,43.99,30832.69
2023-12-11,2023-12-11,Invoice payment - Customer_0042,REF47629273,0.0,157.37,30990.06
2023-12-11,2023-12-11,Service payment - Customer_0084,REF67105229,0.0,59.67,31049.73
2023-12-11,2023-12-11,Payment from Customer_0053,REF99369607,0.0,213.63,31263.36
2023-12-11,2023-12-11,Service payment - Customer_0060,REF90121706,0.0,122.81,31386.17
2023-12-11,2023-12-11,Service payment - Customer_0035,REF53981766,0.0,127.44,31513.61
2023-12-11,2023-12-11,Project payment - Customer_0074,REF59280906,0.0,140.4,31654.01
2023-12-12,2023-12-12,Service payment - Customer_0030,REF94068990,0.0,142.16,31796.17
2023-12-12,2023-12-12,Service payment - Customer_0067,REF73865188,0.0,53.66,31849.83
2023-12-12,2023-12-12,Project payment - Customer_0062,REF77886724,0.0,146.82,31996.65
2023-12-12,2023-12-12,Invoice payment - Customer_0024,REF62957708,0.0,175.81,32172.46
2023-12-12,2023-12-12,Invoice payment - Customer_0080,REF55427812,0.0,205.02,32377.48
2023-12-12,2023-12-12,Invoice payment - Customer_0031,REF18036638,0.0,58.45,32435.93
2023-12-12,2023-12-12,Invoice payment - Customer_0005,REF26131904,0.0,99.31,32535.24
2023-12-13,2023-12-13,Project payment - Customer_0044,REF20421458,0.0,155.91,32691.15
2023-12-13,2023-12-13,Service payment - Customer_0034,REF37666454,0.0,13.82,32704.97
2023-12-13,2023-12-13,Service payment - Customer_0033,REF64789733,0.0,144.55,32849.52
2023-12-13,2023-12-13,Invoice payment - Customer_0037,REF31973441,0.0,188.6,33038.12
2023-12-13,2023-12-13,Payment from Customer_0016,REF64710570,0.0,51.54,33089.66
2023-12-14,2023-12-14,Invoice payment - Customer_0084,REF47258491,0.0,67.57,33157.23
2023-12-14,2023-12-14,Service payment - Customer_0027,REF37727793,0.0,164.05,33321.28
2023-12-14,2023-12-14,Project payment - Customer_0019,REF15013623,0.0,100.53,33421.81
2023-12-14,2023-12-14,Payment from Customer_0057,REF38762940,0.0,67.91,33489.72
2023-12-14,2023-12-14,Invoice payment - Customer_0007,REF58346791,0.0,36.3,33526.02
2023-12-14,2023-12-14,Service payment - Customer_0039,REF21155677,0.0,233.79,33759.81
2023-12-14,2023-12-14,Project payment - Customer_0058,REF24128555,0.0,173.85,33933.66
2023-12-14,2023-12-14,Project payment - Customer_0081,REF25198394,0.0,108.76,34042.42
2023-12-14,2023-12-14,Invoice payment - Customer_0052,REF22653414,0.0,147.73,34190.15
2023-12-15,2023-12-15,Payment from Customer_0072,REF92288942,0.0,98.1,34288.25
2023-12-15,2023-12-15,Business insurance premium,REF37747265,277.37,0.0,34010.88
2023-12-15,2023-12-15,Service payment - Customer_0041,REF56757394,0.0,75.93,34086.81
2023-12-15,2023-12-15,Service payment - Customer_0037,REF59512844,0.0,223.54,34310.35
2023-12-15,2023-12-15,Payment from Customer_0006,REF68122349,0.0,21.55,34331.9
2023-12-15,2023-12-15,Invoice payment - Customer_0087,REF88847469,0.0,143.9,34475.8
2023-12-15,2023-12-15,Service payment - Customer_0040,REF44468549,0.0,161.51,34637.31
2023-12-16,2023-12-16,Project payment - Customer_0053,REF27994246,0.0,182.2,34819.51
2023-12-16,2023-12-16,Invoice payment - Customer_0063,REF58725238,0.0,180.34,34999.85
2023-12-16,2023-12-16,Invoice payment - Customer_0014,REF72434967,0.0,185.55,35185.4
2023-12-16,2023-12-16,Invoice payment - Customer_0007,REF63146181,0.0,35.63,35221.03
2023-12-16,2023-12-16,Service payment - Customer_0050,REF93962129,0.0,118.3,35339.33
2023-12-16,2023-12-16,Service payment - Customer_0058,REF15779511,0.0,127.44,35466.77
2023-12-16,2023-12-16,Payment from Customer_0010,REF30052108,0.0,221.47,35688.24
2023-12-17,2023-12-17,Invoice payment - Customer_0015,REF41142934,0.0,145.12,35833.36
2023-12-17,2023-12-17,Service payment - Customer_0033,REF95316805,0.0,171.58,36004.94
2023-12-17,2023-12-17,Invoice payment - Customer_0089,REF70871743,0.0,100.55,36105.49
2023-12-17,2023-12-17,Service payment - Customer_0080,REF11485987,0.0,180.22,36285.71
2023-12-17,2023-12-17,Project payment - Customer_0035,REF25408660,0.0,127.55,36413.26
2023-12-17,2023-12-17,Invoice payment - Customer_0005,REF12075552,0.0,116.15,36529.41
2023-12-17,2023-12-17,Invoice payment - Customer_0051,REF39574063,0.0,126.98,36656.39
2023-12-18,2023-12-18,Invoice payment - Customer_0001,REF82331906,0.0,84.23,36740.62
2023-12-18,2023-12-18,Service payment - Customer_0065,REF96851880,0.0,78.81,36819.43
2023-12-18,2023-12-18,Service payment - Customer_0006,REF21121843,0.0,19.0,36838.43
2023-12-18,2023-12-18,Payment from Customer_0037,REF91798439,0.0,178.08,37016.51
2023-12-19,2023-12-19,Payment from Customer_0007,REF60813944,0.0,38.53,37055.04
2023-12-19,2023-12-19,Service payment - Customer_0079,REF40595226,0.0,208.72,37263.76
2023-12-19,2023-12-19,Invoice payment - Customer_0001,REF47278375,0.0,124.5,37388.26
2023-12-19,2023-12-19,Payment from Customer_0099,REF17820271,0.0,76.28,37464.54
2023-12-19,2023-12-19,Payment from Customer_0090,REF50441885,0.0,105.79,37570.33
2023-12-19,2023-12-19,Payment from Customer_0045,REF75322939,0.0,160.19,37730.52
2023-12-20,2023-12-20,Service payment - Customer_0026,REF36284925,0.0,149.01,37879.53
2023-12-20,2023-12-20,Invoice payment - Customer_0056,REF10045013,0.0,14.74,37894.27
2023-12-20,2023-12-20,Service payment - Customer_0050,REF34224419,0.0,88.01,37982.28
2023-12-20,2023-12-20,Invoice payment - Customer_0004,REF68975110,0.0,61.45,38043.73
2023-12-20,2023-12-20,Invoice payment - Customer_0074,REF71064715,0.0,163.97,38207.7
2023-12-20,2023-12-20,Invoice payment - Customer_0001,REF16570304,0.0,170.18,38377.88
2023-12-20,2023-12-20,Service payment - Customer_0098,REF55344187,0.0,141.93,38519.81
2023-12-20,2023-12-20,Payment from Customer_0082,REF70923726,0.0,78.67,38598.48
2023-12-20,2023-12-20,Service payment - Customer_0018,REF38736614,0.0,93.89,38692.37
2023-12-20,2023-12-20,Payment from Customer_0007,REF91900157,0.0,28.84,38721.21
2023-12-20,2023-12-20,Project payment - Customer_0015,REF94290570,0.0,131.17,38852.38
2023-12-20,2023-12-20,Payment from Customer_0042,REF74580362,0.0,137.02,38989.4
2023-12-21,2023-12-21,Payment from Customer_0050,REF32499688,0.0,101.5,39090.9
2023-12-21,2023-12-21,Payment from Customer_0019,REF47537730,0.0,95.89,39186.79
2023-12-21,2023-12-21,Payment from Customer_0047,REF17307181,0.0,112.72,39299.51
2023-12-21,2023-12-21,Payment from Customer_0040,REF78010211,0.0,144.43,39443.94
2023-12-21,2023-12-21,Project payment - Customer_0018,REF89954526,0.0,123.56,39567.5
2023-12-21,2023-12-21,Invoice payment - Customer_0005,REF58133412,0.0,104.39,39671.89
2023-12-21,2023-12-21,Invoice payment - Customer_0020,REF63156656,0.0,113.7,39785.59
2023-12-21,2023-12-21,Invoice payment - Customer_0003,REF46599492,0.0,157.51,39943.1
2023-12-21,2023-12-21,Project payment - Customer_0083,REF14126217,0.0,58.8,40001.9
2023-12-22,2023-12-22,Utility bill payment,REF69518601,254.66,0.0,39747.24
2023-12-22,2023-12-22,Payment from Customer_0047,REF89528010,0.0,97.18,39844.42
2023-12-22,2023-12-22,Service payment - Customer_0010,REF96271571,0.0,153.07,39997.49
2023-12-22,2023-12-22,Invoice payment - Customer_0059,REF94054568,0.0,249.81,40247.3
2023-12-22,2023-12-22,Invoice payment - Customer_0090,REF14884310,0.0,125.87,40373.17
2023-12-22,2023-12-22,Project payment - Customer_0021,REF37625719,0.0,91.54,40464.71
2023-12-22,2023-12-22,Invoice payment - Customer_0004,REF67056206,0.0,73.62,40538.33
2023-12-22,2023-12-22,Service payment - Customer_0029,REF96590439,0.0,122.06,40660.39
2023-12-22,2023-12-22,Service payment - Customer_0032,REF20611609,0.0,186.85,40847.24
2023-12-22,2023-12-22,Project payment - Customer_0015,REF35777252,0.0,147.53,40994.77
2023-12-22,2023-12-22,Payment from Customer_0037,REF42476931,0.0,241.61,41236.38
2023-12-22,2023-12-22,Payment from Customer_0016,REF27101262,0.0,54.71,41291.09
2023-12-23,2023-12-23,Project payment - Customer_0059,REF31404885,0.0,261.73,41552.82
2023-12-23,2023-12-23,Payment from Customer_0004,REF34507103,0.0,78.99,41631.81
2023-12-23,2023-12-23,Service payment - Customer_0062,REF97792712,0.0,141.87,41773.68
2023-12-23,2023-12-23,Project payment - Customer_0084,REF82698822,0.0,72.06,41845.74
2023-12-23,2023-12-23,Payment from Customer_0030,REF93920863,0.0,119.0,41964.74
2023-12-23,2023-12-23,Payment from Customer_0003,REF22606764,0.0,176.26,42141.0
2023-12-23,2023-12-23,Project payment - Customer_0094,REF64794830,0.0,28.39,42169.39
2023-12-23,2023-12-23,Invoice payment - Customer_0013,REF14991603,0.0,84.17,42253.56
2023-12-24,2023-12-24,Service payment - Customer_0067,REF80100353,0.0,67.6,42321.16
2023-12-24,2023-12-24,Service payment - Customer_0081,REF32686689,0.0,168.15,42489.31
2023-12-24,2023-12-24,Invoice payment - Customer_0098,REF15393215,0.0,105.22,42594.53
2023-12-24,2023-12-24,Payment from Customer_0029,REF14407656,0.0,96.75,42691.28
2023-12-24,2023-12-24,Service payment - Customer_0044,REF32465678,0.0,225.98,42917.26
2023-12-24,2023-12-24,Service payment - Customer_0022,REF24553887,0.0,105.47,43022.73
2023-12-24,2023-12-24,Invoice payment - Customer_0068,REF73580758,0.0,189.91,43212.64
2023-12-25,2023-12-25,Payment from Customer_0068,REF57991046,0.0,192.5,43405.14
2023-12-25,2023-12-25,Project payment - Customer_0042,REF99174208,0.0,156.54,43561.68
2023-12-25,2023-12-25,Service payment - Customer_0017,REF18423655,0.0,219.43,43781.11
2023-12-25,2023-12-25,Invoice payment - Customer_0072,REF52420247,0.0,97.03,43878.14
2023-12-25,2023-12-25,Service payment - Customer_0003,REF52943519,0.0,148.81,44026.95
2023-12-25,2023-12-25,Payment from Customer_0083,REF31978991,0.0,67.85,44094.8
2023-12-25,2023-12-25,Payment from Customer_0071,REF66253448,0.0,89.63,44184.43
2023-12-26,2023-12-26,Project payment - Customer_0043,REF75105423,0.0,113.54,44297.97
2023-12-26,2023-12-26,Project payment - Customer_0076,REF48125113,0.0,114.45,44412.42
2023-12-26,2023-12-26,Service payment - Customer_0033,REF86810377,0.0,169.01,44581.43
2023-12-26,2023-12-26,Service payment - Customer_0088,REF87665165,0.0,17.49,44598.92
2023-12-26,2023-12-26,Project payment - Customer_0095,REF75616117,0.0,163.68,44762.6
2023-12-26,2023-12-26,Payment from Customer_0065,REF65230168,0.0,79.85,44842.45
2023-12-26,2023-12-26,Service payment - Customer_0052,REF55652355,0.0,164.16,45006.61
2023-12-26,2023-12-26,Project payment - Customer_0064,REF65308671,0.0,74.68,45081.29
2023-12-26,2023-12-26,Invoice payment - Customer_0049,REF16174332,0.0,77.42,45158.71
2023-12-26,2023-12-26,Project payment - Customer_0081,REF50177313,0.0,157.09,45315.8
2023-12-26,2023-12-26,Service payment - Customer_0002,REF79541788,0.0,76.34,45392.14
2023-12-26,2023-12-26,Service payment - Customer_0022,REF31669671,0.0,112.19,45504.33
2023-12-27,2023-12-27,Service payment - Customer_0083,REF41576683,0.0,56.47,45560.8
2023-12-27,2023-12-27,Payment from Customer_0050,REF57300136,0.0,95.1,45655.9
2023-12-27,2023-12-27,Marketing expenses,REF16707042,483.06,0.0,45172.84
2023-12-27,2023-12-27,Service payment - Customer_0057,REF70603813,0.0,61.49,45234.33
2023-12-27,2023-12-27,Service payment - Customer_0024,REF98206921,0.0,166.08,45400.41
2023-12-27,2023-12-27,Project payment - Customer_0003,REF50270012,0.0,151.4,45551.81
2023-12-27,2023-12-27,Service payment - Customer_0049,REF88424183,0.0,69.03,45620.84
2023-12-27,2023-12-27,Project payment - Customer_0009,REF26847109,0.0,217.26,45838.1
2023-12-27,2023-12-27,Service payment - Customer_0087,REF13875787,0.0,140.71,45978.81
2023-12-28,2023-12-28,Payment from Customer_0010,REF94560522,0.0,142.13,46120.94
2023-12-28,2023-12-28,Payment from Customer_0074,REF58518463,0.0,146.19,46267.13
2023-12-28,2023-12-28,Service payment - Customer_0008,REF57651796,0.0,86.14,46353.27
2023-12-28,2023-12-28,Service payment - Customer_0027,REF30401018,0.0,165.46,46518.73
2023-12-28,2023-12-28,Project payment - Customer_0059,REF49412075,0.0,171.19,46689.92
2023-12-28,2023-12-28,Payment from Customer_0053,REF98666745,0.0,264.72,46954.64
2023-12-28,2023-12-28,Payment from Customer_0054,REF95569818,0.0,40.47,46995.11
2023-12-28,2023-12-28,Payment from Customer_0071,REF87716399,0.0,76.9,47072.01
2023-12-28,2023-12-28,Project payment - Customer_0003,REF62344945,0.0,172.8,47244.81
2023-12-28,2023-12-28,Invoice payment - Customer_0062,REF35597759,0.0,204.24,47449.05
2023-12-28,2023-12-28,Service payment - Customer_0077,REF91486765,0.0,149.91,47598.96
2023-12-28,2023-12-28,Payment from Customer_0085,REF73058036,0.0,148.6,47747.56
2023-12-29,2023-12-29,Project payment - Customer_0099,REF62136319,0.0,76.95,47824.51
2023-12-29,2023-12-29,Invoice payment - Customer_0022,REF51695025,0.0,121.21,47945.72
2023-12-29,2023-12-29,Project payment - Customer_0090,REF37394268,0.0,127.32,48073.04
2023-12-29,2023-12-29,Project payment - Customer_0035,REF66626509,0.0,141.69,48214.73
2023-12-29,2023-12-29,Service payment - Customer_0030,REF17926532,0.0,101.11,48315.84
2023-12-29,2023-12-29,Service payment - Customer_0070,REF83913209,0.0,93.72,48409.56
2023-12-29,2023-12-29,Service payment - Customer_0079,REF92930974,0.0,173.49,48583.05
2023-12-29,2023-12-29,Invoice payment - Customer_0077,REF36110754,0.0,162.29,48745.34
2023-12-29,2023-12-29,Project payment - Customer_0049,REF80432070,0.0,68.14,48813.48
2023-12-29,2023-12-29,Service payment - Customer_0008,REF29462988,0.0,91.86,48905.34
2023-12-29,2023-12-29,Payment from Customer_0078,REF32322591,0.0,82.32,48987.66
2023-12-29,2023-12-29,Invoice payment - Customer_0052,REF70056849,0.0,130.52,49118.18
2023-12-30,2023-12-30,Payment from Customer_0043,REF57949852,0.0,116.83,49235.01
2023-12-30,2023-12-30,Project payment - Customer_0062,REF99148804,0.0,206.87,49441.88
2023-12-30,2023-12-30,Payment from Customer_0054,REF11548959,0.0,46.51,49488.39
2023-12-30,2023-12-30,Payment from Customer_0067,REF93601449,0.0,81.41,49569.8
2023-12-30,2023-12-30,Payment from Customer_0001,REF23053117,0.0,117.91,49687.71
2023-12-30,2023-12-30,Payment from Customer_0035,REF87810291,0.0,97.33,49785.04
2023-12-30,2023-12-30,Project payment - Customer_0014,REF15582016,0.0,165.6,49950.64
2023-12-31,2023-12-31,Invoice payment - Customer_0057,REF44616668,0.0,66.26,50016.9
2023-12-31,2023-12-31,Payment from Customer_0099,REF49303817,0.0,55.24,50072.14
2023-12-31,2023-12-31,Invoice payment - Customer_0076,REF90511030,0.0,116.94,50189.08
2023-12-31,2023-12-31,Project payment - Customer_0018,REF68458437,0.0,89.35,50278.43
2023-12-31,2023-12-31,Project payment - Customer_0072,REF17973311,0.0,115.11,50393.54
2023-12-31,2023-12-31,Payment from Customer_0056,REF57003338,0.0,19.21,50412.75
2024-01-01,2024-01-01,Payment from Customer_0005,REF12289982,0.0,51.43,50464.18
2024-01-01,2024-01-01,Monthly office rent,REF71139913,866.38,0.0,49597.8
2024-01-01,2024-01-01,Project payment - Customer_0076,REF82372490,0.0,68.47,49666.27
2024-01-01,2024-01-01,Service payment - Customer_0062,REF51706444,0.0,96.75,49763.02
2024-01-01,2024-01-01,Service payment - Customer_0067,REF32853067,0.0,38.07,49801.09
2024-01-01,2024-01-01,Project payment - Customer_0093,REF21247054,0.0,37.93,49839.02
2024-01-02,2024-01-02,Project payment - Customer_0005,REF64359627,0.0,46.9,49885.92
2024-01-02,2024-01-02,Project payment - Customer_0041,REF76246737,0.0,46.17,49932.09
2024-01-02,2024-01-02,Payment from Customer_0040,REF49844264,0.0,85.79,50017.88
2024-01-02,2024-01-02,Project payment - Customer_0004,REF56966371,0.0,33.06,50050.94
2024-01-02,2024-01-02,Payment from Customer_0086,REF16914704,0.0,85.93,50136.87
2024-01-02,2024-01-02,Project payment - Customer_0027,REF45355696,0.0,71.52,50208.39
2024-01-02,2024-01-02,Project payment - Customer_0081,REF14717040,0.0,64.03,50272.42
2024-01-02,2024-01-02,Payment from Customer_0093,REF54615567,0.0,39.94,50312.36
2024-01-02,2024-01-02,Service payment - Customer_0022,REF93286319,0.0,54.48,50366.84
2024-01-02,2024-01-02,Service payment - Customer_0021,REF36129582,0.0,65.18,50432.02
2024-01-02,2024-01-02,Service payment - Customer_0019,REF56937942,0.0,36.94,50468.96
2024-01-02,2024-01-02,Payment from Customer_0011,REF99980325,0.0,41.91,50510.87
2024-01-02,2024-01-02,Invoice payment - Customer_0009,REF52483633,0.0,125.73,50636.6
2024-01-02,2024-01-02,Project payment - Customer_0088,REF32736590,0.0,10.0,50646.6
2024-01-02,2024-01-02,Service payment - Customer_0048,REF73280742,0.0,66.66,50713.26
2024-01-03,2024-01-03,Project payment - Customer_0058,REF93005346,0.0,96.51,50809.77
2024-01-03,2024-01-03,Payment from Customer_0049,REF30088512,0.0,27.98,50837.75
2024-01-03,2024-01-03,Invoice payment - Customer_0002,REF98059279,0.0,32.44,50870.19
2024-01-03,2024-01-03,Payment from Customer_0075,REF46556711,0.0,48.29,50918.48
2024-01-03,2024-01-03,Service payment - Customer_0051,REF43274710,0.0,46.49,50964.97
2024-01-03,2024-01-03,Service payment - Customer_0039,REF54643850,0.0,111.02,51075.99
2024-01-03,2024-01-03,Service payment - Customer_0092,REF46354644,0.0,67.42,51143.41
2024-01-03,2024-01-03,Payment from Customer_0056,REF61329586,0.0,10.0,51153.41
2024-01-03,2024-01-03,Project payment - Customer_0050,REF56335846,0.0,45.66,51199.07
2024-01-03,2024-01-03,Project payment - Customer_0004,REF57203675,0.0,30.87,51229.94
2024-01-03,2024-01-03,Service payment - Customer_0097,REF23870674,0.0,37.24,51267.18
2024-01-03,2024-01-03,Service payment - Customer_0063,REF40849257,0.0,89.9,51357.08
2024-01-04,2024-01-04,Service payment - Customer_0017,REF57851627,0.0,109.03,51466.11
2024-01-04,2024-01-04,Project payment - Customer_0064,REF32409291,0.0,33.94,51500.05
2024-01-04,2024-01-04,Payment from Customer_0050,REF52113567,0.0,46.94,51546.99
2024-01-04,2024-01-04,Project payment - Customer_0029,REF94896736,0.0,62.11,51609.1
2024-01-04,2024-01-04,Project payment - Customer_0073,REF42069362,0.0,32.44,51641.54
2024-01-04,2024-01-04,Invoice payment - Customer_0052,REF71105319,0.0,77.11,51718.65
2024-01-04,2024-01-04,Project payment - Customer_0014,REF23594580,0.0,74.29,51792.94
2024-01-04,2024-01-04,Invoice payment - Customer_0041,REF34521437,0.0,52.01,51844.95
2024-01-05,2024-01-05,Service payment - Customer_0099,REF27322942,0.0,35.21,51880.16
2024-01-05,2024-01-05,Payment from Customer_0030,REF55750546,0.0,60.84,51941.0
2024-01-05,2024-01-05,Payment from Customer_0056,REF69798549,0.0,10.0,51951.0
2024-01-05,2024-01-05,Project payment - Customer_0035,REF15524015,0.0,57.86,52008.86
2024-01-05,2024-01-05,Invoice payment - Customer_0086,REF36451647,0.0,75.94,52084.8
2024-01-05,2024-01-05,Project payment - Customer_0029,REF34073393,0.0,61.64,52146.44
2024-01-05,2024-01-05,Service payment - Customer_0084,REF13954304,0.0,37.05,52183.49
2024-01-06,2024-01-06,Project payment - Customer_0025,REF41245528,0.0,76.78,52260.27
2024-01-06,2024-01-06,Project payment - Customer_0079,REF31955410,0.0,117.65,52377.92
2024-01-06,2024-01-06,Service payment - Customer_0034,REF14405587,0.0,10.0,52387.92
2024-01-06,2024-01-06,Payment from Customer_0092,REF80772912,0.0,77.46,52465.38
2024-01-06,2024-01-06,Project payment - Customer_0084,REF80181448,0.0,28.67,52494.05
2024-01-06,2024-01-06,Service payment - Customer_0067,REF99928176,0.0,37.67,52531.72
2024-01-06,2024-01-06,Invoice payment - Customer_0004,REF39987602,0.0,24.96,52556.68
2024-01-06,2024-01-06,Service payment - Customer_0003,REF65189282,0.0,113.66,52670.34
2024-01-06,2024-01-06,Project payment - Customer_0064,REF56111885,0.0,28.52,52698.86
2024-01-07,2024-01-07,Invoice payment - Customer_0098,REF94134825,0.0,56.63,52755.49
2024-01-07,2024-01-07,Project payment - Customer_0059,REF40013368,0.0,131.98,52887.47
2024-01-07,2024-01-07,Project payment - Customer_0043,REF43947867,0.0,60.47,52947.94
2024-01-07,2024-01-07,Payment from Customer_0029,REF36572939,0.0,46.4,52994.34
2024-01-07,2024-01-07,Service payment - Customer_0005,REF42749646,0.0,45.88,53040.22
2024-01-07,2024-01-07,Invoice payment - Customer_0080,REF71130317,0.0,88.7,53128.92
2024-01-07,2024-01-07,Invoice payment - Customer_0066,REF17383838,0.0,90.88,53219.8
2024-01-07,2024-01-07,Payment from Customer_0068,REF46049206,0.0,66.15,53285.95
2024-01-07,2024-01-07,Invoice payment - Customer_0023,REF39513323,0.0,47.91,53333.86
2024-01-07,2024-01-07,Invoice payment - Customer_0015,REF87036948,0.0,63.29,53397.15
2024-01-07,2024-01-07,Service payment - Customer_0001,REF21198017,0.0,52.16,53449.31
2024-01-07,2024-01-07,Payment from Customer_0072,REF91686565,0.0,65.88,53515.19
2024-01-07,2024-01-07,Service payment - Customer_0070,REF51020158,0.0,52.08,53567.27
2024-01-07,2024-01-07,Service payment - Customer_0073,REF75396031,0.0,44.32,53611.59
2024-01-07,2024-01-07,Project payment - Customer_0069,REF52476507,0.0,155.24,53766.83
2024-01-07,2024-01-07,Payment from Customer_0085,REF11887453,0.0,60.27,53827.1
2024-01-07,2024-01-07,Payment from Customer_0027,REF69695346,0.0,87.12,53914.22
2024-01-07,2024-01-07,Payment from Customer_0086,REF16417931,0.0,77.04,53991.26
2024-01-08,2024-01-08,Service payment - Customer_0091,REF29420678,0.0,91.03,54082.29
2024-01-08,2024-01-08,Invoice payment - Customer_0037,REF46806199,0.0,86.35,54168.64
2024-01-08,2024-01-08,Project payment - Customer_0045,REF90858299,0.0,71.58,54240.22
2024-01-08,2024-01-08,Payment from Customer_0008,REF96170275,0.0,53.58,54293.8
2024-01-08,2024-01-08,Service payment - Customer_0015,REF71642804,0.0,84.08,54377.88
2024-01-08,2024-01-08,Project payment - Customer_0055,REF57937658,0.0,71.26,54449.14
2024-01-08,2024-01-08,Service payment - Customer_0043,REF61728853,0.0,52.38,54501.52
2024-01-08,2024-01-08,Payment from Customer_0022,REF17055571,0.0,44.38,54545.9
2024-01-08,2024-01-08,Payment from Customer_0089,REF36412025,0.0,38.27,54584.17
2024-01-08,2024-01-08,Project payment - Customer_0006,REF36571539,0.0,10.0,54594.17
2024-01-08,2024-01-08,Invoice payment - Customer_0005,REF47000709,0.0,43.47,54637.64
2024-01-08,2024-01-08,Payment from Customer_0064,REF22086220,0.0,32.32,54669.96
2024-01-08,2024-01-08,Service payment - Customer_0072,REF89674517,0.0,61.72,54731.68
2024-01-09,2024-01-09,Invoice payment - Customer_0013,REF55789187,0.0,36.58,54768.26
2024-01-09,2024-01-09,Payment from Customer_0084,REF70697374,0.0,34.59,54802.85
2024-01-09,2024-01-09,Service payment - Customer_0019,REF48340444,0.0,46.28,54849.13
2024-01-09,2024-01-09,Payment from Customer_0064,REF80605419,0.0,42.23,54891.36
2024-01-09,2024-01-09,Payment from Customer_0026,REF41133830,0.0,75.04,54966.4
2024-01-10,2024-01-10,Inventory purchase,REF40075821,1105.65,0.0,53860.75
2024-01-10,2024-01-10,Payment from Customer_0030,REF43250971,0.0,58.94,53919.69
2024-01-10,2024-01-10,Project payment - Customer_0054,REF60455709,0.0,18.22,53937.91
2024-01-10,2024-01-10,Invoice payment - Customer_0091,REF36060344,0.0,94.54,54032.45
2024-01-10,2024-01-10,Payment from Customer_0060,REF21006715,0.0,46.53,54078.98
2024-01-10,2024-01-10,Payment from Customer_0066,REF52023529,0.0,99.62,54178.6
2024-01-10,2024-01-10,Project payment - Customer_0061,REF25409800,0.0,71.74,54250.34
2024-01-10,2024-01-10,Payment from Customer_0000,REF12742794,0.0,85.85,54336.19
2024-01-10,2024-01-10,Payment from Customer_0026,REF66596838,0.0,80.19,54416.38
2024-01-11,2024-01-11,Service payment - Customer_0012,REF21098682,0.0,79.74,54496.12
2024-01-11,2024-01-11,Invoice payment - Customer_0058,REF96528740,0.0,65.19,54561.31
2024-01-11,2024-01-11,Payment from Customer_0097,REF35451366,0.0,49.74,54611.05
2024-01-11,2024-01-11,Project payment - Customer_0039,REF55022705,0.0,91.7,54702.75
2024-01-11,2024-01-11,Project payment - Customer_0063,REF30257309,0.0,84.13,54786.88
2024-01-11,2024-01-11,Project payment - Customer_0093,REF23110355,0.0,40.63,54827.51
2024-01-11,2024-01-11,Service payment - Customer_0087,REF40112674,0.0,54.48,54881.99
2024-01-11,2024-01-11,Invoice payment - Customer_0054,REF29899022,0.0,14.33,54896.32
2024-01-11,2024-01-11,Project payment - Customer_0000,REF81576267,0.0,80.7,54977.02
2024-01-11,2024-01-11,Invoice payment - Customer_0088,REF98878063,0.0,10.0,54987.02
2024-01-11,2024-01-11,Project payment - Customer_0077,REF55034485,0.0,63.77,55050.79
2024-01-12,2024-01-12,Project payment - Customer_0004,REF60169652,0.0,29.16,55079.95
2024-01-12,2024-01-12,Project payment - Customer_0084,REF73037719,0.0,35.05,55115.0
2024-01-12,2024-01-12,Inventory purchase,REF54335523,2697.73,0.0,52417.27
2024-01-12,2024-01-12,Payment from Customer_0060,REF36567073,0.0,62.66,52479.93
2024-01-12,2024-01-12,Project payment - Customer_0018,REF16942858,0.0,43.75,52523.68
2024-01-12,2024-01-12,Payment from Customer_0090,REF64558359,0.0,60.6,52584.28
2024-01-12,2024-01-12,Project payment - Customer_0017,REF83297209,0.0,107.98,52692.26
2024-01-12,2024-01-12,Service payment - Customer_0074,REF23440467,0.0,89.63,52781.89
2024-01-12,2024-01-12,Service payment - Customer_0059,REF85969693,0.0,102.34,52884.23
2024-01-12,2024-01-12,Project payment - Customer_0050,REF70660997,0.0,53.96,52938.19
2024-01-12,2024-01-12,Payment from Customer_0005,REF41122670,0.0,47.59,52985.78
2024-01-13,2024-01-13,Project payment - Customer_0006,REF40322455,0.0,10.0,52995.78
2024-01-13,2024-01-13,Project payment - Customer_0042,REF57486936,0.0,65.39,53061.17
2024-01-13,2024-01-13,Invoice payment - Customer_0050,REF25844984,0.0,66.24,53127.41
2024-01-13,2024-01-13,Invoice payment - Customer_0024,REF45933296,0.0,118.79,53246.2
2024-01-13,2024-01-13,Inventory purchase,REF89757399,1816.28,0.0,51429.92
2024-01-13,2024-01-13,Invoice payment - Customer_0053,REF28411171,0.0,119.65,51549.57
2024-01-13,2024-01-13,Service payment - Customer_0025,REF41483664,0.0,64.19,51613.76
2024-01-13,2024-01-13,Project payment - Customer_0001,REF86625189,0.0,43.66,51657.42
2024-01-13,2024-01-13,Project payment - Customer_0011,REF84934894,0.0,35.3,51692.72
2024-01-14,2024-01-14,Project payment - Customer_0055,REF52612192,0.0,70.77,51763.49
2024-01-14,2024-01-14,Payment from Customer_0057,REF37232386,0.0,26.89,51790.38
2024-01-14,2024-01-14,Service payment - Customer_0043,REF14476556,0.0,57.75,51848.13
2024-01-14,2024-01-14,Service payment - Customer_0018,REF42477073,0.0,62.42,51910.55
2024-01-14,2024-01-14,Service payment - Customer_0031,REF11734043,0.0,24.85,51935.4
2024-01-14,2024-01-14,Payment from Customer_0082,REF89675607,0.0,49.37,51984.77
2024-01-14,2024-01-14,Project payment - Customer_0066,REF81270730,0.0,77.36,52062.13
2024-01-14,2024-01-14,Project payment - Customer_0083,REF22469791,0.0,20.9,52083.03
2024-01-14,2024-01-14,Payment from Customer_0065,REF19117880,0.0,37.29,52120.32
2024-01-14,2024-01-14,Invoice payment - Customer_0058,REF66938535,0.0,63.57,52183.89
2024-01-14,2024-01-14,Project payment - Customer_0076,REF38926452,0.0,61.12,52245.01
2024-01-14,2024-01-14,Service payment - Customer_0033,REF74786398,0.0,68.22,52313.23
2024-01-14,2024-01-14,Invoice payment - Customer_0098,REF26192489,0.0,51.26,52364.49
2024-01-14,2024-01-14,Invoice payment - Customer_0039,REF44647425,0.0,79.43,52443.92
2024-01-14,2024-01-14,Project payment - Customer_0024,REF47914294,0.0,120.18,52564.1
2024-01-15,2024-01-15,Business insurance premium,REF86811265,149.58,0.0,52414.52
2024-01-15,2024-01-15,Invoice payment - Customer_0048,REF66520721,0.0,67.99,52482.51
2024-01-15,2024-01-15,Payment from Customer_0062,REF69007364,0.0,88.63,52571.14
2024-01-15,2024-01-15,Invoice payment - Customer_0018,REF62230944,0.0,47.59,52618.73
2024-01-15,2024-01-15,Payment from Customer_0072,REF50715065,0.0,67.31,52686.04
2024-01-15,2024-01-15,Employee payroll,REF96798460,1265.86,0.0,51420.18
2024-01-16,2024-01-16,Payment from Customer_0093,REF56360556,0.0,35.94,51456.12
2024-01-16,2024-01-16,Invoice payment - Customer_0000,REF13879870,0.0,83.69,51539.81
2024-01-16,2024-01-16,Payment from Customer_0020,REF73287882,0.0,48.82,51588.63
2024-01-16,2024-01-16,Project payment - Customer_0064,REF89399764,0.0,32.33,51620.96
2024-01-16,2024-01-16,Project payment - Customer_0072,REF32352840,0.0,62.99,51683.95
2024-01-16,2024-01-16,Invoice payment - Customer_0009,REF31627090,0.0,90.98,51774.93
2024-01-16,2024-01-16,Payment from Customer_0006,REF91312431,0.0,10.0,51784.93
2024-01-16,2024-01-16,Invoice payment - Customer_0017,REF35603388,0.0,107.41,51892.34
2024-01-16,2024-01-16,Invoice payment - Customer_0089,REF92935888,0.0,38.64,51930.98
2024-01-16,2024-01-16,Project payment - Customer_0033,REF91403356,0.0,67.25,51998.23
2024-01-17,2024-01-17,Packaging Shipping expense,REF20948885,102.54,0.0,51895.69
2024-01-17,2024-01-17,Payment from Customer_0055,REF60576555,0.0,59.33,51955.02
2024-01-17,2024-01-17,Project payment - Customer_0085,REF59183714,0.0,71.56,52026.58
2024-01-17,2024-01-17,Payment from Customer_0087,REF56256016,0.0,64.56,52091.14
2024-01-17,2024-01-17,Payment from Customer_0028,REF60562360,0.0,79.51,52170.65
2024-01-17,2024-01-17,Service payment - Customer_0005,REF12891611,0.0,41.4,52212.05
2024-01-17,2024-01-17,Invoice payment - Customer_0030,REF30493638,0.0,58.89,52270.94
2024-01-17,2024-01-17,Service payment - Customer_0088,REF45106877,0.0,10.0,52280.94
2024-01-17,2024-01-17,Service payment - Customer_0083,REF58554811,0.0,29.01,52309.95
2024-01-17,2024-01-17,Inventory purchase,REF40517799,2274.87,0.0,50035.08
2024-01-17,2024-01-17,Payment from Customer_0024,REF16828813,0.0,139.84,50174.92
2024-01-17,2024-01-17,Payment from Customer_0019,REF50186549,0.0,52.19,50227.11
2024-01-17,2024-01-17,Project payment - Customer_0084,REF25204772,0.0,34.82,50261.93
2024-01-18,2024-01-18,Project payment - Customer_0089,REF95304778,0.0,38.96,50300.89
2024-01-18,2024-01-18,Invoice payment - Customer_0020,REF92482092,0.0,36.18,50337.07
2024-01-18,2024-01-18,Service payment - Customer_0030,REF70877895,0.0,80.97,50418.04
2024-01-18,2024-01-18,Payment from Customer_0059,REF62125639,0.0,126.11,50544.15
2024-01-18,2024-01-18,Project payment - Customer_0068,REF88832836,0.0,72.0,50616.15
2024-01-18,2024-01-18,Project payment - Customer_0058,REF27793700,0.0,74.77,50690.92
2024-01-18,2024-01-18,Invoice payment - Customer_0083,REF19906945,0.0,25.0,50715.92
2024-01-19,2024-01-19,Project payment - Customer_0080,REF36015496,0.0,101.92,50817.84
2024-01-19,2024-01-19,Invoice payment - Customer_0017,REF36719676,0.0,136.23,50954.07
2024-01-19,2024-01-19,Project payment - Customer_0090,REF68749089,0.0,47.12,51001.19
2024-01-19,2024-01-19,Invoice payment - Customer_0076,REF38736735,0.0,63.26,51064.45
2024-01-19,2024-01-19,Invoice payment - Customer_0061,REF23245111,0.0,62.71,51127.16
2024-01-20,2024-01-20,Invoice payment - Customer_0001,REF94674035,0.0,62.31,51189.47
2024-01-20,2024-01-20,Project payment - Customer_0019,REF75922012,0.0,51.36,51240.83
2024-01-20,2024-01-20,Project payment - Customer_0004,REF12493748,0.0,45.34,51286.17
2024-01-20,2024-01-20,Project payment - Customer_0060,REF78745164,0.0,53.6,51339.77
2024-01-20,2024-01-20,Invoice payment - Customer_0023,REF78944772,0.0,31.74,51371.51
2024-01-20,2024-01-20,Project payment - Customer_0054,REF98448356,0.0,23.77,51395.28
2024-01-20,2024-01-20,Payment from Customer_0096,REF86743239,0.0,36.88,51432.16
2024-01-20,2024-01-20,Payment from Customer_0067,REF25175852,0.0,35.01,51467.17
2024-01-20,2024-01-20,Payment from Customer_0024,REF39217534,0.0,98.07,51565.24
2024-01-21,2024-01-21,Payment from Customer_0038,REF70431149,0.0,33.53,51598.77
2024-01-21,2024-01-21,Invoice payment - Customer_0087,REF91594374,0.0,43.22,51641.99
2024-01-21,2024-01-21,Project payment - Customer_0003,REF51588624,0.0,99.49,51741.48
2024-01-21,2024-01-21,Payment from Customer_0033,REF85569435,0.0,75.11,51816.59
2024-01-21,2024-01-21,Service payment - Customer_0047,REF59129303,0.0,45.94,51862.53
2024-01-21,2024-01-21,Project payment - Customer_0084,REF42325391,0.0,32.08,51894.61
2024-01-21,2024-01-21,Invoice payment - Customer_0001,REF89889755,0.0,83.13,51977.74
2024-01-21,2024-01-21,Invoice payment - Customer_0037,REF21783889,0.0,89.65,52067.39
2024-01-21,2024-01-21,Invoice payment - Customer_0085,REF94784294,0.0,42.02,52109.41
2024-01-22,2024-01-22,Utility bill payment,REF85580188,107.41,0.0,52002.0
2024-01-22,2024-01-22,Project payment - Customer_0024,REF83033852,0.0,110.49,52112.49
2024-01-22,2024-01-22,Payment from Customer_0033,REF70320311,0.0,81.3,52193.79
2024-01-22,2024-01-22,Payment from Customer_0011,REF35790623,0.0,29.25,52223.04
2024-01-22,2024-01-22,Project payment - Customer_0095,REF57948801,0.0,71.55,52294.59
2024-01-22,2024-01-22,Project payment - Customer_0050,REF51572280,0.0,45.9,52340.49
2024-01-23,2024-01-23,Project payment - Customer_0058,REF36826709,0.0,54.01,52394.5
2024-01-23,2024-01-23,Payment from Customer_0029,REF39483199,0.0,54.54,52449.04
2024-01-23,2024-01-23,Project payment - Customer_0011,REF31194616,0.0,27.59,52476.63
2024-01-23,2024-01-23,Service payment - Customer_0095,REF76380923,0.0,66.97,52543.6
2024-01-23,2024-01-23,Payment from Customer_0016,REF43973546,0.0,14.9,52558.5
2024-01-23,2024-01-23,Project payment - Customer_0073,REF89304269,0.0,42.64,52601.14
2024-01-23,2024-01-23,Service payment - Customer_0027,REF92056048,0.0,80.21,52681.35
2024-01-23,2024-01-23,Payment from Customer_0002,REF44612513,0.0,40.45,52721.8
2024-01-23,2024-01-23,Project payment - Customer_0065,REF23297510,0.0,38.66,52760.46
2024-01-23,2024-01-23,Invoice payment - Customer_0074,REF29974210,0.0,87.2,52847.66
2024-01-23,2024-01-23,Payment from Customer_0062,REF71739518,0.0,80.38,52928.04
2024-01-23,2024-01-23,Project payment - Customer_0051,REF61156047,0.0,61.87,52989.91
2024-01-24,2024-01-24,Service payment - Customer_0041,REF33429419,0.0,43.94,53033.85
2024-01-24,2024-01-24,Service payment - Customer_0076,REF74143775,0.0,66.63,53100.48
2024-01-24,2024-01-24,Project payment - Customer_0014,REF46292783,0.0,65.03,53165.51
2024-01-24,2024-01-24,Project payment - Customer_0069,REF94501453,0.0,179.53,53345.04
2024-01-24,2024-01-24,Invoice payment - Customer_0091,REF59832070,0.0,88.17,53433.21
2024-01-24,2024-01-24,Project payment - Customer_0020,REF93402067,0.0,54.15,53487.36
2024-01-24,2024-01-24,Project payment - Customer_0049,REF90981395,0.0,44.66,53532.02
2024-01-24,2024-01-24,Payment from Customer_0030,REF75683637,0.0,77.0,53609.02
2024-01-24,2024-01-24,Invoice payment - Customer_0084,REF43328240,0.0,35.35,53644.37
2024-01-25,2024-01-25,Project payment - Customer_0035,REF88587269,0.0,50.45,53694.82
2024-01-25,2024-01-25,Service payment - Customer_0059,REF14321100,0.0,110.95,53805.77
2024-01-25,2024-01-25,Payment from Customer_0056,REF63997112,0.0,10.0,53815.77
2024-01-25,2024-01-25,Invoice payment - Customer_0001,REF68676465,0.0,59.29,53875.06
2024-01-25,2024-01-25,Service payment - Customer_0098,REF84212833,0.0,64.65,53939.71
2024-01-25,2024-01-25,Project payment - Customer_0051,REF64855546,0.0,62.36,54002.07
2024-01-25,2024-01-25,Payment from Customer_0049,REF39651899,0.0,33.29,54035.36
2024-01-25,2024-01-25,Service payment - Customer_0073,REF94823761,0.0,28.38,54063.74
2024-01-25,2024-01-25,Project payment - Customer_0019,REF44901371,0.0,36.87,54100.61
2024-01-25,2024-01-25,Project payment - Customer_0050,REF86648591,0.0,36.61,54137.22
2024-01-25,2024-01-25,Service payment - Customer_0092,REF30801249,0.0,69.07,54206.29
2024-01-25,2024-01-25,Payment from Customer_0038,REF86686470,0.0,46.51,54252.8
2024-01-26,2024-01-26,Service payment - Customer_0066,REF45218882,0.0,59.49,54312.29
2024-01-26,2024-01-26,Invoice payment - Customer_0089,REF17600314,0.0,41.35,54353.64
2024-01-26,2024-01-26,Invoice payment - Customer_0065,REF74552816,0.0,26.99,54380.63
2024-01-26,2024-01-26,Service payment - Customer_0013,REF69552780,0.0,40.65,54421.28
2024-01-26,2024-01-26,Project payment - Customer_0034,REF25636044,0.0,10.13,54431.41
2024-01-26,2024-01-26,Project payment - Customer_0099,REF64368912,0.0,33.44,54464.85
2024-01-26,2024-01-26,Service payment - Customer_0008,REF14479356,0.0,30.53,54495.38
2024-01-26,2024-01-26,Payment from Customer_0082,REF25172851,0.0,50.59,54545.97
2024-01-26,2024-01-26,Project payment - Customer_0018,REF57374221,0.0,38.46,54584.43
2024-01-26,2024-01-26,Payment from Customer_0098,REF82022568,0.0,49.08,54633.51
2024-01-26,2024-01-26,Payment from Customer_0049,REF23433748,0.0,38.7,54672.21
2024-01-26,2024-01-26,Service payment - Customer_0058,REF84235210,0.0,59.13,54731.34
2024-01-26,2024-01-26,Invoice payment - Customer_0035,REF86636822,0.0,63.47,54794.81
2024-01-26,2024-01-26,Payment from Customer_0026,REF30020522,0.0,58.53,54853.34
2024-01-27,2024-01-27,Invoice payment - Customer_0055,REF93770989,0.0,55.98,54909.32
2024-01-27,2024-01-27,Project payment - Customer_0031,REF55085657,0.0,23.21,54932.53
2024-01-27,2024-01-27,Service payment - Customer_0019,REF30147008,0.0,54.72,54987.25
2024-01-27,2024-01-27,Service payment - Customer_0006,REF16034775,0.0,10.0,54997.25
2024-01-27,2024-01-27,Payment from Customer_0078,REF95251507,0.0,45.78,55043.03
2024-01-27,2024-01-27,Project payment - Customer_0085,REF58105167,0.0,61.58,55104.61
2024-01-27,2024-01-27,Project payment - Customer_0046,REF48238203,0.0,39.77,55144.38
2024-01-27,2024-01-27,Project payment - Customer_0012,REF53672661,0.0,102.06,55246.44
2024-01-27,2024-01-27,Project payment - Customer_0026,REF40187592,0.0,83.07,55329.51
2024-01-27,2024-01-27,Payment from Customer_0047,REF38081006,0.0,40.2,55369.71
2024-01-27,2024-01-27,Project payment - Customer_0003,REF36955602,0.0,85.23,55454.94
2024-01-27,2024-01-27,Service payment - Customer_0076,REF31025437,0.0,59.88,55514.82
2024-01-27,2024-01-27,Service payment - Customer_0098,REF85889161,0.0,63.07,55577.89
2024-01-27,2024-01-27,Payment from Customer_0034,REF89257295,0.0,10.0,55587.89
2024-01-28,2024-01-28,Service payment - Customer_0055,REF69192603,0.0,62.56,55650.45
2024-01-28,2024-01-28,Payment from Customer_0097,REF48562336,0.0,37.31,55687.76
2024-01-28,2024-01-28,Service payment - Customer_0032,REF35231331,0.0,78.77,55766.53
2024-01-28,2024-01-28,Payment from Customer_0056,REF49130262,0.0,10.0,55776.53
2024-01-28,2024-01-28,Service payment - Customer_0069,REF58980039,0.0,147.6,55924.13
2024-01-28,2024-01-28,Payment from Customer_0022,REF42640646,0.0,43.69,55967.82
2024-01-28,2024-01-28,Invoice payment - Customer_0066,REF17415624,0.0,102.38,56070.2
2024-01-28,2024-01-28,Payment from Customer_0053,REF70978835,0.0,158.76,56228.96
2024-01-28,2024-01-28,Service payment - Customer_0037,REF33852835,0.0,77.61,56306.57
2024-01-28,2024-01-28,Project payment - Customer_0015,REF53980692,0.0,84.76,56391.33
2024-01-28,2024-01-28,Project payment - Customer_0090,REF99913285,0.0,67.87,56459.2
2024-01-29,2024-01-29,Payment from Customer_0072,REF29822794,0.0,66.71,56525.91
2024-01-29,2024-01-29,Invoice payment - Customer_0020,REF64891815,0.0,40.94,56566.85
2024-01-29,2024-01-29,Payment from Customer_0056,REF51892388,0.0,10.0,56576.85
2024-01-29,2024-01-29,Invoice payment - Customer_0048,REF75070480,0.0,79.0,56655.85
2024-01-29,2024-01-29,Payment from Customer_0005,REF12134335,0.0,59.68,56715.53
2024-01-29,2024-01-29,Project payment - Customer_0070,REF50204891,0.0,51.15,56766.68
2024-01-29,2024-01-29,Invoice payment - Customer_0009,REF35777263,0.0,125.33,56892.01
2024-01-29,2024-01-29,Payment from Customer_0047,REF56911555,0.0,63.93,56955.94
2024-01-29,2024-01-29,Project payment - Customer_0083,REF33307399,0.0,25.04,56980.98
2024-01-29,2024-01-29,Service payment - Customer_0082,REF91150496,0.0,43.51,57024.49
2024-01-29,2024-01-29,Service payment - Customer_0035,REF10012574,0.0,81.81,57106.3
2024-01-29,2024-01-29,Payment from Customer_0081,REF36109922,0.0,70.01,57176.31
2024-01-29,2024-01-29,Payment from Customer_0068,REF34993644,0.0,89.24,57265.55
2024-01-30,2024-01-30,Invoice payment - Customer_0086,REF95160072,0.0,68.61,57334.16
2024-01-30,2024-01-30,Invoice payment - Customer_0012,REF70197148,0.0,88.43,57422.59
2024-01-30,2024-01-30,Payment from Customer_0080,REF88823434,0.0,81.08,57503.67
2024-01-30,2024-01-30,Project payment - Customer_0070,REF31236249,0.0,30.06,57533.73
2024-01-30,2024-01-30,Project payment - Customer_0033,REF71606922,0.0,73.89,57607.62
2024-01-30,2024-01-30,Project payment - Customer_0058,REF30386122,0.0,74.58,57682.2
2024-01-30,2024-01-30,Invoice payment - Customer_0047,REF42594875,0.0,47.54,57729.74
2024-01-31,2024-01-31,Invoice payment - Customer_0086,REF16715064,0.0,52.82,57782.56
2024-01-31,2024-01-31,Project payment - Customer_0023,REF86103472,0.0,48.36,57830.92
2024-01-31,2024-01-31,Payment from Customer_0030,REF19644759,0.0,63.58,57894.5
2024-01-31,2024-01-31,Payment from Customer_0087,REF76764081,0.0,57.95,57952.45
2024-01-31,2024-01-31,Payment from Customer_0096,REF54177757,0.0,38.63,57991.08
2024-01-31,2024-01-31,Payment from Customer_0056,REF93450231,0.0,10.0,58001.08
2024-01-31,2024-01-31,Invoice payment - Customer_0058,REF83939119,0.0,55.62,58056.7
2024-01-31,2024-01-31,Payment from Customer_0069,REF36085106,0.0,135.1,58191.8
2024-01-31,2024-01-31,Project payment - Customer_0027,REF73026771,0.0,95.45,58287.25
2024-01-31,2024-01-31,Service payment - Customer_0014,REF95889383,0.0,75.8,58363.05
2024-01-31,2024-01-31,Invoice payment - Customer_0038,REF68678055,0.0,46.19,58409.24
2024-02-01,2024-02-01,Employee payroll,REF59109939,1465.28,0.0,56943.96
2024-02-01,2024-02-01,Project payment - Customer_0027,REF48167734,0.0,79.28,57023.24
2024-02-01,2024-02-01,Payment from Customer_0044,REF55997630,0.0,95.09,57118.33
2024-02-01,2024-02-01,Service payment - Customer_0083,REF70452593,0.0,40.13,57158.46
2024-02-01,2024-02-01,Monthly office rent,REF47957185,1025.52,0.0,56132.94
2024-02-01,2024-02-01,Invoice payment - Customer_0042,REF65522523,0.0,90.99,56223.93
2024-02-01,2024-02-01,Project payment - Customer_0030,REF89940141,0.0,78.99,56302.92
2024-02-01,2024-02-01,Invoice payment - Customer_0074,REF45756465,0.0,66.55,56369.47
2024-02-01,2024-02-01,Invoice payment - Customer_0043,REF76922325,0.0,51.14,56420.61
2024-02-01,2024-02-01,Invoice payment - Customer_0010,REF68228845,0.0,99.31,56519.92
2024-02-01,2024-02-01,Invoice payment - Customer_0049,REF80968843,0.0,38.7,56558.62
2024-02-01,2024-02-01,Service payment - Customer_0067,REF29879830,0.0,36.49,56595.11
2024-02-02,2024-02-02,Invoice payment - Customer_0065,REF98705883,0.0,48.84,56643.95
2024-02-02,2024-02-02,Invoice payment - Customer_0026,REF10316444,0.0,67.71,56711.66
2024-02-02,2024-02-02,Service payment - Customer_0069,REF28046614,0.0,147.57,56859.23
2024-02-02,2024-02-02,Project payment - Customer_0028,REF70187225,0.0,78.97,56938.2
2024-02-02,2024-02-02,Project payment - Customer_0089,REF26481645,0.0,35.68,56973.88
2024-02-02,2024-02-02,Invoice payment - Customer_0096,REF23897892,0.0,33.73,57007.61
2024-02-02,2024-02-02,Invoice payment - Customer_0064,REF19307908,0.0,37.88,57045.49
2024-02-02,2024-02-02,Payment from Customer_0019,REF57255749,0.0,56.18,57101.67
2024-02-02,2024-02-02,Project payment - Customer_0062,REF57981185,0.0,92.6,57194.27
2024-02-02,2024-02-02,Project payment - Customer_0023,REF41100262,0.0,39.5,57233.77
2024-02-02,2024-02-02,Payment from Customer_0046,REF37348855,0.0,55.03,57288.8
2024-02-02,2024-02-02,Invoice payment - Customer_0097,REF18571095,0.0,61.08,57349.88
2024-02-03,2024-02-03,Invoice payment - Customer_0008,REF12758838,0.0,49.46,57399.34
2024-02-03,2024-02-03,Project payment - Customer_0099,REF78734285,0.0,38.2,57437.54
2024-02-03,2024-02-03,Invoice payment - Customer_0079,REF54536663,0.0,93.12,57530.66
2024-02-03,2024-02-03,Service payment - Customer_0089,REF23107404,0.0,40.03,57570.69
2024-02-03,2024-02-03,Payment from Customer_0000,REF38665222,0.0,113.62,57684.31
2024-02-03,2024-02-03,Project payment - Customer_0098,REF20662802,0.0,80.23,57764.54
2024-02-03,2024-02-03,Service payment - Customer_0065,REF27116754,0.0,51.81,57816.35
2024-02-03,2024-02-03,Invoice payment - Customer_0007,REF47943383,0.0,26.17,57842.52
2024-02-03,2024-02-03,Invoice payment - Customer_0067,REF60239174,0.0,50.07,57892.59
2024-02-03,2024-02-03,Service payment - Customer_0011,REF67420941,0.0,40.22,57932.81
2024-02-03,2024-02-03,Service payment - Customer_0074,REF94436200,0.0,50.9,57983.71
2024-02-04,2024-02-04,Invoice payment - Customer_0084,REF65593675,0.0,29.64,58013.35
2024-02-04,2024-02-04,Project payment - Customer_0018,REF65739722,0.0,42.52,58055.87
2024-02-04,2024-02-04,Payment from Customer_0077,REF88984576,0.0,78.83,58134.7
2024-02-04,2024-02-04,Service payment - Customer_0031,REF34825941,0.0,31.0,58165.7
2024-02-04,2024-02-04,Service payment - Customer_0085,REF46418661,0.0,65.82,58231.52
2024-02-04,2024-02-04,Service payment - Customer_0016,REF19728463,0.0,28.57,58260.09
2024-02-04,2024-02-04,Packaging Shipping expense,REF17044444,142.58,0.0,58117.51
2024-02-04,2024-02-04,Payment from Customer_0090,REF47752931,0.0,77.75,58195.26
2024-02-04,2024-02-04,Payment from Customer_0003,REF57054025,0.0,120.45,58315.71
2024-02-04,2024-02-04,Payment from Customer_0091,REF41363859,0.0,84.48,58400.19
2024-02-05,2024-02-05,Service payment - Customer_0035,REF33949507,0.0,76.7,58476.89
2024-02-05,2024-02-05,Payment from Customer_0063,REF68410670,0.0,93.12,58570.01
2024-02-05,2024-02-05,Invoice payment - Customer_0087,REF47893039,0.0,78.95,58648.96
2024-02-05,2024-02-05,Service payment - Customer_0069,REF22384614,0.0,133.04,58782.0
2024-02-05,2024-02-05,Payment from Customer_0073,REF71361578,0.0,46.09,58828.09
2024-02-05,2024-02-05,Service payment - Customer_0011,REF43314357,0.0,33.77,58861.86
2024-02-05,2024-02-05,Project payment - Customer_0062,REF10554538,0.0,81.08,58942.94
2024-02-05,2024-02-05,Service payment - Customer_0074,REF53344559,0.0,74.74,59017.68
2024-02-05,2024-02-05,Invoice payment - Customer_0010,REF17749813,0.0,94.65,59112.33
2024-02-05,2024-02-05,Payment from Customer_0007,REF66651272,0.0,22.89,59135.22
2024-02-05,2024-02-05,Service payment - Customer_0005,REF49165187,0.0,45.71,59180.93
2024-02-05,2024-02-05,Payment from Customer_0013,REF35965572,0.0,41.86,59222.79
2024-02-05,2024-02-05,Payment from Customer_0077,REF40161614,0.0,86.61,59309.4
2024-02-05,2024-02-05,Project payment - Customer_0020,REF53997975,0.0,66.14,59375.54
2024-02-05,2024-02-05,Project payment - Customer_0056,REF43472780,0.0,10.0,59385.54
2024-02-05,2024-02-05,Payment from Customer_0078,REF61807997,0.0,49.95,59435.49
2024-02-06,2024-02-06,Invoice payment - Customer_0096,REF98402961,0.0,34.52,59470.01
2024-02-06,2024-02-06,Invoice payment - Customer_0076,REF63181084,0.0,79.9,59549.91
2024-02-06,2024-02-06,Project payment - Customer_0077,REF47294460,0.0,83.4,59633.31
2024-02-06,2024-02-06,Payment from Customer_0070,REF42120771,0.0,49.92,59683.23
2024-02-06,2024-02-06,Service payment - Customer_0004,REF28410767,0.0,46.01,59729.24
2024-02-06,2024-02-06,Project payment - Customer_0007,REF77860994,0.0,19.88,59749.12
2024-02-06,2024-02-06,Payment from Customer_0013,REF19972786,0.0,40.7,59789.82
2024-02-06,2024-02-06,Service payment - Customer_0090,REF16513098,0.0,39.99,59829.81
2024-02-06,2024-02-06,Project payment - Customer_0020,REF94189537,0.0,58.95,59888.76
2024-02-06,2024-02-06,Payment from Customer_0044,REF15838282,0.0,140.63,60029.39
2024-02-07,2024-02-07,Employee payroll,REF73831466,927.76,0.0,59101.63
2024-02-07,2024-02-07,Payment from Customer_0090,REF64251709,0.0,82.46,59184.09
2024-02-07,2024-02-07,Payment from Customer_0032,REF65212759,0.0,111.73,59295.82
2024-02-07,2024-02-07,Service payment - Customer_0011,REF48689956,0.0,40.96,59336.78
2024-02-07,2024-02-07,Invoice payment - Customer_0086,REF67979853,0.0,67.92,59404.7
2024-02-07,2024-02-07,Project payment - Customer_0016,REF20988383,0.0,28.44,59433.14
2024-02-07,2024-02-07,Payment from Customer_0040,REF43343121,0.0,90.77,59523.91
2024-02-07,2024-02-07,Project payment - Customer_0042,REF30088920,0.0,95.03,59618.94
2024-02-07,2024-02-07,Payment from Customer_0063,REF33727873,0.0,100.32,59719.26
2024-02-07,2024-02-07,Payment from Customer_0058,REF54743541,0.0,97.21,59816.47
2024-02-07,2024-02-07,Invoice payment - Customer_0018,REF23109502,0.0,53.83,59870.3
2024-02-07,2024-02-07,Payment from Customer_0031,REF57598838,0.0,27.56,59897.86
2024-02-07,2024-02-07,Service payment - Customer_0082,REF38806672,0.0,47.37,59945.23
2024-02-08,2024-02-08,Service payment - Customer_0000,REF88184846,0.0,104.02,60049.25
2024-02-08,2024-02-08,Invoice payment - Customer_0009,REF99307283,0.0,104.55,60153.8
2024-02-08,2024-02-08,Payment from Customer_0038,REF96187531,0.0,49.16,60202.96
2024-02-08,2024-02-08,Service payment - Customer_0039,REF84486840,0.0,138.12,60341.08
2024-02-08,2024-02-08,Invoice payment - Customer_0054,REF26751322,0.0,20.08,60361.16
2024-02-08,2024-02-08,Invoice payment - Customer_0067,REF92351222,0.0,50.97,60412.13
2024-02-08,2024-02-08,Invoice payment - Customer_0079,REF70424948,0.0,100.82,60512.95
2024-02-08,2024-02-08,Project payment - Customer_0097,REF97176974,0.0,59.06,60572.01
2024-02-09,2024-02-09,Payment from Customer_0035,REF25185359,0.0,77.13,60649.14
2024-02-09,2024-02-09,Project payment - Customer_0098,REF70451368,0.0,62.19,60711.33
2024-02-09,2024-02-09,Invoice payment - Customer_0082,REF72223336,0.0,39.34,60750.67
2024-02-09,2024-02-09,Payment from Customer_0029,REF85621994,0.0,58.53,60809.2
2024-02-09,2024-02-09,Project payment - Customer_0095,REF85605314,0.0,91.25,60900.45
2024-02-09,2024-02-09,Project payment - Customer_0061,REF49173033,0.0,60.73,60961.18
2024-02-09,2024-02-09,Service payment - Customer_0027,REF10146407,0.0,98.8,61059.98
2024-02-09,2024-02-09,Payment from Customer_0084,REF52280429,0.0,40.06,61100.04
2024-02-09,2024-02-09,Invoice payment - Customer_0088,REF98057177,0.0,11.04,61111.08
2024-02-10,2024-02-10,Service payment - Customer_0074,REF50060001,0.0,61.56,61172.64
2024-02-10,2024-02-10,Service payment - Customer_0082,REF38432106,0.0,59.12,61231.76
2024-02-10,2024-02-10,Service payment - Customer_0069,REF26108157,0.0,149.68,61381.44
2024-02-10,2024-02-10,Invoice payment - Customer_0058,REF33284347,0.0,68.91,61450.35
2024-02-10,2024-02-10,Project payment - Customer_0017,REF13854008,0.0,137.22,61587.57
2024-02-10,2024-02-10,Service payment - Customer_0024,REF77954704,0.0,116.32,61703.89
2024-02-10,2024-02-10,Service payment - Customer_0098,REF56240265,0.0,58.32,61762.21
2024-02-11,2024-02-11,Payment from Customer_0088,REF82131379,0.0,10.94,61773.15
2024-02-11,2024-02-11,Service payment - Customer_0022,REF96593245,0.0,61.3,61834.45
2024-02-11,2024-02-11,Project payment - Customer_0052,REF39166440,0.0,71.69,61906.14
2024-02-11,2024-02-11,Service payment - Customer_0095,REF98981799,0.0,75.4,61981.54
2024-02-11,2024-02-11,Payment from Customer_0016,REF62145062,0.0,29.53,62011.07
2024-02-11,2024-02-11,Service payment - Customer_0001,REF43815655,0.0,72.52,62083.59
2024-02-11,2024-02-11,Invoice payment - Customer_0036,REF69808851,0.0,39.92,62123.51
2024-02-11,2024-02-11,Payment from Customer_0030,REF33564921,0.0,55.85,62179.36
2024-02-11,2024-02-11,Invoice payment - Customer_0053,REF20224938,0.0,133.83,62313.19
2024-02-11,2024-02-11,Service payment - Customer_0076,REF99801614,0.0,67.75,62380.94
2024-02-12,2024-02-12,Project payment - Customer_0021,REF48727741,0.0,65.53,62446.47
2024-02-12,2024-02-12,Invoice payment - Customer_0094,REF93707895,0.0,18.42,62464.89
2024-02-12,2024-02-12,Service payment - Customer_0059,REF13832918,0.0,155.25,62620.14
2024-02-12,2024-02-12,Payment from Customer_0037,REF70894654,0.0,89.31,62709.45
2024-02-12,2024-02-12,Project payment - Customer_0066,REF97434369,0.0,72.15,62781.6
2024-02-12,2024-02-12,Project payment - Customer_0022,REF15196184,0.0,65.14,62846.74
2024-02-12,2024-02-12,Project payment - Customer_0013,REF97379784,0.0,46.67,62893.41
2024-02-12,2024-02-12,Service payment - Customer_0061,REF30117197,0.0,90.37,62983.78
2024-02-12,2024-02-12,Service payment - Customer_0011,REF45551858,0.0,34.41,63018.19
2024-02-12,2024-02-12,Project payment - Customer_0005,REF21005389,0.0,41.54,63059.73
2024-02-12,2024-02-12,Payment from Customer_0033,REF82823905,0.0,94.53,63154.26
2024-02-13,2024-02-13,Payment from Customer_0037,REF60522161,0.0,123.65,63277.91
2024-02-13,2024-02-13,Service payment - Customer_0033,REF47858214,0.0,69.54,63347.45
2024-02-13,2024-02-13,Project payment - Customer_0059,REF86649947,0.0,94.49,63441.94
2024-02-13,2024-02-13,Service payment - Customer_0081,REF58498058,0.0,89.58,63531.52
2024-02-13,2024-02-13,Payment from Customer_0084,REF69038745,0.0,33.27,63564.79
2024-02-13,2024-02-13,Project payment - Customer_0067,REF66357112,0.0,35.99,63600.78
2024-02-13,2024-02-13,Payment from Customer_0044,REF65271628,0.0,110.09,63710.87
2024-02-14,2024-02-14,Service payment - Customer_0098,REF30013468,0.0,73.7,63784.57
2024-02-14,2024-02-14,Invoice payment - Customer_0064,REF56402591,0.0,41.38,63825.95
2024-02-14,2024-02-14,Service payment - Customer_0040,REF83123176,0.0,77.14,63903.09
2024-02-14,2024-02-14,Service payment - Customer_0093,REF48997681,0.0,47.36,63950.45
2024-02-14,2024-02-14,Project payment - Customer_0014,REF23627709,0.0,83.14,64033.59
2024-02-14,2024-02-14,Payment from Customer_0046,REF91532274,0.0,46.63,64080.22
2024-02-14,2024-02-14,Service payment - Customer_0084,REF37178886,0.0,38.08,64118.3
2024-02-14,2024-02-14,Service payment - Customer_0067,REF74848897,0.0,38.18,64156.48
2024-02-14,2024-02-14,Payment from Customer_0001,REF45822613,0.0,80.0,64236.48
2024-02-14,2024-02-14,Service payment - Customer_0077,REF92129216,0.0,105.61,64342.09
2024-02-15,2024-02-15,Business insurance premium,REF22670791,153.63,0.0,64188.46
2024-02-15,2024-02-15,Payment from Customer_0040,REF86310757,0.0,78.62,64267.08
2024-02-15,2024-02-15,Project payment - Customer_0007,REF44564125,0.0,21.79,64288.87
2024-02-15,2024-02-15,Payment from Customer_0045,REF40216303,0.0,81.8,64370.67
2024-02-15,2024-02-15,Invoice payment - Customer_0077,REF23754325,0.0,65.5,64436.17
2024-02-15,2024-02-15,Project payment - Customer_0059,REF60589230,0.0,105.86,64542.03
2024-02-15,2024-02-15,Service payment - Customer_0037,REF92251346,0.0,96.5,64638.53
2024-02-15,2024-02-15,Invoice payment - Customer_0033,REF84361763,0.0,81.65,64720.18
2024-02-15,2024-02-15,Project payment - Customer_0014,REF91431188,0.0,110.5,64830.68
2024-02-15,2024-02-15,Project payment - Customer_0004,REF42734589,0.0,47.25,64877.93
2024-02-15,2024-02-15,Service payment - Customer_0024,REF36604044,0.0,74.1,64952.03
2024-02-15,2024-02-15,Payment from Customer_0082,REF53739809,0.0,44.01,64996.04
2024-02-15,2024-02-15,Invoice payment - Customer_0002,REF39631964,0.0,47.61,65043.65
2024-02-16,2024-02-16,Project payment - Customer_0037,REF39090507,0.0,107.38,65151.03
2024-02-16,2024-02-16,Payment from Customer_0086,REF18561500,0.0,76.15,65227.18
2024-02-16,2024-02-16,Project payment - Customer_0038,REF97962738,0.0,47.07,65274.25
2024-02-16,2024-02-16,Payment from Customer_0092,REF94303517,0.0,109.57,65383.82
2024-02-16,2024-02-16,Payment from Customer_0057,REF45687024,0.0,31.52,65415.34
2024-02-16,2024-02-16,Invoice payment - Customer_0023,REF64825483,0.0,59.25,65474.59
2024-02-16,2024-02-16,Service payment - Customer_0091,REF69380083,0.0,77.39,65551.98
2024-02-16,2024-02-16,Payment from Customer_0069,REF38833497,0.0,76.57,65628.55
2024-02-17,2024-02-17,Packaging Shipping expense,REF13263978,255.28,0.0,65373.27
2024-02-17,2024-02-17,Payment from Customer_0086,REF30272774,0.0,76.54,65449.81
2024-02-17,2024-02-17,Service payment - Customer_0057,REF67262811,0.0,35.13,65484.94
2024-02-17,2024-02-17,Project payment - Customer_0063,REF74900309,0.0,101.13,65586.07
2024-02-17,2024-02-17,Payment from Customer_0096,REF20020681,0.0,35.98,65622.05
2024-02-17,2024-02-17,Payment from Customer_0053,REF83259778,0.0,130.52,65752.57
2024-02-17,2024-02-17,Service payment - Customer_0056,REF79014806,0.0,10.43,65763.0
2024-02-17,2024-02-17,Payment from Customer_0013,REF53939883,0.0,47.57,65810.57
2024-02-17,2024-02-17,Service payment - Customer_0022,REF56774304,0.0,50.34,65860.91
2024-02-17,2024-02-17,Invoice payment - Customer_0089,REF82127023,0.0,55.55,65916.46
2024-02-17,2024-02-17,Project payment - Customer_0055,REF36827942,0.0,89.01,66005.47
2024-02-18,2024-02-18,Invoice payment - Customer_0078,REF60312917,0.0,49.93,66055.4
2024-02-18,2024-02-18,Project payment - Customer_0049,REF61693953,0.0,38.45,66093.85
2024-02-18,2024-02-18,Payment from Customer_0062,REF23133982,0.0,90.28,66184.13
2024-02-18,2024-02-18,Service payment - Customer_0050,REF39477025,0.0,77.47,66261.6
2024-02-18,2024-02-18,Project payment - Customer_0000,REF89077099,0.0,66.81,66328.41
2024-02-18,2024-02-18,Service payment - Customer_0064,REF39094852,0.0,36.36,66364.77
2024-02-18,2024-02-18,Invoice payment - Customer_0054,REF10153303,0.0,21.41,66386.18
2024-02-19,2024-02-19,Payment from Customer_0088,REF48832384,0.0,12.81,66398.99
2024-02-19,2024-02-19,Invoice payment - Customer_0021,REF98461053,0.0,75.66,66474.65
2024-02-19,2024-02-19,Project payment - Customer_0074,REF92480127,0.0,85.13,66559.78
2024-02-19,2024-02-19,Payment from Customer_0096,REF16908091,0.0,47.15,66606.93
2024-02-19,2024-02-19,Payment from Customer_0015,REF72595758,0.0,62.15,66669.08
2024-02-19,2024-02-19,Invoice payment - Customer_0034,REF37015922,0.0,10.0,66679.08
2024-02-19,2024-02-19,Service payment - Customer_0026,REF77396100,0.0,97.67,66776.75
2024-02-20,2024-02-20,Service payment - Customer_0052,REF30617606,0.0,90.29,66867.04
2024-02-20,2024-02-20,Invoice payment - Customer_0089,REF89338646,0.0,47.18,66914.22
2024-02-20,2024-02-20,Service payment - Customer_0064,REF23575681,0.0,43.19,66957.41
2024-02-20,2024-02-20,Service payment - Customer_0006,REF24456480,0.0,10.71,66968.12
2024-02-20,2024-02-20,Payment from Customer_0093,REF98547095,0.0,36.91,67005.03
2024-02-20,2024-02-20,Invoice payment - Customer_0066,REF40625191,0.0,108.58,67113.61
2024-02-20,2024-02-20,Invoice payment - Customer_0044,REF75299054,0.0,124.95,67238.56
2024-02-20,2024-02-20,Service payment - Customer_0073,REF97418055,0.0,39.86,67278.42
2024-02-20,2024-02-20,Payment from Customer_0070,REF78137078,0.0,62.48,67340.9
2024-02-21,2024-02-21,Invoice payment - Customer_0067,REF22636616,0.0,37.12,67378.02
2024-02-21,2024-02-21,Payment from Customer_0026,REF57603973,0.0,74.9,67452.92
2024-02-21,2024-02-21,Invoice payment - Customer_0060,REF22301826,0.0,53.42,67506.34
2024-02-21,2024-02-21,Invoice payment - Customer_0085,REF83032874,0.0,54.21,67560.55
2024-02-21,2024-02-21,Service payment - Customer_0056,REF41081963,0.0,11.81,67572.36
2024-02-21,2024-02-21,Service payment - Customer_0012,REF62086165,0.0,101.63,67673.99
2024-02-21,2024-02-21,Service payment - Customer_0069,REF51535024,0.0,138.98,67812.97
2024-02-21,2024-02-21,Invoice payment - Customer_0021,REF98395843,0.0,79.8,67892.77
2024-02-22,2024-02-22,Utility bill payment,REF94142838,132.25,0.0,67760.52
2024-02-22,2024-02-22,Service payment - Customer_0011,REF69194264,0.0,31.23,67791.75
2024-02-22,2024-02-22,Payment from Customer_0033,REF61248937,0.0,76.48,67868.23
2024-02-22,2024-02-22,Invoice payment - Customer_0099,REF65919915,0.0,49.33,67917.56
2024-02-22,2024-02-22,Invoice payment - Customer_0022,REF21762253,0.0,58.38,67975.94
2024-02-22,2024-02-22,Payment from Customer_0059,REF76231728,0.0,145.95,68121.89
2024-02-22,2024-02-22,Payment from Customer_0041,REF54351232,0.0,45.71,68167.6
2024-02-22,2024-02-22,Payment from Customer_0034,REF69332687,0.0,10.0,68177.6
2024-02-23,2024-02-23,Marketing expenses,REF78632768,247.21,0.0,67930.39
2024-02-23,2024-02-23,Service payment - Customer_0088,REF58481790,0.0,10.0,67940.39
2024-02-23,2024-02-23,Payment from Customer_0029,REF48356557,0.0,64.12,68004.51
2024-02-23,2024-02-23,Payment from Customer_0009,REF23884243,0.0,124.92,68129.43
2024-02-23,2024-02-23,Payment from Customer_0003,REF54071113,0.0,96.6,68226.03
2024-02-23,2024-02-23,Project payment - Customer_0097,REF82142951,0.0,52.74,68278.77
2024-02-23,2024-02-23,Project payment - Customer_0001,REF21632294,0.0,78.77,68357.54
2024-02-23,2024-02-23,Project payment - Customer_0031,REF24556118,0.0,31.42,68388.96
2024-02-23,2024-02-23,Invoice payment - Customer_0033,REF78073534,0.0,71.36,68460.32
2024-02-23,2024-02-23,Project payment - Customer_0058,REF81406830,0.0,72.72,68533.04
2024-02-23,2024-02-23,Project payment - Customer_0070,REF59764736,0.0,46.27,68579.31
2024-02-23,2024-02-23,Invoice payment - Customer_0011,REF77897698,0.0,29.47,68608.78
2024-02-23,2024-02-23,Service payment - Customer_0040,REF78100319,0.0,101.57,68710.35
2024-02-24,2024-02-24,Invoice payment - Customer_0095,REF72177576,0.0,73.11,68783.46
2024-02-24,2024-02-24,Payment from Customer_0085,REF43583556,0.0,50.52,68833.98
2024-02-24,2024-02-24,Invoice payment - Customer_0016,REF41231929,0.0,24.85,68858.83
2024-02-24,2024-02-24,Project payment - Customer_0001,REF63328102,0.0,82.93,68941.76
2024-02-24,2024-02-24,Invoice payment - Customer_0070,REF68370564,0.0,48.18,68989.94
2024-02-24,2024-02-24,Payment from Customer_0044,REF41840130,0.0,135.68,69125.62
2024-02-24,2024-02-24,Invoice payment - Customer_0083,REF89090252,0.0,33.19,69158.81
2024-02-24,2024-02-24,Project payment - Customer_0038,REF34415561,0.0,48.34,69207.15
2024-02-24,2024-02-24,Payment from Customer_0017,REF39468324,0.0,130.18,69337.33
2024-02-25,2024-02-25,Invoice payment - Customer_0010,REF88617493,0.0,92.66,69429.99
2024-02-25,2024-02-25,Project payment - Customer_0085,REF80994179,0.0,64.42,69494.41
2024-02-25,2024-02-25,Invoice payment - Customer_0098,REF85781530,0.0,70.59,69565.0
2024-02-25,2024-02-25,Invoice payment - Customer_0054,REF29567329,0.0,19.59,69584.59
2024-02-25,2024-02-25,Service payment - Customer_0086,REF65499184,0.0,67.4,69651.99
2024-02-25,2024-02-25,Service payment - Customer_0094,REF55971562,0.0,25.23,69677.22
2024-02-25,2024-02-25,Service payment - Customer_0089,REF58235534,0.0,48.53,69725.75
2024-02-25,2024-02-25,Service payment - Customer_0009,REF31613456,0.0,148.3,69874.05
2024-02-25,2024-02-25,Service payment - Customer_0097,REF49445700,0.0,57.94,69931.99
2024-02-25,2024-02-25,Invoice payment - Customer_0084,REF70416817,0.0,30.72,69962.71
2024-02-26,2024-02-26,Project payment - Customer_0075,REF38564764,0.0,57.06,70019.77
2024-02-26,2024-02-26,Project payment - Customer_0063,REF10887097,0.0,80.29,70100.06
2024-02-26,2024-02-26,Invoice payment - Customer_0029,REF49948307,0.0,60.66,70160.72
2024-02-26,2024-02-26,Payment from Customer_0027,REF52483333,0.0,63.64,70224.36
2024-02-26,2024-02-26,Project payment - Customer_0079,REF70920822,0.0,160.03,70384.39
2024-02-26,2024-02-26,Project payment - Customer_0094,REF91678353,0.0,19.93,70404.32
2024-02-26,2024-02-26,Project payment - Customer_0030,REF88817884,0.0,93.71,70498.03
2024-02-26,2024-02-26,Project payment - Customer_0095,REF59143289,0.0,94.5,70592.53
2024-02-27,2024-02-27,Invoice payment - Customer_0078,REF60916287,0.0,59.5,70652.03
2024-02-27,2024-02-27,Payment from Customer_0051,REF77722740,0.0,64.44,70716.47
2024-02-27,2024-02-27,Invoice payment - Customer_0046,REF72851209,0.0,52.88,70769.35
2024-02-27,2024-02-27,Invoice payment - Customer_0019,REF90019656,0.0,49.36,70818.71
2024-02-27,2024-02-27,Invoice payment - Customer_0039,REF71667965,0.0,107.87,70926.58
2024-02-27,2024-02-27,Project payment - Customer_0097,REF33724091,0.0,65.06,70991.64
2024-02-27,2024-02-27,Invoice payment - Customer_0061,REF14281325,0.0,76.5,71068.14
2024-02-27,2024-02-27,Payment from Customer_0072,REF70083845,0.0,82.12,71150.26
2024-02-28,2024-02-28,Payment from Customer_0093,REF32889113,0.0,29.1,71179.36
2024-02-28,2024-02-28,Service payment - Customer_0009,REF70610738,0.0,150.74,71330.1
2024-02-28,2024-02-28,Payment from Customer_0015,REF83352611,0.0,65.19,71395.29
2024-02-28,2024-02-28,Invoice payment - Customer_0008,REF74015266,0.0,44.87,71440.16
2024-02-28,2024-02-28,Payment from Customer_0045,REF18381103,0.0,84.77,71524.93
2024-02-28,2024-02-28,Project payment - Customer_0078,REF49579323,0.0,48.08,71573.01
2024-02-28,2024-02-28,Payment from Customer_0022,REF69811502,0.0,69.16,71642.17
2024-02-28,2024-02-28,Invoice payment - Customer_0007,REF56286211,0.0,24.76,71666.93
2024-02-28,2024-02-28,Payment from Customer_0010,REF59844028,0.0,115.25,71782.18
2024-02-28,2024-02-28,Project payment - Customer_0013,REF85635871,0.0,39.4,71821.58
2024-02-29,2024-02-29,Invoice payment - Customer_0075,REF86284228,0.0,51.96,71873.54
2024-02-29,2024-02-29,Project payment - Customer_0047,REF72934346,0.0,60.17,71933.71
2024-02-29,2024-02-29,Project payment - Customer_0077,REF26541633,0.0,82.04,72015.75
2024-02-29,2024-02-29,Payment from Customer_0006,REF36490455,0.0,10.87,72026.62
2024-02-29,2024-02-29,Invoice payment - Customer_0014,REF62945998,0.0,81.91,72108.53
2024-02-29,2024-02-29,Service payment - Customer_0035,REF68602190,0.0,60.51,72169.04
2024-02-29,2024-02-29,Project payment - Customer_0067,REF33891081,0.0,34.87,72203.91
2024-02-29,2024-02-29,Payment from Customer_0057,REF61477954,0.0,46.16,72250.07
2024-02-29,2024-02-29,Invoice payment - Customer_0000,REF79912566,0.0,104.85,72354.92
2024-02-29,2024-02-29,Professional Services expense,REF15593582,145.09,0.0,72209.83
2024-02-29,2024-02-29,Payment from Customer_0053,REF76721398,0.0,130.14,72339.97
2024-03-01,2024-03-01,Monthly office rent,REF79282135,1310.19,0.0,71029.78
2024-03-01,2024-03-01,Invoice payment - Customer_0055,REF55893775,0.0,87.38,71117.16
2024-03-01,2024-03-01,Invoice payment - Customer_0075,REF55553257,0.0,84.83,71201.99
2024-03-01,2024-03-01,Invoice payment - Customer_0058,REF80863562,0.0,85.37,71287.36
2024-03-01,2024-03-01,Payment from Customer_0041,REF18661183,0.0,52.21,71339.57
2024-03-01,2024-03-01,Payment from Customer_0072,REF52228508,0.0,69.79,71409.36
2024-03-01,2024-03-01,Project payment - Customer_0011,REF50688077,0.0,45.65,71455.01
2024-03-01,2024-03-01,Service payment - Customer_0022,REF51060736,0.0,43.65,71498.66
2024-03-01,2024-03-01,Service payment - Customer_0079,REF97371904,0.0,145.57,71644.23
2024-03-01,2024-03-01,Payment from Customer_0080,REF48887365,0.0,123.18,71767.41
2024-03-01,2024-03-01,Service payment - Customer_0091,REF35895030,0.0,105.21,71872.62
2024-03-01,2024-03-01,Invoice payment - Customer_0049,REF41864561,0.0,50.01,71922.63
2024-03-02,2024-03-02,Payment from Customer_0078,REF92894266,0.0,43.17,71965.8
2024-03-02,2024-03-02,Payment from Customer_0028,REF22455832,0.0,97.32,72063.12
2024-03-02,2024-03-02,Invoice payment - Customer_0090,REF80778939,0.0,69.02,72132.14
2024-03-02,2024-03-02,Invoice payment - Customer_0061,REF15299366,0.0,92.81,72224.95
2024-03-02,2024-03-02,Invoice payment - Customer_0065,REF88001096,0.0,58.51,72283.46
2024-03-02,2024-03-02,Project payment - Customer_0033,REF95153360,0.0,105.23,72388.69
2024-03-02,2024-03-02,Project payment - Customer_0019,REF55525322,0.0,56.1,72444.79
2024-03-02,2024-03-02,Project payment - Customer_0066,REF28554144,0.0,78.15,72522.94
2024-03-02,2024-03-02,Invoice payment - Customer_0015,REF93311228,0.0,87.03,72609.97
2024-03-02,2024-03-02,Payment from Customer_0057,REF78624400,0.0,34.97,72644.94
2024-03-02,2024-03-02,Payment from Customer_0008,REF96632821,0.0,37.11,72682.05
2024-03-02,2024-03-02,Project payment - Customer_0016,REF98589112,0.0,29.47,72711.52
2024-03-03,2024-03-03,Payment from Customer_0095,REF53060203,0.0,70.71,72782.23
2024-03-03,2024-03-03,Service payment - Customer_0011,REF62318624,0.0,38.22,72820.45
2024-03-03,2024-03-03,Invoice payment - Customer_0052,REF57916207,0.0,90.04,72910.49
2024-03-03,2024-03-03,Service payment - Customer_0008,REF43449484,0.0,55.99,72966.48
2024-03-03,2024-03-03,Service payment - Customer_0087,REF23916782,0.0,62.1,73028.58
2024-03-03,2024-03-03,Project payment - Customer_0093,REF82605688,0.0,53.63,73082.21
2024-03-03,2024-03-03,Service payment - Customer_0071,REF26183085,0.0,63.76,73145.97
2024-03-03,2024-03-03,Service payment - Customer_0000,REF75641092,0.0,117.88,73263.85
2024-03-03,2024-03-03,Project payment - Customer_0020,REF91323979,0.0,48.48,73312.33
2024-03-03,2024-03-03,Payment from Customer_0072,REF92315743,0.0,55.05,73367.38
2024-03-04,2024-03-04,Payment from Customer_0077,REF15692910,0.0,63.38,73430.76
2024-03-04,2024-03-04,Service payment - Customer_0012,REF41922953,0.0,148.75,73579.51
2024-03-04,2024-03-04,Project payment - Customer_0097,REF99140469,0.0,66.39,73645.9
2024-03-04,2024-03-04,Project payment - Customer_0004,REF39808603,0.0,46.96,73692.86
2024-03-04,2024-03-04,Project payment - Customer_0085,REF36061242,0.0,67.19,73760.05
2024-03-04,2024-03-04,Project payment - Customer_0093,REF78894499,0.0,48.82,73808.87
2024-03-04,2024-03-04,Service payment - Customer_0054,REF82202397,0.0,26.16,73835.03
2024-03-04,2024-03-04,Service payment - Customer_0064,REF70137978,0.0,44.23,73879.26
2024-03-04,2024-03-04,Invoice payment - Customer_0016,REF67564714,0.0,30.09,73909.35
2024-03-04,2024-03-04,Invoice payment - Customer_0073,REF83727688,0.0,44.19,73953.54
2024-03-04,2024-03-04,Project payment - Customer_0038,REF71087882,0.0,50.74,74004.28
2024-03-04,2024-03-04,Payment from Customer_0037,REF16605146,0.0,143.72,74148.0
2024-03-04,2024-03-04,Invoice payment - Customer_0015,REF58363961,0.0,97.46,74245.46
2024-03-04,2024-03-04,Invoice payment - Customer_0009,REF57306320,0.0,119.29,74364.75
2024-03-04,2024-03-04,Invoice payment - Customer_0088,REF79791871,0.0,14.18,74378.93
2024-03-05,2024-03-05,Payment from Customer_0013,REF50030283,0.0,49.81,74428.74
2024-03-05,2024-03-05,Invoice payment - Customer_0084,REF23068816,0.0,32.72,74461.46
2024-03-05,2024-03-05,Project payment - Customer_0087,REF38426350,0.0,79.44,74540.9
2024-03-05,2024-03-05,Payment from Customer_0076,REF81977766,0.0,59.96,74600.86
2024-03-05,2024-03-05,Project payment - Customer_0070,REF58934855,0.0,64.39,74665.25
2024-03-05,2024-03-05,Service payment - Customer_0034,REF66253658,0.0,10.0,74675.25
2024-03-05,2024-03-05,Service payment - Customer_0029,REF95316212,0.0,64.02,74739.27
2024-03-05,2024-03-05,Service payment - Customer_0015,REF51791208,0.0,83.12,74822.39
2024-03-05,2024-03-05,Invoice payment - Customer_0000,REF74728360,0.0,130.46,74952.85
2024-03-06,2024-03-06,Invoice payment - Customer_0077,REF64386269,0.0,79.89,75032.74
2024-03-06,2024-03-06,Project payment - Customer_0076,REF48551389,0.0,87.29,75120.03
2024-03-06,2024-03-06,Payment from Customer_0035,REF13647160,0.0,99.83,75219.86
2024-03-06,2024-03-06,Invoice payment - Customer_0066,REF34412113,0.0,95.19,75315.05
2024-03-06,2024-03-06,Project payment - Customer_0017,REF48534614,0.0,124.81,75439.86
2024-03-06,2024-03-06,Project payment - Customer_0037,REF40722208,0.0,117.46,75557.32
2024-03-06,2024-03-06,Project payment - Customer_0079,REF93798373,0.0,138.57,75695.89
2024-03-06,2024-03-06,Project payment - Customer_0090,REF69624869,0.0,93.7,75789.59
2024-03-06,2024-03-06,Payment from Customer_0093,REF30526815,0.0,52.4,75841.99
2024-03-06,2024-03-06,Service payment - Customer_0099,REF87197570,0.0,44.27,75886.26
2024-03-07,2024-03-07,Payment from Customer_0036,REF26370613,0.0,47.42,75933.68
2024-03-07,2024-03-07,Payment from Customer_0076,REF14538921,0.0,73.88,76007.56
2024-03-07,2024-03-07,Service payment - Customer_0097,REF39054602,0.0,64.71,76072.27
2024-03-07,2024-03-07,Invoice payment - Customer_0027,REF31369397,0.0,75.89,76148.16
2024-03-07,2024-03-07,Service payment - Customer_0040,REF82568123,0.0,97.48,76245.64
2024-03-07,2024-03-07,Project payment - Customer_0072,REF32423172,0.0,88.67,76334.31
2024-03-08,2024-03-08,Payment from Customer_0037,REF51130762,0.0,113.81,76448.12
2024-03-08,2024-03-08,Project payment - Customer_0047,REF34420403,0.0,46.38,76494.5
2024-03-08,2024-03-08,Service payment - Customer_0019,REF20686815,0.0,59.77,76554.27
2024-03-08,2024-03-08,Project payment - Customer_0026,REF26866552,0.0,90.19,76644.46
2024-03-08,2024-03-08,Payment from Customer_0045,REF30315341,0.0,103.87,76748.33
2024-03-08,2024-03-08,Project payment - Customer_0084,REF30865168,0.0,35.18,76783.51
2024-03-08,2024-03-08,Service payment - Customer_0052,REF35417604,0.0,115.51,76899.02
2024-03-08,2024-03-08,Payment from Customer_0033,REF25661141,0.0,103.06,77002.08
2024-03-08,2024-03-08,Invoice payment - Customer_0085,REF46240696,0.0,80.8,77082.88
2024-03-09,2024-03-09,Project payment - Customer_0026,REF71383543,0.0,58.06,77140.94
2024-03-09,2024-03-09,Service payment - Customer_0025,REF57483180,0.0,68.41,77209.35
2024-03-09,2024-03-09,Service payment - Customer_0053,REF87896127,0.0,150.98,77360.33
2024-03-09,2024-03-09,Payment from Customer_0000,REF51894696,0.0,91.2,77451.53
2024-03-09,2024-03-09,Payment from Customer_0023,REF44806387,0.0,60.65,77512.18
2024-03-09,2024-03-09,Inventory purchase,REF64818395,2917.41,0.0,74594.77
2024-03-10,2024-03-10,Service payment - Customer_0061,REF41927979,0.0,88.61,74683.38
2024-03-10,2024-03-10,Payment from Customer_0012,REF22574099,0.0,148.68,74832.06
2024-03-10,2024-03-10,Payment from Customer_0093,REF57763006,0.0,53.42,74885.48
2024-03-10,2024-03-10,Service payment - Customer_0019,REF94903531,0.0,53.18,74938.66
2024-03-10,2024-03-10,Invoice payment - Customer_0034,REF11515210,0.0,10.0,74948.66
2024-03-10,2024-03-10,Invoice payment - Customer_0041,REF47087196,0.0,51.11,74999.77
2024-03-11,2024-03-11,Packaging Shipping expense,REF90411192,260.03,0.0,74739.74
2024-03-11,2024-03-11,Payment from Customer_0072,REF61207713,0.0,74.51,74814.25
2024-03-11,2024-03-11,Pos Systems expense,REF88753291,54.21,0.0,74760.04
2024-03-11,2024-03-11,Project payment - Customer_0061,REF42681099,0.0,70.55,74830.59
2024-03-11,2024-03-11,Service payment - Customer_0071,REF56591665,0.0,47.34,74877.93
2024-03-11,2024-03-11,Project payment - Customer_0059,REF78826814,0.0,152.78,75030.71
2024-03-11,2024-03-11,Payment from Customer_0013,REF55123600,0.0,41.82,75072.53
2024-03-11,2024-03-11,Invoice payment - Customer_0063,REF97449909,0.0,93.52,75166.05
2024-03-11,2024-03-11,Service payment - Customer_0073,REF18751300,0.0,43.96,75210.01
2024-03-12,2024-03-12,Service payment - Customer_0047,REF48791987,0.0,71.07,75281.08
2024-03-12,2024-03-12,Invoice payment - Customer_0050,REF84458829,0.0,70.19,75351.27
2024-03-12,2024-03-12,Invoice payment - Customer_0058,REF21134576,0.0,86.71,75437.98
2024-03-12,2024-03-12,Invoice payment - Customer_0075,REF43478496,0.0,66.83,75504.81
2024-03-13,2024-03-13,Invoice payment - Customer_0050,REF95495376,0.0,63.94,75568.75
2024-03-13,2024-03-13,Invoice payment - Customer_0018,REF97906386,0.0,55.28,75624.03
2024-03-13,2024-03-13,Project payment - Customer_0052,REF62669606,0.0,89.75,75713.78
2024-03-13,2024-03-13,Service payment - Customer_0056,REF75778076,0.0,10.0,75723.78
2024-03-13,2024-03-13,Project payment - Customer_0007,REF21090598,0.0,23.3,75747.08
2024-03-13,2024-03-13,Invoice payment - Customer_0093,REF99519451,0.0,41.56,75788.64
2024-03-13,2024-03-13,Invoice payment - Customer_0013,REF60357576,0.0,48.61,75837.25
2024-03-13,2024-03-13,Project payment - Customer_0069,REF51288858,0.0,138.53,75975.78
2024-03-14,2024-03-14,Payment from Customer_0089,REF21647343,0.0,50.01,76025.79
2024-03-14,2024-03-14,Payment from Customer_0034,REF53221434,0.0,10.0,76035.79
2024-03-14,2024-03-14,Service payment - Customer_0015,REF54962011,0.0,88.03,76123.82
2024-03-14,2024-03-14,Service payment - Customer_0059,REF41580716,0.0,122.02,76245.84
2024-03-14,2024-03-14,Employee payroll,REF63989293,2678.78,0.0,73567.06
2024-03-14,2024-03-14,Project payment - Customer_0000,REF35933396,0.0,108.18,73675.24
2024-03-14,2024-03-14,Payment from Customer_0065,REF80112099,0.0,42.21,73717.45
2024-03-15,2024-03-15,Service payment - Customer_0006,REF44829173,0.0,14.01,73731.46
2024-03-15,2024-03-15,Project payment - Customer_0023,REF34894365,0.0,53.76,73785.22
2024-03-15,2024-03-15,Service payment - Customer_0084,REF82883595,0.0,35.98,73821.2
2024-03-15,2024-03-15,Payment from Customer_0055,REF10553873,0.0,77.54,73898.74
2024-03-15,2024-03-15,Project payment - Customer_0043,REF89404325,0.0,67.75,73966.49
2024-03-15,2024-03-15,Payment from Customer_0014,REF80720382,0.0,92.67,74059.16
2024-03-15,2024-03-15,Invoice payment - Customer_0097,REF94508682,0.0,59.04,74118.2
2024-03-15,2024-03-15,Business insurance premium,REF37510063,184.19,0.0,73934.01
2024-03-15,2024-03-15,Service payment - Customer_0041,REF90509987,0.0,60.6,73994.61
2024-03-15,2024-03-15,Invoice payment - Customer_0048,REF86102041,0.0,59.42,74054.03
2024-03-15,2024-03-15,Service payment - Customer_0035,REF26149087,0.0,83.26,74137.29
2024-03-15,2024-03-15,Payment from Customer_0079,REF79930561,0.0,143.64,74280.93
2024-03-16,2024-03-16,Payment from Customer_0045,REF44857877,0.0,96.71,74377.64
2024-03-16,2024-03-16,Invoice payment - Customer_0091,REF84519383,0.0,97.33,74474.97
2024-03-16,2024-03-16,Invoice payment - Customer_0064,REF60733205,0.0,47.03,74522.0
2024-03-16,2024-03-16,Service payment - Customer_0021,REF89148013,0.0,56.67,74578.67
2024-03-16,2024-03-16,Payment from Customer_0042,REF13019711,0.0,96.13,74674.8
2024-03-16,2024-03-16,Employee payroll,REF45729901,1892.19,0.0,72782.61
2024-03-17,2024-03-17,Payment from Customer_0065,REF71525110,0.0,47.71,72830.32
2024-03-17,2024-03-17,Payment from Customer_0085,REF57621426,0.0,69.41,72899.73
2024-03-17,2024-03-17,Payment from Customer_0038,REF47604606,0.0,49.33,72949.06
2024-03-17,2024-03-17,Service payment - Customer_0046,REF30858950,0.0,58.04,73007.1
2024-03-17,2024-03-17,Payment from Customer_0007,REF39550386,0.0,21.56,73028.66
2024-03-17,2024-03-17,Invoice payment - Customer_0056,REF28953641,0.0,10.0,73038.66
2024-03-17,2024-03-17,Payment from Customer_0078,REF38684837,0.0,61.31,73099.97
2024-03-17,2024-03-17,Project payment - Customer_0073,REF45062327,0.0,60.66,73160.63
2024-03-17,2024-03-17,Project payment - Customer_0063,REF57931474,0.0,99.71,73260.34
2024-03-17,2024-03-17,Invoice payment - Customer_0054,REF70238433,0.0,28.45,73288.79
2024-03-18,2024-03-18,Service payment - Customer_0092,REF32473291,0.0,121.24,73410.03
2024-03-18,2024-03-18,Project payment - Customer_0062,REF86701576,0.0,116.24,73526.27
2024-03-18,2024-03-18,Payment from Customer_0043,REF56313504,0.0,83.02,73609.29
2024-03-18,2024-03-18,Invoice payment - Customer_0031,REF34287314,0.0,30.72,73640.01
2024-03-18,2024-03-18,Project payment - Customer_0044,REF45851679,0.0,137.37,73777.38
2024-03-18,2024-03-18,Invoice payment - Customer_0063,REF31863922,0.0,108.35,73885.73
2024-03-18,2024-03-18,Payment from Customer_0015,REF81859078,0.0,74.59,73960.32
2024-03-18,2024-03-18,Payment from Customer_0065,REF39456014,0.0,60.35,74020.67
2024-03-18,2024-03-18,Invoice payment - Customer_0085,REF66245360,0.0,63.88,74084.55
2024-03-19,2024-03-19,Invoice payment - Customer_0014,REF58997783,0.0,106.81,74191.36
2024-03-19,2024-03-19,Service payment - Customer_0093,REF39604675,0.0,52.29,74243.65
2024-03-19,2024-03-19,Service payment - Customer_0046,REF54688032,0.0,44.52,74288.17
2024-03-19,2024-03-19,Project payment - Customer_0010,REF85107153,0.0,110.02,74398.19
2024-03-19,2024-03-19,Service payment - Customer_0043,REF31664868,0.0,72.6,74470.79
2024-03-19,2024-03-19,Inventory purchase,REF65190756,2723.65,0.0,71747.14
2024-03-19,2024-03-19,Payment from Customer_0078,REF58602061,0.0,52.77,71799.91
2024-03-19,2024-03-19,Project payment - Customer_0032,REF64514110,0.0,100.41,71900.32
2024-03-20,2024-03-20,Project payment - Customer_0068,REF70200170,0.0,110.43,72010.75
2024-03-20,2024-03-20,Invoice payment - Customer_0046,REF70470290,0.0,55.44,72066.19
2024-03-20,2024-03-20,Project payment - Customer_0095,REF10127271,0.0,92.64,72158.83
2024-03-20,2024-03-20,Payment from Customer_0087,REF37889885,0.0,75.21,72234.04
2024-03-20,2024-03-20,Service payment - Customer_0002,REF30113130,0.0,52.97,72287.01
2024-03-20,2024-03-20,Payment from Customer_0006,REF84272884,0.0,15.94,72302.95
2024-03-20,2024-03-20,Project payment - Customer_0010,REF38661388,0.0,87.86,72390.81
2024-03-20,2024-03-20,Project payment - Customer_0090,REF32995156,0.0,86.25,72477.06
2024-03-20,2024-03-20,Invoice payment - Customer_0032,REF30946071,0.0,96.54,72573.6
2024-03-20,2024-03-20,Marketing expenses,REF40147604,225.42,0.0,72348.18
2024-03-21,2024-03-21,Invoice payment - Customer_0052,REF97172586,0.0,78.19,72426.37
2024-03-21,2024-03-21,Payment from Customer_0087,REF15452707,0.0,85.44,72511.81
2024-03-21,2024-03-21,Payment from Customer_0001,REF90631356,0.0,86.11,72597.92
2024-03-21,2024-03-21,Service payment - Customer_0056,REF10286480,0.0,10.0,72607.92
2024-03-21,2024-03-21,Invoice payment - Customer_0015,REF56264484,0.0,82.54,72690.46
2024-03-21,2024-03-21,Service payment - Customer_0028,REF94380347,0.0,83.23,72773.69
2024-03-21,2024-03-21,Payment from Customer_0069,REF61764312,0.0,163.07,72936.76
2024-03-21,2024-03-21,Service payment - Customer_0026,REF18599584,0.0,82.18,73018.94
2024-03-21,2024-03-21,Project payment - Customer_0005,REF80419609,0.0,52.82,73071.76
2024-03-21,2024-03-21,Invoice payment - Customer_0012,REF21819657,0.0,114.34,73186.1
2024-03-22,2024-03-22,Project payment - Customer_0040,REF74263131,0.0,85.28,73271.38
2024-03-22,2024-03-22,Payment from Customer_0050,REF11260140,0.0,60.13,73331.51
2024-03-22,2024-03-22,Payment from Customer_0064,REF68761779,0.0,49.62,73381.13
2024-03-22,2024-03-22,Utility bill payment,REF43662501,137.59,0.0,73243.54
2024-03-22,2024-03-22,Invoice payment - Customer_0017,REF49705086,0.0,161.7,73405.24
2024-03-22,2024-03-22,Payment from Customer_0006,REF11858009,0.0,13.94,73419.18
2024-03-22,2024-03-22,Payment from Customer_0056,REF20355986,0.0,10.97,73430.15
2024-03-22,2024-03-22,Invoice payment - Customer_0066,REF94546300,0.0,81.13,73511.28
2024-03-22,2024-03-22,Invoice payment - Customer_0035,REF74027453,0.0,53.35,73564.63
2024-03-22,2024-03-22,Service payment - Customer_0083,REF58607530,0.0,40.02,73604.65
2024-03-22,2024-03-22,Project payment - Customer_0085,REF55599213,0.0,74.25,73678.9
2024-03-22,2024-03-22,Payment from Customer_0001,REF64832175,0.0,79.73,73758.63
2024-03-22,2024-03-22,Service payment - Customer_0091,REF67637848,0.0,65.4,73824.03
2024-03-23,2024-03-23,Invoice payment - Customer_0019,REF26489356,0.0,62.12,73886.15
2024-03-23,2024-03-23,Service payment - Customer_0082,REF42221158,0.0,41.34,73927.49
2024-03-23,2024-03-23,Service payment - Customer_0023,REF34726612,0.0,51.68,73979.17
2024-03-23,2024-03-23,Payment from Customer_0027,REF78737804,0.0,96.49,74075.66
2024-03-23,2024-03-23,Service payment - Customer_0013,REF76871208,0.0,52.6,74128.26
2024-03-23,2024-03-23,Project payment - Customer_0070,REF99187675,0.0,41.71,74169.97
2024-03-23,2024-03-23,Service payment - Customer_0089,REF11692944,0.0,55.79,74225.76
2024-03-23,2024-03-23,Payment from Customer_0030,REF56589782,0.0,88.0,74313.76
2024-03-23,2024-03-23,Project payment - Customer_0048,REF42384667,0.0,83.63,74397.39
2024-03-24,2024-03-24,Payment from Customer_0002,REF69535000,0.0,44.47,74441.86
2024-03-24,2024-03-24,Project payment - Customer_0020,REF28968152,0.0,67.81,74509.67
2024-03-24,2024-03-24,Invoice payment - Customer_0094,REF61034764,0.0,25.63,74535.3
2024-03-24,2024-03-24,Service payment - Customer_0090,REF77655226,0.0,87.12,74622.42
2024-03-24,2024-03-24,Invoice payment - Customer_0018,REF86329404,0.0,68.88,74691.3
2024-03-24,2024-03-24,Project payment - Customer_0027,REF90195096,0.0,85.44,74776.74
2024-03-24,2024-03-24,Project payment - Customer_0099,REF33704657,0.0,58.16,74834.9
2024-03-24,2024-03-24,Project payment - Customer_0074,REF26277141,0.0,76.4,74911.3
2024-03-24,2024-03-24,Project payment - Customer_0096,REF45855930,0.0,47.86,74959.16
2024-03-24,2024-03-24,Service payment - Customer_0040,REF22316294,0.0,86.05,75045.21
2024-03-24,2024-03-24,Service payment - Customer_0003,REF87255923,0.0,145.47,75190.68
2024-03-25,2024-03-25,Payment from Customer_0092,REF44108878,0.0,126.99,75317.67
2024-03-25,2024-03-25,Invoice payment - Customer_0016,REF55153534,0.0,34.77,75352.44
2024-03-25,2024-03-25,Invoice payment - Customer_0089,REF63377839,0.0,51.89,75404.33
2024-03-25,2024-03-25,Payment from Customer_0070,REF45908095,0.0,49.35,75453.68
2024-03-25,2024-03-25,Invoice payment - Customer_0073,REF55280419,0.0,42.29,75495.97
2024-03-25,2024-03-25,Service payment - Customer_0065,REF59262205,0.0,50.6,75546.57
2024-03-25,2024-03-25,Project payment - Customer_0046,REF65646862,0.0,60.17,75606.74
2024-03-25,2024-03-25,Project payment - Customer_0058,REF68565964,0.0,99.76,75706.5
2024-03-26,2024-03-26,Service payment - Customer_0086,REF89347991,0.0,91.17,75797.67
2024-03-26,2024-03-26,Service payment - Customer_0077,REF41288560,0.0,83.01,75880.68
2024-03-26,2024-03-26,Invoice payment - Customer_0009,REF93949954,0.0,143.05,76023.73
2024-03-26,2024-03-26,Service payment - Customer_0076,REF61552638,0.0,71.21,76094.94
2024-03-26,2024-03-26,Invoice payment - Customer_0052,REF48107388,0.0,112.82,76207.76
2024-03-26,2024-03-26,Project payment - Customer_0066,REF58058534,0.0,102.41,76310.17
2024-03-26,2024-03-26,Service payment - Customer_0088,REF76891934,0.0,10.0,76320.17
2024-03-26,2024-03-26,Invoice payment - Customer_0074,REF88875370,0.0,79.29,76399.46
2024-03-26,2024-03-26,Service payment - Customer_0099,REF72416010,0.0,32.76,76432.22
2024-03-26,2024-03-26,Service payment - Customer_0050,REF77414888,0.0,51.08,76483.3
2024-03-26,2024-03-26,Invoice payment - Customer_0039,REF73197026,0.0,152.95,76636.25
2024-03-26,2024-03-26,Invoice payment - Customer_0083,REF75046231,0.0,35.04,76671.29
2024-03-26,2024-03-26,Service payment - Customer_0082,REF59726924,0.0,59.97,76731.26
2024-03-27,2024-03-27,Marketing expenses,REF28521327,280.25,0.0,76451.01
2024-03-27,2024-03-27,Service payment - Customer_0014,REF56801779,0.0,102.08,76553.09
2024-03-27,2024-03-27,Invoice payment - Customer_0019,REF40710869,0.0,63.71,76616.8
2024-03-27,2024-03-27,Payment from Customer_0065,REF60979903,0.0,47.35,76664.15
2024-03-27,2024-03-27,Payment from Customer_0070,REF98052358,0.0,52.0,76716.15
2024-03-27,2024-03-27,Invoice payment - Customer_0064,REF34857050,0.0,45.62,76761.77
2024-03-27,2024-03-27,Payment from Customer_0048,REF66606229,0.0,73.36,76835.13
2024-03-28,2024-03-28,Payment from Customer_0010,REF26078242,0.0,80.21,76915.34
2024-03-28,2024-03-28,Invoice payment - Customer_0098,REF36054240,0.0,58.07,76973.41
2024-03-28,2024-03-28,Service payment - Customer_0005,REF43051578,0.0,65.5,77038.91
2024-03-28,2024-03-28,Service payment - Customer_0032,REF98719065,0.0,137.17,77176.08
2024-03-28,2024-03-28,Invoice payment - Customer_0041,REF12631764,0.0,64.79,77240.87
2024-03-28,2024-03-28,Project payment - Customer_0087,REF26321644,0.0,93.13,77334.0
2024-03-28,2024-03-28,Service payment - Customer_0045,REF29069145,0.0,96.74,77430.74
2024-03-29,2024-03-29,Payment from Customer_0064,REF55184602,0.0,43.3,77474.04
2024-03-29,2024-03-29,Service payment - Customer_0062,REF61589803,0.0,124.62,77598.66
2024-03-29,2024-03-29,Service payment - Customer_0000,REF89873873,0.0,105.41,77704.07
2024-03-29,2024-03-29,Project payment - Customer_0047,REF58834389,0.0,58.25,77762.32
2024-03-29,2024-03-29,Project payment - Customer_0011,REF79145265,0.0,42.2,77804.52
2024-03-29,2024-03-29,Payment from Customer_0090,REF28443073,0.0,70.26,77874.78
2024-03-29,2024-03-29,Service payment - Customer_0038,REF68625019,0.0,52.36,77927.14
2024-03-29,2024-03-29,Payment from Customer_0010,REF90187045,0.0,135.99,78063.13
2024-03-30,2024-03-30,Payment from Customer_0039,REF88078705,0.0,141.74,78204.87
2024-03-30,2024-03-30,Invoice payment - Customer_0055,REF48112727,0.0,89.77,78294.64
2024-03-30,2024-03-30,Payment from Customer_0049,REF30653946,0.0,39.31,78333.95
2024-03-30,2024-03-30,Service payment - Customer_0053,REF45801761,0.0,127.3,78461.25
2024-03-30,2024-03-30,Project payment - Customer_0074,REF68729140,0.0,96.55,78557.8
2024-03-30,2024-03-30,Service payment - Customer_0054,REF41891783,0.0,24.14,78581.94
2024-03-30,2024-03-30,Invoice payment - Customer_0061,REF29329881,0.0,84.43,78666.37
2024-03-30,2024-03-30,Project payment - Customer_0004,REF30125549,0.0,49.45,78715.82
2024-03-30,2024-03-30,Invoice payment - Customer_0064,REF36768288,0.0,43.0,78758.82
2024-03-30,2024-03-30,Service payment - Customer_0002,REF99459834,0.0,36.18,78795.0
2024-03-30,2024-03-30,Project payment - Customer_0034,REF74106520,0.0,10.66,78805.66
2024-03-30,2024-03-30,Project payment - Customer_0089,REF23616484,0.0,59.17,78864.83
2024-03-30,2024-03-30,Invoice payment - Customer_0044,REF44188759,0.0,136.21,79001.04
2024-03-31,2024-03-31,Project payment - Customer_0001,REF11959971,0.0,76.06,79077.1
2024-03-31,2024-03-31,Project payment - Customer_0074,REF80049142,0.0,84.84,79161.94
2024-03-31,2024-03-31,Payment from Customer_0060,REF38255608,0.0,85.55,79247.49
2024-03-31,2024-03-31,Service payment - Customer_0083,REF69764152,0.0,38.44,79285.93
2024-03-31,2024-03-31,Payment from Customer_0050,REF96685167,0.0,72.93,79358.86
2024-03-31,2024-03-31,Invoice payment - Customer_0029,REF43324652,0.0,69.7,79428.56
2024-03-31,2024-03-31,Project payment - Customer_0069,REF30918478,0.0,197.75,79626.31
2024-03-31,2024-03-31,Project payment - Customer_0085,REF20104509,0.0,61.87,79688.18
2024-03-31,2024-03-31,Project payment - Customer_0077,REF68984165,0.0,84.49,79772.67
2024-03-31,2024-03-31,Service payment - Customer_0012,REF57051867,0.0,119.14,79891.81
2024-03-31,2024-03-31,Project payment - Customer_0073,REF21431482,0.0,53.39,79945.2
2024-04-01,2024-04-01,Service payment - Customer_0024,REF98660402,0.0,91.67,80036.87
2024-04-01,2024-04-01,Monthly office rent,REF97386492,1188.28,0.0,78848.59
2024-04-01,2024-04-01,Payment from Customer_0097,REF50378085,0.0,62.47,78911.06
2024-04-01,2024-04-01,Payment from Customer_0046,REF46631791,0.0,44.02,78955.08
2024-04-01,2024-04-01,Service payment - Customer_0012,REF13358707,0.0,86.68,79041.76
2024-04-01,2024-04-01,Project payment - Customer_0006,REF41534688,0.0,15.71,79057.47
2024-04-01,2024-04-01,Payment from Customer_0031,REF37598277,0.0,37.71,79095.18
2024-04-01,2024-04-01,Service payment - Customer_0090,REF83480633,0.0,68.0,79163.18
2024-04-01,2024-04-01,Invoice payment - Customer_0014,REF41679811,0.0,127.38,79290.56
2024-04-02,2024-04-02,Project payment - Customer_0021,REF19169364,0.0,72.96,79363.52
2024-04-02,2024-04-02,Invoice payment - Customer_0020,REF68415609,0.0,60.67,79424.19
2024-04-02,2024-04-02,Payment from Customer_0026,REF85325415,0.0,88.57,79512.76
2024-04-02,2024-04-02,Service payment - Customer_0016,REF47623437,0.0,30.16,79542.92
2024-04-02,2024-04-02,Invoice payment - Customer_0024,REF73272145,0.0,138.34,79681.26
2024-04-02,2024-04-02,Payment from Customer_0053,REF39326319,0.0,148.9,79830.16
2024-04-02,2024-04-02,Payment from Customer_0094,REF66127557,0.0,22.3,79852.46
2024-04-02,2024-04-02,Payment from Customer_0025,REF37282833,0.0,79.91,79932.37
2024-04-02,2024-04-02,Invoice payment - Customer_0088,REF54660748,0.0,12.66,79945.03
2024-04-03,2024-04-03,Invoice payment - Customer_0055,REF29686395,0.0,90.35,80035.38
2024-04-03,2024-04-03,Invoice payment - Customer_0037,REF43976074,0.0,113.7,80149.08
2024-04-03,2024-04-03,Service payment - Customer_0058,REF76049723,0.0,105.47,80254.55
2024-04-03,2024-04-03,Project payment - Customer_0036,REF17247022,0.0,37.35,80291.9
2024-04-03,2024-04-03,Project payment - Customer_0047,REF31931383,0.0,67.82,80359.72
2024-04-03,2024-04-03,Invoice payment - Customer_0097,REF91207127,0.0,45.76,80405.48
2024-04-03,2024-04-03,Project payment - Customer_0050,REF26203036,0.0,71.85,80477.33
2024-04-03,2024-04-03,Service payment - Customer_0081,REF13571600,0.0,82.43,80559.76
2024-04-03,2024-04-03,Payment from Customer_0089,REF90187986,0.0,49.46,80609.22
2024-04-03,2024-04-03,Pos Systems expense,REF29064395,38.86,0.0,80570.36
2024-04-04,2024-04-04,Professional Services expense,REF93310056,117.86,0.0,80452.5
2024-04-04,2024-04-04,Payment from Customer_0086,REF40782946,0.0,90.83,80543.33
2024-04-04,2024-04-04,Project payment - Customer_0066,REF76263705,0.0,84.54,80627.87
2024-04-04,2024-04-04,Project payment - Customer_0063,REF91953863,0.0,116.02,80743.89
2024-04-04,2024-04-04,Invoice payment - Customer_0027,REF88272496,0.0,101.5,80845.39
2024-04-04,2024-04-04,Invoice payment - Customer_0004,REF23164398,0.0,51.55,80896.94
2024-04-04,2024-04-04,Service payment - Customer_0049,REF13429407,0.0,41.92,80938.86
2024-04-04,2024-04-04,Payment from Customer_0008,REF94622702,0.0,40.75,80979.61
2024-04-04,2024-04-04,Invoice payment - Customer_0005,REF60455771,0.0,62.89,81042.5
2024-04-04,2024-04-04,Payment from Customer_0003,REF88047007,0.0,130.51,81173.01
2024-04-04,2024-04-04,Service payment - Customer_0044,REF63006531,0.0,132.15,81305.16
2024-04-05,2024-04-05,Service payment - Customer_0035,REF58003002,0.0,85.13,81390.29
2024-04-05,2024-04-05,Project payment - Customer_0049,REF76923156,0.0,43.25,81433.54
2024-04-05,2024-04-05,Payment from Customer_0073,REF90113773,0.0,32.07,81465.61
2024-04-05,2024-04-05,Service payment - Customer_0021,REF27783346,0.0,91.75,81557.36
2024-04-05,2024-04-05,Project payment - Customer_0007,REF15211321,0.0,29.5,81586.86
2024-04-05,2024-04-05,Payment from Customer_0065,REF67596121,0.0,52.96,81639.82
2024-04-05,2024-04-05,Invoice payment - Customer_0096,REF55042951,0.0,41.25,81681.07
2024-04-06,2024-04-06,Service payment - Customer_0061,REF86490560,0.0,58.76,81739.83
2024-04-06,2024-04-06,Project payment - Customer_0081,REF65369518,0.0,68.5,81808.33
2024-04-06,2024-04-06,Service payment - Customer_0050,REF20450968,0.0,64.14,81872.47
2024-04-06,2024-04-06,Payment from Customer_0034,REF90813282,0.0,10.0,81882.47
2024-04-07,2024-04-07,Invoice payment - Customer_0064,REF35241110,0.0,40.24,81922.71
2024-04-07,2024-04-07,Project payment - Customer_0068,REF13425957,0.0,107.16,82029.87
2024-04-07,2024-04-07,Invoice payment - Customer_0075,REF38071229,0.0,77.91,82107.78
2024-04-07,2024-04-07,Invoice payment - Customer_0034,REF98688300,0.0,10.0,82117.78
2024-04-07,2024-04-07,Invoice payment - Customer_0067,REF59475264,0.0,45.75,82163.53
2024-04-07,2024-04-07,Employee payroll,REF60033304,2908.18,0.0,79255.35
2024-04-07,2024-04-07,Payment from Customer_0000,REF78567256,0.0,122.72,79378.07
2024-04-07,2024-04-07,Service payment - Customer_0092,REF91449665,0.0,129.81,79507.88
2024-04-07,2024-04-07,Invoice payment - Customer_0019,REF91598048,0.0,64.87,79572.75
2024-04-08,2024-04-08,Professional Services expense,REF70608132,192.36,0.0,79380.39
2024-04-08,2024-04-08,Project payment - Customer_0033,REF33960068,0.0,135.08,79515.47
2024-04-08,2024-04-08,Project payment - Customer_0018,REF20065648,0.0,54.78,79570.25
2024-04-08,2024-04-08,Service payment - Customer_0003,REF29497945,0.0,95.54,79665.79
2024-04-08,2024-04-08,Invoice payment - Customer_0021,REF21001966,0.0,62.88,79728.67
2024-04-08,2024-04-08,Invoice payment - Customer_0075,REF62005593,0.0,58.11,79786.78
2024-04-08,2024-04-08,Service payment - Customer_0056,REF23613201,0.0,10.0,79796.78
2024-04-08,2024-04-08,Service payment - Customer_0060,REF42197100,0.0,96.76,79893.54
2024-04-08,2024-04-08,Invoice payment - Customer_0016,REF86490111,0.0,22.4,79915.94
2024-04-09,2024-04-09,Service payment - Customer_0052,REF41610153,0.0,92.3,80008.24
2024-04-09,2024-04-09,Invoice payment - Customer_0005,REF82213615,0.0,63.21,80071.45
2024-04-09,2024-04-09,Invoice payment - Customer_0057,REF67187034,0.0,40.0,80111.45
2024-04-09,2024-04-09,Service payment - Customer_0072,REF28580890,0.0,72.75,80184.2
2024-04-09,2024-04-09,Project payment - Customer_0062,REF81278399,0.0,125.75,80309.95
2024-04-09,2024-04-09,Invoice payment - Customer_0025,REF29403615,0.0,79.68,80389.63
2024-04-09,2024-04-09,Service payment - Customer_0073,REF57572292,0.0,56.09,80445.72
2024-04-09,2024-04-09,Service payment - Customer_0060,REF98031218,0.0,79.45,80525.17
2024-04-09,2024-04-09,Project payment - Customer_0090,REF40600606,0.0,76.95,80602.12
2024-04-09,2024-04-09,Service payment - Customer_0031,REF99797388,0.0,34.81,80636.93
2024-04-09,2024-04-09,Payment from Customer_0024,REF94072333,0.0,125.04,80761.97
2024-04-09,2024-04-09,Invoice payment - Customer_0056,REF38597016,0.0,10.0,80771.97
2024-04-09,2024-04-09,Payment from Customer_0099,REF89521620,0.0,41.04,80813.01
2024-04-10,2024-04-10,Pos Systems expense,REF95576664,47.27,0.0,80765.74
2024-04-10,2024-04-10,Invoice payment - Customer_0007,REF25562251,0.0,22.98,80788.72
2024-04-10,2024-04-10,Project payment - Customer_0017,REF83958042,0.0,155.23,80943.95
2024-04-10,2024-04-10,Project payment - Customer_0083,REF73027218,0.0,44.62,80988.57
2024-04-10,2024-04-10,Payment from Customer_0020,REF60632582,0.0,59.6,81048.17
2024-04-10,2024-04-10,Invoice payment - Customer_0022,REF61714714,0.0,60.84,81109.01
2024-04-10,2024-04-10,Service payment - Customer_0090,REF23279790,0.0,84.69,81193.7
2024-04-10,2024-04-10,Service payment - Customer_0086,REF73549885,0.0,101.39,81295.09
2024-04-10,2024-04-10,Invoice payment - Customer_0039,REF84741837,0.0,148.67,81443.76
2024-04-10,2024-04-10,Payment from Customer_0001,REF59984961,0.0,61.71,81505.47
2024-04-10,2024-04-10,Service payment - Customer_0013,REF37867473,0.0,54.83,81560.3
2024-04-10,2024-04-10,Payment from Customer_0087,REF40041742,0.0,98.28,81658.58
2024-04-10,2024-04-10,Invoice payment - Customer_0081,REF66397147,0.0,96.95,81755.53
2024-04-11,2024-04-11,Payment from Customer_0058,REF21325080,0.0,89.92,81845.45
2024-04-11,2024-04-11,Payment from Customer_0095,REF23406804,0.0,97.11,81942.56
2024-04-11,2024-04-11,Service payment - Customer_0096,REF20356660,0.0,36.4,81978.96
2024-04-11,2024-04-11,Invoice payment - Customer_0099,REF54190700,0.0,52.22,82031.18
2024-04-11,2024-04-11,Invoice payment - Customer_0022,REF89673025,0.0,75.98,82107.16
2024-04-11,2024-04-11,Service payment - Customer_0047,REF16378581,0.0,67.42,82174.58
2024-04-11,2024-04-11,Invoice payment - Customer_0081,REF28141210,0.0,79.89,82254.47
2024-04-12,2024-04-12,Payment from Customer_0016,REF35186120,0.0,33.71,82288.18
2024-04-12,2024-04-12,Invoice payment - Customer_0065,REF51007125,0.0,64.29,82352.47
2024-04-12,2024-04-12,Payment from Customer_0068,REF49952373,0.0,104.47,82456.94
2024-04-12,2024-04-12,Project payment - Customer_0093,REF55938227,0.0,40.12,82497.06
2024-04-12,2024-04-12,Project payment - Customer_0063,REF75134155,0.0,114.42,82611.48
2024-04-12,2024-04-12,Payment from Customer_0046,REF62160105,0.0,47.46,82658.94
2024-04-12,2024-04-12,Project payment - Customer_0001,REF84750940,0.0,81.36,82740.3
2024-04-12,2024-04-12,Invoice payment - Customer_0025,REF64851881,0.0,90.28,82830.58
2024-04-13,2024-04-13,Project payment - Customer_0088,REF86834767,0.0,13.55,82844.13
2024-04-13,2024-04-13,Invoice payment - Customer_0073,REF17171188,0.0,45.1,82889.23
2024-04-13,2024-04-13,Invoice payment - Customer_0019,REF74933074,0.0,69.74,82958.97
2024-04-13,2024-04-13,Project payment - Customer_0096,REF34933170,0.0,40.38,82999.35
2024-04-13,2024-04-13,Service payment - Customer_0003,REF16809155,0.0,104.4,83103.75
2024-04-13,2024-04-13,Payment from Customer_0041,REF74982445,0.0,56.41,83160.16
2024-04-13,2024-04-13,Payment from Customer_0083,REF84708698,0.0,35.74,83195.9
2024-04-13,2024-04-13,Payment from Customer_0082,REF75840489,0.0,56.32,83252.22
2024-04-14,2024-04-14,Invoice payment - Customer_0079,REF49725688,0.0,115.35,83367.57
2024-04-14,2024-04-14,Service payment - Customer_0049,REF88675955,0.0,40.25,83407.82
2024-04-14,2024-04-14,Project payment - Customer_0076,REF54577250,0.0,67.55,83475.37
2024-04-14,2024-04-14,Invoice payment - Customer_0012,REF95556540,0.0,131.73,83607.1
2024-04-14,2024-04-14,Service payment - Customer_0042,REF25784661,0.0,98.24,83705.34
2024-04-14,2024-04-14,Service payment - Customer_0063,REF44907678,0.0,86.03,83791.37
2024-04-14,2024-04-14,Project payment - Customer_0004,REF93981155,0.0,47.59,83838.96
2024-04-14,2024-04-14,Payment from Customer_0044,REF37070101,0.0,144.65,83983.61
2024-04-14,2024-04-14,Service payment - Customer_0038,REF99133815,0.0,42.14,84025.75
2024-04-14,2024-04-14,Payment from Customer_0027,REF32226163,0.0,118.77,84144.52
2024-04-15,2024-04-15,Project payment - Customer_0015,REF38885719,0.0,112.02,84256.54
2024-04-15,2024-04-15,Service payment - Customer_0052,REF70062701,0.0,92.6,84349.14
2024-04-15,2024-04-15,Project payment - Customer_0076,REF38086008,0.0,68.41,84417.55
2024-04-15,2024-04-15,Invoice payment - Customer_0046,REF49058684,0.0,54.18,84471.73
2024-04-15,2024-04-15,Project payment - Customer_0024,REF30060477,0.0,116.76,84588.49
2024-04-15,2024-04-15,Business insurance premium,REF10378912,168.94,0.0,84419.55
2024-04-15,2024-04-15,Payment from Customer_0003,REF75158534,0.0,110.25,84529.8
2024-04-15,2024-04-15,Inventory purchase,REF86640817,3665.89,0.0,80863.91
2024-04-15,2024-04-15,Project payment - Customer_0063,REF57482343,0.0,115.01,80978.92
2024-04-16,2024-04-16,Service payment - Customer_0050,REF81156737,0.0,69.25,81048.17
2024-04-16,2024-04-16,Invoice payment - Customer_0015,REF92938410,0.0,91.82,81139.99
2024-04-16,2024-04-16,Project payment - Customer_0075,REF58666970,0.0,72.01,81212.0
2024-04-16,2024-04-16,Project payment - Customer_0021,REF47247931,0.0,67.49,81279.49
2024-04-16,2024-04-16,Service payment - Customer_0029,REF71815922,0.0,54.5,81333.99
2024-04-16,2024-04-16,Service payment - Customer_0019,REF77647843,0.0,51.45,81385.44
2024-04-16,2024-04-16,Payment from Customer_0067,REF93153289,0.0,44.87,81430.31
2024-04-16,2024-04-16,Service payment - Customer_0058,REF98513178,0.0,66.5,81496.81
2024-04-16,2024-04-16,Service payment - Customer_0001,REF45171863,0.0,76.57,81573.38
2024-04-16,2024-04-16,Invoice payment - Customer_0044,REF43155037,0.0,133.61,81706.99
2024-04-16,2024-04-16,Payment from Customer_0047,REF91669045,0.0,82.13,81789.12
2024-04-16,2024-04-16,Payment from Customer_0020,REF82061018,0.0,50.91,81840.03
2024-04-16,2024-04-16,Service payment - Customer_0052,REF80734708,0.0,65.74,81905.77
2024-04-16,2024-04-16,Project payment - Customer_0012,REF63911869,0.0,95.15,82000.92
2024-04-17,2024-04-17,Service payment - Customer_0085,REF37897966,0.0,59.66,82060.58
2024-04-17,2024-04-17,Service payment - Customer_0021,REF16071221,0.0,97.27,82157.85
2024-04-17,2024-04-17,Project payment - Customer_0074,REF76330526,0.0,108.94,82266.79
2024-04-17,2024-04-17,Payment from Customer_0069,REF34861309,0.0,160.97,82427.76
2024-04-17,2024-04-17,Project payment - Customer_0045,REF42062455,0.0,96.82,82524.58
2024-04-17,2024-04-17,Invoice payment - Customer_0077,REF91900291,0.0,86.11,82610.69
2024-04-17,2024-04-17,Service payment - Customer_0014,REF98845384,0.0,105.87,82716.56
2024-04-17,2024-04-17,Payment from Customer_0013,REF56691512,0.0,56.76,82773.32
2024-04-17,2024-04-17,Service payment - Customer_0073,REF59038235,0.0,53.34,82826.66
2024-04-17,2024-04-17,Invoice payment - Customer_0006,REF39052431,0.0,17.18,82843.84
2024-04-17,2024-04-17,Payment from Customer_0090,REF38104294,0.0,65.18,82909.02
2024-04-17,2024-04-17,Service payment - Customer_0040,REF79449915,0.0,66.15,82975.17
2024-04-17,2024-04-17,Payment from Customer_0027,REF66220625,0.0,96.58,83071.75
2024-04-17,2024-04-17,Inventory purchase,REF66875938,1631.52,0.0,81440.23
2024-04-17,2024-04-17,Service payment - Customer_0024,REF16242603,0.0,136.76,81576.99
2024-04-18,2024-04-18,Payment from Customer_0025,REF53477104,0.0,102.06,81679.05
2024-04-18,2024-04-18,Payment from Customer_0031,REF11851744,0.0,37.02,81716.07
2024-04-18,2024-04-18,Payment from Customer_0067,REF18721584,0.0,42.83,81758.9
2024-04-18,2024-04-18,Payment from Customer_0058,REF28818466,0.0,61.2,81820.1
2024-04-18,2024-04-18,Payment from Customer_0061,REF97674841,0.0,79.57,81899.67
2024-04-18,2024-04-18,Service payment - Customer_0073,REF94387395,0.0,39.55,81939.22
2024-04-19,2024-04-19,Invoice payment - Customer_0069,REF64083123,0.0,158.62,82097.84
2024-04-19,2024-04-19,Project payment - Customer_0084,REF81746552,0.0,47.23,82145.07
2024-04-19,2024-04-19,Project payment - Customer_0074,REF89944938,0.0,92.18,82237.25
2024-04-19,2024-04-19,Payment from Customer_0096,REF96569566,0.0,48.26,82285.51
2024-04-19,2024-04-19,Project payment - Customer_0020,REF20980400,0.0,57.7,82343.21
2024-04-19,2024-04-19,Service payment - Customer_0034,REF86848545,0.0,10.0,82353.21
2024-04-19,2024-04-19,Inventory purchase,REF88091489,5265.49,0.0,77087.72
2024-04-19,2024-04-19,Service payment - Customer_0055,REF49501089,0.0,77.12,77164.84
2024-04-19,2024-04-19,Invoice payment - Customer_0051,REF79049097,0.0,78.11,77242.95
2024-04-19,2024-04-19,Invoice payment - Customer_0024,REF10973399,0.0,124.59,77367.54
2024-04-19,2024-04-19,Service payment - Customer_0054,REF48679138,0.0,25.55,77393.09
2024-04-19,2024-04-19,Service payment - Customer_0006,REF16329310,0.0,10.94,77404.03
2024-04-19,2024-04-19,Project payment - Customer_0031,REF41779651,0.0,32.08,77436.11
2024-04-19,2024-04-19,Project payment - Customer_0064,REF89940204,0.0,46.55,77482.66
2024-04-19,2024-04-19,Service payment - Customer_0016,REF26082281,0.0,37.31,77519.97
2024-04-19,2024-04-19,Payment from Customer_0037,REF57014727,0.0,138.63,77658.6
2024-04-20,2024-04-20,Payment from Customer_0016,REF15110010,0.0,30.23,77688.83
2024-04-20,2024-04-20,Project payment - Customer_0056,REF58179569,0.0,10.0,77698.83
2024-04-20,2024-04-20,Project payment - Customer_0007,REF76720856,0.0,23.71,77722.54
2024-04-20,2024-04-20,Project payment - Customer_0065,REF76151948,0.0,37.18,77759.72
2024-04-20,2024-04-20,Service payment - Customer_0051,REF74436850,0.0,73.3,77833.02
2024-04-20,2024-04-20,Service payment - Customer_0074,REF96995780,0.0,97.7,77930.72
2024-04-20,2024-04-20,Service payment - Customer_0055,REF67056725,0.0,66.7,77997.42
2024-04-20,2024-04-20,Project payment - Customer_0002,REF82450353,0.0,53.1,78050.52
2024-04-20,2024-04-20,Invoice payment - Customer_0061,REF49488241,0.0,71.59,78122.11
2024-04-21,2024-04-21,Invoice payment - Customer_0054,REF24544426,0.0,25.42,78147.53
2024-04-21,2024-04-21,Invoice payment - Customer_0034,REF77379859,0.0,10.0,78157.53
2024-04-21,2024-04-21,Payment from Customer_0056,REF13017572,0.0,11.36,78168.89
2024-04-21,2024-04-21,Project payment - Customer_0033,REF60059725,0.0,91.31,78260.2
2024-04-21,2024-04-21,Service payment - Customer_0079,REF32002184,0.0,112.75,78372.95
2024-04-21,2024-04-21,Invoice payment - Customer_0021,REF30483960,0.0,86.1,78459.05
2024-04-21,2024-04-21,Project payment - Customer_0025,REF76385393,0.0,88.04,78547.09
2024-04-21,2024-04-21,Payment from Customer_0068,REF49546406,0.0,93.55,78640.64
2024-04-21,2024-04-21,Project payment - Customer_0072,REF33405942,0.0,91.68,78732.32
2024-04-21,2024-04-21,Project payment - Customer_0099,REF43601992,0.0,39.96,78772.28
2024-04-21,2024-04-21,Project payment - Customer_0020,REF58469334,0.0,57.49,78829.77
2024-04-21,2024-04-21,Project payment - Customer_0085,REF76152564,0.0,77.48,78907.25
2024-04-22,2024-04-22,Service payment - Customer_0099,REF70363978,0.0,40.34,78947.59
2024-04-22,2024-04-22,Payment from Customer_0029,REF96893485,0.0,67.23,79014.82
2024-04-22,2024-04-22,Project payment - Customer_0000,REF56182751,0.0,119.41,79134.23
2024-04-22,2024-04-22,Service payment - Customer_0093,REF66171167,0.0,44.83,79179.06
2024-04-22,2024-04-22,Project payment - Customer_0092,REF50561430,0.0,107.53,79286.59
2024-04-22,2024-04-22,Utility bill payment,REF66582751,146.62,0.0,79139.97
2024-04-23,2024-04-23,Project payment - Customer_0078,REF72871557,0.0,60.81,79200.78
2024-04-23,2024-04-23,Project payment - Customer_0059,REF72052494,0.0,131.01,79331.79
2024-04-23,2024-04-23,Service payment - Customer_0071,REF19596869,0.0,58.47,79390.26
2024-04-23,2024-04-23,Payment from Customer_0004,REF32812337,0.0,55.68,79445.94
2024-04-23,2024-04-23,Payment from Customer_0008,REF88624526,0.0,45.34,79491.28
2024-04-23,2024-04-23,Service payment - Customer_0002,REF24093987,0.0,32.41,79523.69
2024-04-23,2024-04-23,Invoice payment - Customer_0036,REF82793749,0.0,54.19,79577.88
2024-04-23,2024-04-23,Project payment - Customer_0068,REF92417969,0.0,83.74,79661.62
2024-04-23,2024-04-23,Service payment - Customer_0098,REF77200534,0.0,96.19,79757.81
2024-04-23,2024-04-23,Invoice payment - Customer_0066,REF80752692,0.0,91.89,79849.7
2024-04-24,2024-04-24,Invoice payment - Customer_0014,REF55185901,0.0,107.39,79957.09
2024-04-24,2024-04-24,Service payment - Customer_0067,REF29773450,0.0,44.48,80001.57
2024-04-24,2024-04-24,Invoice payment - Customer_0054,REF90338617,0.0,28.44,80030.01
2024-04-24,2024-04-24,Packaging Shipping expense,REF58991829,163.08,0.0,79866.93
2024-04-24,2024-04-24,Project payment - Customer_0085,REF58847931,0.0,68.89,79935.82
2024-04-24,2024-04-24,Marketing expenses,REF86820647,509.81,0.0,79426.01
2024-04-24,2024-04-24,Invoice payment - Customer_0099,REF68489133,0.0,50.62,79476.63
2024-04-25,2024-04-25,Invoice payment - Customer_0066,REF49628956,0.0,85.37,79562.0
2024-04-25,2024-04-25,Payment from Customer_0061,REF60831461,0.0,91.4,79653.4
2024-04-25,2024-04-25,Payment from Customer_0056,REF44547755,0.0,11.0,79664.4
2024-04-25,2024-04-25,Project payment - Customer_0081,REF35338755,0.0,82.8,79747.2
2024-04-25,2024-04-25,Invoice payment - Customer_0090,REF49151309,0.0,69.69,79816.89
2024-04-25,2024-04-25,Service payment - Customer_0036,REF81084585,0.0,45.62,79862.51
2024-04-25,2024-04-25,Project payment - Customer_0021,REF12096569,0.0,48.91,79911.42
2024-04-25,2024-04-25,Service payment - Customer_0047,REF56342620,0.0,63.72,79975.14
2024-04-25,2024-04-25,Service payment - Customer_0080,REF77841058,0.0,134.43,80109.57
2024-04-25,2024-04-25,Service payment - Customer_0083,REF53843465,0.0,51.39,80160.96
2024-04-25,2024-04-25,Project payment - Customer_0079,REF20552520,0.0,141.29,80302.25
2024-04-26,2024-04-26,Project payment - Customer_0075,REF83544966,0.0,83.63,80385.88
2024-04-26,2024-04-26,Project payment - Customer_0027,REF68143200,0.0,107.32,80493.2
2024-04-26,2024-04-26,Invoice payment - Customer_0061,REF66029132,0.0,90.57,80583.77
2024-04-26,2024-04-26,Project payment - Customer_0035,REF69060669,0.0,53.16,80636.93
2024-04-26,2024-04-26,Invoice payment - Customer_0011,REF92232007,0.0,38.03,80674.96
2024-04-26,2024-04-26,Service payment - Customer_0046,REF22145599,0.0,58.99,80733.95
2024-04-26,2024-04-26,Project payment - Customer_0037,REF60019899,0.0,114.03,80847.98
2024-04-26,2024-04-26,Service payment - Customer_0094,REF36011345,0.0,26.52,80874.5
2024-04-27,2024-04-27,Invoice payment - Customer_0044,REF41254939,0.0,114.06,80988.56
2024-04-27,2024-04-27,Project payment - Customer_0006,REF62164575,0.0,14.92,81003.48
2024-04-27,2024-04-27,Service payment - Customer_0049,REF25239660,0.0,53.92,81057.4
2024-04-27,2024-04-27,Payment from Customer_0047,REF74842789,0.0,73.25,81130.65
2024-04-27,2024-04-27,Payment from Customer_0020,REF35992570,0.0,62.78,81193.43
2024-04-27,2024-04-27,Invoice payment - Customer_0043,REF16961056,0.0,63.84,81257.27
2024-04-27,2024-04-27,Service payment - Customer_0098,REF60163423,0.0,98.49,81355.76
2024-04-27,2024-04-27,Payment from Customer_0029,REF71807762,0.0,54.83,81410.59
2024-04-27,2024-04-27,Service payment - Customer_0076,REF13256749,0.0,72.02,81482.61
2024-04-28,2024-04-28,Invoice payment - Customer_0085,REF17771795,0.0,70.61,81553.22
2024-04-28,2024-04-28,Invoice payment - Customer_0025,REF65040625,0.0,83.46,81636.68
2024-04-28,2024-04-28,Service payment - Customer_0044,REF26292216,0.0,137.74,81774.42
2024-04-28,2024-04-28,Project payment - Customer_0048,REF77450227,0.0,74.76,81849.18
2024-04-28,2024-04-28,Payment from Customer_0097,REF25022275,0.0,47.58,81896.76
2024-04-28,2024-04-28,Project payment - Customer_0067,REF49240487,0.0,39.45,81936.21
2024-04-28,2024-04-28,Payment from Customer_0030,REF32923475,0.0,73.88,82010.09
2024-04-28,2024-04-28,Service payment - Customer_0021,REF18235122,0.0,70.95,82081.04
2024-04-28,2024-04-28,Project payment - Customer_0080,REF74832886,0.0,119.82,82200.86
2024-04-28,2024-04-28,Service payment - Customer_0016,REF43162528,0.0,31.08,82231.94
2024-04-28,2024-04-28,Service payment - Customer_0077,REF82757520,0.0,61.48,82293.42
2024-04-28,2024-04-28,Service payment - Customer_0096,REF24027020,0.0,50.87,82344.29
2024-04-28,2024-04-28,Payment from Customer_0053,REF64237775,0.0,162.77,82507.06
2024-04-28,2024-04-28,Invoice payment - Customer_0094,REF39877385,0.0,20.15,82527.21
2024-04-29,2024-04-29,Payment from Customer_0037,REF87034598,0.0,117.9,82645.11
2024-04-29,2024-04-29,Payment from Customer_0032,REF55465690,0.0,117.7,82762.81
2024-04-29,2024-04-29,Invoice payment - Customer_0036,REF54312502,0.0,59.47,82822.28
2024-04-29,2024-04-29,Invoice payment - Customer_0015,REF36818907,0.0,81.56,82903.84
2024-04-29,2024-04-29,Service payment - Customer_0033,REF32280226,0.0,79.25,82983.09
2024-04-29,2024-04-29,Invoice payment - Customer_0083,REF66606672,0.0,40.84,83023.93
2024-04-29,2024-04-29,Payment from Customer_0056,REF97664327,0.0,11.62,83035.55
2024-04-29,2024-04-29,Service payment - Customer_0060,REF56382091,0.0,90.01,83125.56
2024-04-29,2024-04-29,Service payment - Customer_0002,REF80599465,0.0,50.17,83175.73
2024-04-29,2024-04-29,Invoice payment - Customer_0041,REF44347925,0.0,48.28,83224.01
2024-04-29,2024-04-29,Service payment - Customer_0020,REF39994876,0.0,74.32,83298.33
2024-04-29,2024-04-29,Project payment - Customer_0098,REF68805323,0.0,86.04,83384.37
2024-04-29,2024-04-29,Project payment - Customer_0001,REF23550566,0.0,93.2,83477.57
2024-04-29,2024-04-29,Service payment - Customer_0070,REF84060815,0.0,63.06,83540.63
2024-04-29,2024-04-29,Invoice payment - Customer_0069,REF13923058,0.0,219.36,83759.99
2024-04-30,2024-04-30,Project payment - Customer_0060,REF23420938,0.0,74.66,83834.65
2024-04-30,2024-04-30,Payment from Customer_0053,REF94519673,0.0,129.17,83963.82
2024-04-30,2024-04-30,Project payment - Customer_0068,REF99907136,0.0,118.5,84082.32
2024-04-30,2024-04-30,Payment from Customer_0080,REF75267134,0.0,96.4,84178.72
2024-04-30,2024-04-30,Service payment - Customer_0057,REF58637896,0.0,33.9,84212.62
2024-04-30,2024-04-30,Invoice payment - Customer_0077,REF70167339,0.0,59.89,84272.51
2024-04-30,2024-04-30,Project payment - Customer_0073,REF33423504,0.0,54.26,84326.77
2024-05-01,2024-05-01,Monthly office rent,REF23607161,1388.7,0.0,82938.07
2024-05-01,2024-05-01,Project payment - Customer_0004,REF28733087,0.0,59.48,82997.55
2024-05-01,2024-05-01,Payment from Customer_0044,REF26427135,0.0,149.48,83147.03
2024-05-01,2024-05-01,Invoice payment - Customer_0055,REF72838278,0.0,107.31,83254.34
2024-05-01,2024-05-01,Invoice payment - Customer_0025,REF85050577,0.0,86.34,83340.68
2024-05-01,2024-05-01,Project payment - Customer_0037,REF47362719,0.0,137.83,83478.51
2024-05-01,2024-05-01,Project payment - Customer_0029,REF55680702,0.0,69.14,83547.65
2024-05-01,2024-05-01,Inventory purchase,REF42528419,3394.51,0.0,80153.14
2024-05-01,2024-05-01,Payment from Customer_0023,REF44167682,0.0,68.24,80221.38
2024-05-01,2024-05-01,Service payment - Customer_0054,REF38891486,0.0,27.86,80249.24
2024-05-01,2024-05-01,Project payment - Customer_0019,REF24568437,0.0,56.19,80305.43
2024-05-01,2024-05-01,Invoice payment - Customer_0078,REF23490791,0.0,62.55,80367.98
2024-05-01,2024-05-01,Invoice payment - Customer_0035,REF26770334,0.0,102.5,80470.48
2024-05-01,2024-05-01,Invoice payment - Customer_0040,REF71859479,0.0,137.57,80608.05
2024-05-02,2024-05-02,Invoice payment - Customer_0030,REF20257771,0.0,89.11,80697.16
2024-05-02,2024-05-02,Project payment - Customer_0082,REF55480403,0.0,62.6,80759.76
2024-05-02,2024-05-02,Invoice payment - Customer_0089,REF82773202,0.0,50.2,80809.96
2024-05-02,2024-05-02,Invoice payment - Customer_0023,REF41907703,0.0,53.64,80863.6
2024-05-02,2024-05-02,Project payment - Customer_0016,REF47680835,0.0,28.78,80892.38
2024-05-02,2024-05-02,Payment from Customer_0053,REF25170794,0.0,230.15,81122.53
2024-05-02,2024-05-02,Project payment - Customer_0051,REF76095473,0.0,58.25,81180.78
2024-05-03,2024-05-03,Service payment - Customer_0020,REF68876329,0.0,68.16,81248.94
2024-05-03,2024-05-03,Invoice payment - Customer_0053,REF98569254,0.0,124.83,81373.77
2024-05-03,2024-05-03,Project payment - Customer_0063,REF49971046,0.0,96.35,81470.12
2024-05-03,2024-05-03,Payment from Customer_0005,REF52621873,0.0,79.98,81550.1
2024-05-03,2024-05-03,Payment from Customer_0074,REF16023696,0.0,96.36,81646.46
2024-05-03,2024-05-03,Project payment - Customer_0043,REF29658105,0.0,72.74,81719.2
2024-05-03,2024-05-03,Payment from Customer_0050,REF62307661,0.0,74.86,81794.06
2024-05-03,2024-05-03,Project payment - Customer_0002,REF73993382,0.0,42.51,81836.57
2024-05-04,2024-05-04,Payment from Customer_0053,REF56323141,0.0,148.76,81985.33
2024-05-04,2024-05-04,Payment from Customer_0055,REF46484810,0.0,84.64,82069.97
2024-05-04,2024-05-04,Payment from Customer_0085,REF99050112,0.0,75.61,82145.58
2024-05-04,2024-05-04,Marketing expenses,REF58388654,388.67,0.0,81756.91
2024-05-04,2024-05-04,Invoice payment - Customer_0086,REF76316818,0.0,88.72,81845.63
2024-05-04,2024-05-04,Project payment - Customer_0030,REF86805812,0.0,93.26,81938.89
2024-05-04,2024-05-04,Invoice payment - Customer_0098,REF38777179,0.0,81.64,82020.53
2024-05-04,2024-05-04,Project payment - Customer_0023,REF28717774,0.0,59.43,82079.96
2024-05-04,2024-05-04,Invoice payment - Customer_0082,REF58834071,0.0,58.69,82138.65
2024-05-04,2024-05-04,Invoice payment - Customer_0039,REF78692410,0.0,158.24,82296.89
2024-05-04,2024-05-04,Payment from Customer_0002,REF93514379,0.0,45.78,82342.67
2024-05-05,2024-05-05,Service payment - Customer_0022,REF57934443,0.0,73.14,82415.81
2024-05-05,2024-05-05,Invoice payment - Customer_0037,REF62250743,0.0,125.4,82541.21
2024-05-05,2024-05-05,Payment from Customer_0094,REF22868828,0.0,27.55,82568.76
2024-05-05,2024-05-05,Payment from Customer_0001,REF96059169,0.0,70.12,82638.88
2024-05-05,2024-05-05,Service payment - Customer_0000,REF31029700,0.0,123.0,82761.88
2024-05-05,2024-05-05,Invoice payment - Customer_0007,REF11767615,0.0,27.55,82789.43
2024-05-05,2024-05-05,Project payment - Customer_0035,REF40275848,0.0,78.02,82867.45
2024-05-05,2024-05-05,Service payment - Customer_0029,REF49692765,0.0,51.58,82919.03
2024-05-06,2024-05-06,Payment from Customer_0035,REF58174726,0.0,83.92,83002.95
2024-05-06,2024-05-06,Service payment - Customer_0090,REF12121844,0.0,87.28,83090.23
2024-05-06,2024-05-06,Project payment - Customer_0060,REF92746920,0.0,76.79,83167.02
2024-05-06,2024-05-06,Service payment - Customer_0045,REF33902346,0.0,88.77,83255.79
2024-05-06,2024-05-06,Service payment - Customer_0072,REF88420472,0.0,72.36,83328.15
2024-05-06,2024-05-06,Payment from Customer_0079,REF27222777,0.0,174.77,83502.92
2024-05-06,2024-05-06,Service payment - Customer_0011,REF34815400,0.0,43.04,83545.96
2024-05-06,2024-05-06,Payment from Customer_0032,REF82167815,0.0,140.36,83686.32
2024-05-06,2024-05-06,Invoice payment - Customer_0061,REF46437806,0.0,82.77,83769.09
2024-05-07,2024-05-07,Invoice payment - Customer_0081,REF81794529,0.0,92.71,83861.8
2024-05-07,2024-05-07,Project payment - Customer_0021,REF64345043,0.0,88.56,83950.36
2024-05-07,2024-05-07,Project payment - Customer_0016,REF27666432,0.0,30.16,83980.52
2024-05-07,2024-05-07,Payment from Customer_0053,REF66643497,0.0,164.77,84145.29
2024-05-07,2024-05-07,Payment from Customer_0012,REF42165399,0.0,155.27,84300.56
2024-05-07,2024-05-07,Marketing expenses,REF12520047,355.34,0.0,83945.22
2024-05-07,2024-05-07,Service payment - Customer_0091,REF60751669,0.0,115.2,84060.42
2024-05-07,2024-05-07,Project payment - Customer_0034,REF71827146,0.0,12.27,84072.69
2024-05-07,2024-05-07,Service payment - Customer_0013,REF81610679,0.0,64.19,84136.88
2024-05-08,2024-05-08,Payment from Customer_0032,REF30254840,0.0,134.41,84271.29
2024-05-08,2024-05-08,Project payment - Customer_0040,REF55002850,0.0,129.9,84401.19
2024-05-08,2024-05-08,Invoice payment - Customer_0004,REF52915765,0.0,58.02,84459.21
2024-05-08,2024-05-08,Service payment - Customer_0054,REF18318889,0.0,25.14,84484.35
2024-05-08,2024-05-08,Service payment - Customer_0095,REF79645828,0.0,93.36,84577.71
2024-05-09,2024-05-09,Invoice payment - Customer_0013,REF65935783,0.0,56.93,84634.64
2024-05-09,2024-05-09,Service payment - Customer_0061,REF35455397,0.0,79.98,84714.62
2024-05-09,2024-05-09,Project payment - Customer_0074,REF38829833,0.0,56.65,84771.27
2024-05-09,2024-05-09,Payment from Customer_0063,REF58876364,0.0,110.2,84881.47
2024-05-09,2024-05-09,Service payment - Customer_0090,REF54208679,0.0,71.28,84952.75
2024-05-09,2024-05-09,Service payment - Customer_0036,REF45583105,0.0,55.23,85007.98
2024-05-10,2024-05-10,Invoice payment - Customer_0056,REF84106940,0.0,10.0,85017.98
2024-05-10,2024-05-10,Project payment - Customer_0067,REF69387268,0.0,47.77,85065.75
2024-05-10,2024-05-10,Invoice payment - Customer_0082,REF25029640,0.0,59.18,85124.93
2024-05-10,2024-05-10,Service payment - Customer_0023,REF26137133,0.0,62.34,85187.27
2024-05-10,2024-05-10,Project payment - Customer_0003,REF50607873,0.0,141.14,85328.41
2024-05-10,2024-05-10,Service payment - Customer_0092,REF33271579,0.0,156.68,85485.09
2024-05-10,2024-05-10,Project payment - Customer_0040,REF84195576,0.0,90.92,85576.01
2024-05-10,2024-05-10,Payment from Customer_0069,REF72480495,0.0,191.32,85767.33
2024-05-10,2024-05-10,Project payment - Customer_0057,REF88544882,0.0,46.93,85814.26
2024-05-10,2024-05-10,Service payment - Customer_0070,REF54141447,0.0,57.2,85871.46
2024-05-10,2024-05-10,Payment from Customer_0021,REF51638418,0.0,81.97,85953.43
2024-05-11,2024-05-11,Payment from Customer_0044,REF46289405,0.0,151.15,86104.58
2024-05-11,2024-05-11,Invoice payment - Customer_0002,REF81064338,0.0,54.36,86158.94
2024-05-11,2024-05-11,Project payment - Customer_0098,REF20503756,0.0,74.48,86233.42
2024-05-11,2024-05-11,Service payment - Customer_0097,REF84414356,0.0,62.66,86296.08
2024-05-11,2024-05-11,Project payment - Customer_0028,REF28194840,0.0,93.03,86389.11
2024-05-11,2024-05-11,Project payment - Customer_0037,REF62858489,0.0,126.13,86515.24
2024-05-11,2024-05-11,Payment from Customer_0049,REF41895428,0.0,57.05,86572.29
2024-05-11,2024-05-11,Project payment - Customer_0039,REF84598111,0.0,155.59,86727.88
2024-05-11,2024-05-11,Project payment - Customer_0067,REF93096595,0.0,59.09,86786.97
2024-05-11,2024-05-11,Invoice payment - Customer_0093,REF75413113,0.0,56.68,86843.65
2024-05-11,2024-05-11,Project payment - Customer_0069,REF51977854,0.0,205.42,87049.07
2024-05-12,2024-05-12,Professional Services expense,REF45626799,248.9,0.0,86800.17
2024-05-12,2024-05-12,Invoice payment - Customer_0098,REF28228853,0.0,82.17,86882.34
2024-05-12,2024-05-12,Payment from Customer_0077,REF83802036,0.0,97.43,86979.77
2024-05-12,2024-05-12,Payment from Customer_0054,REF54682073,0.0,24.72,87004.49
2024-05-12,2024-05-12,Invoice payment - Customer_0000,REF93212635,0.0,113.77,87118.26
2024-05-12,2024-05-12,Project payment - Customer_0033,REF72213928,0.0,84.45,87202.71
2024-05-12,2024-05-12,Service payment - Customer_0014,REF52211173,0.0,116.42,87319.13
2024-05-12,2024-05-12,Project payment - Customer_0043,REF98265168,0.0,65.51,87384.64
2024-05-12,2024-05-12,Service payment - Customer_0032,REF63656745,0.0,137.36,87522.0
2024-05-13,2024-05-13,Project payment - Customer_0098,REF48893739,0.0,112.32,87634.32
2024-05-13,2024-05-13,Payment from Customer_0068,REF81346694,0.0,98.19,87732.51
2024-05-13,2024-05-13,Service payment - Customer_0030,REF24743560,0.0,85.97,87818.48
2024-05-13,2024-05-13,Payment from Customer_0087,REF75075045,0.0,75.03,87893.51
2024-05-13,2024-05-13,Invoice payment - Customer_0036,REF74122421,0.0,60.73,87954.24
2024-05-13,2024-05-13,Invoice payment - Customer_0089,REF53546108,0.0,49.74,88003.98
2024-05-13,2024-05-13,Service payment - Customer_0039,REF97040690,0.0,158.64,88162.62
2024-05-13,2024-05-13,Payment from Customer_0027,REF20066594,0.0,64.83,88227.45
2024-05-13,2024-05-13,Project payment - Customer_0031,REF81377654,0.0,44.7,88272.15
2024-05-13,2024-05-13,Invoice payment - Customer_0034,REF50439812,0.0,12.88,88285.03
2024-05-14,2024-05-14,Service payment - Customer_0007,REF74152392,0.0,26.22,88311.25
2024-05-14,2024-05-14,Payment from Customer_0008,REF71507796,0.0,58.29,88369.54
2024-05-14,2024-05-14,Project payment - Customer_0084,REF11448899,0.0,45.57,88415.11
2024-05-14,2024-05-14,Service payment - Customer_0028,REF88208204,0.0,67.89,88483.0
2024-05-14,2024-05-14,Payment from Customer_0039,REF91308231,0.0,160.25,88643.25
2024-05-14,2024-05-14,Project payment - Customer_0050,REF59774508,0.0,74.56,88717.81
2024-05-14,2024-05-14,Invoice payment - Customer_0017,REF84754416,0.0,175.42,88893.23
2024-05-14,2024-05-14,Invoice payment - Customer_0023,REF96460220,0.0,82.22,88975.45
2024-05-14,2024-05-14,Service payment - Customer_0074,REF87726371,0.0,114.02,89089.47
2024-05-14,2024-05-14,Service payment - Customer_0012,REF56798467,0.0,132.43,89221.9
2024-05-14,2024-05-14,Service payment - Customer_0089,REF45964707,0.0,59.87,89281.77
2024-05-14,2024-05-14,Service payment - Customer_0067,REF89790114,0.0,54.98,89336.75
2024-05-14,2024-05-14,Invoice payment - Customer_0025,REF81298552,0.0,88.8,89425.55
2024-05-14,2024-05-14,Project payment - Customer_0042,REF48729264,0.0,120.65,89546.2
2024-05-14,2024-05-14,Payment from Customer_0027,REF10357759,0.0,122.19,89668.39
2024-05-15,2024-05-15,Service payment - Customer_0005,REF90838418,0.0,71.27,89739.66
2024-05-15,2024-05-15,Project payment - Customer_0027,REF60432590,0.0,113.67,89853.33
2024-05-15,2024-05-15,Project payment - Customer_0050,REF80974071,0.0,80.43,89933.76
2024-05-15,2024-05-15,Invoice payment - Customer_0022,REF73831804,0.0,68.17,90001.93
2024-05-15,2024-05-15,Invoice payment - Customer_0092,REF51246238,0.0,143.72,90145.65
2024-05-15,2024-05-15,Service payment - Customer_0031,REF48758025,0.0,35.28,90180.93
2024-05-15,2024-05-15,Service payment - Customer_0002,REF87638044,0.0,54.45,90235.38
2024-05-15,2024-05-15,Service payment - Customer_0007,REF87508360,0.0,28.62,90264.0
2024-05-15,2024-05-15,Payment from Customer_0071,REF30412214,0.0,34.4,90298.4
2024-05-15,2024-05-15,Invoice payment - Customer_0059,REF15441230,0.0,161.67,90460.07
2024-05-15,2024-05-15,Invoice payment - Customer_0016,REF16313673,0.0,26.86,90486.93
2024-05-15,2024-05-15,Business insurance premium,REF16994601,206.31,0.0,90280.62
2024-05-15,2024-05-15,Invoice payment - Customer_0075,REF60972482,0.0,77.19,90357.81
2024-05-15,2024-05-15,Project payment - Customer_0025,REF56690671,0.0,98.07,90455.88
2024-05-16,2024-05-16,Invoice payment - Customer_0034,REF80510596,0.0,12.39,90468.27
2024-05-16,2024-05-16,Payment from Customer_0045,REF66730138,0.0,80.6,90548.87
2024-05-16,2024-05-16,Project payment - Customer_0047,REF61721532,0.0,63.89,90612.76
2024-05-16,2024-05-16,Invoice payment - Customer_0012,REF53445176,0.0,139.45,90752.21
2024-05-16,2024-05-16,Invoice payment - Customer_0076,REF53494996,0.0,75.84,90828.05
2024-05-16,2024-05-16,Payment from Customer_0073,REF90275029,0.0,54.46,90882.51
2024-05-16,2024-05-16,Project payment - Customer_0009,REF34008666,0.0,186.39,91068.9
2024-05-16,2024-05-16,Payment from Customer_0021,REF40466345,0.0,73.15,91142.05
2024-05-16,2024-05-16,Service payment - Customer_0072,REF52401070,0.0,73.34,91215.39
2024-05-17,2024-05-17,Project payment - Customer_0093,REF16832309,0.0,57.51,91272.9
2024-05-17,2024-05-17,Payment from Customer_0026,REF61220115,0.0,104.15,91377.05
2024-05-17,2024-05-17,Service payment - Customer_0020,REF53274891,0.0,70.77,91447.82
2024-05-17,2024-05-17,Invoice payment - Customer_0045,REF30735498,0.0,101.21,91549.03
2024-05-17,2024-05-17,Project payment - Customer_0050,REF50428348,0.0,66.34,91615.37
2024-05-17,2024-05-17,Invoice payment - Customer_0038,REF84366623,0.0,38.34,91653.71
2024-05-17,2024-05-17,Project payment - Customer_0077,REF79523208,0.0,91.71,91745.42
2024-05-17,2024-05-17,Service payment - Customer_0048,REF80673523,0.0,127.7,91873.12
2024-05-18,2024-05-18,Service payment - Customer_0028,REF77334623,0.0,73.42,91946.54
2024-05-18,2024-05-18,Payment from Customer_0039,REF34233097,0.0,185.51,92132.05
2024-05-18,2024-05-18,Project payment - Customer_0004,REF31517612,0.0,64.67,92196.72
2024-05-18,2024-05-18,Service payment - Customer_0015,REF26213277,0.0,89.04,92285.76
2024-05-18,2024-05-18,Service payment - Customer_0046,REF30876722,0.0,60.07,92345.83
2024-05-18,2024-05-18,Service payment - Customer_0094,REF71562581,0.0,23.32,92369.15
2024-05-18,2024-05-18,Service payment - Customer_0007,REF18662618,0.0,20.69,92389.84
2024-05-18,2024-05-18,Project payment - Customer_0091,REF31986804,0.0,119.42,92509.26
2024-05-19,2024-05-19,Project payment - Customer_0072,REF98984616,0.0,76.01,92585.27
2024-05-19,2024-05-19,Invoice payment - Customer_0090,REF20410515,0.0,83.99,92669.26
2024-05-19,2024-05-19,Service payment - Customer_0044,REF11775047,0.0,131.27,92800.53
2024-05-19,2024-05-19,Project payment - Customer_0045,REF92225278,0.0,94.29,92894.82
2024-05-19,2024-05-19,Project payment - Customer_0091,REF46856158,0.0,76.62,92971.44
2024-05-19,2024-05-19,Payment from Customer_0051,REF66607734,0.0,85.41,93056.85
2024-05-19,2024-05-19,Invoice payment - Customer_0017,REF20090120,0.0,163.81,93220.66
2024-05-19,2024-05-19,Project payment - Customer_0005,REF94370360,0.0,57.32,93277.98
2024-05-20,2024-05-20,Marketing expenses,REF39035566,255.16,0.0,93022.82
2024-05-20,2024-05-20,Project payment - Customer_0038,REF95689919,0.0,75.0,93097.82
2024-05-20,2024-05-20,Service payment - Customer_0049,REF12716916,0.0,63.0,93160.82
2024-05-20,2024-05-20,Service payment - Customer_0073,REF28522995,0.0,42.14,93202.96
2024-05-20,2024-05-20,Project payment - Customer_0000,REF51218239,0.0,119.97,93322.93
2024-05-20,2024-05-20,Invoice payment - Customer_0090,REF70177821,0.0,75.06,93397.99
2024-05-20,2024-05-20,Employee payroll,REF39289149,2920.13,0.0,90477.86
2024-05-20,2024-05-20,Invoice payment - Customer_0013,REF76084860,0.0,61.92,90539.78
2024-05-20,2024-05-20,Invoice payment - Customer_0055,REF45999700,0.0,88.02,90627.8
2024-05-20,2024-05-20,Service payment - Customer_0066,REF13877684,0.0,141.06,90768.86
2024-05-20,2024-05-20,Project payment - Customer_0025,REF92348999,0.0,92.63,90861.49
2024-05-21,2024-05-21,Project payment - Customer_0074,REF30979066,0.0,97.91,90959.4
2024-05-21,2024-05-21,Invoice payment - Customer_0033,REF37878189,0.0,132.02,91091.42
2024-05-21,2024-05-21,Project payment - Customer_0078,REF78619863,0.0,56.24,91147.66
2024-05-21,2024-05-21,Project payment - Customer_0094,REF36376411,0.0,27.44,91175.1
2024-05-21,2024-05-21,Service payment - Customer_0073,REF82730870,0.0,51.71,91226.81
2024-05-21,2024-05-21,Service payment - Customer_0057,REF89327134,0.0,42.43,91269.24
2024-05-21,2024-05-21,Service payment - Customer_0006,REF12237944,0.0,11.8,91281.04
2024-05-21,2024-05-21,Invoice payment - Customer_0056,REF41014835,0.0,10.39,91291.43
2024-05-21,2024-05-21,Service payment - Customer_0070,REF25496450,0.0,51.3,91342.73
2024-05-22,2024-05-22,Payment from Customer_0061,REF39782557,0.0,63.42,91406.15
2024-05-22,2024-05-22,Project payment - Customer_0005,REF22102253,0.0,61.68,91467.83
2024-05-22,2024-05-22,Payment from Customer_0008,REF60680928,0.0,58.15,91525.98
2024-05-22,2024-05-22,Project payment - Customer_0068,REF26385343,0.0,145.68,91671.66
2024-05-22,2024-05-22,Utility bill payment,REF86591775,155.37,0.0,91516.29
2024-05-22,2024-05-22,Payment from Customer_0017,REF56794754,0.0,176.89,91693.18
2024-05-22,2024-05-22,Payment from Customer_0062,REF96006509,0.0,92.9,91786.08
2024-05-22,2024-05-22,Project payment - Customer_0002,REF50927506,0.0,55.65,91841.73
2024-05-22,2024-05-22,Project payment - Customer_0071,REF24237255,0.0,70.01,91911.74
2024-05-22,2024-05-22,Payment from Customer_0009,REF56720157,0.0,123.31,92035.05
2024-05-22,2024-05-22,Payment from Customer_0051,REF39554991,0.0,88.76,92123.81
2024-05-22,2024-05-22,Service payment - Customer_0077,REF83063883,0.0,103.61,92227.42
2024-05-23,2024-05-23,Payment from Customer_0067,REF26863338,0.0,48.15,92275.57
2024-05-23,2024-05-23,Project payment - Customer_0018,REF11523383,0.0,72.97,92348.54
2024-05-23,2024-05-23,Payment from Customer_0032,REF21935066,0.0,143.83,92492.37
2024-05-23,2024-05-23,Payment from Customer_0036,REF73691906,0.0,43.86,92536.23
2024-05-23,2024-05-23,Payment from Customer_0043,REF75910263,0.0,88.69,92624.92
2024-05-23,2024-05-23,Payment from Customer_0026,REF94961938,0.0,82.92,92707.84
2024-05-23,2024-05-23,Payment from Customer_0073,REF87396243,0.0,59.27,92767.11
2024-05-24,2024-05-24,Invoice payment - Customer_0002,REF20181593,0.0,48.3,92815.41
2024-05-24,2024-05-24,Payment from Customer_0066,REF61876226,0.0,130.99,92946.4
2024-05-24,2024-05-24,Invoice payment - Customer_0057,REF68739345,0.0,58.37,93004.77
2024-05-24,2024-05-24,Payment from Customer_0038,REF22590275,0.0,48.88,93053.65
2024-05-24,2024-05-24,Invoice payment - Customer_0072,REF28308457,0.0,88.35,93142.0
2024-05-24,2024-05-24,Project payment - Customer_0059,REF68653154,0.0,155.96,93297.96
2024-05-24,2024-05-24,Invoice payment - Customer_0025,REF83970464,0.0,120.24,93418.2
2024-05-24,2024-05-24,Invoice payment - Customer_0058,REF77391850,0.0,123.72,93541.92
2024-05-24,2024-05-24,Invoice payment - Customer_0006,REF43152430,0.0,15.75,93557.67
2024-05-24,2024-05-24,Invoice payment - Customer_0018,REF57630052,0.0,70.26,93627.93
2024-05-24,2024-05-24,Project payment - Customer_0003,REF61051131,0.0,137.58,93765.51
2024-05-24,2024-05-24,Payment from Customer_0097,REF60928665,0.0,66.41,93831.92
2024-05-25,2024-05-25,Service payment - Customer_0070,REF59781163,0.0,71.74,93903.66
2024-05-25,2024-05-25,Project payment - Customer_0080,REF91465093,0.0,110.97,94014.63
2024-05-25,2024-05-25,Payment from Customer_0046,REF49441976,0.0,60.06,94074.69
2024-05-25,2024-05-25,Payment from Customer_0020,REF44493412,0.0,79.52,94154.21
2024-05-25,2024-05-25,Payment from Customer_0007,REF21430017,0.0,28.81,94183.02
2024-05-25,2024-05-25,Invoice payment - Customer_0010,REF67438358,0.0,97.43,94280.45
2024-05-25,2024-05-25,Project payment - Customer_0082,REF77152123,0.0,48.31,94328.76
2024-05-25,2024-05-25,Payment from Customer_0063,REF90562958,0.0,108.93,94437.69
2024-05-25,2024-05-25,Invoice payment - Customer_0047,REF85621361,0.0,69.49,94507.18
2024-05-26,2024-05-26,Payment from Customer_0038,REF44857890,0.0,38.32,94545.5
2024-05-26,2024-05-26,Project payment - Customer_0041,REF11771274,0.0,50.95,94596.45
2024-05-26,2024-05-26,Service payment - Customer_0001,REF32651333,0.0,98.36,94694.81
2024-05-26,2024-05-26,Project payment - Customer_0094,REF45073701,0.0,27.27,94722.08
2024-05-26,2024-05-26,Invoice payment - Customer_0004,REF77616351,0.0,51.52,94773.6
2024-05-26,2024-05-26,Service payment - Customer_0079,REF24118720,0.0,143.02,94916.62
2024-05-26,2024-05-26,Payment from Customer_0081,REF31695118,0.0,92.74,95009.36
2024-05-27,2024-05-27,Service payment - Customer_0082,REF13071967,0.0,72.69,95082.05
2024-05-27,2024-05-27,Service payment - Customer_0007,REF40022835,0.0,27.79,95109.84
2024-05-27,2024-05-27,Invoice payment - Customer_0004,REF99878792,0.0,57.4,95167.24
2024-05-27,2024-05-27,Project payment - Customer_0009,REF24337980,0.0,163.57,95330.81
2024-05-27,2024-05-27,Service payment - Customer_0090,REF90074030,0.0,77.37,95408.18
2024-05-28,2024-05-28,Service payment - Customer_0077,REF26098098,0.0,63.78,95471.96
2024-05-28,2024-05-28,Payment from Customer_0071,REF78767568,0.0,50.59,95522.55
2024-05-28,2024-05-28,Service payment - Customer_0049,REF45659894,0.0,48.75,95571.3
2024-05-28,2024-05-28,Project payment - Customer_0044,REF83858817,0.0,155.71,95727.01
2024-05-28,2024-05-28,Payment from Customer_0006,REF12086886,0.0,15.18,95742.19
2024-05-28,2024-05-28,Project payment - Customer_0080,REF68788432,0.0,163.0,95905.19
2024-05-28,2024-05-28,Project payment - Customer_0035,REF23553552,0.0,94.63,95999.82
2024-05-29,2024-05-29,Payment from Customer_0053,REF26600456,0.0,191.35,96191.17
2024-05-29,2024-05-29,Invoice payment - Customer_0027,REF15178730,0.0,105.48,96296.65
2024-05-29,2024-05-29,Payment from Customer_0013,REF90039736,0.0,64.29,96360.94
2024-05-29,2024-05-29,Service payment - Customer_0023,REF75068266,0.0,58.52,96419.46
2024-05-29,2024-05-29,Payment from Customer_0025,REF54576470,0.0,104.6,96524.06
2024-05-29,2024-05-29,Invoice payment - Customer_0011,REF83414470,0.0,43.79,96567.85
2024-05-29,2024-05-29,Service payment - Customer_0093,REF37621159,0.0,32.85,96600.7
2024-05-30,2024-05-30,Inventory purchase,REF67123904,3672.09,0.0,92928.61
2024-05-30,2024-05-30,Invoice payment - Customer_0054,REF55294053,0.0,27.6,92956.21
2024-05-30,2024-05-30,Invoice payment - Customer_0076,REF70411219,0.0,91.53,93047.74
2024-05-30,2024-05-30,Payment from Customer_0044,REF87519650,0.0,156.47,93204.21
2024-05-30,2024-05-30,Service payment - Customer_0090,REF30404006,0.0,65.54,93269.75
2024-05-30,2024-05-30,Invoice payment - Customer_0096,REF48564496,0.0,38.87,93308.62
2024-05-30,2024-05-30,Invoice payment - Customer_0013,REF42499207,0.0,52.34,93360.96
2024-05-30,2024-05-30,Project payment - Customer_0075,REF52644273,0.0,77.65,93438.61
2024-05-30,2024-05-30,Service payment - Customer_0034,REF63311571,0.0,11.5,93450.11
2024-05-30,2024-05-30,Project payment - Customer_0041,REF30559588,0.0,49.06,93499.17
2024-05-30,2024-05-30,Invoice payment - Customer_0039,REF97782583,0.0,165.46,93664.63
2024-05-31,2024-05-31,Invoice payment - Customer_0095,REF22174261,0.0,90.12,93754.75
2024-05-31,2024-05-31,Payment from Customer_0078,REF58527190,0.0,70.43,93825.18
2024-05-31,2024-05-31,Payment from Customer_0059,REF69578787,0.0,124.82,93950.0
2024-05-31,2024-05-31,Invoice payment - Customer_0093,REF37242862,0.0,39.2,93989.2
2024-05-31,2024-05-31,Payment from Customer_0002,REF22778278,0.0,49.14,94038.34
2024-05-31,2024-05-31,Project payment - Customer_0060,REF14182814,0.0,87.61,94125.95
2024-05-31,2024-05-31,Service payment - Customer_0069,REF18946441,0.0,178.99,94304.94
2024-05-31,2024-05-31,Project payment - Customer_0030,REF87480351,0.0,79.61,94384.55
2024-06-01,2024-06-01,Monthly office rent,REF26244423,1073.26,0.0,93311.29
2024-06-01,2024-06-01,Invoice payment - Customer_0065,REF40505450,0.0,39.89,93351.18
2024-06-01,2024-06-01,Invoice payment - Customer_0066,REF74972042,0.0,105.77,93456.95
2024-06-01,2024-06-01,Service payment - Customer_0029,REF94902126,0.0,59.05,93516.0
2024-06-01,2024-06-01,Project payment - Customer_0073,REF94522465,0.0,52.43,93568.43
2024-06-01,2024-06-01,Project payment - Customer_0061,REF93210776,0.0,87.18,93655.61
2024-06-01,2024-06-01,Pos Systems expense,REF77769951,29.89,0.0,93625.72
2024-06-01,2024-06-01,Invoice payment - Customer_0001,REF12329848,0.0,76.62,93702.34
2024-06-01,2024-06-01,Payment from Customer_0087,REF18079202,0.0,84.68,93787.02
2024-06-01,2024-06-01,Project payment - Customer_0052,REF87096419,0.0,79.87,93866.89
2024-06-01,2024-06-01,Payment from Customer_0008,REF11297287,0.0,49.29,93916.18
2024-06-01,2024-06-01,Service payment - Customer_0046,REF95979271,0.0,49.37,93965.55
2024-06-01,2024-06-01,Payment from Customer_0048,REF16179813,0.0,77.46,94043.01
2024-06-02,2024-06-02,Invoice payment - Customer_0027,REF64656182,0.0,101.7,94144.71
2024-06-02,2024-06-02,Payment from Customer_0087,REF35099895,0.0,80.17,94224.88
2024-06-02,2024-06-02,Service payment - Customer_0082,REF34704149,0.0,51.45,94276.33
2024-06-02,2024-06-02,Project payment - Customer_0020,REF44617467,0.0,64.89,94341.22
2024-06-02,2024-06-02,Service payment - Customer_0047,REF49104008,0.0,63.9,94405.12
2024-06-02,2024-06-02,Payment from Customer_0002,REF55796295,0.0,45.59,94450.71
2024-06-02,2024-06-02,Project payment - Customer_0054,REF15991213,0.0,27.79,94478.5
2024-06-02,2024-06-02,Project payment - Customer_0013,REF21572916,0.0,41.99,94520.49
2024-06-02,2024-06-02,Project payment - Customer_0046,REF48133506,0.0,56.18,94576.67
2024-06-03,2024-06-03,Payment from Customer_0044,REF14913531,0.0,125.21,94701.88
2024-06-03,2024-06-03,Service payment - Customer_0057,REF63741060,0.0,32.2,94734.08
2024-06-03,2024-06-03,Payment from Customer_0016,REF44701998,0.0,23.95,94758.03
2024-06-03,2024-06-03,Project payment - Customer_0078,REF31664483,0.0,40.07,94798.1
2024-06-03,2024-06-03,Payment from Customer_0021,REF39814329,0.0,75.63,94873.73
2024-06-03,2024-06-03,Service payment - Customer_0076,REF92110409,0.0,95.66,94969.39
2024-06-03,2024-06-03,Project payment - Customer_0041,REF36826476,0.0,59.84,95029.23
2024-06-03,2024-06-03,Payment from Customer_0036,REF33453894,0.0,49.22,95078.45
2024-06-03,2024-06-03,Service payment - Customer_0031,REF89597381,0.0,28.8,95107.25
2024-06-03,2024-06-03,Payment from Customer_0087,REF41733730,0.0,85.8,95193.05
2024-06-03,2024-06-03,Invoice payment - Customer_0048,REF79329817,0.0,86.2,95279.25
2024-06-03,2024-06-03,Invoice payment - Customer_0092,REF49047770,0.0,129.72,95408.97
2024-06-03,2024-06-03,Service payment - Customer_0061,REF98029115,0.0,82.23,95491.2
2024-06-03,2024-06-03,Service payment - Customer_0082,REF42116946,0.0,74.01,95565.21
2024-06-03,2024-06-03,Project payment - Customer_0079,REF78328567,0.0,137.1,95702.31
2024-06-03,2024-06-03,Invoice payment - Customer_0073,REF10798960,0.0,52.61,95754.92
2024-06-04,2024-06-04,Project payment - Customer_0061,REF32829906,0.0,85.99,95840.91
2024-06-04,2024-06-04,Project payment - Customer_0008,REF14337166,0.0,44.93,95885.84
2024-06-04,2024-06-04,Service payment - Customer_0029,REF67913791,0.0,64.88,95950.72
2024-06-04,2024-06-04,Payment from Customer_0086,REF88823161,0.0,58.7,96009.42
2024-06-04,2024-06-04,Payment from Customer_0055,REF77514113,0.0,86.53,96095.95
2024-06-04,2024-06-04,Service payment - Customer_0083,REF83354678,0.0,34.08,96130.03
2024-06-04,2024-06-04,Invoice payment - Customer_0002,REF14836301,0.0,47.58,96177.61
2024-06-05,2024-06-05,Service payment - Customer_0055,REF94902212,0.0,97.01,96274.62
2024-06-05,2024-06-05,Service payment - Customer_0038,REF86214050,0.0,45.42,96320.04
2024-06-05,2024-06-05,Payment from Customer_0035,REF74327057,0.0,78.98,96399.02
2024-06-05,2024-06-05,Invoice payment - Customer_0028,REF79893528,0.0,80.95,96479.97
2024-06-05,2024-06-05,Invoice payment - Customer_0041,REF70360876,0.0,58.72,96538.69
2024-06-05,2024-06-05,Project payment - Customer_0069,REF41432885,0.0,144.34,96683.03
2024-06-05,2024-06-05,Project payment - Customer_0087,REF87545355,0.0,80.33,96763.36
2024-06-05,2024-06-05,Project payment - Customer_0049,REF25662830,0.0,46.98,96810.34
2024-06-05,2024-06-05,Payment from Customer_0095,REF75161760,0.0,77.18,96887.52
2024-06-05,2024-06-05,Project payment - Customer_0020,REF55247787,0.0,47.71,96935.23
2024-06-06,2024-06-06,Payment from Customer_0050,REF83951344,0.0,69.06,97004.29
2024-06-06,2024-06-06,Service payment - Customer_0049,REF47844750,0.0,43.93,97048.22
2024-06-06,2024-06-06,Invoice payment - Customer_0010,REF38780885,0.0,120.64,97168.86
2024-06-06,2024-06-06,Payment from Customer_0053,REF51418729,0.0,132.58,97301.44
2024-06-06,2024-06-06,Project payment - Customer_0037,REF46529439,0.0,131.18,97432.62
2024-06-06,2024-06-06,Service payment - Customer_0048,REF25081415,0.0,88.19,97520.81
2024-06-06,2024-06-06,Project payment - Customer_0013,REF17774782,0.0,46.64,97567.45
2024-06-06,2024-06-06,Project payment - Customer_0034,REF80725067,0.0,10.0,97577.45
2024-06-06,2024-06-06,Project payment - Customer_0088,REF38474198,0.0,13.91,97591.36
2024-06-06,2024-06-06,Invoice payment - Customer_0082,REF94507627,0.0,59.03,97650.39
2024-06-06,2024-06-06,Project payment - Customer_0029,REF79726693,0.0,68.64,97719.03
2024-06-06,2024-06-06,Project payment - Customer_0004,REF20646271,0.0,50.85,97769.88
2024-06-06,2024-06-06,Invoice payment - Customer_0005,REF97896236,0.0,56.29,97826.17
2024-06-06,2024-06-06,Service payment - Customer_0019,REF65999538,0.0,46.58,97872.75
2024-06-06,2024-06-06,Project payment - Customer_0077,REF77977911,0.0,79.3,97952.05
2024-06-06,2024-06-06,Invoice payment - Customer_0017,REF98852379,0.0,146.13,98098.18
2024-06-06,2024-06-06,Invoice payment - Customer_0057,REF81393914,0.0,42.48,98140.66
2024-06-07,2024-06-07,Project payment - Customer_0086,REF25941104,0.0,101.89,98242.55
2024-06-07,2024-06-07,Payment from Customer_0024,REF73974297,0.0,155.52,98398.07
2024-06-07,2024-06-07,Project payment - Customer_0063,REF41653280,0.0,89.53,98487.6
2024-06-07,2024-06-07,Project payment - Customer_0060,REF17333198,0.0,72.66,98560.26
2024-06-07,2024-06-07,Service payment - Customer_0026,REF29916496,0.0,69.56,98629.82
2024-06-07,2024-06-07,Invoice payment - Customer_0023,REF53393141,0.0,55.88,98685.7
2024-06-07,2024-06-07,Service payment - Customer_0087,REF83908280,0.0,91.21,98776.91
2024-06-07,2024-06-07,Project payment - Customer_0076,REF99640270,0.0,52.66,98829.57
2024-06-07,2024-06-07,Service payment - Customer_0022,REF18099917,0.0,88.34,98917.91
2024-06-07,2024-06-07,Invoice payment - Customer_0050,REF62359325,0.0,67.73,98985.64
2024-06-07,2024-06-07,Project payment - Customer_0043,REF99347128,0.0,57.2,99042.84
2024-06-07,2024-06-07,Payment from Customer_0033,REF99128628,0.0,100.71,99143.55
2024-06-07,2024-06-07,Project payment - Customer_0001,REF69607438,0.0,77.57,99221.12
2024-06-07,2024-06-07,Service payment - Customer_0092,REF87180186,0.0,96.42,99317.54
2024-06-07,2024-06-07,Invoice payment - Customer_0039,REF66611694,0.0,132.8,99450.34
2024-06-07,2024-06-07,Service payment - Customer_0084,REF52638013,0.0,41.64,99491.98
2024-06-07,2024-06-07,Payment from Customer_0051,REF80336200,0.0,67.9,99559.88
2024-06-07,2024-06-07,Service payment - Customer_0085,REF21715632,0.0,74.7,99634.58
2024-06-08,2024-06-08,Service payment - Customer_0006,REF13993604,0.0,12.46,99647.04
2024-06-08,2024-06-08,Invoice payment - Customer_0056,REF38480084,0.0,10.0,99657.04
2024-06-08,2024-06-08,Payment from Customer_0007,REF65996316,0.0,23.44,99680.48
2024-06-08,2024-06-08,Payment from Customer_0018,REF19874913,0.0,74.09,99754.57
2024-06-08,2024-06-08,Invoice payment - Customer_0017,REF57134519,0.0,174.61,99929.18
2024-06-08,2024-06-08,Invoice payment - Customer_0049,REF69240882,0.0,38.27,99967.45
2024-06-08,2024-06-08,Invoice payment - Customer_0035,REF71523521,0.0,62.91,100030.36
2024-06-09,2024-06-09,Service payment - Customer_0040,REF30100661,0.0,115.23,100145.59
2024-06-09,2024-06-09,Payment from Customer_0030,REF92410587,0.0,89.31,100234.9
2024-06-09,2024-06-09,Invoice payment - Customer_0051,REF37417694,0.0,64.78,100299.68
2024-06-09,2024-06-09,Invoice payment - Customer_0016,REF76868756,0.0,31.31,100330.99
2024-06-09,2024-06-09,Invoice payment - Customer_0095,REF63751909,0.0,90.61,100421.6
2024-06-09,2024-06-09,Invoice payment - Customer_0008,REF95338700,0.0,60.63,100482.23
2024-06-09,2024-06-09,Service payment - Customer_0002,REF60078292,0.0,50.8,100533.03
2024-06-09,2024-06-09,Payment from Customer_0056,REF20829252,0.0,10.0,100543.03
2024-06-09,2024-06-09,Invoice payment - Customer_0000,REF33326741,0.0,102.09,100645.12
2024-06-09,2024-06-09,Service payment - Customer_0037,REF32225028,0.0,123.28,100768.4
2024-06-10,2024-06-10,Project payment - Customer_0020,REF55459130,0.0,69.35,100837.75
2024-06-10,2024-06-10,Project payment - Customer_0054,REF75945515,0.0,19.95,100857.7
2024-06-10,2024-06-10,Payment from Customer_0029,REF45613961,0.0,68.58,100926.28
2024-06-10,2024-06-10,Invoice payment - Customer_0096,REF76877906,0.0,51.22,100977.5
2024-06-10,2024-06-10,Payment from Customer_0071,REF50011299,0.0,51.09,101028.59
2024-06-10,2024-06-10,Payment from Customer_0038,REF20003766,0.0,50.57,101079.16
2024-06-10,2024-06-10,Payment from Customer_0001,REF54648014,0.0,58.39,101137.55
2024-06-10,2024-06-10,Service payment - Customer_0009,REF28937860,0.0,133.13,101270.68
2024-06-10,2024-06-10,Payment from Customer_0084,REF11368474,0.0,37.96,101308.64
2024-06-10,2024-06-10,Project payment - Customer_0095,REF19439658,0.0,90.56,101399.2
2024-06-11,2024-06-11,Service payment - Customer_0004,REF20019599,0.0,48.74,101447.94
2024-06-11,2024-06-11,Project payment - Customer_0072,REF11466378,0.0,74.97,101522.91
2024-06-11,2024-06-11,Project payment - Customer_0037,REF87897658,0.0,131.8,101654.71
2024-06-11,2024-06-11,Invoice payment - Customer_0019,REF25466127,0.0,44.56,101699.27
2024-06-11,2024-06-11,Service payment - Customer_0063,REF34918998,0.0,113.68,101812.95
2024-06-11,2024-06-11,Payment from Customer_0012,REF41100375,0.0,111.48,101924.43
2024-06-11,2024-06-11,Invoice payment - Customer_0020,REF59213659,0.0,65.47,101989.9
2024-06-11,2024-06-11,Service payment - Customer_0066,REF27234169,0.0,87.31,102077.21
2024-06-11,2024-06-11,Project payment - Customer_0096,REF68602781,0.0,38.44,102115.65
2024-06-11,2024-06-11,Invoice payment - Customer_0036,REF50972339,0.0,49.98,102165.63
2024-06-12,2024-06-12,Project payment - Customer_0026,REF24562050,0.0,83.29,102248.92
2024-06-12,2024-06-12,Service payment - Customer_0006,REF42656483,0.0,16.42,102265.34
2024-06-12,2024-06-12,Invoice payment - Customer_0078,REF33767404,0.0,47.74,102313.08
2024-06-12,2024-06-12,Project payment - Customer_0080,REF82159227,0.0,120.24,102433.32
2024-06-12,2024-06-12,Payment from Customer_0086,REF69853975,0.0,81.71,102515.03
2024-06-12,2024-06-12,Invoice payment - Customer_0028,REF82990620,0.0,93.0,102608.03
2024-06-12,2024-06-12,Invoice payment - Customer_0027,REF13782951,0.0,118.02,102726.05
2024-06-12,2024-06-12,Invoice payment - Customer_0035,REF23233762,0.0,71.32,102797.37
2024-06-12,2024-06-12,Service payment - Customer_0056,REF39255984,0.0,10.0,102807.37
2024-06-13,2024-06-13,Invoice payment - Customer_0082,REF88563128,0.0,40.17,102847.54
2024-06-13,2024-06-13,Service payment - Customer_0052,REF70880621,0.0,94.11,102941.65
2024-06-13,2024-06-13,Service payment - Customer_0041,REF46389234,0.0,63.4,103005.05
2024-06-13,2024-06-13,Payment from Customer_0021,REF28245042,0.0,77.34,103082.39
2024-06-13,2024-06-13,Payment from Customer_0091,REF16866761,0.0,83.34,103165.73
2024-06-13,2024-06-13,Invoice payment - Customer_0051,REF30042480,0.0,77.67,103243.4
2024-06-13,2024-06-13,Invoice payment - Customer_0034,REF86796960,0.0,10.0,103253.4
2024-06-13,2024-06-13,Invoice payment - Customer_0011,REF77430473,0.0,26.71,103280.11
2024-06-13,2024-06-13,Payment from Customer_0055,REF64378992,0.0,72.28,103352.39
2024-06-13,2024-06-13,Payment from Customer_0012,REF73867501,0.0,88.59,103440.98
2024-06-13,2024-06-13,Project payment - Customer_0061,REF91831754,0.0,85.7,103526.68
2024-06-13,2024-06-13,Payment from Customer_0023,REF47864101,0.0,60.46,103587.14
2024-06-13,2024-06-13,Payment from Customer_0057,REF76025801,0.0,27.45,103614.59
2024-06-13,2024-06-13,Invoice payment - Customer_0030,REF29785907,0.0,79.67,103694.26
2024-06-14,2024-06-14,Project payment - Customer_0071,REF85073003,0.0,41.39,103735.65
2024-06-14,2024-06-14,Invoice payment - Customer_0077,REF36476993,0.0,64.28,103799.93
2024-06-14,2024-06-14,Payment from Customer_0011,REF93740649,0.0,40.73,103840.66
2024-06-14,2024-06-14,Project payment - Customer_0086,REF25260347,0.0,100.15,103940.81
2024-06-14,2024-06-14,Service payment - Customer_0010,REF99450708,0.0,97.81,104038.62
2024-06-14,2024-06-14,Service payment - Customer_0069,REF73073336,0.0,166.18,104204.8
2024-06-14,2024-06-14,Project payment - Customer_0013,REF39770045,0.0,41.97,104246.77
2024-06-14,2024-06-14,Payment from Customer_0088,REF13268149,0.0,10.77,104257.54
2024-06-14,2024-06-14,Service payment - Customer_0082,REF65368246,0.0,44.39,104301.93
2024-06-14,2024-06-14,Payment from Customer_0040,REF63801684,0.0,98.75,104400.68
2024-06-15,2024-06-15,Payment from Customer_0078,REF92147007,0.0,70.41,104471.09
2024-06-15,2024-06-15,Service payment - Customer_0059,REF51524899,0.0,154.94,104626.03
2024-06-15,2024-06-15,Invoice payment - Customer_0008,REF43889548,0.0,52.34,104678.37
2024-06-15,2024-06-15,Payment from Customer_0081,REF20941987,0.0,104.43,104782.8
2024-06-15,2024-06-15,Project payment - Customer_0019,REF29973298,0.0,50.14,104832.94
2024-06-15,2024-06-15,Project payment - Customer_0086,REF25713976,0.0,75.43,104908.37
2024-06-15,2024-06-15,Payment from Customer_0050,REF15505382,0.0,60.16,104968.53
2024-06-15,2024-06-15,Invoice payment - Customer_0052,REF23807050,0.0,96.95,105065.48
2024-06-15,2024-06-15,Invoice payment - Customer_0023,REF22886503,0.0,50.73,105116.21
2024-06-15,2024-06-15,Business insurance premium,REF64531834,195.1,0.0,104921.11
2024-06-15,2024-06-15,Service payment - Customer_0062,REF64878037,0.0,88.38,105009.49
2024-06-15,2024-06-15,Payment from Customer_0037,REF18266066,0.0,121.68,105131.17
2024-06-16,2024-06-16,Project payment - Customer_0090,REF74028406,0.0,68.84,105200.01
2024-06-16,2024-06-16,Service payment - Customer_0045,REF93291346,0.0,102.32,105302.33
2024-06-16,2024-06-16,Invoice payment - Customer_0059,REF26343580,0.0,134.56,105436.89
2024-06-16,2024-06-16,Project payment - Customer_0016,REF77238538,0.0,27.1,105463.99
2024-06-16,2024-06-16,Payment from Customer_0028,REF68143513,0.0,80.69,105544.68
2024-06-17,2024-06-17,Project payment - Customer_0089,REF59846655,0.0,63.27,105607.95
2024-06-17,2024-06-17,Project payment - Customer_0072,REF28174853,0.0,50.15,105658.1
2024-06-17,2024-06-17,Payment from Customer_0013,REF43929225,0.0,67.93,105726.03
2024-06-17,2024-06-17,Project payment - Customer_0087,REF65729507,0.0,105.55,105831.58
2024-06-17,2024-06-17,Service payment - Customer_0003,REF46463824,0.0,111.44,105943.02
2024-06-17,2024-06-17,Invoice payment - Customer_0086,REF26730859,0.0,66.86,106009.88
2024-06-17,2024-06-17,Payment from Customer_0025,REF30922110,0.0,91.88,106101.76
2024-06-17,2024-06-17,Project payment - Customer_0073,REF23787936,0.0,39.61,106141.37
2024-06-17,2024-06-17,Payment from Customer_0024,REF45334791,0.0,121.42,106262.79
2024-06-17,2024-06-17,Service payment - Customer_0051,REF87171906,0.0,81.54,106344.33
2024-06-18,2024-06-18,Payment from Customer_0094,REF32498886,0.0,21.02,106365.35
2024-06-18,2024-06-18,Service payment - Customer_0021,REF28696210,0.0,82.57,106447.92
2024-06-18,2024-06-18,Project payment - Customer_0025,REF86114548,0.0,87.32,106535.24
2024-06-18,2024-06-18,Service payment - Customer_0064,REF47521198,0.0,43.21,106578.45
2024-06-19,2024-06-19,Payment from Customer_0086,REF21510314,0.0,73.01,106651.46
2024-06-19,2024-06-19,Invoice payment - Customer_0064,REF40422101,0.0,52.98,106704.44
2024-06-19,2024-06-19,Project payment - Customer_0085,REF88783530,0.0,43.96,106748.4
2024-06-19,2024-06-19,Payment from Customer_0083,REF75451211,0.0,33.01,106781.41
2024-06-19,2024-06-19,Payment from Customer_0077,REF94112094,0.0,69.18,106850.59
2024-06-19,2024-06-19,Payment from Customer_0052,REF54134978,0.0,87.55,106938.14
2024-06-19,2024-06-19,Payment from Customer_0066,REF71438539,0.0,106.42,107044.56
2024-06-20,2024-06-20,Service payment - Customer_0078,REF26094249,0.0,48.56,107093.12
2024-06-20,2024-06-20,Invoice payment - Customer_0008,REF95490325,0.0,50.37,107143.49
2024-06-20,2024-06-20,Service payment - Customer_0089,REF96508561,0.0,50.84,107194.33
2024-06-20,2024-06-20,Project payment - Customer_0025,REF86912743,0.0,79.16,107273.49
2024-06-20,2024-06-20,Payment from Customer_0039,REF61720086,0.0,143.11,107416.6
2024-06-20,2024-06-20,Payment from Customer_0047,REF53744375,0.0,66.56,107483.16
2024-06-20,2024-06-20,Invoice payment - Customer_0000,REF23218949,0.0,120.57,107603.73
2024-06-20,2024-06-20,Service payment - Customer_0053,REF73855643,0.0,199.44,107803.17
2024-06-20,2024-06-20,Project payment - Customer_0001,REF19219900,0.0,90.77,107893.94
2024-06-20,2024-06-20,Payment from Customer_0056,REF18850631,0.0,10.29,107904.23
2024-06-20,2024-06-20,Project payment - Customer_0074,REF58242333,0.0,91.74,107995.97
2024-06-20,2024-06-20,Invoice payment - Customer_0063,REF20739385,0.0,107.31,108103.28
2024-06-20,2024-06-20,Project payment - Customer_0087,REF84883470,0.0,85.23,108188.51
2024-06-20,2024-06-20,Invoice payment - Customer_0035,REF32891466,0.0,60.57,108249.08
2024-06-20,2024-06-20,Payment from Customer_0049,REF58304399,0.0,41.33,108290.41
2024-06-21,2024-06-21,Payment from Customer_0039,REF23665259,0.0,147.67,108438.08
2024-06-21,2024-06-21,Project payment - Customer_0042,REF30091921,0.0,113.41,108551.49
2024-06-21,2024-06-21,Service payment - Customer_0041,REF17058930,0.0,50.18,108601.67
2024-06-21,2024-06-21,Payment from Customer_0007,REF34590584,0.0,20.87,108622.54
2024-06-21,2024-06-21,Professional Services expense,REF58621747,137.72,0.0,108484.82
2024-06-21,2024-06-21,Project payment - Customer_0018,REF46705062,0.0,58.45,108543.27
2024-06-21,2024-06-21,Invoice payment - Customer_0035,REF43974937,0.0,78.32,108621.59
2024-06-21,2024-06-21,Service payment - Customer_0089,REF48069239,0.0,75.03,108696.62
2024-06-21,2024-06-21,Invoice payment - Customer_0090,REF42814734,0.0,69.42,108766.04
2024-06-21,2024-06-21,Invoice payment - Customer_0060,REF90168439,0.0,93.21,108859.25
2024-06-22,2024-06-22,Invoice payment - Customer_0032,REF28543939,0.0,102.25,108961.5
2024-06-22,2024-06-22,Project payment - Customer_0024,REF71252108,0.0,99.95,109061.45
2024-06-22,2024-06-22,Project payment - Customer_0022,REF18633497,0.0,59.93,109121.38
2024-06-22,2024-06-22,Invoice payment - Customer_0085,REF30909404,0.0,66.08,109187.46
2024-06-22,2024-06-22,Payment from Customer_0005,REF28467439,0.0,65.31,109252.77
2024-06-22,2024-06-22,Payment from Customer_0076,REF17513191,0.0,82.54,109335.31
2024-06-22,2024-06-22,Project payment - Customer_0053,REF66126265,0.0,166.08,109501.39
2024-06-22,2024-06-22,Invoice payment - Customer_0023,REF85251943,0.0,60.25,109561.64
2024-06-22,2024-06-22,Payment from Customer_0055,REF99658942,0.0,84.04,109645.68
2024-06-22,2024-06-22,Utility bill payment,REF60050436,143.03,0.0,109502.65
2024-06-22,2024-06-22,Payment from Customer_0036,REF99689351,0.0,46.85,109549.5
2024-06-22,2024-06-22,Service payment - Customer_0020,REF74553616,0.0,57.02,109606.52
2024-06-22,2024-06-22,Invoice payment - Customer_0034,REF89498209,0.0,10.0,109616.52
2024-06-23,2024-06-23,Invoice payment - Customer_0054,REF91252173,0.0,23.03,109639.55
2024-06-23,2024-06-23,Payment from Customer_0067,REF72197391,0.0,42.33,109681.88
2024-06-23,2024-06-23,Invoice payment - Customer_0098,REF41195180,0.0,92.35,109774.23
2024-06-23,2024-06-23,Service payment - Customer_0025,REF68683737,0.0,76.95,109851.18
2024-06-23,2024-06-23,Service payment - Customer_0051,REF35158385,0.0,57.23,109908.41
2024-06-23,2024-06-23,Payment from Customer_0071,REF83941784,0.0,74.57,109982.98
2024-06-23,2024-06-23,Service payment - Customer_0021,REF94063124,0.0,78.35,110061.33
2024-06-23,2024-06-23,Service payment - Customer_0005,REF85543711,0.0,73.58,110134.91
2024-06-23,2024-06-23,Payment from Customer_0072,REF89478309,0.0,81.16,110216.07
2024-06-23,2024-06-23,Payment from Customer_0097,REF71027055,0.0,58.08,110274.15
2024-06-23,2024-06-23,Project payment - Customer_0091,REF38127934,0.0,117.41,110391.56
2024-06-24,2024-06-24,Service payment - Customer_0040,REF96764626,0.0,87.0,110478.56
2024-06-24,2024-06-24,Employee payroll,REF31666631,2452.37,0.0,108026.19
2024-06-24,2024-06-24,Invoice payment - Customer_0068,REF70718807,0.0,85.6,108111.79
2024-06-24,2024-06-24,Service payment - Customer_0067,REF27579514,0.0,46.22,108158.01
2024-06-24,2024-06-24,Payment from Customer_0052,REF75894727,0.0,97.56,108255.57
2024-06-24,2024-06-24,Invoice payment - Customer_0054,REF63179064,0.0,25.67,108281.24
2024-06-25,2024-06-25,Invoice payment - Customer_0084,REF32491034,0.0,57.9,108339.14
2024-06-25,2024-06-25,Invoice payment - Customer_0071,REF78407643,0.0,53.02,108392.16
2024-06-25,2024-06-25,Invoice payment - Customer_0076,REF26827351,0.0,89.2,108481.36
2024-06-25,2024-06-25,Service payment - Customer_0070,REF15788977,0.0,49.49,108530.85
2024-06-25,2024-06-25,Invoice payment - Customer_0060,REF91000363,0.0,88.11,108618.96
2024-06-25,2024-06-25,Project payment - Customer_0020,REF20361979,0.0,50.65,108669.61
2024-06-26,2024-06-26,Service payment - Customer_0019,REF20773059,0.0,48.53,108718.14
2024-06-26,2024-06-26,Project payment - Customer_0034,REF26167536,0.0,10.0,108728.14
2024-06-26,2024-06-26,Invoice payment - Customer_0074,REF79829088,0.0,80.0,108808.14
2024-06-26,2024-06-26,Service payment - Customer_0002,REF36718025,0.0,38.07,108846.21
2024-06-26,2024-06-26,Service payment - Customer_0098,REF31024646,0.0,58.42,108904.63
2024-06-26,2024-06-26,Invoice payment - Customer_0010,REF89019892,0.0,136.1,109040.73
2024-06-26,2024-06-26,Service payment - Customer_0053,REF47104000,0.0,145.15,109185.88
2024-06-26,2024-06-26,Project payment - Customer_0050,REF23640079,0.0,70.85,109256.73
2024-06-27,2024-06-27,Project payment - Customer_0005,REF94141699,0.0,44.19,109300.92
2024-06-27,2024-06-27,Service payment - Customer_0039,REF53710025,0.0,92.69,109393.61
2024-06-27,2024-06-27,Project payment - Customer_0066,REF16898810,0.0,120.61,109514.22
2024-06-27,2024-06-27,Payment from Customer_0026,REF15689149,0.0,89.68,109603.9
2024-06-27,2024-06-27,Project payment - Customer_0086,REF99922294,0.0,65.45,109669.35
2024-06-27,2024-06-27,Project payment - Customer_0041,REF74069685,0.0,39.79,109709.14
2024-06-27,2024-06-27,Service payment - Customer_0046,REF82236127,0.0,41.99,109751.13
2024-06-27,2024-06-27,Project payment - Customer_0087,REF67106757,0.0,100.88,109852.01
2024-06-27,2024-06-27,Service payment - Customer_0090,REF13429365,0.0,57.96,109909.97
2024-06-27,2024-06-27,Invoice payment - Customer_0031,REF22013303,0.0,28.41,109938.38
2024-06-28,2024-06-28,Project payment - Customer_0049,REF87628485,0.0,44.74,109983.12
2024-06-28,2024-06-28,Payment from Customer_0009,REF84109345,0.0,180.71,110163.83
2024-06-28,2024-06-28,Project payment - Customer_0043,REF52164955,0.0,48.54,110212.37
2024-06-28,2024-06-28,Project payment - Customer_0090,REF45833241,0.0,68.87,110281.24
2024-06-28,2024-06-28,Invoice payment - Customer_0097,REF99452369,0.0,59.48,110340.72
2024-06-28,2024-06-28,Invoice payment - Customer_0091,REF73040338,0.0,77.81,110418.53
2024-06-28,2024-06-28,Service payment - Customer_0075,REF93729855,0.0,72.3,110490.83
2024-06-28,2024-06-28,Service payment - Customer_0076,REF74767093,0.0,70.3,110561.13
2024-06-28,2024-06-28,Invoice payment - Customer_0095,REF97657281,0.0,78.78,110639.91
2024-06-28,2024-06-28,Project payment - Customer_0096,REF82663108,0.0,32.86,110672.77
2024-06-28,2024-06-28,Payment from Customer_0048,REF16963610,0.0,81.57,110754.34
2024-06-29,2024-06-29,Service payment - Customer_0065,REF41389177,0.0,43.01,110797.35
2024-06-29,2024-06-29,Service payment - Customer_0050,REF87229632,0.0,60.99,110858.34
2024-06-29,2024-06-29,Project payment - Customer_0056,REF90363506,0.0,11.38,110869.72
2024-06-29,2024-06-29,Service payment - Customer_0084,REF40111550,0.0,50.65,110920.37
2024-06-29,2024-06-29,Project payment - Customer_0005,REF96824214,0.0,71.51,110991.88
2024-06-29,2024-06-29,Payment from Customer_0085,REF31240730,0.0,65.69,111057.57
2024-06-29,2024-06-29,Invoice payment - Customer_0099,REF10548882,0.0,48.68,111106.25
2024-06-29,2024-06-29,Service payment - Customer_0082,REF56017920,0.0,58.54,111164.79
2024-06-29,2024-06-29,Service payment - Customer_0072,REF75922654,0.0,90.11,111254.9
2024-06-29,2024-06-29,Payment from Customer_0016,REF60721891,0.0,35.12,111290.02
2024-06-30,2024-06-30,Invoice payment - Customer_0019,REF51602552,0.0,47.72,111337.74
2024-06-30,2024-06-30,Payment from Customer_0010,REF26026719,0.0,97.8,111435.54
2024-06-30,2024-06-30,Service payment - Customer_0046,REF49528851,0.0,48.36,111483.9
2024-06-30,2024-06-30,Invoice payment - Customer_0093,REF10521852,0.0,54.52,111538.42
2024-06-30,2024-06-30,Payment from Customer_0009,REF29610234,0.0,122.23,111660.65
2024-07-01,2024-07-01,Service payment - Customer_0053,REF78632198,0.0,155.84,111816.49
2024-07-01,2024-07-01,Project payment - Customer_0089,REF45928198,0.0,48.52,111865.01
2024-07-01,2024-07-01,Service payment - Customer_0091,REF42948374,0.0,104.91,111969.92
2024-07-01,2024-07-01,Invoice payment - Customer_0093,REF15384271,0.0,50.65,112020.57
2024-07-01,2024-07-01,Monthly office rent,REF36760144,1233.22,0.0,110787.35
2024-07-01,2024-07-01,Invoice payment - Customer_0044,REF97065863,0.0,140.93,110928.28
2024-07-01,2024-07-01,Service payment - Customer_0094,REF86498265,0.0,21.76,110950.04
2024-07-01,2024-07-01,Invoice payment - Customer_0070,REF31286583,0.0,34.68,110984.72
2024-07-01,2024-07-01,Payment from Customer_0030,REF64880432,0.0,69.22,111053.94
2024-07-01,2024-07-01,Service payment - Customer_0013,REF38921367,0.0,43.97,111097.91
2024-07-01,2024-07-01,Service payment - Customer_0084,REF93559134,0.0,42.34,111140.25
2024-07-01,2024-07-01,Employee payroll,REF53772973,1736.39,0.0,109403.86
2024-07-01,2024-07-01,Professional Services expense,REF67203518,167.51,0.0,109236.35
2024-07-02,2024-07-02,Payment from Customer_0042,REF65285385,0.0,98.23,109334.58
2024-07-02,2024-07-02,Service payment - Customer_0059,REF75557905,0.0,132.34,109466.92
2024-07-02,2024-07-02,Service payment - Customer_0094,REF13433572,0.0,18.18,109485.1
2024-07-02,2024-07-02,Service payment - Customer_0000,REF60856304,0.0,106.06,109591.16
2024-07-02,2024-07-02,Payment from Customer_0002,REF35676782,0.0,38.56,109629.72
2024-07-02,2024-07-02,Invoice payment - Customer_0001,REF46977587,0.0,76.4,109706.12
2024-07-02,2024-07-02,Service payment - Customer_0022,REF50738931,0.0,51.71,109757.83
2024-07-02,2024-07-02,Payment from Customer_0048,REF26690124,0.0,99.52,109857.35
2024-07-02,2024-07-02,Project payment - Customer_0016,REF69205027,0.0,31.23,109888.58
2024-07-02,2024-07-02,Invoice payment - Customer_0083,REF63205120,0.0,42.63,109931.21
2024-07-03,2024-07-03,Payment from Customer_0075,REF35572020,0.0,60.08,109991.29
2024-07-03,2024-07-03,Payment from Customer_0086,REF23167327,0.0,102.06,110093.35
2024-07-03,2024-07-03,Invoice payment - Customer_0073,REF20457239,0.0,44.25,110137.6
2024-07-03,2024-07-03,Service payment - Customer_0055,REF73323094,0.0,71.74,110209.34
2024-07-03,2024-07-03,Payment from Customer_0027,REF42420089,0.0,105.32,110314.66
2024-07-03,2024-07-03,Project payment - Customer_0090,REF75285029,0.0,74.7,110389.36
2024-07-03,2024-07-03,Service payment - Customer_0039,REF53217718,0.0,126.71,110516.07
2024-07-03,2024-07-03,Service payment - Customer_0095,REF54113734,0.0,105.83,110621.9
2024-07-03,2024-07-03,Invoice payment - Customer_0069,REF52317613,0.0,160.87,110782.77
2024-07-03,2024-07-03,Payment from Customer_0070,REF16577004,0.0,44.87,110827.64
2024-07-03,2024-07-03,Service payment - Customer_0066,REF74321679,0.0,88.27,110915.91
2024-07-04,2024-07-04,Project payment - Customer_0063,REF58823017,0.0,81.35,110997.26
2024-07-04,2024-07-04,Project payment - Customer_0040,REF96514042,0.0,109.72,111106.98
2024-07-04,2024-07-04,Invoice payment - Customer_0003,REF84665570,0.0,124.88,111231.86
2024-07-04,2024-07-04,Project payment - Customer_0073,REF42338716,0.0,55.28,111287.14
2024-07-04,2024-07-04,Invoice payment - Customer_0044,REF92545150,0.0,139.62,111426.76
2024-07-04,2024-07-04,Payment from Customer_0095,REF98710210,0.0,79.85,111506.61
2024-07-04,2024-07-04,Payment from Customer_0023,REF34861491,0.0,56.74,111563.35
2024-07-04,2024-07-04,Project payment - Customer_0054,REF21463032,0.0,19.4,111582.75
2024-07-04,2024-07-04,Service payment - Customer_0089,REF57462189,0.0,44.1,111626.85
2024-07-04,2024-07-04,Project payment - Customer_0034,REF10401112,0.0,10.0,111636.85
2024-07-04,2024-07-04,Project payment - Customer_0046,REF21941027,0.0,63.8,111700.65
2024-07-05,2024-07-05,Invoice payment - Customer_0087,REF55656473,0.0,75.46,111776.11
2024-07-05,2024-07-05,Invoice payment - Customer_0091,REF92248567,0.0,122.23,111898.34
2024-07-05,2024-07-05,Service payment - Customer_0043,REF63216085,0.0,38.1,111936.44
2024-07-05,2024-07-05,Invoice payment - Customer_0029,REF71826973,0.0,71.15,112007.59
2024-07-05,2024-07-05,Invoice payment - Customer_0096,REF21792588,0.0,39.53,112047.12
2024-07-05,2024-07-05,Payment from Customer_0012,REF48564247,0.0,97.32,112144.44
2024-07-05,2024-07-05,Payment from Customer_0073,REF15524396,0.0,49.4,112193.84
2024-07-05,2024-07-05,Invoice payment - Customer_0084,REF76566928,0.0,36.89,112230.73
2024-07-05,2024-07-05,Service payment - Customer_0048,REF77295595,0.0,84.74,112315.47
2024-07-06,2024-07-06,Payment from Customer_0036,REF81186926,0.0,50.33,112365.8
2024-07-06,2024-07-06,Service payment - Customer_0043,REF27144530,0.0,68.4,112434.2
2024-07-06,2024-07-06,Service payment - Customer_0080,REF84569685,0.0,84.83,112519.03
2024-07-06,2024-07-06,Service payment - Customer_0023,REF37884474,0.0,48.98,112568.01
2024-07-06,2024-07-06,Project payment - Customer_0092,REF56251620,0.0,105.32,112673.33
2024-07-06,2024-07-06,Service payment - Customer_0053,REF60471457,0.0,150.55,112823.88
2024-07-06,2024-07-06,Service payment - Customer_0060,REF71110144,0.0,63.01,112886.89
2024-07-06,2024-07-06,Invoice payment - Customer_0075,REF57407724,0.0,63.74,112950.63
2024-07-06,2024-07-06,Payment from Customer_0091,REF73665895,0.0,88.15,113038.78
2024-07-06,2024-07-06,Service payment - Customer_0051,REF22331797,0.0,69.39,113108.17
2024-07-07,2024-07-07,Service payment - Customer_0012,REF44534077,0.0,132.27,113240.44
2024-07-07,2024-07-07,Service payment - Customer_0031,REF18086158,0.0,35.6,113276.04
2024-07-07,2024-07-07,Project payment - Customer_0082,REF32289880,0.0,77.38,113353.42
2024-07-07,2024-07-07,Professional Services expense,REF64566715,141.81,0.0,113211.61
2024-07-08,2024-07-08,Invoice payment - Customer_0054,REF44695809,0.0,15.13,113226.74
2024-07-08,2024-07-08,Invoice payment - Customer_0023,REF82518952,0.0,48.19,113274.93
2024-07-08,2024-07-08,Payment from Customer_0003,REF45321397,0.0,106.72,113381.65
2024-07-08,2024-07-08,Invoice payment - Customer_0053,REF58063120,0.0,157.58,113539.23
2024-07-08,2024-07-08,Payment from Customer_0015,REF33824562,0.0,70.13,113609.36
2024-07-08,2024-07-08,Payment from Customer_0010,REF72025789,0.0,101.31,113710.67
2024-07-08,2024-07-08,Service payment - Customer_0012,REF28628916,0.0,115.91,113826.58
2024-07-08,2024-07-08,Service payment - Customer_0059,REF68752357,0.0,177.29,114003.87
2024-07-08,2024-07-08,Payment from Customer_0041,REF82811035,0.0,60.55,114064.42
2024-07-08,2024-07-08,Invoice payment - Customer_0066,REF64446504,0.0,86.42,114150.84
2024-07-08,2024-07-08,Service payment - Customer_0014,REF21602669,0.0,92.91,114243.75
2024-07-08,2024-07-08,Marketing expenses,REF13032966,298.87,0.0,113944.88
2024-07-09,2024-07-09,Invoice payment - Customer_0079,REF25933962,0.0,137.99,114082.87
2024-07-09,2024-07-09,Project payment - Customer_0020,REF98978078,0.0,51.04,114133.91
2024-07-09,2024-07-09,Payment from Customer_0073,REF43877225,0.0,42.39,114176.3
2024-07-09,2024-07-09,Project payment - Customer_0001,REF57946812,0.0,100.04,114276.34
2024-07-09,2024-07-09,Payment from Customer_0089,REF88788557,0.0,47.51,114323.85
2024-07-09,2024-07-09,Project payment - Customer_0055,REF32839220,0.0,83.48,114407.33
2024-07-10,2024-07-10,Invoice payment - Customer_0052,REF64831956,0.0,92.18,114499.51
2024-07-10,2024-07-10,Invoice payment - Customer_0070,REF41799885,0.0,50.02,114549.53
2024-07-10,2024-07-10,Payment from Customer_0096,REF48127693,0.0,42.48,114592.01
2024-07-10,2024-07-10,Project payment - Customer_0088,REF23447739,0.0,10.86,114602.87
2024-07-10,2024-07-10,Service payment - Customer_0044,REF84375582,0.0,138.99,114741.86
2024-07-10,2024-07-10,Service payment - Customer_0054,REF42498106,0.0,20.66,114762.52
2024-07-10,2024-07-10,Project payment - Customer_0019,REF74913721,0.0,48.32,114810.84
2024-07-10,2024-07-10,Service payment - Customer_0026,REF40075867,0.0,87.2,114898.04
2024-07-11,2024-07-11,Payment from Customer_0050,REF74906162,0.0,83.95,114981.99
2024-07-11,2024-07-11,Service payment - Customer_0040,REF51184875,0.0,122.71,115104.7
2024-07-11,2024-07-11,Service payment - Customer_0079,REF75466526,0.0,118.09,115222.79
2024-07-11,2024-07-11,Payment from Customer_0042,REF14275352,0.0,97.72,115320.51
2024-07-11,2024-07-11,Service payment - Customer_0037,REF51218458,0.0,124.88,115445.39
2024-07-11,2024-07-11,Payment from Customer_0072,REF19890010,0.0,77.84,115523.23
2024-07-11,2024-07-11,Payment from Customer_0097,REF88482696,0.0,55.86,115579.09
2024-07-12,2024-07-12,Service payment - Customer_0041,REF66819910,0.0,54.33,115633.42
2024-07-12,2024-07-12,Professional Services expense,REF58710712,149.57,0.0,115483.85
2024-07-12,2024-07-12,Invoice payment - Customer_0031,REF84746180,0.0,31.1,115514.95
2024-07-12,2024-07-12,Project payment - Customer_0045,REF60676432,0.0,92.99,115607.94
2024-07-12,2024-07-12,Project payment - Customer_0092,REF46319244,0.0,80.34,115688.28
2024-07-12,2024-07-12,Invoice payment - Customer_0001,REF81394164,0.0,96.59,115784.87
2024-07-12,2024-07-12,Service payment - Customer_0050,REF53520914,0.0,56.93,115841.8
2024-07-12,2024-07-12,Service payment - Customer_0046,REF34431712,0.0,63.61,115905.41
2024-07-13,2024-07-13,Service payment - Customer_0065,REF86790892,0.0,58.89,115964.3
2024-07-13,2024-07-13,Project payment - Customer_0000,REF90406985,0.0,83.28,116047.58
2024-07-13,2024-07-13,Payment from Customer_0015,REF45872317,0.0,100.1,116147.68
2024-07-13,2024-07-13,Invoice payment - Customer_0092,REF83416544,0.0,105.25,116252.93
2024-07-13,2024-07-13,Service payment - Customer_0037,REF70981163,0.0,124.7,116377.63
2024-07-13,2024-07-13,Invoice payment - Customer_0090,REF15778262,0.0,87.07,116464.7
2024-07-13,2024-07-13,Payment from Customer_0024,REF76388522,0.0,126.83,116591.53
2024-07-13,2024-07-13,Invoice payment - Customer_0018,REF77799570,0.0,55.93,116647.46
2024-07-13,2024-07-13,Payment from Customer_0099,REF17167226,0.0,46.16,116693.62
2024-07-14,2024-07-14,Service payment - Customer_0040,REF21101357,0.0,120.82,116814.44
2024-07-14,2024-07-14,Service payment - Customer_0054,REF22664038,0.0,25.25,116839.69
2024-07-14,2024-07-14,Invoice payment - Customer_0049,REF31157787,0.0,53.0,116892.69
2024-07-14,2024-07-14,Service payment - Customer_0055,REF39982652,0.0,57.61,116950.3
2024-07-14,2024-07-14,Project payment - Customer_0017,REF20586765,0.0,159.24,117109.54
2024-07-15,2024-07-15,Business insurance premium,REF73195452,187.57,0.0,116921.97
2024-07-15,2024-07-15,Project payment - Customer_0021,REF88332377,0.0,77.05,116999.02
2024-07-15,2024-07-15,Payment from Customer_0039,REF71658638,0.0,130.53,117129.55
2024-07-15,2024-07-15,Invoice payment - Customer_0056,REF55430587,0.0,10.83,117140.38
2024-07-15,2024-07-15,Invoice payment - Customer_0001,REF64978485,0.0,85.42,117225.8
2024-07-15,2024-07-15,Project payment - Customer_0084,REF68149966,0.0,42.24,117268.04
2024-07-15,2024-07-15,Service payment - Customer_0058,REF45070530,0.0,104.42,117372.46
2024-07-15,2024-07-15,Payment from Customer_0068,REF25599159,0.0,85.46,117457.92
2024-07-16,2024-07-16,Invoice payment - Customer_0038,REF33693350,0.0,48.37,117506.29
2024-07-16,2024-07-16,Project payment - Customer_0000,REF31176987,0.0,121.68,117627.97
2024-07-16,2024-07-16,Invoice payment - Customer_0060,REF74511195,0.0,72.89,117700.86
2024-07-16,2024-07-16,Invoice payment - Customer_0022,REF70370276,0.0,66.8,117767.66
2024-07-16,2024-07-16,Invoice payment - Customer_0090,REF74986252,0.0,62.68,117830.34
2024-07-16,2024-07-16,Project payment - Customer_0094,REF14694713,0.0,24.13,117854.47
2024-07-17,2024-07-17,Invoice payment - Customer_0022,REF94975571,0.0,73.05,117927.52
2024-07-17,2024-07-17,Service payment - Customer_0048,REF91267359,0.0,86.58,118014.1
2024-07-17,2024-07-17,Invoice payment - Customer_0013,REF25913041,0.0,49.92,118064.02
2024-07-17,2024-07-17,Invoice payment - Customer_0018,REF52642562,0.0,64.68,118128.7
2024-07-17,2024-07-17,Service payment - Customer_0084,REF12550016,0.0,41.28,118169.98
2024-07-17,2024-07-17,Service payment - Customer_0009,REF16698268,0.0,93.19,118263.17
2024-07-17,2024-07-17,Service payment - Customer_0000,REF57944834,0.0,64.55,118327.72
2024-07-17,2024-07-17,Project payment - Customer_0025,REF94060799,0.0,83.9,118411.62
2024-07-17,2024-07-17,Project payment - Customer_0082,REF21489214,0.0,42.3,118453.92
2024-07-17,2024-07-17,Project payment - Customer_0011,REF71035869,0.0,47.42,118501.34
2024-07-18,2024-07-18,Project payment - Customer_0057,REF29707353,0.0,29.95,118531.29
2024-07-18,2024-07-18,Service payment - Customer_0026,REF25420736,0.0,66.72,118598.01
2024-07-18,2024-07-18,Payment from Customer_0052,REF68732942,0.0,103.62,118701.63
2024-07-18,2024-07-18,Service payment - Customer_0073,REF46641594,0.0,47.13,118748.76
2024-07-18,2024-07-18,Invoice payment - Customer_0069,REF68390687,0.0,222.11,118970.87
2024-07-18,2024-07-18,Invoice payment - Customer_0054,REF87587834,0.0,22.53,118993.4
2024-07-18,2024-07-18,Project payment - Customer_0002,REF48865404,0.0,38.01,119031.41
2024-07-18,2024-07-18,Payment from Customer_0086,REF65414245,0.0,76.52,119107.93
2024-07-19,2024-07-19,Inventory purchase,REF40889976,2968.26,0.0,116139.67
2024-07-19,2024-07-19,Invoice payment - Customer_0050,REF23390672,0.0,69.5,116209.17
2024-07-19,2024-07-19,Project payment - Customer_0040,REF75812176,0.0,98.68,116307.85
2024-07-19,2024-07-19,Payment from Customer_0008,REF39147970,0.0,47.8,116355.65
2024-07-19,2024-07-19,Invoice payment - Customer_0064,REF58599783,0.0,42.91,116398.56
2024-07-19,2024-07-19,Invoice payment - Customer_0027,REF71282919,0.0,97.82,116496.38
2024-07-19,2024-07-19,Project payment - Customer_0041,REF88423051,0.0,30.93,116527.31
2024-07-19,2024-07-19,Invoice payment - Customer_0012,REF95918522,0.0,107.67,116634.98
2024-07-19,2024-07-19,Payment from Customer_0074,REF27956120,0.0,108.63,116743.61
2024-07-19,2024-07-19,Project payment - Customer_0020,REF64848782,0.0,48.8,116792.41
2024-07-19,2024-07-19,Payment from Customer_0078,REF78227351,0.0,78.33,116870.74
2024-07-19,2024-07-19,Invoice payment - Customer_0085,REF75852118,0.0,87.44,116958.18
2024-07-19,2024-07-19,Payment from Customer_0016,REF13847336,0.0,28.96,116987.14
2024-07-19,2024-07-19,Project payment - Customer_0089,REF30496929,0.0,56.29,117043.43
2024-07-19,2024-07-19,Service payment - Customer_0083,REF77810518,0.0,37.31,117080.74
2024-07-20,2024-07-20,Employee payroll,REF52467267,2333.08,0.0,114747.66
2024-07-20,2024-07-20,Payment from Customer_0046,REF33010404,0.0,68.8,114816.46
2024-07-20,2024-07-20,Project payment - Customer_0021,REF66932780,0.0,62.37,114878.83
2024-07-20,2024-07-20,Invoice payment - Customer_0023,REF90883509,0.0,57.73,114936.56
2024-07-20,2024-07-20,Payment from Customer_0017,REF19656056,0.0,136.05,115072.61
2024-07-20,2024-07-20,Payment from Customer_0044,REF73017812,0.0,137.9,115210.51
2024-07-20,2024-07-20,Project payment - Customer_0068,REF83863403,0.0,87.57,115298.08
2024-07-21,2024-07-21,Service payment - Customer_0015,REF63874059,0.0,107.38,115405.46
2024-07-21,2024-07-21,Project payment - Customer_0090,REF66242209,0.0,80.99,115486.45
2024-07-21,2024-07-21,Service payment - Customer_0036,REF76315158,0.0,49.0,115535.45
2024-07-21,2024-07-21,Service payment - Customer_0065,REF64591176,0.0,36.7,115572.15
2024-07-21,2024-07-21,Invoice payment - Customer_0082,REF72921618,0.0,71.16,115643.31
2024-07-21,2024-07-21,Invoice payment - Customer_0088,REF25412724,0.0,14.36,115657.67
2024-07-21,2024-07-21,Service payment - Customer_0080,REF63114699,0.0,116.22,115773.89
2024-07-21,2024-07-21,Invoice payment - Customer_0006,REF17974148,0.0,15.13,115789.02
2024-07-21,2024-07-21,Project payment - Customer_0038,REF43058572,0.0,59.08,115848.1
2024-07-21,2024-07-21,Payment from Customer_0011,REF18790113,0.0,36.7,115884.8
2024-07-22,2024-07-22,Project payment - Customer_0046,REF71223102,0.0,43.16,115927.96
2024-07-22,2024-07-22,Project payment - Customer_0012,REF60903008,0.0,90.77,116018.73
2024-07-22,2024-07-22,Service payment - Customer_0070,REF38029335,0.0,55.51,116074.24
2024-07-22,2024-07-22,Utility bill payment,REF63296580,140.91,0.0,115933.33
2024-07-22,2024-07-22,Invoice payment - Customer_0072,REF19597869,0.0,45.98,115979.31
2024-07-22,2024-07-22,Payment from Customer_0000,REF56921768,0.0,109.94,116089.25
2024-07-22,2024-07-22,Service payment - Customer_0019,REF64000369,0.0,57.04,116146.29
2024-07-22,2024-07-22,Invoice payment - Customer_0080,REF98556752,0.0,125.59,116271.88
2024-07-22,2024-07-22,Project payment - Customer_0053,REF95529336,0.0,200.06,116471.94
2024-07-22,2024-07-22,Project payment - Customer_0030,REF20485609,0.0,77.73,116549.67
2024-07-23,2024-07-23,Invoice payment - Customer_0029,REF29881891,0.0,62.78,116612.45
2024-07-23,2024-07-23,Service payment - Customer_0064,REF97051283,0.0,41.11,116653.56
2024-07-23,2024-07-23,Invoice payment - Customer_0006,REF36576255,0.0,10.0,116663.56
2024-07-23,2024-07-23,Payment from Customer_0098,REF34674276,0.0,80.7,116744.26
2024-07-23,2024-07-23,Invoice payment - Customer_0013,REF55411355,0.0,59.74,116804.0
2024-07-23,2024-07-23,Service payment - Customer_0066,REF84382608,0.0,110.57,116914.57
2024-07-24,2024-07-24,Service payment - Customer_0074,REF47687642,0.0,68.34,116982.91
2024-07-24,2024-07-24,Service payment - Customer_0075,REF18358262,0.0,73.58,117056.49
2024-07-24,2024-07-24,Service payment - Customer_0061,REF32365031,0.0,92.27,117148.76
2024-07-24,2024-07-24,Service payment - Customer_0055,REF92526277,0.0,85.12,117233.88
2024-07-24,2024-07-24,Payment from Customer_0017,REF37677422,0.0,98.17,117332.05
2024-07-24,2024-07-24,Service payment - Customer_0041,REF86627687,0.0,58.33,117390.38
2024-07-24,2024-07-24,Service payment - Customer_0089,REF71349772,0.0,54.6,117444.98
2024-07-24,2024-07-24,Project payment - Customer_0077,REF38733322,0.0,103.56,117548.54
2024-07-25,2024-07-25,Service payment - Customer_0032,REF27653949,0.0,122.46,117671.0
2024-07-25,2024-07-25,Payment from Customer_0085,REF14071921,0.0,45.2,117716.2
2024-07-25,2024-07-25,Project payment - Customer_0047,REF89755425,0.0,61.4,117777.6
2024-07-25,2024-07-25,Payment from Customer_0064,REF35108103,0.0,54.59,117832.19
2024-07-25,2024-07-25,Service payment - Customer_0058,REF97091258,0.0,77.08,117909.27
2024-07-25,2024-07-25,Service payment - Customer_0091,REF45806451,0.0,109.08,118018.35
2024-07-26,2024-07-26,Pos Systems expense,REF52223311,32.7,0.0,117985.65
2024-07-26,2024-07-26,Invoice payment - Customer_0038,REF35916211,0.0,54.36,118040.01
2024-07-26,2024-07-26,Service payment - Customer_0005,REF58425804,0.0,57.32,118097.33
2024-07-26,2024-07-26,Payment from Customer_0059,REF35144285,0.0,121.01,118218.34
2024-07-26,2024-07-26,Invoice payment - Customer_0098,REF54231611,0.0,69.49,118287.83
2024-07-26,2024-07-26,Service payment - Customer_0099,REF13935132,0.0,46.99,118334.82
2024-07-26,2024-07-26,Service payment - Customer_0067,REF85275619,0.0,47.51,118382.33
2024-07-26,2024-07-26,Service payment - Customer_0014,REF23974488,0.0,114.56,118496.89
2024-07-27,2024-07-27,Service payment - Customer_0086,REF25722697,0.0,70.12,118567.01
2024-07-27,2024-07-27,Invoice payment - Customer_0093,REF21149982,0.0,40.49,118607.5
2024-07-27,2024-07-27,Service payment - Customer_0045,REF65068039,0.0,110.07,118717.57
2024-07-27,2024-07-27,Invoice payment - Customer_0029,REF33529592,0.0,67.8,118785.37
2024-07-27,2024-07-27,Service payment - Customer_0021,REF18486031,0.0,74.73,118860.1
2024-07-27,2024-07-27,Service payment - Customer_0061,REF82922456,0.0,86.56,118946.66
2024-07-27,2024-07-27,Service payment - Customer_0087,REF82968475,0.0,89.93,119036.59
2024-07-27,2024-07-27,Payment from Customer_0023,REF66878886,0.0,58.39,119094.98
2024-07-27,2024-07-27,Service payment - Customer_0020,REF59313468,0.0,53.27,119148.25
2024-07-28,2024-07-28,Service payment - Customer_0009,REF50555348,0.0,109.23,119257.48
2024-07-28,2024-07-28,Invoice payment - Customer_0079,REF41626106,0.0,159.72,119417.2
2024-07-28,2024-07-28,Service payment - Customer_0055,REF34278490,0.0,73.81,119491.01
2024-07-28,2024-07-28,Payment from Customer_0088,REF68306088,0.0,11.75,119502.76
2024-07-28,2024-07-28,Payment from Customer_0085,REF76985068,0.0,65.1,119567.86
2024-07-28,2024-07-28,Payment from Customer_0027,REF43102758,0.0,119.58,119687.44
2024-07-28,2024-07-28,Service payment - Customer_0030,REF31797945,0.0,84.15,119771.59
2024-07-28,2024-07-28,Invoice payment - Customer_0093,REF64775252,0.0,42.04,119813.63
2024-07-28,2024-07-28,Service payment - Customer_0021,REF20954757,0.0,97.86,119911.49
2024-07-29,2024-07-29,Payment from Customer_0096,REF41826817,0.0,38.55,119950.04
2024-07-29,2024-07-29,Project payment - Customer_0087,REF42760274,0.0,80.38,120030.42
2024-07-29,2024-07-29,Invoice payment - Customer_0084,REF18239474,0.0,43.1,120073.52
2024-07-29,2024-07-29,Service payment - Customer_0079,REF80663662,0.0,130.47,120203.99
2024-07-29,2024-07-29,Inventory purchase,REF88626176,3586.1,0.0,116617.89
2024-07-29,2024-07-29,Payment from Customer_0008,REF45259826,0.0,35.0,116652.89
2024-07-29,2024-07-29,Project payment - Customer_0053,REF40222669,0.0,118.89,116771.78
2024-07-29,2024-07-29,Payment from Customer_0073,REF32844276,0.0,50.54,116822.32
2024-07-29,2024-07-29,Invoice payment - Customer_0043,REF56490210,0.0,56.27,116878.59
2024-07-30,2024-07-30,Payment from Customer_0044,REF63517500,0.0,137.85,117016.44
2024-07-30,2024-07-30,Payment from Customer_0032,REF33710046,0.0,135.89,117152.33
2024-07-30,2024-07-30,Project payment - Customer_0001,REF81638294,0.0,76.1,117228.43
2024-07-30,2024-07-30,Invoice payment - Customer_0020,REF99231182,0.0,65.74,117294.17
2024-07-30,2024-07-30,Payment from Customer_0021,REF72071320,0.0,65.53,117359.7
2024-07-30,2024-07-30,Service payment - Customer_0040,REF14701590,0.0,109.7,117469.4
2024-07-30,2024-07-30,Invoice payment - Customer_0007,REF93189693,0.0,24.83,117494.23
2024-07-30,2024-07-30,Payment from Customer_0082,REF40923593,0.0,55.36,117549.59
2024-07-30,2024-07-30,Project payment - Customer_0099,REF15759453,0.0,43.12,117592.71
2024-07-30,2024-07-30,Invoice payment - Customer_0077,REF94246595,0.0,95.29,117688.0
2024-07-31,2024-07-31,Payment from Customer_0019,REF13605825,0.0,74.9,117762.9
2024-07-31,2024-07-31,Payment from Customer_0030,REF57527430,0.0,59.93,117822.83
2024-07-31,2024-07-31,Invoice payment - Customer_0060,REF45415263,0.0,59.37,117882.2
2024-07-31,2024-07-31,Payment from Customer_0082,REF51011231,0.0,50.47,117932.67
2024-07-31,2024-07-31,Payment from Customer_0098,REF19196968,0.0,109.81,118042.48
2024-07-31,2024-07-31,Service payment - Customer_0083,REF79338158,0.0,45.35,118087.83
2024-07-31,2024-07-31,Project payment - Customer_0059,REF52472657,0.0,139.65,118227.48
2024-07-31,2024-07-31,Payment from Customer_0017,REF67000039,0.0,144.91,118372.39
2024-08-01,2024-08-01,Project payment - Customer_0012,REF75375054,0.0,148.57,118520.96
2024-08-01,2024-08-01,Service payment - Customer_0064,REF95430729,0.0,44.37,118565.33
2024-08-01,2024-08-01,Payment from Customer_0007,REF58686555,0.0,27.05,118592.38
2024-08-01,2024-08-01,Service payment - Customer_0009,REF70623577,0.0,145.49,118737.87
2024-08-01,2024-08-01,Monthly office rent,REF67486758,1156.72,0.0,117581.15
2024-08-02,2024-08-02,Service payment - Customer_0075,REF66066831,0.0,75.26,117656.41
2024-08-02,2024-08-02,Packaging Shipping expense,REF86494353,297.76,0.0,117358.65
2024-08-02,2024-08-02,Service payment - Customer_0004,REF81267409,0.0,48.46,117407.11
2024-08-02,2024-08-02,Project payment - Customer_0087,REF13245723,0.0,78.05,117485.16
2024-08-02,2024-08-02,Invoice payment - Customer_0000,REF13133293,0.0,77.85,117563.01
2024-08-02,2024-08-02,Project payment - Customer_0012,REF39642041,0.0,134.61,117697.62
2024-08-02,2024-08-02,Payment from Customer_0080,REF17266365,0.0,76.48,117774.1
2024-08-02,2024-08-02,Service payment - Customer_0055,REF58698755,0.0,74.74,117848.84
2024-08-02,2024-08-02,Payment from Customer_0053,REF43072273,0.0,160.42,118009.26
2024-08-02,2024-08-02,Payment from Customer_0096,REF18945094,0.0,45.55,118054.81
2024-08-03,2024-08-03,Service payment - Customer_0018,REF61896818,0.0,50.78,118105.59
2024-08-03,2024-08-03,Payment from Customer_0046,REF44825420,0.0,40.74,118146.33
2024-08-03,2024-08-03,Project payment - Customer_0028,REF58599963,0.0,102.1,118248.43
2024-08-03,2024-08-03,Project payment - Customer_0001,REF72398669,0.0,78.22,118326.65
2024-08-03,2024-08-03,Invoice payment - Customer_0003,REF73181227,0.0,118.24,118444.89
2024-08-03,2024-08-03,Service payment - Customer_0082,REF76760387,0.0,55.03,118499.92
2024-08-03,2024-08-03,Invoice payment - Customer_0016,REF95075020,0.0,29.44,118529.36
2024-08-03,2024-08-03,Service payment - Customer_0064,REF61472016,0.0,53.49,118582.85
2024-08-04,2024-08-04,Project payment - Customer_0092,REF77664528,0.0,105.67,118688.52
2024-08-04,2024-08-04,Project payment - Customer_0038,REF87830314,0.0,35.46,118723.98
2024-08-04,2024-08-04,Service payment - Customer_0058,REF24506203,0.0,111.44,118835.42
2024-08-04,2024-08-04,Service payment - Customer_0091,REF28741280,0.0,100.81,118936.23
2024-08-04,2024-08-04,Service payment - Customer_0005,REF59186439,0.0,64.5,119000.73
2024-08-04,2024-08-04,Invoice payment - Customer_0089,REF11691432,0.0,61.21,119061.94
2024-08-04,2024-08-04,Invoice payment - Customer_0033,REF16765843,0.0,107.12,119169.06
2024-08-04,2024-08-04,Service payment - Customer_0023,REF16664854,0.0,55.37,119224.43
2024-08-05,2024-08-05,Payment from Customer_0044,REF72195860,0.0,103.68,119328.11
2024-08-05,2024-08-05,Invoice payment - Customer_0045,REF53249989,0.0,75.21,119403.32
2024-08-05,2024-08-05,Project payment - Customer_0030,REF59332157,0.0,78.15,119481.47
2024-08-05,2024-08-05,Payment from Customer_0060,REF29553810,0.0,83.59,119565.06
2024-08-05,2024-08-05,Service payment - Customer_0014,REF65626976,0.0,106.87,119671.93
2024-08-05,2024-08-05,Invoice payment - Customer_0050,REF83101954,0.0,79.02,119750.95
2024-08-05,2024-08-05,Invoice payment - Customer_0026,REF97518001,0.0,76.66,119827.61
2024-08-05,2024-08-05,Project payment - Customer_0061,REF96640574,0.0,88.04,119915.65
2024-08-05,2024-08-05,Project payment - Customer_0027,REF49238730,0.0,114.91,120030.56
2024-08-05,2024-08-05,Invoice payment - Customer_0089,REF90198593,0.0,57.6,120088.16
2024-08-06,2024-08-06,Invoice payment - Customer_0087,REF85820688,0.0,89.24,120177.4
2024-08-06,2024-08-06,Payment from Customer_0088,REF26663222,0.0,14.1,120191.5
2024-08-06,2024-08-06,Project payment - Customer_0010,REF74807956,0.0,119.23,120310.73
2024-08-06,2024-08-06,Project payment - Customer_0052,REF39751078,0.0,86.61,120397.34
2024-08-06,2024-08-06,Invoice payment - Customer_0023,REF87087621,0.0,63.73,120461.07
2024-08-06,2024-08-06,Project payment - Customer_0018,REF37740633,0.0,59.1,120520.17
2024-08-06,2024-08-06,Project payment - Customer_0090,REF65866262,0.0,93.61,120613.78
2024-08-06,2024-08-06,Project payment - Customer_0004,REF64352777,0.0,44.75,120658.53
2024-08-06,2024-08-06,Project payment - Customer_0043,REF82934954,0.0,68.81,120727.34
2024-08-06,2024-08-06,Service payment - Customer_0097,REF36465817,0.0,49.8,120777.14
2024-08-06,2024-08-06,Project payment - Customer_0078,REF74106536,0.0,55.61,120832.75
2024-08-06,2024-08-06,Invoice payment - Customer_0034,REF57465072,0.0,11.04,120843.79
2024-08-06,2024-08-06,Invoice payment - Customer_0093,REF69780507,0.0,60.15,120903.94
2024-08-06,2024-08-06,Invoice payment - Customer_0065,REF14420644,0.0,48.62,120952.56
2024-08-06,2024-08-06,Service payment - Customer_0045,REF86622938,0.0,101.94,121054.5
2024-08-07,2024-08-07,Invoice payment - Customer_0031,REF16417255,0.0,35.44,121089.94
2024-08-07,2024-08-07,Invoice payment - Customer_0091,REF70942139,0.0,86.48,121176.42
2024-08-07,2024-08-07,Payment from Customer_0080,REF70310181,0.0,125.33,121301.75
2024-08-07,2024-08-07,Payment from Customer_0007,REF99151210,0.0,23.64,121325.39
2024-08-07,2024-08-07,Payment from Customer_0059,REF58924124,0.0,120.95,121446.34
2024-08-07,2024-08-07,Invoice payment - Customer_0027,REF74901609,0.0,107.08,121553.42
2024-08-08,2024-08-08,Invoice payment - Customer_0043,REF57774410,0.0,60.78,121614.2
2024-08-08,2024-08-08,Service payment - Customer_0059,REF49613752,0.0,114.54,121728.74
2024-08-08,2024-08-08,Project payment - Customer_0053,REF21884745,0.0,144.74,121873.48
2024-08-08,2024-08-08,Service payment - Customer_0058,REF30508723,0.0,100.37,121973.85
2024-08-09,2024-08-09,Invoice payment - Customer_0009,REF16287320,0.0,138.31,122112.16
2024-08-09,2024-08-09,Invoice payment - Customer_0046,REF18766581,0.0,46.63,122158.79
2024-08-09,2024-08-09,Professional Services expense,REF71376567,142.81,0.0,122015.98
2024-08-09,2024-08-09,Payment from Customer_0036,REF72115189,0.0,49.76,122065.74
2024-08-09,2024-08-09,Service payment - Customer_0023,REF93455134,0.0,61.66,122127.4
2024-08-09,2024-08-09,Project payment - Customer_0012,REF21728950,0.0,106.85,122234.25
2024-08-09,2024-08-09,Pos Systems expense,REF58605927,41.01,0.0,122193.24
2024-08-09,2024-08-09,Invoice payment - Customer_0010,REF15597390,0.0,112.98,122306.22
2024-08-09,2024-08-09,Invoice payment - Customer_0085,REF56674646,0.0,61.91,122368.13
2024-08-09,2024-08-09,Payment from Customer_0018,REF40279995,0.0,55.15,122423.28
2024-08-09,2024-08-09,Service payment - Customer_0090,REF40282462,0.0,85.49,122508.77
2024-08-09,2024-08-09,Service payment - Customer_0008,REF34464651,0.0,52.25,122561.02
2024-08-10,2024-08-10,Project payment - Customer_0019,REF66580238,0.0,57.16,122618.18
2024-08-10,2024-08-10,Invoice payment - Customer_0046,REF15595685,0.0,49.97,122668.15
2024-08-10,2024-08-10,Payment from Customer_0009,REF82004772,0.0,104.4,122772.55
2024-08-10,2024-08-10,Payment from Customer_0024,REF76584744,0.0,132.25,122904.8
2024-08-10,2024-08-10,Project payment - Customer_0021,REF49551284,0.0,56.01,122960.81
2024-08-10,2024-08-10,Service payment - Customer_0048,REF81083099,0.0,84.35,123045.16
2024-08-10,2024-08-10,Service payment - Customer_0061,REF44212540,0.0,83.26,123128.42
2024-08-10,2024-08-10,Payment from Customer_0020,REF33301044,0.0,56.87,123185.29
2024-08-10,2024-08-10,Payment from Customer_0071,REF91001607,0.0,64.29,123249.58
2024-08-10,2024-08-10,Invoice payment - Customer_0028,REF51531782,0.0,65.9,123315.48
2024-08-10,2024-08-10,Inventory purchase,REF53657163,3913.62,0.0,119401.86
2024-08-11,2024-08-11,Payment from Customer_0057,REF49999931,0.0,42.08,119443.94
2024-08-11,2024-08-11,Payment from Customer_0058,REF89631868,0.0,86.22,119530.16
2024-08-11,2024-08-11,Payment from Customer_0090,REF30584770,0.0,68.27,119598.43
2024-08-11,2024-08-11,Service payment - Customer_0038,REF81126760,0.0,43.97,119642.4
2024-08-12,2024-08-12,Project payment - Customer_0097,REF53733266,0.0,48.61,119691.01
2024-08-12,2024-08-12,Payment from Customer_0045,REF85023093,0.0,95.71,119786.72
2024-08-12,2024-08-12,Service payment - Customer_0070,REF77633635,0.0,47.9,119834.62
2024-08-12,2024-08-12,Service payment - Customer_0046,REF16689524,0.0,69.09,119903.71
2024-08-12,2024-08-12,Project payment - Customer_0074,REF48708987,0.0,76.17,119979.88
2024-08-12,2024-08-12,Service payment - Customer_0049,REF59283496,0.0,36.86,120016.74
2024-08-12,2024-08-12,Invoice payment - Customer_0000,REF90218260,0.0,102.0,120118.74
2024-08-12,2024-08-12,Project payment - Customer_0073,REF92444162,0.0,51.52,120170.26
2024-08-12,2024-08-12,Payment from Customer_0017,REF94556309,0.0,146.65,120316.91
2024-08-13,2024-08-13,Invoice payment - Customer_0035,REF19433879,0.0,97.02,120413.93
2024-08-13,2024-08-13,Project payment - Customer_0042,REF11352644,0.0,71.81,120485.74
2024-08-13,2024-08-13,Project payment - Customer_0083,REF26429996,0.0,40.02,120525.76
2024-08-13,2024-08-13,Project payment - Customer_0000,REF30668757,0.0,93.1,120618.86
2024-08-13,2024-08-13,Invoice payment - Customer_0054,REF89412904,0.0,26.57,120645.43
2024-08-13,2024-08-13,Service payment - Customer_0088,REF41572639,0.0,10.74,120656.17
2024-08-13,2024-08-13,Service payment - Customer_0003,REF48093994,0.0,116.95,120773.12
2024-08-13,2024-08-13,Service payment - Customer_0081,REF29617349,0.0,83.93,120857.05
2024-08-13,2024-08-13,Payment from Customer_0015,REF17986385,0.0,91.48,120948.53
2024-08-14,2024-08-14,Invoice payment - Customer_0034,REF15605918,0.0,10.61,120959.14
2024-08-14,2024-08-14,Payment from Customer_0070,REF97804560,0.0,65.78,121024.92
2024-08-14,2024-08-14,Service payment - Customer_0039,REF18323305,0.0,146.73,121171.65
2024-08-14,2024-08-14,Service payment - Customer_0098,REF51371638,0.0,64.51,121236.16
2024-08-14,2024-08-14,Project payment - Customer_0055,REF97129992,0.0,81.08,121317.24
2024-08-14,2024-08-14,Service payment - Customer_0043,REF69752543,0.0,55.15,121372.39
2024-08-14,2024-08-14,Project payment - Customer_0078,REF21106166,0.0,64.91,121437.3
2024-08-14,2024-08-14,Service payment - Customer_0050,REF41731700,0.0,52.38,121489.68
2024-08-14,2024-08-14,Project payment - Customer_0081,REF80919487,0.0,82.47,121572.15
2024-08-14,2024-08-14,Invoice payment - Customer_0022,REF78280511,0.0,86.59,121658.74
2024-08-15,2024-08-15,Business insurance premium,REF82308598,182.17,0.0,121476.57
2024-08-15,2024-08-15,Payment from Customer_0033,REF76777345,0.0,65.92,121542.49
2024-08-15,2024-08-15,Payment from Customer_0040,REF38311811,0.0,88.02,121630.51
2024-08-15,2024-08-15,Invoice payment - Customer_0009,REF99221753,0.0,150.41,121780.92
2024-08-15,2024-08-15,Payment from Customer_0061,REF17950076,0.0,96.83,121877.75
2024-08-15,2024-08-15,Service payment - Customer_0029,REF46399282,0.0,52.41,121930.16
2024-08-15,2024-08-15,Invoice payment - Customer_0004,REF24129380,0.0,55.59,121985.75
2024-08-15,2024-08-15,Project payment - Customer_0078,REF27975073,0.0,42.97,122028.72
2024-08-15,2024-08-15,Payment from Customer_0048,REF22474316,0.0,88.08,122116.8
2024-08-16,2024-08-16,Invoice payment - Customer_0060,REF30518326,0.0,78.09,122194.89
2024-08-16,2024-08-16,Payment from Customer_0056,REF52260943,0.0,10.51,122205.4
2024-08-16,2024-08-16,Project payment - Customer_0021,REF31745308,0.0,88.3,122293.7
2024-08-16,2024-08-16,Payment from Customer_0047,REF38187973,0.0,70.66,122364.36
2024-08-16,2024-08-16,Payment from Customer_0022,REF49809942,0.0,98.2,122462.56
2024-08-16,2024-08-16,Payment from Customer_0086,REF17461793,0.0,72.9,122535.46
2024-08-16,2024-08-16,Project payment - Customer_0014,REF24133818,0.0,66.14,122601.6
2024-08-17,2024-08-17,Pos Systems expense,REF69354576,24.55,0.0,122577.05
2024-08-17,2024-08-17,Service payment - Customer_0058,REF89246557,0.0,99.22,122676.27
2024-08-17,2024-08-17,Service payment - Customer_0000,REF22603543,0.0,116.16,122792.43
2024-08-17,2024-08-17,Payment from Customer_0079,REF83994768,0.0,159.6,122952.03
2024-08-17,2024-08-17,Invoice payment - Customer_0002,REF44856649,0.0,41.87,122993.9
2024-08-17,2024-08-17,Invoice payment - Customer_0084,REF90824547,0.0,38.75,123032.65
2024-08-17,2024-08-17,Service payment - Customer_0019,REF65800971,0.0,59.64,123092.29
2024-08-17,2024-08-17,Payment from Customer_0022,REF87376156,0.0,85.8,123178.09
2024-08-17,2024-08-17,Inventory purchase,REF11705929,1749.68,0.0,121428.41
2024-08-17,2024-08-17,Payment from Customer_0069,REF74952932,0.0,109.9,5436.56
2024-08-17,2024-08-17,Invoice payment - Customer_0073,REF41181336,0.0,51.32,5487.88
2024-08-17,2024-08-17,Service payment - Customer_0068,REF25787937,0.0,89.36,5577.24
2024-08-17,2024-08-17,Invoice payment - Customer_0016,REF11275803,0.0,13.54,5590.78
2024-08-17,2024-08-17,Invoice payment - Customer_0038,REF56731154,0.0,110.3,5701.08
2024-08-17,2024-08-17,Payment from Customer_0047,REF50188787,0.0,133.51,5834.59
2024-08-17,2024-08-17,Payment from Customer_0089,REF33555859,0.0,90.02,5924.61
2024-08-17,2024-08-17,Employee payroll,REF87035771,1608.59,0.0,4316.02
2024-08-17,2024-08-17,Invoice payment - Customer_0030,REF16171452,0.0,58.4,4374.42
2024-08-17,2024-08-17,Invoice payment - Customer_0055,REF97797628,0.0,103.78,4478.2
2024-08-17,2024-08-17,Payment from Customer_0034,REF15100392,0.0,148.43,4626.63
2024-08-18,2024-08-18,Invoice payment - Customer_0005,REF57358037,0.0,37.77,4664.4
2024-08-18,2024-08-18,Invoice payment - Customer_0066,REF74720206,0.0,71.44,4735.84
2024-08-18,2024-08-18,Service payment - Customer_0033,REF31734144,0.0,96.62,4832.46
2024-08-18,2024-08-18,Invoice payment - Customer_0087,REF55978127,0.0,80.45,4912.91
2024-08-18,2024-08-18,Project payment - Customer_0030,REF96414958,0.0,47.7,4960.61
2024-08-18,2024-08-18,Invoice payment - Customer_0089,REF31484115,0.0,130.45,5091.06
2024-08-18,2024-08-18,Payment from Customer_0098,REF21994420,0.0,86.81,5177.87
2024-08-19,2024-08-19,Project payment - Customer_0034,REF21008371,0.0,152.73,5330.6
2024-08-19,2024-08-19,Payment from Customer_0086,REF31094915,0.0,102.47,5433.07
2024-08-19,2024-08-19,Project payment - Customer_0094,REF71677657,0.0,131.48,5564.55
2024-08-19,2024-08-19,Payment from Customer_0009,REF58844197,0.0,63.25,5627.8
2024-08-19,2024-08-19,Service payment - Customer_0066,REF70645183,0.0,69.96,5697.76
2024-08-19,2024-08-19,Service payment - Customer_0058,REF30737039,0.0,54.59,5752.35
2024-08-19,2024-08-19,Service payment - Customer_0022,REF80753661,0.0,129.26,5881.61
2024-08-19,2024-08-19,Invoice payment - Customer_0005,REF22142824,0.0,61.35,5942.96
2024-08-19,2024-08-19,Service payment - Customer_0047,REF87777196,0.0,94.43,6037.39
2024-08-19,2024-08-19,Service payment - Customer_0098,REF36855085,0.0,83.72,6121.11
2024-08-20,2024-08-20,Project payment - Customer_0067,REF97806854,0.0,71.13,6192.24
2024-08-20,2024-08-20,Invoice payment - Customer_0054,REF93266443,0.0,136.81,6329.05
2024-08-20,2024-08-20,Payment from Customer_0040,REF47566845,0.0,63.45,6392.5
2024-08-20,2024-08-20,Service payment - Customer_0027,REF16518826,0.0,23.77,6416.27
2024-08-20,2024-08-20,Invoice payment - Customer_0022,REF84203259,0.0,131.37,6547.64
2024-08-21,2024-08-21,Invoice payment - Customer_0007,REF74829924,0.0,71.95,6619.59
2024-08-21,2024-08-21,Project payment - Customer_0018,REF12713438,0.0,131.83,6751.42
2024-08-21,2024-08-21,Payment from Customer_0051,REF92999711,0.0,85.12,6836.54
2024-08-21,2024-08-21,Service payment - Customer_0029,REF92341275,0.0,91.54,6928.08
2024-08-21,2024-08-21,Project payment - Customer_0008,REF79999873,0.0,90.78,7018.86
2024-08-21,2024-08-21,Service payment - Customer_0040,REF49684417,0.0,65.86,7084.72
2024-08-21,2024-08-21,Service payment - Customer_0030,REF95151351,0.0,38.18,7122.9
2024-08-21,2024-08-21,Project payment - Customer_0087,REF93546626,0.0,92.15,7215.05
2024-08-21,2024-08-21,Project payment - Customer_0046,REF45486344,0.0,78.42,7293.47
2024-08-21,2024-08-21,Payment from Customer_0099,REF19009559,0.0,52.93,7346.4
2024-08-21,2024-08-21,Service payment - Customer_0076,REF46453300,0.0,62.39,7408.79
2024-08-22,2024-08-22,Payment from Customer_0051,REF46283820,0.0,112.99,7521.78
2024-08-22,2024-08-22,Invoice payment - Customer_0060,REF52439030,0.0,53.2,7574.98
2024-08-22,2024-08-22,Service payment - Customer_0054,REF30297308,0.0,129.27,7704.25
2024-08-22,2024-08-22,Utility bill payment,REF96508497,138.91,0.0,7565.34
2024-08-22,2024-08-22,Service payment - Customer_0001,REF81688054,0.0,63.78,7629.12
2024-08-22,2024-08-22,Service payment - Customer_0016,REF10439236,0.0,14.71,7643.83
2024-08-22,2024-08-22,Service payment - Customer_0062,REF66531723,0.0,59.8,7703.63
2024-08-22,2024-08-22,Project payment - Customer_0021,REF99212437,0.0,72.92,7776.55
2024-08-22,2024-08-22,Service payment - Customer_0013,REF35743402,0.0,79.4,7855.95
2024-08-22,2024-08-22,Project payment - Customer_0027,REF10399563,0.0,43.49,7899.44
2024-08-22,2024-08-22,Service payment - Customer_0052,REF96651164,0.0,71.81,7971.25
2024-08-23,2024-08-23,Service payment - Customer_0029,REF90482078,0.0,80.24,8051.49
2024-08-23,2024-08-23,Payment from Customer_0068,REF91036410,0.0,93.19,8144.68
2024-08-23,2024-08-23,Project payment - Customer_0038,REF72526139,0.0,73.42,8218.1
2024-08-23,2024-08-23,Invoice payment - Customer_0004,REF71730701,0.0,113.0,8331.1
2024-08-23,2024-08-23,Invoice payment - Customer_0054,REF66173459,0.0,114.87,8445.97
2024-08-23,2024-08-23,Invoice payment - Customer_0052,REF76663736,0.0,70.05,8516.02
2024-08-23,2024-08-23,Invoice payment - Customer_0061,REF12380117,0.0,49.25,8565.27
2024-08-23,2024-08-23,Project payment - Customer_0071,REF31317179,0.0,218.34,8783.61
2024-08-23,2024-08-23,Service payment - Customer_0024,REF12007507,0.0,46.34,8829.95
2024-08-24,2024-08-24,Payment from Customer_0091,REF96011664,0.0,77.99,8907.94
2024-08-24,2024-08-24,Invoice payment - Customer_0040,REF81476099,0.0,56.78,8964.72
2024-08-24,2024-08-24,Invoice payment - Customer_0055,REF14386677,0.0,86.11,9050.83
2024-08-24,2024-08-24,Invoice payment - Customer_0005,REF76692583,0.0,41.16,9091.99
2024-08-24,2024-08-24,Payment from Customer_0030,REF70933382,0.0,54.13,9146.12
2024-08-24,2024-08-24,Payment from Customer_0020,REF11345335,0.0,78.83,9224.95
2024-08-24,2024-08-24,Payment from Customer_0016,REF98595403,0.0,16.07,9241.02
2024-08-24,2024-08-24,Payment from Customer_0076,REF68416161,0.0,65.8,9306.82
2024-08-24,2024-08-24,Service payment - Customer_0097,REF99050373,0.0,41.43,9348.25
2024-08-24,2024-08-24,Invoice payment - Customer_0088,REF13778389,0.0,79.91,9428.16
2024-08-25,2024-08-25,Payment from Customer_0075,REF26146004,0.0,111.58,9539.74
2024-08-25,2024-08-25,Service payment - Customer_0023,REF46657607,0.0,105.94,9645.68
2024-08-25,2024-08-25,Project payment - Customer_0086,REF66455685,0.0,79.73,9725.41
2024-08-25,2024-08-25,Service payment - Customer_0066,REF67379423,0.0,81.8,9807.21
2024-08-25,2024-08-25,Invoice payment - Customer_0013,REF21666769,0.0,88.09,9895.3
2024-08-25,2024-08-25,Project payment - Customer_0091,REF13921231,0.0,77.31,9972.61
2024-08-25,2024-08-25,Payment from Customer_0030,REF29768279,0.0,41.57,10014.18
2024-08-25,2024-08-25,Service payment - Customer_0074,REF59463122,0.0,39.47,10053.65
2024-08-25,2024-08-25,Project payment - Customer_0028,REF56920022,0.0,47.4,10101.05
2024-08-25,2024-08-25,Payment from Customer_0019,REF17399073,0.0,54.48,10155.53
2024-08-25,2024-08-25,Project payment - Customer_0051,REF59197400,0.0,61.54,10217.07
2024-08-25,2024-08-25,Payment from Customer_0049,REF35428347,0.0,102.99,10320.06
2024-08-26,2024-08-26,Invoice payment - Customer_0094,REF88087771,0.0,104.9,10424.96
2024-08-26,2024-08-26,Project payment - Customer_0054,REF72329616,0.0,108.47,10533.43
2024-08-26,2024-08-26,Project payment - Customer_0042,REF40774547,0.0,27.91,10561.34
2024-08-26,2024-08-26,Project payment - Customer_0040,REF39011198,0.0,71.33,10632.67
2024-08-26,2024-08-26,Service payment - Customer_0070,REF27595195,0.0,36.16,10668.83
2024-08-26,2024-08-26,Project payment - Customer_0009,REF55823948,0.0,68.02,10736.85
2024-08-26,2024-08-26,Project payment - Customer_0032,REF61555056,0.0,81.85,10818.7
2024-08-26,2024-08-26,Service payment - Customer_0047,REF63088262,0.0,83.49,10902.19
2024-08-26,2024-08-26,Invoice payment - Customer_0082,REF96629736,0.0,37.03,10939.22
2024-08-26,2024-08-26,Service payment - Customer_0043,REF29427978,0.0,114.12,11053.34
2024-08-26,2024-08-26,Invoice payment - Customer_0007,REF17604808,0.0,38.16,11091.5
2024-08-26,2024-08-26,Project payment - Customer_0016,REF29381932,0.0,18.48,11109.98
2024-08-26,2024-08-26,Payment from Customer_0078,REF55801156,0.0,45.45,11155.43
2024-08-26,2024-08-26,Invoice payment - Customer_0080,REF64625678,0.0,143.96,11299.39
2024-08-26,2024-08-26,Payment from Customer_0081,REF42643333,0.0,92.31,11391.7
2024-08-27,2024-08-27,Project payment - Customer_0065,REF65814183,0.0,86.59,11478.29
2024-08-27,2024-08-27,Service payment - Customer_0014,REF90344475,0.0,10.0,11488.29
2024-08-27,2024-08-27,Invoice payment - Customer_0026,REF24053049,0.0,31.32,11519.61
2024-08-27,2024-08-27,Service payment - Customer_0008,REF44619678,0.0,99.54,11619.15
2024-08-27,2024-08-27,Project payment - Customer_0061,REF32183738,0.0,55.39,11674.54
2024-08-27,2024-08-27,Invoice payment - Customer_0058,REF56821045,0.0,65.61,11740.15
2024-08-27,2024-08-27,Invoice payment - Customer_0032,REF24770916,0.0,80.18,11820.33
2024-08-27,2024-08-27,Invoice payment - Customer_0083,REF65803663,0.0,71.33,11891.66
2024-08-28,2024-08-28,Service payment - Customer_0002,REF26266386,0.0,80.17,11971.83
2024-08-28,2024-08-28,Project payment - Customer_0098,REF88512101,0.0,62.84,12034.67
2024-08-28,2024-08-28,Project payment - Customer_0013,REF78004194,0.0,83.84,12118.51
2024-08-28,2024-08-28,Invoice payment - Customer_0026,REF40269276,0.0,39.17,12157.68
2024-08-28,2024-08-28,Project payment - Customer_0065,REF59980485,0.0,101.16,12258.84
2024-08-28,2024-08-28,Invoice payment - Customer_0086,REF98294350,0.0,74.58,12333.42
2024-08-28,2024-08-28,Service payment - Customer_0095,REF31512865,0.0,26.59,12360.01
2024-08-28,2024-08-28,Invoice payment - Customer_0024,REF49376335,0.0,50.31,12410.32
2024-08-29,2024-08-29,Project payment - Customer_0015,REF51272913,0.0,34.72,12445.04
2024-08-29,2024-08-29,Invoice payment - Customer_0004,REF16521760,0.0,109.76,12554.8
2024-08-29,2024-08-29,Invoice payment - Customer_0094,REF90593335,0.0,111.02,12665.82
2024-08-29,2024-08-29,Project payment - Customer_0084,REF32578378,0.0,110.8,12776.62
2024-08-29,2024-08-29,Project payment - Customer_0005,REF37127582,0.0,36.33,12812.95
2024-08-29,2024-08-29,Service payment - Customer_0059,REF97691774,0.0,10.0,12822.95
2024-08-29,2024-08-29,Invoice payment - Customer_0093,REF37173459,0.0,58.78,12881.73
2024-08-29,2024-08-29,Project payment - Customer_0002,REF44970988,0.0,65.85,12947.58
2024-08-29,2024-08-29,Payment from Customer_0081,REF14921276,0.0,75.2,13022.78
2024-08-29,2024-08-29,Service payment - Customer_0092,REF13760971,0.0,32.16,13054.94
2024-08-30,2024-08-30,Project payment - Customer_0084,REF11414584,0.0,144.73,13199.67
2024-08-30,2024-08-30,Invoice payment - Customer_0081,REF40445051,0.0,77.69,13277.36
2024-08-30,2024-08-30,Invoice payment - Customer_0057,REF85424948,0.0,98.51,13375.87
2024-08-30,2024-08-30,Service payment - Customer_0037,REF24750637,0.0,135.35,13511.22
2024-08-30,2024-08-30,Service payment - Customer_0067,REF61726863,0.0,56.35,13567.57
2024-08-30,2024-08-30,Payment from Customer_0060,REF57759529,0.0,54.12,13621.69
2024-08-30,2024-08-30,Payment from Customer_0087,REF17381921,0.0,144.28,13765.97
2024-08-30,2024-08-30,Payment from Customer_0061,REF76106612,0.0,62.84,13828.81
2024-08-30,2024-08-30,Project payment - Customer_0038,REF41834256,0.0,138.01,13966.82
2024-08-30,2024-08-30,Invoice payment - Customer_0086,REF47671557,0.0,55.08,14021.9
2024-08-31,2024-08-31,Payment from Customer_0031,REF79798380,0.0,61.96,14083.86
2024-08-31,2024-08-31,Project payment - Customer_0093,REF33668517,0.0,56.66,14140.52
2024-08-31,2024-08-31,Project payment - Customer_0034,REF61416223,0.0,120.37,14260.89
2024-08-31,2024-08-31,Payment from Customer_0014,REF12680157,0.0,11.87,14272.76
2024-08-31,2024-08-31,Invoice payment - Customer_0008,REF85975968,0.0,85.49,14358.25
2024-08-31,2024-08-31,Invoice payment - Customer_0052,REF78531940,0.0,72.49,14430.74
2024-08-31,2024-08-31,Invoice payment - Customer_0079,REF76915070,0.0,47.46,14478.2
2024-08-31,2024-08-31,Service payment - Customer_0025,REF51520409,0.0,18.9,14497.1
2024-08-31,2024-08-31,Invoice payment - Customer_0011,REF39493034,0.0,51.69,14548.79
2024-08-31,2024-08-31,Invoice payment - Customer_0099,REF43240097,0.0,46.2,14594.99
2024-09-01,2024-09-01,Service payment - Customer_0095,REF21440774,0.0,30.86,14625.85
2024-09-01,2024-09-01,Payment from Customer_0029,REF64815043,0.0,107.43,14733.28
2024-09-01,2024-09-01,Invoice payment - Customer_0081,REF24409524,0.0,93.13,14826.41
2024-09-01,2024-09-01,Service payment - Customer_0040,REF77858970,0.0,68.55,14894.96
2024-09-01,2024-09-01,Service payment - Customer_0027,REF91139398,0.0,37.81,14932.77
2024-09-01,2024-09-01,Service payment - Customer_0009,REF25134130,0.0,63.01,14995.78
2024-09-01,2024-09-01,Payment from Customer_0045,REF70386133,0.0,200.19,15195.97
2024-09-01,2024-09-01,Payment from Customer_0030,REF36023925,0.0,46.26,15242.23
2024-09-01,2024-09-01,Invoice payment - Customer_0068,REF57889454,0.0,81.21,15323.44
2024-09-01,2024-09-01,Monthly office rent,REF95951681,1179.06,0.0,14144.38
2024-09-01,2024-09-01,Service payment - Customer_0044,REF99430198,0.0,59.57,14203.95
2024-09-01,2024-09-01,Service payment - Customer_0096,REF83274398,0.0,54.43,14258.38
2024-09-01,2024-09-01,Project payment - Customer_0093,REF54891546,0.0,63.04,14321.42
2024-09-02,2024-09-02,Project payment - Customer_0020,REF75361115,0.0,80.21,14401.63
2024-09-02,2024-09-02,Service payment - Customer_0013,REF87562688,0.0,85.77,14487.4
2024-09-02,2024-09-02,Service payment - Customer_0052,REF37622209,0.0,71.87,14559.27
2024-09-02,2024-09-02,Professional Services expense,REF78923315,106.07,0.0,14453.2
2024-09-02,2024-09-02,Payment from Customer_0095,REF84977190,0.0,31.35,14484.55
2024-09-02,2024-09-02,Payment from Customer_0028,REF51692293,0.0,56.41,14540.96
2024-09-02,2024-09-02,Payment from Customer_0042,REF75900567,0.0,33.77,14574.73
2024-09-02,2024-09-02,Project payment - Customer_0004,REF51059597,0.0,121.67,14696.4
2024-09-02,2024-09-02,Payment from Customer_0036,REF31209528,0.0,45.35,14741.75
2024-09-02,2024-09-02,Invoice payment - Customer_0080,REF50350169,0.0,159.72,14901.47
2024-09-02,2024-09-02,Service payment - Customer_0082,REF91800089,0.0,45.86,14947.33
2024-09-03,2024-09-03,Payment from Customer_0085,REF89811716,0.0,42.27,14989.6
2024-09-03,2024-09-03,Payment from Customer_0084,REF57832007,0.0,114.23,15103.83
2024-09-03,2024-09-03,Invoice payment - Customer_0034,REF78560129,0.0,214.93,15318.76
2024-09-03,2024-09-03,Payment from Customer_0023,REF94036620,0.0,92.66,15411.42
2024-09-03,2024-09-03,Invoice payment - Customer_0065,REF61968325,0.0,108.39,15519.81
2024-09-03,2024-09-03,Service payment - Customer_0030,REF67688675,0.0,46.12,15565.93
2024-09-03,2024-09-03,Payment from Customer_0039,REF91804348,0.0,76.41,15642.34
2024-09-03,2024-09-03,Project payment - Customer_0020,REF46474437,0.0,72.77,15715.11
2024-09-03,2024-09-03,Project payment - Customer_0070,REF50300621,0.0,45.08,15760.19
2024-09-04,2024-09-04,Inventory purchase,REF89278891,3748.92,0.0,12011.27
2024-09-04,2024-09-04,Payment from Customer_0035,REF79855164,0.0,96.12,12107.39
2024-09-04,2024-09-04,Service payment - Customer_0060,REF92958967,0.0,45.43,12152.82
2024-09-04,2024-09-04,Service payment - Customer_0031,REF93949488,0.0,89.25,12242.07
2024-09-04,2024-09-04,Invoice payment - Customer_0023,REF67635543,0.0,97.61,12339.68
2024-09-04,2024-09-04,Project payment - Customer_0043,REF51798990,0.0,103.18,12442.86
2024-09-04,2024-09-04,Invoice payment - Customer_0077,REF79908457,0.0,66.6,12509.46
2024-09-04,2024-09-04,Service payment - Customer_0098,REF92949836,0.0,73.53,12582.99
2024-09-05,2024-09-05,Service payment - Customer_0017,REF40244314,0.0,81.96,12664.95
2024-09-05,2024-09-05,Project payment - Customer_0054,REF54668838,0.0,117.49,12782.44
2024-09-05,2024-09-05,Service payment - Customer_0010,REF46397905,0.0,131.34,12913.78
2024-09-05,2024-09-05,Project payment - Customer_0061,REF58222620,0.0,40.04,12953.82
2024-09-05,2024-09-05,Service payment - Customer_0004,REF14781688,0.0,121.98,13075.8
2024-09-05,2024-09-05,Service payment - Customer_0000,REF90576491,0.0,153.89,13229.69
2024-09-05,2024-09-05,Project payment - Customer_0059,REF70453849,0.0,10.1,13239.79
2024-09-05,2024-09-05,Service payment - Customer_0087,REF83011986,0.0,107.27,13347.06
2024-09-05,2024-09-05,Invoice payment - Customer_0007,REF14444438,0.0,69.59,13416.65
2024-09-05,2024-09-05,Invoice payment - Customer_0055,REF33987497,0.0,117.05,13533.7
2024-09-05,2024-09-05,Payment from Customer_0044,REF73067322,0.0,51.86,13585.56
2024-09-06,2024-09-06,Invoice payment - Customer_0067,REF21017013,0.0,60.11,13645.67
2024-09-06,2024-09-06,Project payment - Customer_0075,REF10235304,0.0,77.93,13723.6
2024-09-06,2024-09-06,Invoice payment - Customer_0018,REF66263087,0.0,104.31,13827.91
2024-09-06,2024-09-06,Invoice payment - Customer_0066,REF20990894,0.0,72.29,13900.2
2024-09-06,2024-09-06,Service payment - Customer_0022,REF30964434,0.0,105.54,14005.74
2024-09-06,2024-09-06,Service payment - Customer_0058,REF44368768,0.0,57.56,14063.3
2024-09-06,2024-09-06,Payment from Customer_0042,REF64485447,0.0,36.22,14099.52
2024-09-06,2024-09-06,Service payment - Customer_0088,REF28943664,0.0,71.51,14171.03
2024-09-06,2024-09-06,Project payment - Customer_0036,REF32156023,0.0,50.32,14221.35
2024-09-06,2024-09-06,Payment from Customer_0080,REF66245306,0.0,119.76,14341.11
2024-09-06,2024-09-06,Payment from Customer_0004,REF55331865,0.0,114.41,14455.52
2024-09-07,2024-09-07,Service payment - Customer_0088,REF65313462,0.0,79.49,14535.01
2024-09-07,2024-09-07,Invoice payment - Customer_0096,REF81006225,0.0,62.91,14597.92
2024-09-07,2024-09-07,Project payment - Customer_0019,REF92183614,0.0,44.51,14642.43
2024-09-07,2024-09-07,Service payment - Customer_0060,REF33468688,0.0,54.81,14697.24
2024-09-07,2024-09-07,Project payment - Customer_0067,REF80384513,0.0,55.26,14752.5
2024-09-07,2024-09-07,Payment from Customer_0063,REF50932850,0.0,41.79,14794.29
2024-09-07,2024-09-07,Project payment - Customer_0098,REF50871687,0.0,70.71,14865.0
2024-09-08,2024-09-08,Project payment - Customer_0046,REF93293628,0.0,115.39,14980.39
2024-09-08,2024-09-08,Service payment - Customer_0021,REF88212933,0.0,89.01,15069.4
2024-09-08,2024-09-08,Service payment - Customer_0013,REF65906668,0.0,97.91,15167.31
2024-09-08,2024-09-08,Service payment - Customer_0099,REF67466635,0.0,73.89,15241.2
2024-09-08,2024-09-08,Project payment - Customer_0044,REF87447240,0.0,44.8,15286.0
2024-09-08,2024-09-08,Project payment - Customer_0012,REF29091471,0.0,139.14,15425.14
2024-09-09,2024-09-09,Project payment - Customer_0052,REF33701555,0.0,77.59,15502.73
2024-09-09,2024-09-09,Service payment - Customer_0024,REF54977168,0.0,43.99,15546.72
2024-09-09,2024-09-09,Payment from Customer_0090,REF35158789,0.0,75.04,15621.76
2024-09-09,2024-09-09,Service payment - Customer_0034,REF11709471,0.0,183.92,15805.68
2024-09-09,2024-09-09,Payment from Customer_0026,REF87389159,0.0,34.08,15839.76
2024-09-09,2024-09-09,Project payment - Customer_0055,REF10639178,0.0,133.13,15972.89
2024-09-09,2024-09-09,Invoice payment - Customer_0061,REF56136860,0.0,81.51,16054.4
2024-09-09,2024-09-09,Service payment - Customer_0002,REF94273205,0.0,59.45,16113.85
2024-09-09,2024-09-09,Payment from Customer_0093,REF81301515,0.0,59.53,16173.38
2024-09-09,2024-09-09,Payment from Customer_0016,REF34682713,0.0,13.11,16186.49
2024-09-09,2024-09-09,Payment from Customer_0062,REF79038556,0.0,57.3,16243.79
2024-09-09,2024-09-09,Payment from Customer_0041,REF21503939,0.0,95.83,16339.62
2024-09-10,2024-09-10,Service payment - Customer_0021,REF96214297,0.0,86.12,16425.74
2024-09-10,2024-09-10,Service payment - Customer_0026,REF83583256,0.0,36.57,16462.31
2024-09-10,2024-09-10,Payment from Customer_0092,REF48083773,0.0,48.4,16510.71
2024-09-10,2024-09-10,Service payment - Customer_0065,REF95089488,0.0,90.5,16601.21
2024-09-10,2024-09-10,Project payment - Customer_0040,REF39776330,0.0,55.86,16657.07
2024-09-10,2024-09-10,Payment from Customer_0073,REF63086560,0.0,36.4,16693.47
2024-09-10,2024-09-10,Service payment - Customer_0037,REF49389715,0.0,99.56,16793.03
2024-09-10,2024-09-10,Service payment - Customer_0043,REF92184635,0.0,112.7,16905.73
2024-09-11,2024-09-11,Project payment - Customer_0026,REF66585478,0.0,36.48,16942.21
2024-09-11,2024-09-11,Invoice payment - Customer_0075,REF21092748,0.0,85.02,17027.23
2024-09-11,2024-09-11,Invoice payment - Customer_0080,REF17486904,0.0,126.71,17153.94
2024-09-11,2024-09-11,Project payment - Customer_0059,REF49840048,0.0,10.0,17163.94
2024-09-11,2024-09-11,Project payment - Customer_0049,REF27976325,0.0,72.48,17236.42
2024-09-11,2024-09-11,Invoice payment - Customer_0099,REF91426805,0.0,50.43,17286.85
2024-09-11,2024-09-11,Service payment - Customer_0069,REF48336158,0.0,79.41,17366.26
2024-09-11,2024-09-11,Service payment - Customer_0001,REF80747317,0.0,82.07,17448.33
2024-09-11,2024-09-11,Service payment - Customer_0022,REF34548257,0.0,142.69,17591.02
2024-09-11,2024-09-11,Invoice payment - Customer_0038,REF73630935,0.0,114.1,17705.12
2024-09-12,2024-09-12,Payment from Customer_0084,REF12590633,0.0,87.86,17792.98
2024-09-12,2024-09-12,Invoice payment - Customer_0031,REF29048169,0.0,92.92,17885.9
2024-09-12,2024-09-12,Payment from Customer_0012,REF48060849,0.0,137.13,18023.03
2024-09-12,2024-09-12,Service payment - Customer_0097,REF48435585,0.0,51.26,18074.29
2024-09-12,2024-09-12,Service payment - Customer_0072,REF54251343,0.0,70.7,18144.99
2024-09-12,2024-09-12,Service payment - Customer_0089,REF39490584,0.0,92.12,18237.11
2024-09-12,2024-09-12,Project payment - Customer_0045,REF17015503,0.0,167.81,18404.92
2024-09-12,2024-09-12,Payment from Customer_0017,REF77134734,0.0,73.33,18478.25
2024-09-12,2024-09-12,Service payment - Customer_0039,REF39042621,0.0,64.8,18543.05
2024-09-13,2024-09-13,Payment from Customer_0088,REF81929384,0.0,72.52,18615.57
2024-09-13,2024-09-13,Project payment - Customer_0005,REF19502491,0.0,48.77,18664.34
2024-09-13,2024-09-13,Invoice payment - Customer_0006,REF26039759,0.0,77.14,18741.48
2024-09-13,2024-09-13,Service payment - Customer_0026,REF55555229,0.0,38.66,18780.14
2024-09-13,2024-09-13,Invoice payment - Customer_0012,REF62283461,0.0,101.44,18881.58
2024-09-13,2024-09-13,Payment from Customer_0035,REF29455397,0.0,89.49,18971.07
2024-09-13,2024-09-13,Project payment - Customer_0051,REF45039036,0.0,102.99,19074.06
2024-09-13,2024-09-13,Project payment - Customer_0010,REF81968550,0.0,133.46,19207.52
2024-09-13,2024-09-13,Service payment - Customer_0048,REF33182221,0.0,99.93,19307.45
2024-09-14,2024-09-14,Professional Services expense,REF30325048,210.08,0.0,19097.37
2024-09-14,2024-09-14,Project payment - Customer_0086,REF83218162,0.0,56.73,19154.1
2024-09-14,2024-09-14,Payment from Customer_0025,REF44265384,0.0,19.24,19173.34
2024-09-14,2024-09-14,Invoice payment - Customer_0028,REF67312080,0.0,53.96,19227.3
2024-09-14,2024-09-14,Project payment - Customer_0049,REF50897161,0.0,93.77,19321.07
2024-09-14,2024-09-14,Service payment - Customer_0048,REF34587276,0.0,132.09,19453.16
2024-09-14,2024-09-14,Service payment - Customer_0079,REF52828621,0.0,41.44,19494.6
2024-09-14,2024-09-14,Service payment - Customer_0096,REF17713257,0.0,61.94,19556.54
2024-09-14,2024-09-14,Employee payroll,REF96935339,1380.55,0.0,18175.99
2024-09-14,2024-09-14,Invoice payment - Customer_0012,REF20378132,0.0,119.56,18295.55
2024-09-14,2024-09-14,Service payment - Customer_0037,REF78486872,0.0,93.86,18389.41
2024-09-14,2024-09-14,Invoice payment - Customer_0056,REF94821887,0.0,105.67,18495.08
2024-09-14,2024-09-14,Payment from Customer_0041,REF26366434,0.0,75.32,18570.4
2024-09-14,2024-09-14,Project payment - Customer_0081,REF82713112,0.0,103.77,18674.17
2024-09-15,2024-09-15,Project payment - Customer_0049,REF62384644,0.0,111.9,18786.07
2024-09-15,2024-09-15,Project payment - Customer_0031,REF22964007,0.0,73.42,18859.49
2024-09-15,2024-09-15,Payment from Customer_0007,REF57997142,0.0,54.13,18913.62
2024-09-15,2024-09-15,Business insurance premium,REF20131427,174.25,0.0,18739.37
2024-09-15,2024-09-15,Payment from Customer_0041,REF79591454,0.0,116.35,18855.72
2024-09-15,2024-09-15,Project payment - Customer_0085,REF89232285,0.0,38.25,18893.97
2024-09-15,2024-09-15,Project payment - Customer_0079,REF91107507,0.0,43.73,18937.7
2024-09-15,2024-09-15,Service payment - Customer_0061,REF95936072,0.0,54.76,18992.46
2024-09-15,2024-09-15,Payment from Customer_0004,REF36618379,0.0,86.53,19078.99
2024-09-15,2024-09-15,Project payment - Customer_0025,REF26159672,0.0,16.46,19095.45
2024-09-15,2024-09-15,Service payment - Customer_0067,REF65539542,0.0,66.39,19161.84
2024-09-15,2024-09-15,Invoice payment - Customer_0069,REF49560452,0.0,66.45,19228.29
2024-09-15,2024-09-15,Payment from Customer_0050,REF33130272,0.0,102.22,19330.51
2024-09-15,2024-09-15,Payment from Customer_0019,REF50603667,0.0,39.0,19369.51
2024-09-16,2024-09-16,Service payment - Customer_0087,REF88701758,0.0,109.04,19478.55
2024-09-16,2024-09-16,Project payment - Customer_0050,REF24331752,0.0,87.3,19565.85
2024-09-16,2024-09-16,Payment from Customer_0057,REF30171230,0.0,103.75,19669.6
2024-09-16,2024-09-16,Payment from Customer_0097,REF95778613,0.0,33.77,19703.37
2024-09-16,2024-09-16,Project payment - Customer_0043,REF73464304,0.0,125.34,19828.71
2024-09-16,2024-09-16,Project payment - Customer_0016,REF46041421,0.0,14.48,19843.19
2024-09-16,2024-09-16,Project payment - Customer_0073,REF90694184,0.0,47.76,19890.95
2024-09-16,2024-09-16,Invoice payment - Customer_0031,REF31774897,0.0,99.28,19990.23
2024-09-16,2024-09-16,Project payment - Customer_0040,REF53447385,0.0,78.75,20068.98
2024-09-16,2024-09-16,Professional Services expense,REF77279042,145.21,0.0,19923.77
2024-09-17,2024-09-17,Inventory purchase,REF67269332,2345.27,0.0,17578.5
2024-09-17,2024-09-17,Project payment - Customer_0040,REF61523416,0.0,50.06,17628.56
2024-09-17,2024-09-17,Service payment - Customer_0029,REF57236526,0.0,76.72,17705.28
2024-09-17,2024-09-17,Invoice payment - Customer_0049,REF80359598,0.0,136.52,17841.8
2024-09-17,2024-09-17,Invoice payment - Customer_0021,REF24246574,0.0,90.23,17932.03
2024-09-17,2024-09-17,Service payment - Customer_0023,REF58865279,0.0,109.92,18041.95
2024-09-17,2024-09-17,Project payment - Customer_0005,REF37977678,0.0,40.61,18082.56
2024-09-17,2024-09-17,Project payment - Customer_0087,REF26312916,0.0,105.62,18188.18
2024-09-18,2024-09-18,Service payment - Customer_0041,REF89244929,0.0,102.84,18291.02
2024-09-18,2024-09-18,Service payment - Customer_0045,REF33204724,0.0,192.61,18483.63
2024-09-18,2024-09-18,Project payment - Customer_0024,REF31576828,0.0,53.28,18536.91
2024-09-18,2024-09-18,Invoice payment - Customer_0031,REF78150942,0.0,97.81,18634.72
2024-09-18,2024-09-18,Project payment - Customer_0094,REF78726982,0.0,114.84,18749.56
2024-09-18,2024-09-18,Project payment - Customer_0026,REF65960221,0.0,41.78,18791.34
2024-09-18,2024-09-18,Service payment - Customer_0002,REF61166986,0.0,79.32,18870.66
2024-09-19,2024-09-19,Invoice payment - Customer_0099,REF92808268,0.0,75.85,18946.51
2024-09-19,2024-09-19,Invoice payment - Customer_0093,REF86921840,0.0,58.82,19005.33
2024-09-19,2024-09-19,Project payment - Customer_0008,REF73852892,0.0,86.81,19092.14
2024-09-19,2024-09-19,Payment from Customer_0017,REF84246312,0.0,106.43,19198.57
2024-09-19,2024-09-19,Service payment - Customer_0034,REF20562334,0.0,160.28,19358.85
2024-09-19,2024-09-19,Project payment - Customer_0066,REF92318808,0.0,81.7,19440.55
2024-09-20,2024-09-20,Invoice payment - Customer_0067,REF15414943,0.0,86.13,19526.68
2024-09-20,2024-09-20,Service payment - Customer_0030,REF75681998,0.0,57.6,19584.28
2024-09-20,2024-09-20,Invoice payment - Customer_0094,REF70928723,0.0,100.24,19684.52
2024-09-20,2024-09-20,Project payment - Customer_0098,REF85953656,0.0,84.87,19769.39
2024-09-20,2024-09-20,Invoice payment - Customer_0008,REF22708228,0.0,92.04,19861.43
2024-09-20,2024-09-20,Payment from Customer_0092,REF99694048,0.0,41.35,19902.78
2024-09-20,2024-09-20,Service payment - Customer_0001,REF59729501,0.0,70.58,19973.36
2024-09-20,2024-09-20,Service payment - Customer_0058,REF87997451,0.0,41.12,20014.48
2024-09-20,2024-09-20,Project payment - Customer_0039,REF54149112,0.0,63.54,20078.02
2024-09-20,2024-09-20,Service payment - Customer_0025,REF96481092,0.0,14.27,20092.29
2024-09-20,2024-09-20,Project payment - Customer_0084,REF76784622,0.0,107.05,20199.34
2024-09-20,2024-09-20,Project payment - Customer_0006,REF74220792,0.0,82.86,20282.2
2024-09-20,2024-09-20,Service payment - Customer_0010,REF13435723,0.0,125.72,20407.92
2024-09-21,2024-09-21,Payment from Customer_0074,REF16653254,0.0,34.82,20442.74
2024-09-21,2024-09-21,Service payment - Customer_0022,REF61749408,0.0,157.69,20600.43
2024-09-21,2024-09-21,Payment from Customer_0063,REF45127417,0.0,52.26,20652.69
2024-09-21,2024-09-21,Service payment - Customer_0079,REF69062059,0.0,42.13,20694.82
2024-09-21,2024-09-21,Project payment - Customer_0029,REF86158782,0.0,106.01,20800.83
2024-09-21,2024-09-21,Service payment - Customer_0005,REF17413974,0.0,43.35,20844.18
2024-09-21,2024-09-21,Invoice payment - Customer_0038,REF73411175,0.0,96.22,20940.4
2024-09-21,2024-09-21,Invoice payment - Customer_0000,REF16419164,0.0,129.37,21069.77
2024-09-21,2024-09-21,Project payment - Customer_0013,REF20831859,0.0,104.97,21174.74
2024-09-22,2024-09-22,Payment from Customer_0082,REF16924427,0.0,37.42,21212.16
2024-09-22,2024-09-22,Utility bill payment,REF94984428,135.31,0.0,21076.85
2024-09-22,2024-09-22,Project payment - Customer_0014,REF55455258,0.0,10.87,21087.72
2024-09-22,2024-09-22,Project payment - Customer_0092,REF84026149,0.0,44.28,21132.0
2024-09-22,2024-09-22,Invoice payment - Customer_0096,REF84953917,0.0,61.04,21193.04
2024-09-22,2024-09-22,Project payment - Customer_0011,REF24717366,0.0,61.49,21254.53
2024-09-22,2024-09-22,Project payment - Customer_0051,REF41141130,0.0,71.15,21325.68
2024-09-22,2024-09-22,Payment from Customer_0009,REF82087599,0.0,57.15,21382.83
2024-09-23,2024-09-23,Project payment - Customer_0081,REF39155484,0.0,104.7,21487.53
2024-09-23,2024-09-23,Payment from Customer_0012,REF27921313,0.0,129.1,21616.63
2024-09-23,2024-09-23,Service payment - Customer_0013,REF15060209,0.0,97.41,21714.04
2024-09-23,2024-09-23,Payment from Customer_0084,REF79052385,0.0,153.36,21867.4
2024-09-23,2024-09-23,Project payment - Customer_0076,REF53316613,0.0,69.2,21936.6
2024-09-23,2024-09-23,Service payment - Customer_0023,REF40629213,0.0,98.43,22035.03
2024-09-23,2024-09-23,Service payment - Customer_0044,REF35988314,0.0,54.83,22089.86
2024-09-23,2024-09-23,Service payment - Customer_0032,REF50019768,0.0,92.14,22182.0
2024-09-23,2024-09-23,Service payment - Customer_0005,REF20498558,0.0,49.59,22231.59
2024-09-23,2024-09-23,Payment from Customer_0065,REF41592218,0.0,118.1,22349.69
2024-09-24,2024-09-24,Payment from Customer_0010,REF72263136,0.0,132.0,22481.69
2024-09-24,2024-09-24,Service payment - Customer_0041,REF28903221,0.0,125.9,22607.59
2024-09-24,2024-09-24,Invoice payment - Customer_0083,REF84772202,0.0,73.25,22680.84
2024-09-24,2024-09-24,Project payment - Customer_0031,REF50325904,0.0,85.32,22766.16
2024-09-25,2024-09-25,Project payment - Customer_0059,REF57225552,0.0,10.11,22776.27
2024-09-25,2024-09-25,Payment from Customer_0008,REF22394496,0.0,75.71,22851.98
2024-09-25,2024-09-25,Service payment - Customer_0090,REF89047621,0.0,65.6,22917.58
2024-09-25,2024-09-25,Project payment - Customer_0036,REF63673943,0.0,42.0,22959.58
2024-09-25,2024-09-25,Service payment - Customer_0099,REF54272686,0.0,64.73,23024.31
2024-09-25,2024-09-25,Project payment - Customer_0034,REF72172615,0.0,212.84,23237.15
2024-09-25,2024-09-25,Service payment - Customer_0024,REF19326075,0.0,44.47,23281.62
2024-09-25,2024-09-25,Invoice payment - Customer_0037,REF15584038,0.0,91.91,23373.53
2024-09-25,2024-09-25,Payment from Customer_0043,REF91235323,0.0,116.9,23490.43
2024-09-25,2024-09-25,Payment from Customer_0040,REF90114385,0.0,54.0,23544.43
2024-09-25,2024-09-25,Invoice payment - Customer_0051,REF86504600,0.0,81.48,23625.91
2024-09-25,2024-09-25,Invoice payment - Customer_0044,REF77963784,0.0,60.7,23686.61
2024-09-25,2024-09-25,Invoice payment - Customer_0079,REF70345969,0.0,48.16,23734.77
2024-09-25,2024-09-25,Payment from Customer_0072,REF60793333,0.0,64.95,23799.72
2024-09-26,2024-09-26,Service payment - Customer_0004,REF97054135,0.0,118.8,23918.52
2024-09-26,2024-09-26,Payment from Customer_0065,REF70674022,0.0,84.05,24002.57
2024-09-26,2024-09-26,Service payment - Customer_0096,REF53025954,0.0,63.75,24066.32
2024-09-26,2024-09-26,Service payment - Customer_0048,REF36935574,0.0,91.69,24158.01
2024-09-26,2024-09-26,Payment from Customer_0000,REF91093146,0.0,126.35,24284.36
2024-09-26,2024-09-26,Invoice payment - Customer_0051,REF30176720,0.0,103.85,24388.21
2024-09-26,2024-09-26,Payment from Customer_0035,REF45140206,0.0,96.19,24484.4
2024-09-26,2024-09-26,Project payment - Customer_0058,REF81070142,0.0,45.63,24530.03
2024-09-26,2024-09-26,Service payment - Customer_0019,REF95966299,0.0,45.3,24575.33
2024-09-26,2024-09-26,Invoice payment - Customer_0069,REF63108386,0.0,82.37,24657.7
2024-09-26,2024-09-26,Payment from Customer_0010,REF79205336,0.0,93.46,24751.16
2024-09-26,2024-09-26,Service payment - Customer_0085,REF23418774,0.0,32.66,24783.82
2024-09-27,2024-09-27,Service payment - Customer_0039,REF22488709,0.0,55.38,24839.2
2024-09-27,2024-09-27,Payment from Customer_0002,REF14023482,0.0,74.45,24913.65
2024-09-27,2024-09-27,Invoice payment - Customer_0049,REF90734583,0.0,95.1,25008.75
2024-09-27,2024-09-27,Project payment - Customer_0004,REF99205884,0.0,130.78,25139.53
2024-09-27,2024-09-27,Payment from Customer_0020,REF76544198,0.0,62.79,25202.32
2024-09-28,2024-09-28,Payment from Customer_0079,REF29394596,0.0,53.39,25255.71
2024-09-28,2024-09-28,Project payment - Customer_0064,REF61241937,0.0,152.1,25407.81
2024-09-28,2024-09-28,Payment from Customer_0027,REF59702724,0.0,44.33,25452.14
2024-09-28,2024-09-28,Project payment - Customer_0050,REF67437310,0.0,157.72,25609.86
2024-09-28,2024-09-28,Service payment - Customer_0043,REF47314380,0.0,106.93,25716.79
2024-09-29,2024-09-29,Invoice payment - Customer_0082,REF21437412,0.0,31.47,25748.26
2024-09-29,2024-09-29,Service payment - Customer_0000,REF54199097,0.0,171.33,25919.59
2024-09-29,2024-09-29,Payment from Customer_0075,REF28528595,0.0,104.96,26024.55
2024-09-29,2024-09-29,Project payment - Customer_0004,REF40909244,0.0,104.19,26128.74
2024-09-29,2024-09-29,Invoice payment - Customer_0018,REF58398861,0.0,151.73,26280.47
2024-09-29,2024-09-29,Project payment - Customer_0020,REF66275295,0.0,80.19,26360.66
2024-09-29,2024-09-29,Service payment - Customer_0042,REF77648373,0.0,30.41,26391.07
2024-09-29,2024-09-29,Invoice payment - Customer_0085,REF97661074,0.0,42.96,26434.03
2024-09-29,2024-09-29,Payment from Customer_0097,REF27161372,0.0,54.27,26488.3
2024-09-29,2024-09-29,Service payment - Customer_0022,REF13669041,0.0,103.06,26591.36
2024-09-29,2024-09-29,Payment from Customer_0091,REF85169553,0.0,80.3,26671.66
2024-09-30,2024-09-30,Project payment - Customer_0058,REF53007253,0.0,47.04,26718.7
2024-09-30,2024-09-30,Invoice payment - Customer_0051,REF42800636,0.0,89.15,26807.85
2024-09-30,2024-09-30,Payment from Customer_0083,REF78709831,0.0,47.49,26855.34
2024-09-30,2024-09-30,Invoice payment - Customer_0053,REF84793474,0.0,95.74,26951.08
2024-10-01,2024-10-01,Payment from Customer_0059,REF52958264,0.0,10.0,26961.08
2024-10-01,2024-10-01,Payment from Customer_0036,REF72846317,0.0,57.94,27019.02
2024-10-01,2024-10-01,Packaging Shipping expense,REF52924098,234.94,0.0,26784.08
2024-10-01,2024-10-01,Invoice payment - Customer_0001,REF99478462,0.0,94.54,26878.62
2024-10-01,2024-10-01,Project payment - Customer_0024,REF88402710,0.0,50.31,26928.93
2024-10-01,2024-10-01,Service payment - Customer_0069,REF94886431,0.0,103.66,27032.59
2024-10-01,2024-10-01,Monthly office rent,REF61647669,1208.23,0.0,25824.36
2024-10-02,2024-10-02,Invoice payment - Customer_0072,REF41748764,0.0,49.74,25874.1
2024-10-02,2024-10-02,Payment from Customer_0043,REF34720094,0.0,158.18,26032.28
2024-10-02,2024-10-02,Service payment - Customer_0022,REF57035952,0.0,144.93,26177.21
2024-10-02,2024-10-02,Payment from Customer_0026,REF32339045,0.0,44.74,26221.95
2024-10-02,2024-10-02,Payment from Customer_0012,REF82234587,0.0,125.39,26347.34
2024-10-02,2024-10-02,Payment from Customer_0029,REF71501592,0.0,93.22,26440.56
2024-10-02,2024-10-02,Payment from Customer_0032,REF25510414,0.0,88.57,26529.13
2024-10-03,2024-10-03,Project payment - Customer_0018,REF11513573,0.0,135.5,26664.63
2024-10-03,2024-10-03,Payment from Customer_0093,REF64003310,0.0,51.58,26716.21
2024-10-03,2024-10-03,Service payment - Customer_0024,REF45850921,0.0,52.43,26768.64
2024-10-03,2024-10-03,Service payment - Customer_0086,REF50096873,0.0,100.17,26868.81
2024-10-03,2024-10-03,Project payment - Customer_0039,REF18034362,0.0,72.97,26941.78
2024-10-03,2024-10-03,Invoice payment - Customer_0031,REF50180587,0.0,70.69,27012.47
2024-10-03,2024-10-03,Service payment - Customer_0058,REF40278324,0.0,61.6,27074.07
2024-10-03,2024-10-03,Project payment - Customer_0091,REF12386920,0.0,99.98,27174.05
2024-10-04,2024-10-04,Payment from Customer_0051,REF57423297,0.0,122.13,27296.18
2024-10-04,2024-10-04,Service payment - Customer_0084,REF87320296,0.0,104.1,27400.28
2024-10-04,2024-10-04,Invoice payment - Customer_0054,REF33292524,0.0,109.21,27509.49
2024-10-04,2024-10-04,Invoice payment - Customer_0064,REF19408874,0.0,101.34,27610.83
2024-10-04,2024-10-04,Payment from Customer_0042,REF16699935,0.0,33.12,27643.95
2024-10-04,2024-10-04,Invoice payment - Customer_0009,REF22995831,0.0,75.69,27719.64
2024-10-04,2024-10-04,Project payment - Customer_0000,REF59975604,0.0,164.58,27884.22
2024-10-04,2024-10-04,Payment from Customer_0069,REF24435002,0.0,83.24,27967.46
2024-10-04,2024-10-04,Service payment - Customer_0028,REF51300042,0.0,52.76,28020.22
2024-10-04,2024-10-04,Payment from Customer_0099,REF33393328,0.0,63.47,28083.69
2024-10-04,2024-10-04,Invoice payment - Customer_0057,REF85422529,0.0,135.65,28219.34
2024-10-04,2024-10-04,Invoice payment - Customer_0039,REF46223826,0.0,87.68,28307.02
2024-10-04,2024-10-04,Project payment - Customer_0034,REF97136458,0.0,192.47,28499.49
2024-10-05,2024-10-05,Invoice payment - Customer_0060,REF22677399,0.0,65.57,28565.06
2024-10-05,2024-10-05,Project payment - Customer_0018,REF63133895,0.0,86.97,28652.03
2024-10-05,2024-10-05,Payment from Customer_0024,REF92250397,0.0,52.49,28704.52
2024-10-05,2024-10-05,Invoice payment - Customer_0000,REF74158263,0.0,180.41,28884.93
2024-10-05,2024-10-05,Project payment - Customer_0038,REF50588310,0.0,120.94,29005.87
2024-10-05,2024-10-05,Payment from Customer_0094,REF93504945,0.0,152.84,29158.71
2024-10-05,2024-10-05,Payment from Customer_0028,REF41680502,0.0,64.37,29223.08
2024-10-05,2024-10-05,Payment from Customer_0055,REF13871392,0.0,132.68,29355.76
2024-10-05,2024-10-05,Payment from Customer_0048,REF37361011,0.0,110.56,29466.32
2024-10-05,2024-10-05,Invoice payment - Customer_0035,REF76631803,0.0,66.93,29533.25
2024-10-05,2024-10-05,Project payment - Customer_0041,REF40321597,0.0,160.19,29693.44
2024-10-05,2024-10-05,Service payment - Customer_0062,REF31368267,0.0,54.04,29747.48
2024-10-06,2024-10-06,Payment from Customer_0083,REF29675001,0.0,104.4,29851.88
2024-10-06,2024-10-06,Project payment - Customer_0065,REF34775723,0.0,113.12,29965.0
2024-10-06,2024-10-06,Project payment - Customer_0060,REF43301155,0.0,57.85,30022.85
2024-10-06,2024-10-06,Invoice payment - Customer_0018,REF11103901,0.0,143.74,30166.59
2024-10-06,2024-10-06,Inventory purchase,REF26870986,4785.78,0.0,25380.81
2024-10-06,2024-10-06,Service payment - Customer_0087,REF80759880,0.0,101.67,25482.48
2024-10-06,2024-10-06,Payment from Customer_0078,REF48193280,0.0,64.76,25547.24
2024-10-06,2024-10-06,Project payment - Customer_0056,REF19418575,0.0,100.32,25647.56
2024-10-06,2024-10-06,Service payment - Customer_0095,REF60913483,0.0,34.71,25682.27
2024-10-06,2024-10-06,Payment from Customer_0097,REF75445550,0.0,49.78,25732.05
2024-10-07,2024-10-07,Payment from Customer_0086,REF21983327,0.0,95.24,25827.29
2024-10-07,2024-10-07,Payment from Customer_0006,REF17272190,0.0,101.86,25929.15
2024-10-07,2024-10-07,Project payment - Customer_0051,REF29735004,0.0,129.95,26059.1
2024-10-07,2024-10-07,Payment from Customer_0003,REF99502050,0.0,84.75,26143.85
2024-10-07,2024-10-07,Payment from Customer_0071,REF49733358,0.0,135.8,26279.65
2024-10-07,2024-10-07,Payment from Customer_0082,REF20412038,0.0,40.52,26320.17
2024-10-07,2024-10-07,Service payment - Customer_0021,REF16677192,0.0,87.11,26407.28
2024-10-07,2024-10-07,Project payment - Customer_0043,REF41481108,0.0,135.08,26542.36
2024-10-07,2024-10-07,Payment from Customer_0009,REF70674124,0.0,67.11,26609.47
2024-10-08,2024-10-08,Project payment - Customer_0096,REF41073518,0.0,87.2,26696.67
2024-10-08,2024-10-08,Payment from Customer_0085,REF84784342,0.0,46.72,26743.39
2024-10-08,2024-10-08,Project payment - Customer_0040,REF49447250,0.0,74.74,26818.13
2024-10-08,2024-10-08,Payment from Customer_0074,REF60648602,0.0,30.56,26848.69
2024-10-08,2024-10-08,Payment from Customer_0049,REF98882182,0.0,103.79,26952.48
2024-10-08,2024-10-08,Invoice payment - Customer_0020,REF51358240,0.0,84.82,27037.3
2024-10-08,2024-10-08,Service payment - Customer_0017,REF56231077,0.0,82.31,27119.61
2024-10-09,2024-10-09,Invoice payment - Customer_0069,REF90141430,0.0,92.86,27212.47
2024-10-09,2024-10-09,Payment from Customer_0076,REF74250848,0.0,60.54,27273.01
2024-10-09,2024-10-09,Service payment - Customer_0064,REF43850673,0.0,131.71,27404.72
2024-10-09,2024-10-09,Invoice payment - Customer_0045,REF45681082,0.0,262.28,27667.0
2024-10-09,2024-10-09,Invoice payment - Customer_0097,REF13610662,0.0,51.41,27718.41
2024-10-09,2024-10-09,Service payment - Customer_0005,REF11700051,0.0,44.97,27763.38
2024-10-09,2024-10-09,Invoice payment - Customer_0030,REF69858559,0.0,53.07,27816.45
2024-10-09,2024-10-09,Service payment - Customer_0043,REF25301857,0.0,126.15,27942.6
2024-10-09,2024-10-09,Invoice payment - Customer_0025,REF92340448,0.0,20.37,27962.97
2024-10-09,2024-10-09,Invoice payment - Customer_0024,REF80306688,0.0,34.17,27997.14
2024-10-09,2024-10-09,Payment from Customer_0066,REF37346619,0.0,83.21,28080.35
2024-10-10,2024-10-10,Project payment - Customer_0051,REF59567864,0.0,77.3,28157.65
2024-10-10,2024-10-10,Invoice payment - Customer_0039,REF49987757,0.0,89.67,28247.32
2024-10-10,2024-10-10,Invoice payment - Customer_0034,REF73835328,0.0,161.57,28408.89
2024-10-10,2024-10-10,Project payment - Customer_0012,REF97543619,0.0,163.85,28572.74
2024-10-10,2024-10-10,Service payment - Customer_0098,REF69297339,0.0,98.02,28670.76
2024-10-10,2024-10-10,Payment from Customer_0046,REF73190340,0.0,93.04,28763.8
2024-10-10,2024-10-10,Project payment - Customer_0040,REF10557366,0.0,77.15,28840.95
2024-10-10,2024-10-10,Payment from Customer_0053,REF76302872,0.0,104.79,28945.74
2024-10-10,2024-10-10,Project payment - Customer_0085,REF99283150,0.0,38.58,28984.32
2024-10-10,2024-10-10,Service payment - Customer_0027,REF84135799,0.0,40.34,29024.66
2024-10-10,2024-10-10,Service payment - Customer_0065,REF15066565,0.0,95.52,29120.18
2024-10-11,2024-10-11,Service payment - Customer_0082,REF47972256,0.0,39.57,29159.75
2024-10-11,2024-10-11,Project payment - Customer_0034,REF70871504,0.0,153.75,29313.5
2024-10-11,2024-10-11,Invoice payment - Customer_0000,REF35310386,0.0,175.05,29488.55
2024-10-11,2024-10-11,Payment from Customer_0032,REF87583853,0.0,94.48,29583.03
2024-10-11,2024-10-11,Payment from Customer_0027,REF64726095,0.0,41.16,29624.19
2024-10-11,2024-10-11,Marketing expenses,REF76182629,350.05,0.0,29274.14
2024-10-11,2024-10-11,Payment from Customer_0075,REF62599133,0.0,97.78,29371.92
2024-10-11,2024-10-11,Invoice payment - Customer_0050,REF10569979,0.0,126.13,29498.05
2024-10-11,2024-10-11,Project payment - Customer_0097,REF26455601,0.0,48.83,29546.88
2024-10-11,2024-10-11,Inventory purchase,REF40540194,3397.39,0.0,26149.49
2024-10-12,2024-10-12,Invoice payment - Customer_0084,REF42032931,0.0,157.25,26306.74
2024-10-12,2024-10-12,Service payment - Customer_0095,REF30461442,0.0,43.52,26350.26
2024-10-12,2024-10-12,Payment from Customer_0071,REF76419620,0.0,185.25,26535.51
2024-10-12,2024-10-12,Invoice payment - Customer_0089,REF56724931,0.0,83.55,26619.06
2024-10-12,2024-10-12,Service payment - Customer_0000,REF39061229,0.0,178.7,26797.76
2024-10-12,2024-10-12,Payment from Customer_0098,REF28746802,0.0,78.5,26876.26
2024-10-12,2024-10-12,Service payment - Customer_0082,REF78802162,0.0,45.18,26921.44
2024-10-13,2024-10-13,Invoice payment - Customer_0044,REF15204876,0.0,60.23,26981.67
2024-10-13,2024-10-13,Payment from Customer_0002,REF56625795,0.0,89.99,27071.66
2024-10-13,2024-10-13,Service payment - Customer_0007,REF70419570,0.0,57.91,27129.57
2024-10-13,2024-10-13,Invoice payment - Customer_0089,REF71034414,0.0,103.43,27233.0
2024-10-13,2024-10-13,Service payment - Customer_0001,REF25046407,0.0,96.52,27329.52
2024-10-13,2024-10-13,Payment from Customer_0081,REF79950311,0.0,127.78,27457.3
2024-10-13,2024-10-13,Service payment - Customer_0086,REF69618395,0.0,77.55,27534.85
2024-10-13,2024-10-13,Service payment - Customer_0091,REF48727785,0.0,100.87,27635.72
2024-10-13,2024-10-13,Project payment - Customer_0093,REF52758377,0.0,74.0,27709.72
2024-10-13,2024-10-13,Invoice payment - Customer_0003,REF77971031,0.0,73.76,27783.48
2024-10-13,2024-10-13,Payment from Customer_0072,REF39073338,0.0,54.98,27838.46
2024-10-13,2024-10-13,Service payment - Customer_0047,REF89012039,0.0,94.02,27932.48
2024-10-13,2024-10-13,Service payment - Customer_0064,REF44735162,0.0,154.66,28087.14
2024-10-13,2024-10-13,Service payment - Customer_0043,REF17206313,0.0,125.1,28212.24
2024-10-13,2024-10-13,Service payment - Customer_0014,REF83479817,0.0,11.84,28224.08
2024-10-13,2024-10-13,Invoice payment - Customer_0056,REF52264273,0.0,103.42,28327.5
2024-10-13,2024-10-13,Invoice payment - Customer_0038,REF78417351,0.0,91.4,28418.9
2024-10-14,2024-10-14,Invoice payment - Customer_0046,REF72823587,0.0,127.14,28546.04
2024-10-14,2024-10-14,Service payment - Customer_0077,REF76750220,0.0,86.77,28632.81
2024-10-14,2024-10-14,Invoice payment - Customer_0085,REF66069984,0.0,54.46,28687.27
2024-10-14,2024-10-14,Service payment - Customer_0099,REF85018752,0.0,81.84,28769.11
2024-10-14,2024-10-14,Service payment - Customer_0083,REF27052992,0.0,65.25,28834.36
2024-10-14,2024-10-14,Service payment - Customer_0031,REF92460297,0.0,94.69,28929.05
2024-10-14,2024-10-14,Project payment - Customer_0051,REF54983341,0.0,111.47,29040.52
2024-10-14,2024-10-14,Service payment - Customer_0044,REF65145560,0.0,60.88,29101.4
2024-10-14,2024-10-14,Service payment - Customer_0008,REF36294708,0.0,109.58,29210.98
2024-10-14,2024-10-14,Payment from Customer_0026,REF10838231,0.0,34.46,29245.44
2024-10-14,2024-10-14,Inventory purchase,REF28034461,1620.33,0.0,27625.11
2024-10-14,2024-10-14,Service payment - Customer_0027,REF18337752,0.0,39.99,27665.1
2024-10-14,2024-10-14,Service payment - Customer_0014,REF55465488,0.0,10.63,27675.73
2024-10-15,2024-10-15,Professional Services expense,REF35058235,154.27,0.0,27521.46
2024-10-15,2024-10-15,Business insurance premium,REF65930459,190.93,0.0,27330.53
2024-10-15,2024-10-15,Packaging Shipping expense,REF84187931,152.47,0.0,27178.06
2024-10-15,2024-10-15,Invoice payment - Customer_0014,REF69231728,0.0,14.76,27192.82
2024-10-15,2024-10-15,Invoice payment - Customer_0074,REF47604909,0.0,32.89,27225.71
2024-10-15,2024-10-15,Invoice payment - Customer_0045,REF58875135,0.0,154.57,27380.28
2024-10-15,2024-10-15,Invoice payment - Customer_0057,REF97911364,0.0,116.89,27497.17
2024-10-15,2024-10-15,Payment from Customer_0006,REF59745210,0.0,101.28,27598.45
2024-10-15,2024-10-15,Project payment - Customer_0032,REF17209642,0.0,93.25,27691.7
2024-10-15,2024-10-15,Project payment - Customer_0081,REF75027978,0.0,86.74,27778.44
2024-10-16,2024-10-16,Project payment - Customer_0053,REF42008822,0.0,99.83,27878.27
2024-10-16,2024-10-16,Invoice payment - Customer_0040,REF15005156,0.0,58.88,27937.15
2024-10-16,2024-10-16,Project payment - Customer_0008,REF21835899,0.0,99.59,28036.74
2024-10-16,2024-10-16,Service payment - Customer_0002,REF61604856,0.0,88.28,28125.02
2024-10-16,2024-10-16,Service payment - Customer_0032,REF21019554,0.0,72.01,28197.03
2024-10-16,2024-10-16,Project payment - Customer_0006,REF74350604,0.0,108.26,28305.29
2024-10-16,2024-10-16,Project payment - Customer_0079,REF89565443,0.0,54.36,28359.65
2024-10-16,2024-10-16,Professional Services expense,REF92569359,253.73,0.0,28105.92
2024-10-16,2024-10-16,Payment from Customer_0014,REF56254962,0.0,11.34,28117.26
2024-10-16,2024-10-16,Payment from Customer_0074,REF80157666,0.0,38.14,28155.4
2024-10-16,2024-10-16,Invoice payment - Customer_0029,REF79298063,0.0,80.31,28235.71
2024-10-16,2024-10-16,Payment from Customer_0097,REF23510322,0.0,41.78,28277.49
2024-10-16,2024-10-16,Service payment - Customer_0036,REF31217680,0.0,53.44,28330.93
2024-10-16,2024-10-16,Project payment - Customer_0069,REF88321514,0.0,94.91,28425.84
2024-10-17,2024-10-17,Invoice payment - Customer_0080,REF14174599,0.0,145.16,28571.0
2024-10-17,2024-10-17,Invoice payment - Customer_0009,REF51883083,0.0,74.74,28645.74
2024-10-17,2024-10-17,Invoice payment - Customer_0072,REF61927472,0.0,50.24,28695.98
2024-10-17,2024-10-17,Payment from Customer_0098,REF48611184,0.0,67.91,28763.89
2024-10-17,2024-10-17,Project payment - Customer_0064,REF41297592,0.0,143.69,28907.58
2024-10-17,2024-10-17,Project payment - Customer_0069,REF83812919,0.0,111.87,29019.45
2024-10-17,2024-10-17,Service payment - Customer_0094,REF11267340,0.0,117.15,29136.6
2024-10-18,2024-10-18,Service payment - Customer_0062,REF75655144,0.0,62.12,29198.72
2024-10-18,2024-10-18,Project payment - Customer_0057,REF15004115,0.0,122.95,29321.67
2024-10-18,2024-10-18,Project payment - Customer_0044,REF17030165,0.0,67.19,29388.86
2024-10-18,2024-10-18,Service payment - Customer_0042,REF61979518,0.0,38.43,29427.29
2024-10-18,2024-10-18,Invoice payment - Customer_0085,REF39663376,0.0,43.5,29470.79
2024-10-18,2024-10-18,Project payment - Customer_0001,REF68278872,0.0,102.14,29572.93
2024-10-18,2024-10-18,Payment from Customer_0020,REF31120295,0.0,58.31,29631.24
2024-10-18,2024-10-18,Project payment - Customer_0049,REF54440049,0.0,130.21,29761.45
2024-10-18,2024-10-18,Payment from Customer_0016,REF54098257,0.0,15.39,29776.84
2024-10-18,2024-10-18,Project payment - Customer_0093,REF37572819,0.0,64.33,29841.17
2024-10-18,2024-10-18,Payment from Customer_0036,REF59423191,0.0,43.07,29884.24
2024-10-18,2024-10-18,Invoice payment - Customer_0028,REF45098505,0.0,47.45,29931.69
2024-10-19,2024-10-19,Service payment - Customer_0035,REF92289123,0.0,89.73,30021.42
2024-10-19,2024-10-19,Service payment - Customer_0059,REF12216675,0.0,10.0,30031.42
2024-10-19,2024-10-19,Project payment - Customer_0043,REF97817820,0.0,139.37,30170.79
2024-10-19,2024-10-19,Service payment - Customer_0006,REF25419777,0.0,88.74,30259.53
2024-10-19,2024-10-19,Invoice payment - Customer_0032,REF69820233,0.0,104.95,30364.48
2024-10-19,2024-10-19,Service payment - Customer_0098,REF59398921,0.0,114.28,30478.76
2024-10-19,2024-10-19,Invoice payment - Customer_0018,REF97282568,0.0,133.28,30612.04
2024-10-20,2024-10-20,Project payment - Customer_0051,REF60653318,0.0,118.84,30730.88
2024-10-20,2024-10-20,Service payment - Customer_0019,REF39962614,0.0,58.14,30789.02
2024-10-20,2024-10-20,Project payment - Customer_0054,REF19192606,0.0,127.02,30916.04
2024-10-20,2024-10-20,Invoice payment - Customer_0097,REF82067619,0.0,43.71,30959.75
2024-10-20,2024-10-20,Invoice payment - Customer_0079,REF93516285,0.0,58.87,31018.62
2024-10-20,2024-10-20,Payment from Customer_0095,REF62338725,0.0,26.14,31044.76
2024-10-21,2024-10-21,Invoice payment - Customer_0092,REF22160358,0.0,54.71,31099.47
2024-10-21,2024-10-21,Payment from Customer_0085,REF24549880,0.0,40.75,31140.22
2024-10-21,2024-10-21,Project payment - Customer_0066,REF99389272,0.0,101.71,31241.93
2024-10-21,2024-10-21,Service payment - Customer_0024,REF48423650,0.0,45.13,31287.06
2024-10-21,2024-10-21,Inventory purchase,REF96945044,3259.86,0.0,28027.2
2024-10-21,2024-10-21,Project payment - Customer_0036,REF87539484,0.0,51.43,28078.63
2024-10-21,2024-10-21,Invoice payment - Customer_0058,REF59876849,0.0,58.85,28137.48
2024-10-21,2024-10-21,Service payment - Customer_0028,REF92827777,0.0,54.85,28192.33
2024-10-21,2024-10-21,Service payment - Customer_0064,REF16634447,0.0,160.63,28352.96
2024-10-21,2024-10-21,Project payment - Customer_0090,REF91180164,0.0,54.07,28407.03
2024-10-21,2024-10-21,Service payment - Customer_0097,REF10230091,0.0,49.61,28456.64
2024-10-21,2024-10-21,Payment from Customer_0069,REF23020080,0.0,65.37,28522.01
2024-10-21,2024-10-21,Invoice payment - Customer_0063,REF18593335,0.0,63.98,28585.99
2024-10-21,2024-10-21,Invoice payment - Customer_0030,REF40349180,0.0,52.54,28638.53
2024-10-22,2024-10-22,Invoice payment - Customer_0026,REF54301113,0.0,40.37,28678.9
2024-10-22,2024-10-22,Utility bill payment,REF45073821,145.65,0.0,28533.25
2024-10-22,2024-10-22,Invoice payment - Customer_0086,REF25843723,0.0,69.47,28602.72
2024-10-22,2024-10-22,Invoice payment - Customer_0059,REF36543065,0.0,10.29,28613.01
2024-10-22,2024-10-22,Project payment - Customer_0001,REF47441422,0.0,80.33,28693.34
2024-10-22,2024-10-22,Project payment - Customer_0052,REF60281141,0.0,49.29,28742.63
2024-10-22,2024-10-22,Payment from Customer_0084,REF80787080,0.0,132.08,28874.71
2024-10-22,2024-10-22,Service payment - Customer_0094,REF44482279,0.0,135.61,29010.32
2024-10-22,2024-10-22,Payment from Customer_0012,REF61659020,0.0,183.5,29193.82
2024-10-23,2024-10-23,Project payment - Customer_0018,REF45870468,0.0,152.3,29346.12
2024-10-23,2024-10-23,Invoice payment - Customer_0060,REF50098277,0.0,74.03,29420.15
2024-10-23,2024-10-23,Project payment - Customer_0049,REF79508806,0.0,123.88,29544.03
2024-10-23,2024-10-23,Service payment - Customer_0062,REF66290380,0.0,53.75,29597.78
2024-10-23,2024-10-23,Payment from Customer_0014,REF81817433,0.0,10.38,29608.16
2024-10-23,2024-10-23,Service payment - Customer_0086,REF41502467,0.0,76.48,29684.64
2024-10-23,2024-10-23,Payment from Customer_0091,REF34115065,0.0,84.34,29768.98
2024-10-23,2024-10-23,Invoice payment - Customer_0099,REF86582075,0.0,81.86,29850.84
2024-10-23,2024-10-23,Service payment - Customer_0083,REF72951709,0.0,90.84,29941.68
2024-10-23,2024-10-23,Service payment - Customer_0007,REF95168147,0.0,47.99,29989.67
2024-10-23,2024-10-23,Service payment - Customer_0033,REF97805626,0.0,114.14,30103.81
2024-10-23,2024-10-23,Service payment - Customer_0071,REF15433778,0.0,166.2,30270.01
2024-10-23,2024-10-23,Invoice payment - Customer_0088,REF53849760,0.0,79.27,30349.28
2024-10-23,2024-10-23,Project payment - Customer_0078,REF26562471,0.0,60.41,30409.69
2024-10-23,2024-10-23,Invoice payment - Customer_0026,REF10637152,0.0,28.12,30437.81
2024-10-23,2024-10-23,Project payment - Customer_0096,REF54392084,0.0,88.75,30526.56
2024-10-23,2024-10-23,Project payment - Customer_0092,REF75464926,0.0,44.67,30571.23
2024-10-24,2024-10-24,Invoice payment - Customer_0076,REF82104776,0.0,89.24,30660.47
2024-10-24,2024-10-24,Project payment - Customer_0073,REF52320142,0.0,55.6,30716.07
2024-10-24,2024-10-24,Project payment - Customer_0027,REF56270388,0.0,41.83,30757.9
2024-10-24,2024-10-24,Project payment - Customer_0005,REF41684881,0.0,40.83,30798.73
2024-10-24,2024-10-24,Project payment - Customer_0098,REF24588653,0.0,88.3,30887.03
2024-10-24,2024-10-24,Service payment - Customer_0044,REF97085133,0.0,62.84,30949.87
2024-10-24,2024-10-24,Project payment - Customer_0003,REF25286177,0.0,109.92,31059.79
2024-10-24,2024-10-24,Project payment - Customer_0053,REF31650280,0.0,90.57,31150.36
2024-10-24,2024-10-24,Service payment - Customer_0065,REF62554056,0.0,101.66,31252.02
2024-10-24,2024-10-24,Invoice payment - Customer_0097,REF30610339,0.0,31.82,31283.84
2024-10-24,2024-10-24,Invoice payment - Customer_0057,REF70738169,0.0,131.34,31415.18
2024-10-25,2024-10-25,Service payment - Customer_0042,REF96166467,0.0,38.84,31454.02
2024-10-25,2024-10-25,Invoice payment - Customer_0094,REF36564663,0.0,106.72,31560.74
2024-10-25,2024-10-25,Service payment - Customer_0013,REF95973917,0.0,101.15,31661.89
2024-10-25,2024-10-25,Project payment - Customer_0000,REF71485671,0.0,185.75,31847.64
2024-10-25,2024-10-25,Payment from Customer_0050,REF88485015,0.0,145.62,31993.26
2024-10-25,2024-10-25,Service payment - Customer_0019,REF99113497,0.0,33.64,32026.9
2024-10-25,2024-10-25,Service payment - Customer_0022,REF67017754,0.0,143.69,32170.59
2024-10-25,2024-10-25,Invoice payment - Customer_0053,REF77570271,0.0,125.68,32296.27
2024-10-26,2024-10-26,Invoice payment - Customer_0066,REF75100878,0.0,80.05,32376.32
2024-10-26,2024-10-26,Service payment - Customer_0025,REF28148670,0.0,24.05,32400.37
2024-10-26,2024-10-26,Service payment - Customer_0019,REF63769149,0.0,58.72,32459.09
2024-10-26,2024-10-26,Project payment - Customer_0017,REF43750410,0.0,121.81,32580.9
2024-10-26,2024-10-26,Payment from Customer_0000,REF91043739,0.0,151.61,32732.51
2024-10-26,2024-10-26,Payment from Customer_0026,REF85587020,0.0,31.01,32763.52
2024-10-26,2024-10-26,Payment from Customer_0011,REF88476771,0.0,73.74,32837.26
2024-10-26,2024-10-26,Project payment - Customer_0028,REF52006316,0.0,71.3,32908.56
2024-10-26,2024-10-26,Payment from Customer_0046,REF53215153,0.0,151.98,33060.54
2024-10-26,2024-10-26,Invoice payment - Customer_0092,REF99231703,0.0,45.84,33106.38
2024-10-26,2024-10-26,Invoice payment - Customer_0083,REF46643457,0.0,59.42,33165.8
2024-10-27,2024-10-27,Invoice payment - Customer_0031,REF18188050,0.0,74.24,33240.04
2024-10-27,2024-10-27,Payment from Customer_0039,REF30765021,0.0,72.86,33312.9
2024-10-27,2024-10-27,Project payment - Customer_0075,REF29254325,0.0,102.68,33415.58
2024-10-27,2024-10-27,Service payment - Customer_0037,REF38750536,0.0,120.82,33536.4
2024-10-27,2024-10-27,Invoice payment - Customer_0021,REF32432166,0.0,64.69,33601.09
2024-10-27,2024-10-27,Payment from Customer_0081,REF79001026,0.0,108.4,33709.49
2024-10-27,2024-10-27,Service payment - Customer_0004,REF33170970,0.0,135.06,33844.55
2024-10-27,2024-10-27,Invoice payment - Customer_0027,REF61760583,0.0,32.05,33876.6
2024-10-27,2024-10-27,Service payment - Customer_0026,REF99021447,0.0,37.99,33914.59
2024-10-27,2024-10-27,Payment from Customer_0052,REF16481181,0.0,89.95,34004.54
2024-10-28,2024-10-28,Payment from Customer_0037,REF39211593,0.0,86.14,34090.68
2024-10-28,2024-10-28,Project payment - Customer_0072,REF35502988,0.0,49.38,34140.06
2024-10-28,2024-10-28,Project payment - Customer_0099,REF96404118,0.0,56.87,34196.93
2024-10-28,2024-10-28,Service payment - Customer_0039,REF65598116,0.0,76.19,34273.12
2024-10-28,2024-10-28,Project payment - Customer_0009,REF32871369,0.0,51.16,34324.28
2024-10-28,2024-10-28,Payment from Customer_0010,REF81606159,0.0,146.93,34471.21
2024-10-28,2024-10-28,Service payment - Customer_0030,REF73659849,0.0,52.17,34523.38
2024-10-28,2024-10-28,Invoice payment - Customer_0040,REF49247686,0.0,66.83,34590.21
2024-10-28,2024-10-28,Invoice payment - Customer_0054,REF85936307,0.0,154.7,34744.91
2024-10-28,2024-10-28,Service payment - Customer_0012,REF35225562,0.0,144.86,34889.77
2024-10-29,2024-10-29,Payment from Customer_0094,REF77007624,0.0,115.16,35004.93
2024-10-29,2024-10-29,Payment from Customer_0060,REF84114705,0.0,52.88,35057.81
2024-10-29,2024-10-29,Payment from Customer_0058,REF96183550,0.0,55.89,35113.7
2024-10-29,2024-10-29,Invoice payment - Customer_0014,REF89743955,0.0,12.46,35126.16
2024-10-29,2024-10-29,Invoice payment - Customer_0039,REF96850362,0.0,99.29,35225.45
2024-10-29,2024-10-29,Service payment - Customer_0082,REF64986650,0.0,39.38,35264.83
2024-10-29,2024-10-29,Project payment - Customer_0008,REF15651825,0.0,82.75,35347.58
2024-10-29,2024-10-29,Payment from Customer_0001,REF20470566,0.0,80.34,35427.92
2024-10-29,2024-10-29,Service payment - Customer_0020,REF29149270,0.0,99.8,35527.72
2024-10-29,2024-10-29,Payment from Customer_0059,REF55852098,0.0,10.6,35538.32
2024-10-29,2024-10-29,Invoice payment - Customer_0038,REF36475548,0.0,111.46,35649.78
2024-10-29,2024-10-29,Invoice payment - Customer_0035,REF58487831,0.0,100.74,35750.52
2024-10-30,2024-10-30,Invoice payment - Customer_0000,REF18999925,0.0,172.85,35923.37
2024-10-30,2024-10-30,Invoice payment - Customer_0029,REF56000457,0.0,92.73,36016.1
2024-10-30,2024-10-30,Payment from Customer_0035,REF37153592,0.0,80.54,36096.64
2024-10-30,2024-10-30,Service payment - Customer_0023,REF16905400,0.0,148.24,36244.88
2024-10-30,2024-10-30,Invoice payment - Customer_0091,REF61860855,0.0,49.27,36294.15
2024-10-30,2024-10-30,Invoice payment - Customer_0025,REF52638195,0.0,22.83,36316.98
2024-10-30,2024-10-30,Service payment - Customer_0024,REF37053829,0.0,44.15,36361.13
2024-10-30,2024-10-30,Payment from Customer_0011,REF75656432,0.0,44.47,36405.6
2024-10-31,2024-10-31,Payment from Customer_0035,REF11872713,0.0,73.83,36479.43
2024-10-31,2024-10-31,Service payment - Customer_0024,REF69814495,0.0,53.21,36532.64
2024-10-31,2024-10-31,Payment from Customer_0093,REF96945109,0.0,60.14,36592.78
2024-10-31,2024-10-31,Invoice payment - Customer_0058,REF85547136,0.0,59.41,36652.19
2024-10-31,2024-10-31,Invoice payment - Customer_0032,REF70185152,0.0,93.18,36745.37
2024-10-31,2024-10-31,Payment from Customer_0096,REF16320442,0.0,77.94,36823.31
2024-10-31,2024-10-31,Service payment - Customer_0048,REF22619922,0.0,113.75,36937.06
2024-10-31,2024-10-31,Service payment - Customer_0062,REF40627306,0.0,66.94,37004.0
2024-10-31,2024-10-31,Invoice payment - Customer_0068,REF63607059,0.0,77.27,37081.27
2024-10-31,2024-10-31,Invoice payment - Customer_0089,REF21025122,0.0,81.6,37162.87
2024-10-31,2024-10-31,Payment from Customer_0075,REF99372589,0.0,109.15,37272.02
2024-10-31,2024-10-31,Project payment - Customer_0083,REF80634130,0.0,84.97,37356.99
2024-10-31,2024-10-31,Payment from Customer_0079,REF60766487,0.0,71.43,37428.42
2024-11-01,2024-11-01,Monthly office rent,REF58913631,1716.94,0.0,35711.48
2024-11-01,2024-11-01,Invoice payment - Customer_0062,REF12201544,0.0,79.97,35791.45
2024-11-01,2024-11-01,Invoice payment - Customer_0013,REF17766357,0.0,119.77,35911.22
2024-11-01,2024-11-01,Service payment - Customer_0081,REF38262898,0.0,121.89,36033.11
2024-11-01,2024-11-01,Project payment - Customer_0020,REF78199610,0.0,114.36,36147.47
2024-11-01,2024-11-01,Payment from Customer_0080,REF96021202,0.0,166.29,36313.76
2024-11-01,2024-11-01,Payment from Customer_0090,REF84230408,0.0,105.13,36418.89
2024-11-01,2024-11-01,Project payment - Customer_0019,REF14667619,0.0,65.66,36484.55
2024-11-01,2024-11-01,Payment from Customer_0099,REF18180631,0.0,67.52,36552.07
2024-11-01,2024-11-01,Project payment - Customer_0026,REF22861814,0.0,48.01,36600.08
2024-11-01,2024-11-01,Project payment - Customer_0015,REF40556907,0.0,47.59,36647.67
2024-11-02,2024-11-02,Payment from Customer_0058,REF83903305,0.0,88.33,36736.0
2024-11-02,2024-11-02,Payment from Customer_0042,REF39980561,0.0,56.46,36792.46
2024-11-02,2024-11-02,Service payment - Customer_0068,REF15291352,0.0,131.65,36924.11
2024-11-02,2024-11-02,Project payment - Customer_0070,REF75717278,0.0,58.77,36982.88
2024-11-02,2024-11-02,Project payment - Customer_0021,REF73019421,0.0,128.43,37111.31
2024-11-02,2024-11-02,Project payment - Customer_0048,REF10530554,0.0,129.37,37240.68
2024-11-02,2024-11-02,Service payment - Customer_0040,REF85464604,0.0,87.39,37328.07
2024-11-03,2024-11-03,Service payment - Customer_0040,REF90229385,0.0,69.66,37397.73
2024-11-03,2024-11-03,Payment from Customer_0090,REF23047195,0.0,84.79,37482.52
2024-11-03,2024-11-03,Invoice payment - Customer_0072,REF10030123,0.0,66.98,37549.5
2024-11-03,2024-11-03,Service payment - Customer_0035,REF74834343,0.0,117.17,37666.67
2024-11-03,2024-11-03,Invoice payment - Customer_0068,REF83588382,0.0,125.51,37792.18
2024-11-03,2024-11-03,Project payment - Customer_0071,REF87032896,0.0,196.67,37988.85
2024-11-04,2024-11-04,Payment from Customer_0097,REF56261920,0.0,58.51,38047.36
2024-11-04,2024-11-04,Invoice payment - Customer_0022,REF91458411,0.0,212.57,38259.93
2024-11-04,2024-11-04,Project payment - Customer_0083,REF79423786,0.0,90.96,38350.89
2024-11-04,2024-11-04,Service payment - Customer_0000,REF99288986,0.0,270.59,38621.48
2024-11-05,2024-11-05,Invoice payment - Customer_0003,REF11625570,0.0,81.16,38702.64
2024-11-05,2024-11-05,Project payment - Customer_0060,REF67764842,0.0,82.71,38785.35
2024-11-05,2024-11-05,Project payment - Customer_0067,REF64223712,0.0,109.91,38895.26
2024-11-05,2024-11-05,Payment from Customer_0034,REF52575466,0.0,263.74,39159.0
2024-11-05,2024-11-05,Service payment - Customer_0087,REF87707180,0.0,101.86,39260.86
2024-11-05,2024-11-05,Invoice payment - Customer_0068,REF39832417,0.0,140.85,39401.71
2024-11-05,2024-11-05,Project payment - Customer_0097,REF67698453,0.0,59.21,39460.92
2024-11-05,2024-11-05,Service payment - Customer_0098,REF65599132,0.0,115.74,39576.66
2024-11-05,2024-11-05,Project payment - Customer_0096,REF15765349,0.0,99.15,39675.81
2024-11-05,2024-11-05,Invoice payment - Customer_0000,REF29257757,0.0,200.49,39876.3
2024-11-05,2024-11-05,Packaging Shipping expense,REF26715674,124.38,0.0,39751.92
2024-11-06,2024-11-06,Service payment - Customer_0060,REF36124102,0.0,96.02,39847.94
2024-11-06,2024-11-06,Invoice payment - Customer_0024,REF99043927,0.0,75.97,39923.91
2024-11-06,2024-11-06,Invoice payment - Customer_0094,REF84681961,0.0,157.8,40081.71
2024-11-06,2024-11-06,Project payment - Customer_0067,REF10703957,0.0,92.75,40174.46
2024-11-06,2024-11-06,Payment from Customer_0070,REF68079497,0.0,57.01,40231.47
2024-11-06,2024-11-06,Project payment - Customer_0032,REF49973793,0.0,105.98,40337.45
2024-11-06,2024-11-06,Project payment - Customer_0031,REF77673402,0.0,134.14,40471.59
2024-11-06,2024-11-06,Payment from Customer_0049,REF35916067,0.0,149.01,40620.6
2024-11-06,2024-11-06,Service payment - Customer_0042,REF36892924,0.0,46.59,40667.19
2024-11-07,2024-11-07,Service payment - Customer_0059,REF29582575,0.0,15.57,40682.76
2024-11-07,2024-11-07,Service payment - Customer_0027,REF36506613,0.0,63.25,40746.01
2024-11-07,2024-11-07,Service payment - Customer_0077,REF41172904,0.0,117.0,40863.01
2024-11-07,2024-11-07,Service payment - Customer_0032,REF35016765,0.0,92.96,40955.97
2024-11-07,2024-11-07,Service payment - Customer_0056,REF21869671,0.0,109.92,41065.89
2024-11-07,2024-11-07,Invoice payment - Customer_0057,REF24707228,0.0,145.72,41211.61
2024-11-07,2024-11-07,Service payment - Customer_0051,REF62843195,0.0,131.79,41343.4
2024-11-07,2024-11-07,Project payment - Customer_0005,REF60042487,0.0,72.75,41416.15
2024-11-07,2024-11-07,Invoice payment - Customer_0024,REF24056402,0.0,65.37,41481.52
2024-11-07,2024-11-07,Invoice payment - Customer_0064,REF59457340,0.0,205.5,41687.02
2024-11-08,2024-11-08,Project payment - Customer_0004,REF42623948,0.0,142.92,41829.94
2024-11-08,2024-11-08,Project payment - Customer_0053,REF30326161,0.0,151.87,41981.81
2024-11-08,2024-11-08,Project payment - Customer_0061,REF75088014,0.0,91.11,42072.92
2024-11-08,2024-11-08,Project payment - Customer_0037,REF75937532,0.0,131.19,42204.11
2024-11-08,2024-11-08,Service payment - Customer_0017,REF48361592,0.0,138.53,42342.64
2024-11-08,2024-11-08,Payment from Customer_0008,REF21104859,0.0,138.42,42481.06
2024-11-08,2024-11-08,Invoice payment - Customer_0002,REF75718834,0.0,156.74,42637.8
2024-11-08,2024-11-08,Invoice payment - Customer_0079,REF50450834,0.0,70.54,42708.34
2024-11-08,2024-11-08,Invoice payment - Customer_0001,REF44432407,0.0,67.87,42776.21
2024-11-09,2024-11-09,Payment from Customer_0012,REF45549580,0.0,183.33,42959.54
2024-11-09,2024-11-09,Payment from Customer_0071,REF77009621,0.0,204.12,43163.66
2024-11-09,2024-11-09,Invoice payment - Customer_0000,REF31532080,0.0,260.39,43424.05
2024-11-09,2024-11-09,Project payment - Customer_0050,REF81669766,0.0,161.6,43585.65
2024-11-09,2024-11-09,Invoice payment - Customer_0073,REF11163087,0.0,64.75,43650.4
2024-11-09,2024-11-09,Project payment - Customer_0049,REF20628241,0.0,140.81,43791.21
2024-11-09,2024-11-09,Service payment - Customer_0055,REF46237082,0.0,103.27,43894.48
2024-11-09,2024-11-09,Payment from Customer_0014,REF64297906,0.0,16.21,43910.69
2024-11-10,2024-11-10,Payment from Customer_0085,REF22954134,0.0,66.58,43977.27
2024-11-10,2024-11-10,Invoice payment - Customer_0043,REF60739423,0.0,199.72,44176.99
2024-11-10,2024-11-10,Service payment - Customer_0087,REF40973430,0.0,146.84,44323.83
2024-11-10,2024-11-10,Service payment - Customer_0093,REF58418316,0.0,65.76,44389.59
2024-11-10,2024-11-10,Project payment - Customer_0028,REF69475662,0.0,78.47,44468.06
2024-11-10,2024-11-10,Project payment - Customer_0020,REF95410634,0.0,130.57,44598.63
2024-11-10,2024-11-10,Payment from Customer_0038,REF58864304,0.0,123.42,44722.05
2024-11-10,2024-11-10,Invoice payment - Customer_0061,REF49466458,0.0,47.63,44769.68
2024-11-10,2024-11-10,Payment from Customer_0004,REF11938871,0.0,174.3,44943.98
2024-11-11,2024-11-11,Payment from Customer_0086,REF25935089,0.0,107.33,45051.31
2024-11-11,2024-11-11,Project payment - Customer_0055,REF31543593,0.0,124.28,45175.59
2024-11-11,2024-11-11,Service payment - Customer_0031,REF15654107,0.0,121.08,45296.67
2024-11-11,2024-11-11,Payment from Customer_0069,REF79259867,0.0,123.23,45419.9
2024-11-11,2024-11-11,Service payment - Customer_0091,REF14905490,0.0,120.16,45540.06
2024-11-11,2024-11-11,Invoice payment - Customer_0005,REF97870947,0.0,65.51,45605.57
2024-11-11,2024-11-11,Invoice payment - Customer_0043,REF11017120,0.0,203.66,45809.23
2024-11-11,2024-11-11,Project payment - Customer_0019,REF87323145,0.0,56.94,45866.17
2024-11-11,2024-11-11,Project payment - Customer_0049,REF79264284,0.0,148.75,46014.92
2024-11-11,2024-11-11,Inventory purchase,REF42496371,3855.39,0.0,42159.53
2024-11-12,2024-11-12,Project payment - Customer_0056,REF50793295,0.0,142.68,42302.21
2024-11-12,2024-11-12,Payment from Customer_0004,REF34696468,0.0,122.49,42424.7
2024-11-12,2024-11-12,Service payment - Customer_0024,REF72120385,0.0,69.23,42493.93
2024-11-12,2024-11-12,Project payment - Customer_0096,REF81825907,0.0,83.88,42577.81
2024-11-12,2024-11-12,Employee payroll,REF63996484,3784.95,0.0,38792.86
2024-11-12,2024-11-12,Payment from Customer_0021,REF65667504,0.0,122.98,38915.84
2024-11-12,2024-11-12,Payment from Customer_0042,REF18499680,0.0,39.67,38955.51
2024-11-12,2024-11-12,Service payment - Customer_0070,REF38614200,0.0,63.65,39019.16
2024-11-12,2024-11-12,Project payment - Customer_0065,REF80044899,0.0,126.02,39145.18
2024-11-12,2024-11-12,Payment from Customer_0014,REF91790258,0.0,11.11,39156.29
2024-11-13,2024-11-13,Invoice payment - Customer_0083,REF12516519,0.0,119.7,39275.99
2024-11-13,2024-11-13,Payment from Customer_0013,REF54811118,0.0,127.67,39403.66
2024-11-13,2024-11-13,Invoice payment - Customer_0068,REF64694129,0.0,132.05,39535.71
2024-11-13,2024-11-13,Service payment - Customer_0004,REF94369606,0.0,135.85,39671.56
2024-11-13,2024-11-13,Payment from Customer_0060,REF74015731,0.0,62.35,39733.91
2024-11-13,2024-11-13,Service payment - Customer_0032,REF44841116,0.0,111.72,39845.63
2024-11-13,2024-11-13,Project payment - Customer_0051,REF80154432,0.0,155.35,40000.98
2024-11-13,2024-11-13,Payment from Customer_0086,REF36811158,0.0,109.27,40110.25
2024-11-13,2024-11-13,Service payment - Customer_0071,REF58647197,0.0,285.15,40395.4
2024-11-13,2024-11-13,Invoice payment - Customer_0088,REF92324642,0.0,126.56,40521.96
2024-11-14,2024-11-14,Invoice payment - Customer_0033,REF20638217,0.0,173.98,40695.94
2024-11-14,2024-11-14,Payment from Customer_0016,REF26191377,0.0,20.83,40716.77
2024-11-14,2024-11-14,Invoice payment - Customer_0089,REF48329514,0.0,91.75,40808.52
2024-11-14,2024-11-14,Payment from Customer_0025,REF72081099,0.0,21.85,40830.37
2024-11-15,2024-11-15,Invoice payment - Customer_0031,REF68407699,0.0,101.09,40931.46
2024-11-15,2024-11-15,Service payment - Customer_0085,REF19092874,0.0,66.13,40997.59
2024-11-15,2024-11-15,Business insurance premium,REF42107259,268.57,0.0,40729.02
2024-11-15,2024-11-15,Service payment - Customer_0074,REF97896125,0.0,49.81,40778.83
2024-11-15,2024-11-15,Payment from Customer_0009,REF23854923,0.0,120.56,40899.39
2024-11-15,2024-11-15,Service payment - Customer_0083,REF99846044,0.0,102.75,41002.14
2024-11-15,2024-11-15,Project payment - Customer_0022,REF80442502,0.0,192.32,41194.46
2024-11-15,2024-11-15,Payment from Customer_0072,REF73913134,0.0,87.69,41282.15
2024-11-15,2024-11-15,Service payment - Customer_0095,REF34709871,0.0,39.78,41321.93
2024-11-15,2024-11-15,Service payment - Customer_0026,REF36368183,0.0,55.34,41377.27
2024-11-15,2024-11-15,Service payment - Customer_0052,REF23979679,0.0,110.17,41487.44
2024-11-16,2024-11-16,Invoice payment - Customer_0019,REF96938430,0.0,72.38,41559.82
2024-11-16,2024-11-16,Payment from Customer_0040,REF57289612,0.0,107.47,41667.29
2024-11-16,2024-11-16,Payment from Customer_0057,REF54269021,0.0,156.81,41824.1
2024-11-16,2024-11-16,Service payment - Customer_0086,REF31623092,0.0,88.93,41913.03
2024-11-16,2024-11-16,Invoice payment - Customer_0037,REF54113787,0.0,139.53,42052.56
2024-11-16,2024-11-16,Service payment - Customer_0005,REF84168970,0.0,70.22,42122.78
2024-11-16,2024-11-16,Payment from Customer_0051,REF52267056,0.0,95.58,42218.36
2024-11-16,2024-11-16,Service payment - Customer_0010,REF24644313,0.0,159.9,42378.26
2024-11-17,2024-11-17,Invoice payment - Customer_0074,REF27337970,0.0,53.8,42432.06
2024-11-17,2024-11-17,Payment from Customer_0040,REF85032441,0.0,81.61,42513.67
2024-11-17,2024-11-17,Project payment - Customer_0061,REF84055049,0.0,88.99,42602.66
2024-11-17,2024-11-17,Invoice payment - Customer_0042,REF14664015,0.0,50.83,42653.49
2024-11-17,2024-11-17,Service payment - Customer_0054,REF94901516,0.0,166.02,42819.51
2024-11-17,2024-11-17,Invoice payment - Customer_0025,REF62304529,0.0,21.23,42840.74
2024-11-18,2024-11-18,Project payment - Customer_0008,REF51011017,0.0,121.54,42962.28
2024-11-18,2024-11-18,Payment from Customer_0052,REF43540244,0.0,108.21,43070.49
2024-11-18,2024-11-18,Service payment - Customer_0055,REF97593738,0.0,145.66,43216.15
2024-11-18,2024-11-18,Service payment - Customer_0051,REF51274895,0.0,157.84,43373.99
2024-11-18,2024-11-18,Project payment - Customer_0057,REF28169313,0.0,119.91,43493.9
2024-11-18,2024-11-18,Project payment - Customer_0014,REF27698880,0.0,15.09,43508.99
2024-11-18,2024-11-18,Project payment - Customer_0011,REF86424413,0.0,71.08,43580.07
2024-11-18,2024-11-18,Project payment - Customer_0026,REF26800878,0.0,45.17,43625.24
2024-11-19,2024-11-19,Project payment - Customer_0034,REF66886281,0.0,145.38,43770.62
2024-11-19,2024-11-19,Payment from Customer_0010,REF60712689,0.0,195.46,43966.08
2024-11-19,2024-11-19,Payment from Customer_0001,REF68732292,0.0,125.1,44091.18
2024-11-19,2024-11-19,Invoice payment - Customer_0078,REF99862704,0.0,80.1,44171.28
2024-11-19,2024-11-19,Payment from Customer_0028,REF19771863,0.0,48.16,44219.44
2024-11-20,2024-11-20,Payment from Customer_0081,REF38958900,0.0,114.13,44333.57
2024-11-20,2024-11-20,Project payment - Customer_0013,REF11975401,0.0,105.29,44438.86
2024-11-20,2024-11-20,Service payment - Customer_0060,REF43826533,0.0,87.23,44526.09
2024-11-20,2024-11-20,Payment from Customer_0033,REF52931264,0.0,112.7,44638.79
2024-11-20,2024-11-20,Invoice payment - Customer_0069,REF99510032,0.0,128.18,44766.97
2024-11-20,2024-11-20,Service payment - Customer_0009,REF52754417,0.0,112.83,44879.8
2024-11-20,2024-11-20,Payment from Customer_0031,REF70274537,0.0,120.5,45000.3
2024-11-20,2024-11-20,Payment from Customer_0091,REF98842880,0.0,116.38,45116.68
2024-11-21,2024-11-21,Payment from Customer_0055,REF92485192,0.0,168.84,45285.52
2024-11-21,2024-11-21,Service payment - Customer_0039,REF19296035,0.0,99.6,45385.12
2024-11-21,2024-11-21,Service payment - Customer_0028,REF33153334,0.0,45.03,45430.15
2024-11-21,2024-11-21,Payment from Customer_0043,REF27075781,0.0,132.08,45562.23
2024-11-21,2024-11-21,Invoice payment - Customer_0001,REF82095298,0.0,114.64,45676.87
2024-11-21,2024-11-21,Project payment - Customer_0053,REF75594016,0.0,125.66,45802.53
2024-11-21,2024-11-21,Payment from Customer_0080,REF39582428,0.0,186.25,45988.78
2024-11-21,2024-11-21,Project payment - Customer_0044,REF60379772,0.0,89.76,46078.54
2024-11-21,2024-11-21,Project payment - Customer_0046,REF89090479,0.0,151.83,46230.37
2024-11-22,2024-11-22,Utility bill payment,REF94998216,171.86,0.0,46058.51
2024-11-22,2024-11-22,Payment from Customer_0038,REF79422627,0.0,131.36,46189.87
2024-11-22,2024-11-22,Project payment - Customer_0093,REF55494918,0.0,71.77,46261.64
2024-11-22,2024-11-22,Payment from Customer_0077,REF69004155,0.0,106.02,46367.66
2024-11-22,2024-11-22,Project payment - Customer_0047,REF66100687,0.0,76.92,46444.58
2024-11-22,2024-11-22,Project payment - Customer_0020,REF67161496,0.0,88.1,46532.68
2024-11-22,2024-11-22,Project payment - Customer_0013,REF48200958,0.0,122.49,46655.17
2024-11-22,2024-11-22,Invoice payment - Customer_0054,REF60835478,0.0,203.91,46859.08
2024-11-22,2024-11-22,Payment from Customer_0057,REF75313988,0.0,140.2,46999.28
2024-11-22,2024-11-22,Payment from Customer_0088,REF32932545,0.0,88.25,47087.53
2024-11-22,2024-11-22,Invoice payment - Customer_0061,REF39031655,0.0,77.39,47164.92
2024-11-22,2024-11-22,Service payment - Customer_0059,REF51160475,0.0,12.6,47177.52
2024-11-22,2024-11-22,Project payment - Customer_0075,REF91996759,0.0,140.65,47318.17
2024-11-23,2024-11-23,Invoice payment - Customer_0014,REF31352583,0.0,16.27,47334.44
2024-11-23,2024-11-23,Payment from Customer_0073,REF49460456,0.0,52.24,47386.68
2024-11-23,2024-11-23,Payment from Customer_0047,REF10227081,0.0,135.47,47522.15
2024-11-23,2024-11-23,Service payment - Customer_0043,REF27189064,0.0,164.44,47686.59
2024-11-23,2024-11-23,Project payment - Customer_0065,REF19697599,0.0,167.14,47853.73
2024-11-23,2024-11-23,Service payment - Customer_0011,REF83051209,0.0,74.78,47928.51
2024-11-23,2024-11-23,Invoice payment - Customer_0094,REF44365116,0.0,168.07,48096.58
2024-11-23,2024-11-23,Payment from Customer_0034,REF23233441,0.0,186.91,48283.49
2024-11-23,2024-11-23,Payment from Customer_0020,REF40228969,0.0,107.5,48390.99
2024-11-23,2024-11-23,Invoice payment - Customer_0064,REF19759747,0.0,175.4,48566.39
2024-11-24,2024-11-24,Payment from Customer_0081,REF18901609,0.0,136.13,48702.52
2024-11-24,2024-11-24,Invoice payment - Customer_0042,REF95918916,0.0,46.96,48749.48
2024-11-24,2024-11-24,Invoice payment - Customer_0048,REF21374957,0.0,143.95,48893.43
2024-11-24,2024-11-24,Project payment - Customer_0027,REF18212594,0.0,51.32,48944.75
2024-11-24,2024-11-24,Invoice payment - Customer_0084,REF61408089,0.0,187.94,49132.69
2024-11-24,2024-11-24,Project payment - Customer_0067,REF87374954,0.0,85.79,49218.48
2024-11-24,2024-11-24,Payment from Customer_0088,REF63019527,0.0,135.5,49353.98
2024-11-24,2024-11-24,Service payment - Customer_0038,REF15723877,0.0,129.63,49483.61
2024-11-25,2024-11-25,Payment from Customer_0009,REF80959215,0.0,74.84,49558.45
2024-11-25,2024-11-25,Invoice payment - Customer_0063,REF95894081,0.0,55.19,49613.64
2024-11-25,2024-11-25,Invoice payment - Customer_0032,REF39762852,0.0,100.23,49713.87
2024-11-25,2024-11-25,Service payment - Customer_0071,REF23886166,0.0,253.43,49967.3
2024-11-25,2024-11-25,Payment from Customer_0017,REF47487449,0.0,91.48,50058.78
2024-11-25,2024-11-25,Invoice payment - Customer_0045,REF17636058,0.0,290.31,50349.09
2024-11-25,2024-11-25,Service payment - Customer_0072,REF61327165,0.0,86.94,50436.03
2024-11-26,2024-11-26,Invoice payment - Customer_0077,REF93018486,0.0,105.06,50541.09
2024-11-26,2024-11-26,Project payment - Customer_0044,REF21375457,0.0,63.14,50604.23
2024-11-26,2024-11-26,Project payment - Customer_0082,REF78624381,0.0,44.74,50648.97
2024-11-26,2024-11-26,Payment from Customer_0054,REF76551068,0.0,206.44,50855.41
2024-11-26,2024-11-26,Payment from Customer_0063,REF92005227,0.0,74.1,50929.51
2024-11-26,2024-11-26,Payment from Customer_0000,REF70221298,0.0,206.23,51135.74
2024-11-26,2024-11-26,Service payment - Customer_0071,REF98773225,0.0,231.48,51367.22
2024-11-26,2024-11-26,Invoice payment - Customer_0076,REF62367607,0.0,120.99,51488.21
2024-11-26,2024-11-26,Invoice payment - Customer_0096,REF29837160,0.0,84.73,51572.94
2024-11-26,2024-11-26,Project payment - Customer_0091,REF64582999,0.0,81.75,51654.69
2024-11-26,2024-11-26,Payment from Customer_0011,REF32374770,0.0,107.1,51761.79
2024-11-27,2024-11-27,Project payment - Customer_0027,REF72750202,0.0,54.05,51815.84
2024-11-27,2024-11-27,Service payment - Customer_0044,REF85158441,0.0,59.37,51875.21
2024-11-27,2024-11-27,Service payment - Customer_0009,REF28333368,0.0,113.3,51988.51
2024-11-27,2024-11-27,Service payment - Customer_0091,REF90701266,0.0,125.55,52114.06
2024-11-27,2024-11-27,Service payment - Customer_0093,REF78903244,0.0,67.42,52181.48
2024-11-27,2024-11-27,Invoice payment - Customer_0057,REF46685387,0.0,169.19,52350.67
2024-11-27,2024-11-27,Payment from Customer_0092,REF69840862,0.0,69.64,52420.31
2024-11-27,2024-11-27,Service payment - Customer_0003,REF47660940,0.0,117.77,52538.08
2024-11-27,2024-11-27,Project payment - Customer_0012,REF50923484,0.0,169.42,52707.5
2024-11-27,2024-11-27,Project payment - Customer_0005,REF22501237,0.0,43.59,52751.09
2024-11-27,2024-11-27,Service payment - Customer_0022,REF45158054,0.0,180.46,52931.55
2024-11-28,2024-11-28,Invoice payment - Customer_0090,REF96069711,0.0,98.51,53030.06
2024-11-28,2024-11-28,Payment from Customer_0025,REF30805941,0.0,23.04,53053.1
2024-11-28,2024-11-28,Payment from Customer_0087,REF93740616,0.0,187.86,53240.96
2024-11-28,2024-11-28,Invoice payment - Customer_0043,REF48350252,0.0,189.81,53430.77
2024-11-28,2024-11-28,Service payment - Customer_0055,REF44724012,0.0,145.78,53576.55
2024-11-28,2024-11-28,Service payment - Customer_0046,REF48016278,0.0,146.82,53723.37
2024-11-28,2024-11-28,Invoice payment - Customer_0089,REF53627676,0.0,146.87,53870.24
2024-11-28,2024-11-28,Payment from Customer_0027,REF51286804,0.0,52.05,53922.29
2024-11-28,2024-11-28,Invoice payment - Customer_0072,REF34260046,0.0,48.5,53970.79
2024-11-28,2024-11-28,Payment from Customer_0005,REF56594401,0.0,45.54,54016.33
2024-11-28,2024-11-28,Invoice payment - Customer_0045,REF57457079,0.0,229.03,54245.36
2024-11-28,2024-11-28,Invoice payment - Customer_0042,REF77824937,0.0,52.56,54297.92
2024-11-29,2024-11-29,Invoice payment - Customer_0081,REF41328579,0.0,129.6,54427.52
2024-11-29,2024-11-29,Service payment - Customer_0080,REF42708540,0.0,249.9,54677.42
2024-11-29,2024-11-29,Payment from Customer_0086,REF96044135,0.0,127.64,54805.06
2024-11-30,2024-11-30,Service payment - Customer_0001,REF50680086,0.0,107.25,54912.31
2024-11-30,2024-11-30,Project payment - Customer_0019,REF52024723,0.0,73.99,54986.3
2024-11-30,2024-11-30,Service payment - Customer_0017,REF92223805,0.0,130.13,55116.43
2024-11-30,2024-11-30,Payment from Customer_0074,REF20107561,0.0,47.38,55163.81
2024-11-30,2024-11-30,Invoice payment - Customer_0099,REF38970364,0.0,90.25,55254.06
2024-11-30,2024-11-30,Project payment - Customer_0045,REF60895762,0.0,229.28,55483.34
2024-11-30,2024-11-30,Project payment - Customer_0098,REF56103824,0.0,115.23,55598.57
2024-11-30,2024-11-30,Service payment - Customer_0024,REF29758672,0.0,49.5,55648.07
2024-11-30,2024-11-30,Payment from Customer_0011,REF81954748,0.0,69.12,55717.19
2024-11-30,2024-11-30,Invoice payment - Customer_0050,REF33729352,0.0,125.08,55842.27
2024-11-30,2024-11-30,Invoice payment - Customer_0082,REF13650757,0.0,58.81,55901.08
2024-11-30,2024-11-30,Payment from Customer_0002,REF62512733,0.0,101.68,56002.76
2024-12-01,2024-12-01,Invoice payment - Customer_0026,REF32709417,0.0,59.58,56062.34
2024-12-01,2024-12-01,Service payment - Customer_0042,REF69783692,0.0,53.64,56115.98
2024-12-01,2024-12-01,Payment from Customer_0039,REF64445719,0.0,111.71,56227.69
2024-12-01,2024-12-01,Service payment - Customer_0050,REF53931919,0.0,204.76,56432.45
2024-12-01,2024-12-01,Invoice payment - Customer_0087,REF14333740,0.0,148.97,56581.42
2024-12-01,2024-12-01,Payment from Customer_0075,REF18503920,0.0,173.8,56755.22
2024-12-01,2024-12-01,Service payment - Customer_0038,REF71176893,0.0,193.58,56948.8
2024-12-01,2024-12-01,Service payment - Customer_0031,REF57037057,0.0,121.63,57070.43
2024-12-01,2024-12-01,Monthly office rent,REF18334394,1965.83,0.0,55104.6
2024-12-02,2024-12-02,Payment from Customer_0029,REF87540300,0.0,119.58,55224.18
2024-12-02,2024-12-02,Service payment - Customer_0001,REF67081825,0.0,135.32,55359.5
2024-12-02,2024-12-02,Project payment - Customer_0037,REF34496482,0.0,161.48,55520.98
2024-12-02,2024-12-02,Project payment - Customer_0012,REF74109967,0.0,243.61,55764.59
2024-12-02,2024-12-02,Payment from Customer_0032,REF14558762,0.0,153.5,55918.09
2024-12-02,2024-12-02,Project payment - Customer_0080,REF92064509,0.0,243.21,56161.3
2024-12-02,2024-12-02,Service payment - Customer_0045,REF42738309,0.0,257.67,56418.97
2024-12-02,2024-12-02,Invoice payment - Customer_0000,REF86650158,0.0,235.41,56654.38
2024-12-02,2024-12-02,Service payment - Customer_0057,REF24525767,0.0,161.48,56815.86
2024-12-02,2024-12-02,Service payment - Customer_0064,REF11975546,0.0,244.7,57060.56
2024-12-02,2024-12-02,Payment from Customer_0075,REF34802272,0.0,141.02,57201.58
2024-12-03,2024-12-03,Service payment - Customer_0073,REF52609295,0.0,73.69,57275.27
2024-12-03,2024-12-03,Service payment - Customer_0024,REF47593261,0.0,89.22,57364.49
2024-12-03,2024-12-03,Project payment - Customer_0039,REF53966807,0.0,115.3,57479.79
2024-12-03,2024-12-03,Project payment - Customer_0038,REF47918942,0.0,175.02,57654.81
2024-12-03,2024-12-03,Invoice payment - Customer_0085,REF42657107,0.0,85.41,57740.22
2024-12-03,2024-12-03,Invoice payment - Customer_0080,REF97415012,0.0,246.22,57986.44
2024-12-03,2024-12-03,Service payment - Customer_0093,REF51036656,0.0,86.37,58072.81
2024-12-03,2024-12-03,Payment from Customer_0061,REF34646983,0.0,110.0,58182.81
2024-12-03,2024-12-03,Project payment - Customer_0023,REF45719628,0.0,201.17,58383.98
2024-12-03,2024-12-03,Payment from Customer_0059,REF33216222,0.0,14.55,58398.53
2024-12-03,2024-12-03,Payment from Customer_0040,REF36903134,0.0,111.78,58510.31
2024-12-03,2024-12-03,Invoice payment - Customer_0053,REF49187673,0.0,128.0,58638.31
2024-12-04,2024-12-04,Invoice payment - Customer_0002,REF22916716,0.0,129.01,58767.32
2024-12-04,2024-12-04,Service payment - Customer_0032,REF73915303,0.0,135.4,58902.72
2024-12-04,2024-12-04,Service payment - Customer_0014,REF76006117,0.0,18.0,58920.72
2024-12-04,2024-12-04,Service payment - Customer_0020,REF99477026,0.0,108.88,59029.6
2024-12-04,2024-12-04,Service payment - Customer_0019,REF48553952,0.0,104.46,59134.06
2024-12-04,2024-12-04,Service payment - Customer_0025,REF92564171,0.0,23.66,59157.72
2024-12-04,2024-12-04,Payment from Customer_0028,REF81148729,0.0,86.28,59244.0
2024-12-05,2024-12-05,Service payment - Customer_0040,REF93025296,0.0,103.86,59347.86
2024-12-05,2024-12-05,Project payment - Customer_0007,REF64014365,0.0,67.91,59415.77
2024-12-05,2024-12-05,Invoice payment - Customer_0080,REF77202670,0.0,283.96,59699.73
2024-12-05,2024-12-05,Project payment - Customer_0003,REF49518161,0.0,120.34,59820.07
2024-12-05,2024-12-05,Service payment - Customer_0074,REF55232766,0.0,58.62,59878.69
2024-12-05,2024-12-05,Project payment - Customer_0056,REF33853253,0.0,135.48,60014.17
2024-12-05,2024-12-05,Service payment - Customer_0017,REF86593865,0.0,143.69,60157.86
2024-12-05,2024-12-05,Project payment - Customer_0016,REF15735779,0.0,19.8,60177.66
2024-12-05,2024-12-05,Invoice payment - Customer_0060,REF15850577,0.0,70.0,60247.66
2024-12-05,2024-12-05,Invoice payment - Customer_0051,REF80281449,0.0,148.6,60396.26
2024-12-05,2024-12-05,Payment from Customer_0097,REF85783576,0.0,79.54,60475.8
2024-12-05,2024-12-05,Service payment - Customer_0065,REF77905000,0.0,124.96,60600.76
2024-12-05,2024-12-05,Service payment - Customer_0022,REF79860557,0.0,177.18,60777.94
2024-12-05,2024-12-05,Invoice payment - Customer_0055,REF43864771,0.0,184.56,60962.5
2024-12-05,2024-12-05,Payment from Customer_0066,REF13523164,0.0,109.96,61072.46
2024-12-06,2024-12-06,Payment from Customer_0063,REF80896463,0.0,81.66,61154.12
2024-12-06,2024-12-06,Payment from Customer_0014,REF83423898,0.0,16.58,61170.7
2024-12-06,2024-12-06,Project payment - Customer_0005,REF24058540,0.0,77.05,61247.75
2024-12-06,2024-12-06,Service payment - Customer_0064,REF92158014,0.0,227.79,61475.54
2024-12-06,2024-12-06,Payment from Customer_0053,REF98075068,0.0,189.72,61665.26
2024-12-06,2024-12-06,Payment from Customer_0061,REF23089956,0.0,79.17,61744.43
2024-12-06,2024-12-06,Payment from Customer_0070,REF53954865,0.0,79.63,61824.06
2024-12-06,2024-12-06,Invoice payment - Customer_0058,REF36976189,0.0,88.66,61912.72
2024-12-06,2024-12-06,Payment from Customer_0036,REF10455884,0.0,62.02,61974.74
2024-12-06,2024-12-06,Project payment - Customer_0050,REF62771308,0.0,230.51,62205.25
2024-12-06,2024-12-06,Payment from Customer_0098,REF53602549,0.0,132.95,62338.2
2024-12-06,2024-12-06,Payment from Customer_0066,REF88939760,0.0,128.49,62466.69
2024-12-06,2024-12-06,Payment from Customer_0037,REF58276687,0.0,164.88,62631.57
2024-12-06,2024-12-06,Invoice payment - Customer_0069,REF31279886,0.0,136.78,62768.35
2024-12-06,2024-12-06,Invoice payment - Customer_0071,REF22971407,0.0,205.34,62973.69
2024-12-06,2024-12-06,Service payment - Customer_0094,REF26550842,0.0,225.53,63199.22
2024-12-07,2024-12-07,Payment from Customer_0096,REF75932528,0.0,99.93,63299.15
2024-12-07,2024-12-07,Service payment - Customer_0074,REF57725210,0.0,54.67,63353.82
2024-12-07,2024-12-07,Payment from Customer_0089,REF89383980,0.0,134.48,63488.3
2024-12-07,2024-12-07,Service payment - Customer_0043,REF14284263,0.0,184.06,63672.36
2024-12-07,2024-12-07,Service payment - Customer_0094,REF31494258,0.0,173.43,63845.79
2024-12-07,2024-12-07,Professional Services expense,REF47153252,263.55,0.0,63582.24
2024-12-08,2024-12-08,Service payment - Customer_0012,REF63133246,0.0,171.62,63753.86
2024-12-08,2024-12-08,Project payment - Customer_0044,REF68048919,0.0,72.63,63826.49
2024-12-08,2024-12-08,Inventory purchase,REF61825077,2175.91,0.0,61650.58
2024-12-08,2024-12-08,Invoice payment - Customer_0059,REF27817202,0.0,10.16,61660.74
2024-12-08,2024-12-08,Project payment - Customer_0013,REF12851140,0.0,194.21,61854.95
2024-12-08,2024-12-08,Invoice payment - Customer_0079,REF97842833,0.0,72.85,61927.8
2024-12-08,2024-12-08,Project payment - Customer_0077,REF88974253,0.0,134.54,62062.34
2024-12-09,2024-12-09,Pos Systems expense,REF48596888,137.79,0.0,61924.55
2024-12-09,2024-12-09,Project payment - Customer_0052,REF49473868,0.0,115.94,62040.49
2024-12-09,2024-12-09,Service payment - Customer_0032,REF85179188,0.0,130.54,62171.03
2024-12-09,2024-12-09,Service payment - Customer_0000,REF72421468,0.0,216.2,62387.23
2024-12-09,2024-12-09,Invoice payment - Customer_0071,REF21086074,0.0,280.11,62667.34
2024-12-09,2024-12-09,Project payment - Customer_0096,REF15982490,0.0,132.49,62799.83
2024-12-09,2024-12-09,Invoice payment - Customer_0064,REF65596020,0.0,202.67,63002.5
2024-12-09,2024-12-09,Payment from Customer_0060,REF23512311,0.0,93.2,63095.7
2024-12-09,2024-12-09,Service payment - Customer_0017,REF15931834,0.0,128.44,63224.14
2024-12-09,2024-12-09,Invoice payment - Customer_0003,REF43380391,0.0,148.78,63372.92
2024-12-09,2024-12-09,Invoice payment - Customer_0074,REF68428349,0.0,39.43,63412.35
2024-12-09,2024-12-09,Invoice payment - Customer_0092,REF28633440,0.0,81.98,63494.33
2024-12-09,2024-12-09,Invoice payment - Customer_0075,REF76628115,0.0,141.85,63636.18
2024-12-10,2024-12-10,Payment from Customer_0049,REF87825256,0.0,139.45,63775.63
2024-12-10,2024-12-10,Invoice payment - Customer_0032,REF64428646,0.0,132.51,63908.14
2024-12-10,2024-12-10,Project payment - Customer_0011,REF86222089,0.0,105.99,64014.13
2024-12-10,2024-12-10,Invoice payment - Customer_0083,REF67706680,0.0,97.45,64111.58
2024-12-11,2024-12-11,Service payment - Customer_0032,REF62777456,0.0,127.11,64238.69
2024-12-11,2024-12-11,Invoice payment - Customer_0089,REF20975327,0.0,173.14,64411.83
2024-12-11,2024-12-11,Invoice payment - Customer_0001,REF86290006,0.0,135.87,64547.7
2024-12-11,2024-12-11,Service payment - Customer_0060,REF34722367,0.0,97.85,64645.55
2024-12-11,2024-12-11,Payment from Customer_0079,REF13813448,0.0,85.31,64730.86
2024-12-11,2024-12-11,Payment from Customer_0080,REF14129552,0.0,216.86,64947.72
2024-12-11,2024-12-11,Service payment - Customer_0007,REF55851533,0.0,92.32,65040.04
2024-12-11,2024-12-11,Project payment - Customer_0006,REF97727402,0.0,141.87,65181.91
2024-12-11,2024-12-11,Service payment - Customer_0019,REF63712079,0.0,96.35,65278.26
2024-12-12,2024-12-12,Invoice payment - Customer_0010,REF86915265,0.0,300.49,65578.75
2024-12-12,2024-12-12,Project payment - Customer_0052,REF89776276,0.0,123.75,65702.5
2024-12-12,2024-12-12,Payment from Customer_0028,REF60922217,0.0,76.81,65779.31
2024-12-12,2024-12-12,Service payment - Customer_0068,REF80135224,0.0,145.15,65924.46
2024-12-12,2024-12-12,Service payment - Customer_0015,REF44550161,0.0,50.01,65974.47
2024-12-12,2024-12-12,Service payment - Customer_0006,REF19162098,0.0,135.38,66109.85
2024-12-12,2024-12-12,Invoice payment - Customer_0066,REF57284727,0.0,110.82,66220.67
2024-12-12,2024-12-12,Invoice payment - Customer_0092,REF96615826,0.0,54.54,66275.21
2024-12-12,2024-12-12,Project payment - Customer_0035,REF99081401,0.0,110.83,66386.04
2024-12-12,2024-12-12,Service payment - Customer_0024,REF50688248,0.0,79.34,66465.38
2024-12-12,2024-12-12,Invoice payment - Customer_0099,REF30657958,0.0,105.6,66570.98
2024-12-12,2024-12-12,Service payment - Customer_0019,REF39105639,0.0,92.58,66663.56
2024-12-12,2024-12-12,Service payment - Customer_0096,REF69821109,0.0,110.56,66774.12
2024-12-13,2024-12-13,Invoice payment - Customer_0098,REF69274179,0.0,134.08,66908.2
2024-12-13,2024-12-13,Invoice payment - Customer_0083,REF51285108,0.0,90.97,66999.17
2024-12-13,2024-12-13,Project payment - Customer_0051,REF64166972,0.0,189.37,67188.54
2024-12-13,2024-12-13,Payment from Customer_0029,REF29433185,0.0,153.13,67341.67
2024-12-13,2024-12-13,Project payment - Customer_0050,REF61239238,0.0,147.88,67489.55
2024-12-13,2024-12-13,Payment from Customer_0041,REF88131628,0.0,225.08,67714.63
2024-12-13,2024-12-13,Project payment - Customer_0018,REF62289199,0.0,219.17,67933.8
2024-12-14,2024-12-14,Pos Systems expense,REF42837533,119.06,0.0,67814.74
2024-12-14,2024-12-14,Payment from Customer_0075,REF54039261,0.0,136.46,67951.2
2024-12-14,2024-12-14,Project payment - Customer_0084,REF68226888,0.0,269.57,68220.77
2024-12-14,2024-12-14,Invoice payment - Customer_0004,REF87537652,0.0,177.22,68397.99
2024-12-14,2024-12-14,Payment from Customer_0061,REF62947264,0.0,107.42,68505.41
2024-12-14,2024-12-14,Service payment - Customer_0010,REF91406498,0.0,165.62,68671.03
2024-12-14,2024-12-14,Payment from Customer_0051,REF71177455,0.0,163.22,68834.25
2024-12-14,2024-12-14,Service payment - Customer_0034,REF87910280,0.0,189.96,69024.21
2024-12-14,2024-12-14,Project payment - Customer_0090,REF65727838,0.0,100.56,69124.77
2024-12-14,2024-12-14,Project payment - Customer_0069,REF92140054,0.0,131.37,69256.14
2024-12-14,2024-12-14,Project payment - Customer_0024,REF84890245,0.0,81.12,69337.26
2024-12-15,2024-12-15,Service payment - Customer_0052,REF96699342,0.0,140.17,69477.43
2024-12-15,2024-12-15,Invoice payment - Customer_0056,REF16396926,0.0,149.1,69626.53
2024-12-15,2024-12-15,Business insurance premium,REF91110991,282.22,0.0,69344.31
2024-12-15,2024-12-15,Invoice payment - Customer_0001,REF17779112,0.0,112.92,69457.23
2024-12-15,2024-12-15,Payment from Customer_0037,REF53632877,0.0,126.48,69583.71
2024-12-16,2024-12-16,Invoice payment - Customer_0041,REF48845380,0.0,176.87,69760.58
2024-12-16,2024-12-16,Payment from Customer_0093,REF90108077,0.0,84.07,69844.65
2024-12-16,2024-12-16,Payment from Customer_0092,REF95442723,0.0,67.57,69912.22
2024-12-16,2024-12-16,Invoice payment - Customer_0089,REF33149774,0.0,179.07,70091.29
2024-12-16,2024-12-16,Service payment - Customer_0039,REF33267235,0.0,129.89,70221.18
2024-12-16,2024-12-16,Project payment - Customer_0015,REF59998442,0.0,44.92,70266.1
2024-12-16,2024-12-16,Invoice payment - Customer_0031,REF82452065,0.0,103.86,70369.96
2024-12-17,2024-12-17,Service payment - Customer_0097,REF30471294,0.0,72.9,70442.86
2024-12-17,2024-12-17,Marketing expenses,REF31901610,529.36,0.0,69913.5
2024-12-17,2024-12-17,Service payment - Customer_0023,REF85625956,0.0,230.8,70144.3
2024-12-17,2024-12-17,Payment from Customer_0016,REF15635243,0.0,22.09,70166.39
2024-12-17,2024-12-17,Service payment - Customer_0096,REF93807921,0.0,80.67,70247.06
2024-12-17,2024-12-17,Project payment - Customer_0065,REF34008494,0.0,116.55,70363.61
2024-12-17,2024-12-17,Project payment - Customer_0052,REF35095357,0.0,102.59,70466.2
2024-12-17,2024-12-17,Invoice payment - Customer_0038,REF54912136,0.0,202.87,70669.07
2024-12-17,2024-12-17,Service payment - Customer_0020,REF65467338,0.0,105.54,70774.61
2024-12-17,2024-12-17,Service payment - Customer_0089,REF89466280,0.0,149.77,70924.38
2024-12-17,2024-12-17,Service payment - Customer_0009,REF37349520,0.0,140.24,71064.62
2024-12-17,2024-12-17,Invoice payment - Customer_0013,REF13492489,0.0,139.42,71204.04
2024-12-18,2024-12-18,Invoice payment - Customer_0046,REF86327013,0.0,153.06,71357.1
2024-12-18,2024-12-18,Service payment - Customer_0080,REF19885288,0.0,183.51,71540.61
2024-12-18,2024-12-18,Service payment - Customer_0089,REF55859657,0.0,171.99,71712.6
2024-12-18,2024-12-18,Project payment - Customer_0090,REF70430812,0.0,93.96,71806.56
2024-12-18,2024-12-18,Project payment - Customer_0079,REF30671423,0.0,85.45,71892.01
2024-12-18,2024-12-18,Invoice payment - Customer_0038,REF30574216,0.0,191.36,72083.37
2024-12-18,2024-12-18,Service payment - Customer_0072,REF56142145,0.0,74.64,72158.01
2024-12-18,2024-12-18,Project payment - Customer_0015,REF43521355,0.0,45.64,72203.65
2024-12-19,2024-12-19,Invoice payment - Customer_0097,REF86523870,0.0,56.01,72259.66
2024-12-19,2024-12-19,Payment from Customer_0062,REF82946229,0.0,86.07,72345.73
2024-12-19,2024-12-19,Payment from Customer_0061,REF14524329,0.0,81.7,72427.43
2024-12-19,2024-12-19,Payment from Customer_0086,REF12296044,0.0,129.42,72556.85
2024-12-19,2024-12-19,Service payment - Customer_0011,REF72509788,0.0,102.0,72658.85
2024-12-19,2024-12-19,Invoice payment - Customer_0017,REF66953399,0.0,121.63,72780.48
2024-12-19,2024-12-19,Invoice payment - Customer_0087,REF57429346,0.0,183.56,72964.04
2024-12-20,2024-12-20,Project payment - Customer_0054,REF64707900,0.0,206.95,73170.99
2024-12-20,2024-12-20,Project payment - Customer_0025,REF96754427,0.0,31.56,73202.55
2024-12-20,2024-12-20,Project payment - Customer_0031,REF62134397,0.0,156.29,73358.84
2024-12-20,2024-12-20,Payment from Customer_0084,REF52395754,0.0,237.69,73596.53
2024-12-20,2024-12-20,Invoice payment - Customer_0064,REF40717196,0.0,176.77,73773.3
2024-12-20,2024-12-20,Payment from Customer_0085,REF23729507,0.0,69.85,73843.15
2024-12-20,2024-12-20,Service payment - Customer_0063,REF79683277,0.0,76.88,73920.03
2024-12-20,2024-12-20,Project payment - Customer_0057,REF70524867,0.0,162.95,74082.98
2024-12-20,2024-12-20,Project payment - Customer_0002,REF60231109,0.0,191.09,74274.07
2024-12-20,2024-12-20,Payment from Customer_0065,REF10387374,0.0,156.67,74430.74
2024-12-21,2024-12-21,Service payment - Customer_0041,REF35503695,0.0,200.64,74631.38
2024-12-21,2024-12-21,Inventory purchase,REF28139191,2146.49,0.0,72484.89
2024-12-21,2024-12-21,Invoice payment - Customer_0066,REF44117917,0.0,116.71,72601.6
2024-12-21,2024-12-21,Project payment - Customer_0009,REF44568987,0.0,107.51,72709.11
2024-12-21,2024-12-21,Service payment - Customer_0060,REF97836101,0.0,94.49,72803.6
2024-12-21,2024-12-21,Invoice payment - Customer_0089,REF28100375,0.0,181.42,72985.02
2024-12-21,2024-12-21,Service payment - Customer_0059,REF24202219,0.0,13.01,72998.03
2024-12-21,2024-12-21,Invoice payment - Customer_0097,REF38795821,0.0,87.17,73085.2
2024-12-22,2024-12-22,Invoice payment - Customer_0089,REF31125530,0.0,112.61,73197.81
2024-12-22,2024-12-22,Payment from Customer_0075,REF38797810,0.0,165.15,73362.96
2024-12-22,2024-12-22,Utility bill payment,REF30968618,253.4,0.0,73109.56
2024-12-22,2024-12-22,Project payment - Customer_0051,REF78057505,0.0,179.36,73288.92
2024-12-22,2024-12-22,Service payment - Customer_0095,REF20407321,0.0,57.39,73346.31
2024-12-23,2024-12-23,Invoice payment - Customer_0020,REF41481355,0.0,129.95,73476.26
2024-12-23,2024-12-23,Project payment - Customer_0080,REF61285730,0.0,223.41,73699.67
2024-12-23,2024-12-23,Project payment - Customer_0095,REF32116777,0.0,44.94,73744.61
2024-12-23,2024-12-23,Invoice payment - Customer_0011,REF98923472,0.0,88.43,73833.04
2024-12-23,2024-12-23,Invoice payment - Customer_0067,REF75483101,0.0,97.95,73930.99
2024-12-23,2024-12-23,Service payment - Customer_0050,REF91406791,0.0,136.68,74067.67
2024-12-24,2024-12-24,Project payment - Customer_0061,REF57516023,0.0,95.93,74163.6
2024-12-24,2024-12-24,Project payment - Customer_0074,REF26662803,0.0,53.87,74217.47
2024-12-24,2024-12-24,Payment from Customer_0032,REF30498911,0.0,157.41,74374.88
2024-12-24,2024-12-24,Project payment - Customer_0065,REF64095428,0.0,139.38,74514.26
2024-12-24,2024-12-24,Invoice payment - Customer_0007,REF26888227,0.0,122.08,74636.34
2024-12-24,2024-12-24,Invoice payment - Customer_0079,REF16919973,0.0,81.38,74717.72
2024-12-24,2024-12-24,Invoice payment - Customer_0029,REF75124789,0.0,141.85,74859.57
2024-12-24,2024-12-24,Service payment - Customer_0060,REF99691693,0.0,94.25,74953.82
2024-12-24,2024-12-24,Inventory purchase,REF25131837,5452.32,0.0,69501.5
2024-12-24,2024-12-24,Project payment - Customer_0030,REF70070689,0.0,67.37,69568.87
2024-12-25,2024-12-25,Project payment - Customer_0023,REF76882146,0.0,168.09,69736.96
2024-12-25,2024-12-25,Invoice payment - Customer_0051,REF84412852,0.0,132.82,69869.78
2024-12-25,2024-12-25,Inventory purchase,REF13124785,4515.79,0.0,65353.99
2024-12-25,2024-12-25,Invoice payment - Customer_0052,REF48830821,0.0,165.75,65519.74
2024-12-25,2024-12-25,Invoice payment - Customer_0027,REF67132847,0.0,52.34,65572.08
2024-12-25,2024-12-25,Project payment - Customer_0033,REF43877737,0.0,163.77,65735.85
2024-12-25,2024-12-25,Project payment - Customer_0008,REF53916436,0.0,159.42,65895.27
2024-12-26,2024-12-26,Payment from Customer_0034,REF90142611,0.0,155.51,66050.78
2024-12-26,2024-12-26,Service payment - Customer_0065,REF54807902,0.0,122.04,66172.82
2024-12-26,2024-12-26,Project payment - Customer_0028,REF28016346,0.0,101.28,66274.1
2024-12-26,2024-12-26,Payment from Customer_0087,REF55216196,0.0,186.92,66461.02
2024-12-26,2024-12-26,Invoice payment - Customer_0096,REF85577809,0.0,87.52,66548.54
2024-12-26,2024-12-26,Service payment - Customer_0027,REF29363088,0.0,54.36,66602.9
2024-12-26,2024-12-26,Service payment - Customer_0049,REF16830078,0.0,169.75,66772.65
2024-12-26,2024-12-26,Service payment - Customer_0051,REF56957672,0.0,151.22,66923.87
2024-12-26,2024-12-26,Invoice payment - Customer_0017,REF64176224,0.0,146.97,67070.84
2024-12-26,2024-12-26,Service payment - Customer_0057,REF80807880,0.0,114.09,67184.93
2024-12-27,2024-12-27,Payment from Customer_0040,REF59305191,0.0,111.61,67296.54
2024-12-27,2024-12-27,Project payment - Customer_0079,REF51557309,0.0,75.91,67372.45
2024-12-27,2024-12-27,Payment from Customer_0060,REF16065358,0.0,83.93,67456.38
2024-12-27,2024-12-27,Payment from Customer_0045,REF78439937,0.0,214.69,67671.07
2024-12-27,2024-12-27,Invoice payment - Customer_0092,REF21633021,0.0,54.87,67725.94
2024-12-27,2024-12-27,Payment from Customer_0066,REF85400409,0.0,120.52,67846.46
2024-12-27,2024-12-27,Service payment - Customer_0096,REF65842406,0.0,104.81,67951.27
2024-12-27,2024-12-27,Payment from Customer_0015,REF93760657,0.0,55.24,68006.51
2024-12-27,2024-12-27,Invoice payment - Customer_0003,REF37394587,0.0,146.16,68152.67
2024-12-27,2024-12-27,Invoice payment - Customer_0063,REF88541883,0.0,63.68,68216.35
2024-12-27,2024-12-27,Service payment - Customer_0029,REF51600952,0.0,163.24,68379.59
2024-12-28,2024-12-28,Payment from Customer_0033,REF52344699,0.0,146.95,68526.54
2024-12-28,2024-12-28,Invoice payment - Customer_0018,REF81787796,0.0,164.19,68690.73
2024-12-28,2024-12-28,Service payment - Customer_0072,REF73400470,0.0,92.29,68783.02
2024-12-28,2024-12-28,Project payment - Customer_0001,REF34443391,0.0,109.69,68892.71
2024-12-28,2024-12-28,Payment from Customer_0053,REF34227934,0.0,150.98,69043.69
2024-12-28,2024-12-28,Payment from Customer_0000,REF97281056,0.0,257.51,69301.2
2024-12-28,2024-12-28,Project payment - Customer_0093,REF63348149,0.0,81.96,69383.16
2024-12-28,2024-12-28,Project payment - Customer_0023,REF86811900,0.0,159.66,69542.82
2024-12-28,2024-12-28,Project payment - Customer_0084,REF84821664,0.0,188.21,69731.03
2024-12-29,2024-12-29,Payment from Customer_0004,REF57691548,0.0,184.87,69915.9
2024-12-29,2024-12-29,Project payment - Customer_0028,REF76151954,0.0,75.59,69991.49
2024-12-29,2024-12-29,Project payment - Customer_0050,REF85497882,0.0,160.66,70152.15
2024-12-29,2024-12-29,Service payment - Customer_0095,REF40177797,0.0,54.09,70206.24
2024-12-30,2024-12-30,Payment from Customer_0015,REF95264501,0.0,50.66,70256.9
2024-12-30,2024-12-30,Service payment - Customer_0075,REF55390512,0.0,143.22,70400.12
2024-12-30,2024-12-30,Service payment - Customer_0017,REF27767821,0.0,115.89,70516.01
2024-12-30,2024-12-30,Service payment - Customer_0014,REF91522002,0.0,16.43,70532.44
2024-12-30,2024-12-30,Project payment - Customer_0006,REF84827984,0.0,124.38,70656.82
2024-12-30,2024-12-30,Service payment - Customer_0074,REF87924841,0.0,37.12,70693.94
2024-12-30,2024-12-30,Payment from Customer_0063,REF83639238,0.0,90.95,70784.89
2024-12-30,2024-12-30,Service payment - Customer_0057,REF39433694,0.0,129.33,70914.22
2024-12-30,2024-12-30,Payment from Customer_0031,REF80891390,0.0,134.21,71048.43
2024-12-30,2024-12-30,Invoice payment - Customer_0061,REF19285557,0.0,112.78,71161.21
2024-12-30,2024-12-30,Service payment - Customer_0084,REF53138605,0.0,210.68,71371.89
2024-12-30,2024-12-30,Invoice payment - Customer_0058,REF19029188,0.0,59.78,71431.67
2024-12-31,2024-12-31,Service payment - Customer_0012,REF17853858,0.0,185.29,71616.96
2024-12-31,2024-12-31,Payment from Customer_0065,REF26742830,0.0,176.16,71793.12
2024-12-31,2024-12-31,Payment from Customer_0013,REF46661752,0.0,130.84,71923.96
2024-12-31,2024-12-31,Project payment - Customer_0022,REF84070372,0.0,191.47,72115.43
2024-12-31,2024-12-31,Invoice payment - Customer_0060,REF83527956,0.0,90.55,72205.98
2024-12-31,2024-12-31,Inventory purchase,REF70718080,6035.27,0.0,66170.71
2025-01-01,2025-01-01,Invoice payment - Customer_0016,REF97687760,0.0,10.0,66180.71
2025-01-01,2025-01-01,Project payment - Customer_0022,REF84987588,0.0,79.69,66260.4
2025-01-01,2025-01-01,Service payment - Customer_0084,REF73790571,0.0,140.06,66400.46
2025-01-01,2025-01-01,Invoice payment - Customer_0097,REF10695017,0.0,33.46,66433.92
2025-01-01,2025-01-01,Payment from Customer_0019,REF70018244,0.0,52.6,66486.52
2025-01-01,2025-01-01,Invoice payment - Customer_0038,REF53422082,0.0,66.15,66552.67
2025-01-01,2025-01-01,Service payment - Customer_0073,REF83650420,0.0,29.76,66582.43
2025-01-01,2025-01-01,Project payment - Customer_0029,REF66510725,0.0,84.09,66666.52
2025-01-01,2025-01-01,Invoice payment - Customer_0006,REF35710349,0.0,49.68,66716.2
2025-01-01,2025-01-01,Project payment - Customer_0076,REF69326607,0.0,54.35,66770.55
2025-01-01,2025-01-01,Payment from Customer_0023,REF96093132,0.0,68.96,66839.51
2025-01-01,2025-01-01,Project payment - Customer_0069,REF47431237,0.0,48.1,66887.61
2025-01-01,2025-01-01,Monthly office rent,REF68715546,975.99,0.0,65911.62
2025-01-02,2025-01-02,Project payment - Customer_0052,REF68739567,0.0,61.93,65973.55
2025-01-02,2025-01-02,Payment from Customer_0087,REF31701494,0.0,80.95,66054.5
2025-01-02,2025-01-02,Payment from Customer_0000,REF85553099,0.0,115.7,66170.2
2025-01-02,2025-01-02,Payment from Customer_0028,REF41885532,0.0,41.17,66211.37
2025-01-02,2025-01-02,Service payment - Customer_0093,REF52068557,0.0,49.93,66261.3
2025-01-02,2025-01-02,Service payment - Customer_0033,REF92992648,0.0,83.48,66344.78
2025-01-02,2025-01-02,Service payment - Customer_0066,REF28534438,0.0,67.47,66412.25
2025-01-02,2025-01-02,Payment from Customer_0068,REF86828090,0.0,77.47,66489.72
2025-01-02,2025-01-02,Service payment - Customer_0095,REF47724930,0.0,34.07,66523.79
2025-01-02,2025-01-02,Payment from Customer_0016,REF25997591,0.0,10.0,66533.79
2025-01-02,2025-01-02,Invoice payment - Customer_0065,REF32483713,0.0,66.11,66599.9
2025-01-02,2025-01-02,Invoice payment - Customer_0047,REF98129552,0.0,74.81,66674.71
2025-01-02,2025-01-02,Payment from Customer_0015,REF33126280,0.0,31.22,66705.93
2025-01-02,2025-01-02,Invoice payment - Customer_0072,REF49183260,0.0,32.23,66738.16
2025-01-03,2025-01-03,Project payment - Customer_0076,REF19395886,0.0,29.13,66767.29
2025-01-03,2025-01-03,Project payment - Customer_0035,REF71903517,0.0,57.35,66824.64
2025-01-03,2025-01-03,Service payment - Customer_0096,REF90732109,0.0,64.26,66888.9
2025-01-03,2025-01-03,Payment from Customer_0013,REF49368785,0.0,68.05,66956.95
2025-01-03,2025-01-03,Payment from Customer_0014,REF17583832,0.0,10.0,66966.95
2025-01-03,2025-01-03,Payment from Customer_0019,REF13714498,0.0,39.36,67006.31
2025-01-03,2025-01-03,Service payment - Customer_0055,REF10786897,0.0,106.2,67112.51
2025-01-03,2025-01-03,Service payment - Customer_0026,REF36473698,0.0,27.82,67140.33
2025-01-03,2025-01-03,Project payment - Customer_0079,REF19440589,0.0,39.74,67180.07
2025-01-04,2025-01-04,Payment from Customer_0061,REF18558597,0.0,41.47,67221.54
2025-01-04,2025-01-04,Payment from Customer_0093,REF97428149,0.0,53.51,67275.05
2025-01-04,2025-01-04,Payment from Customer_0069,REF93628107,0.0,62.72,67337.77
2025-01-04,2025-01-04,Payment from Customer_0000,REF47402484,0.0,109.16,67446.93
2025-01-04,2025-01-04,Project payment - Customer_0039,REF83551966,0.0,57.61,67504.54
2025-01-04,2025-01-04,Invoice payment - Customer_0040,REF81016635,0.0,46.22,67550.76
2025-01-04,2025-01-04,Invoice payment - Customer_0049,REF75847516,0.0,84.75,67635.51
2025-01-04,2025-01-04,Project payment - Customer_0027,REF29028789,0.0,34.94,67670.45
2025-01-04,2025-01-04,Payment from Customer_0030,REF63900393,0.0,38.12,67708.57
2025-01-04,2025-01-04,Project payment - Customer_0080,REF20870541,0.0,140.96,67849.53
2025-01-05,2025-01-05,Invoice payment - Customer_0002,REF91081069,0.0,62.76,67912.29
2025-01-05,2025-01-05,Invoice payment - Customer_0035,REF65908744,0.0,65.31,67977.6
2025-01-05,2025-01-05,Service payment - Customer_0021,REF74605526,0.0,72.0,68049.6
2025-01-05,2025-01-05,Invoice payment - Customer_0040,REF50973085,0.0,39.6,68089.2
2025-01-05,2025-01-05,Project payment - Customer_0023,REF10010330,0.0,91.25,68180.45
2025-01-05,2025-01-05,Service payment - Customer_0055,REF15383351,0.0,72.58,68253.03
2025-01-05,2025-01-05,Packaging Shipping expense,REF86875231,130.59,0.0,68122.44
2025-01-05,2025-01-05,Invoice payment - Customer_0014,REF73674153,0.0,10.0,68132.44
2025-01-05,2025-01-05,Service payment - Customer_0017,REF90343290,0.0,65.09,68197.53
2025-01-05,2025-01-05,Project payment - Customer_0042,REF70946406,0.0,24.26,68221.79
2025-01-05,2025-01-05,Invoice payment - Customer_0044,REF18355897,0.0,41.16,68262.95
2025-01-05,2025-01-05,Payment from Customer_0052,REF47938695,0.0,56.72,68319.67
2025-01-05,2025-01-05,Service payment - Customer_0058,REF72667756,0.0,44.5,68364.17
2025-01-05,2025-01-05,Payment from Customer_0091,REF52275354,0.0,93.14,68457.31
2025-01-06,2025-01-06,Invoice payment - Customer_0071,REF24331723,0.0,140.84,68598.15
2025-01-06,2025-01-06,Payment from Customer_0022,REF55743129,0.0,105.18,68703.33
2025-01-06,2025-01-06,Project payment - Customer_0060,REF86926756,0.0,56.64,68759.97
2025-01-06,2025-01-06,Project payment - Customer_0079,REF98953765,0.0,47.11,68807.08
2025-01-06,2025-01-06,Payment from Customer_0058,REF29502585,0.0,50.05,68857.13
2025-01-06,2025-01-06,Payment from Customer_0000,REF73619743,0.0,119.48,68976.61
2025-01-06,2025-01-06,Project payment - Customer_0069,REF43510398,0.0,62.35,69038.96
2025-01-07,2025-01-07,Project payment - Customer_0082,REF57385143,0.0,38.06,69077.02
2025-01-07,2025-01-07,Payment from Customer_0000,REF27560271,0.0,87.95,69164.97
2025-01-07,2025-01-07,Invoice payment - Customer_0034,REF45977098,0.0,149.68,69314.65
2025-01-07,2025-01-07,Invoice payment - Customer_0013,REF26888751,0.0,83.22,69397.87
2025-01-07,2025-01-07,Payment from Customer_0026,REF41338744,0.0,26.94,69424.81
2025-01-07,2025-01-07,Project payment - Customer_0025,REF85825694,0.0,15.47,69440.28
2025-01-07,2025-01-07,Invoice payment - Customer_0035,REF73940289,0.0,62.01,69502.29
2025-01-08,2025-01-08,Project payment - Customer_0044,REF66935922,0.0,42.16,69544.45
2025-01-08,2025-01-08,Payment from Customer_0006,REF59075559,0.0,77.33,69621.78
2025-01-08,2025-01-08,Project payment - Customer_0031,REF21119307,0.0,88.77,69710.55
2025-01-08,2025-01-08,Payment from Customer_0047,REF32694185,0.0,80.46,69791.01
2025-01-08,2025-01-08,Payment from Customer_0018,REF93964965,0.0,79.08,69870.09
2025-01-08,2025-01-08,Payment from Customer_0056,REF72304178,0.0,78.33,69948.42
2025-01-08,2025-01-08,Project payment - Customer_0083,REF11997528,0.0,54.19,70002.61
2025-01-08,2025-01-08,Invoice payment - Customer_0050,REF85386199,0.0,79.07,70081.68
2025-01-09,2025-01-09,Payment from Customer_0045,REF90544174,0.0,101.68,70183.36
2025-01-09,2025-01-09,Project payment - Customer_0025,REF83079733,0.0,16.81,70200.17
2025-01-09,2025-01-09,Payment from Customer_0051,REF58905835,0.0,68.32,70268.49
2025-01-09,2025-01-09,Invoice payment - Customer_0007,REF61862176,0.0,52.54,70321.03
2025-01-09,2025-01-09,Payment from Customer_0020,REF37190190,0.0,59.3,70380.33
2025-01-09,2025-01-09,Project payment - Customer_0038,REF25975439,0.0,81.92,70462.25
2025-01-09,2025-01-09,Service payment - Customer_0090,REF86111538,0.0,58.45,70520.7
2025-01-09,2025-01-09,Invoice payment - Customer_0040,REF11239397,0.0,39.12,70559.82
2025-01-09,2025-01-09,Payment from Customer_0089,REF30523789,0.0,60.16,70619.98
2025-01-10,2025-01-10,Payment from Customer_0084,REF65418050,0.0,87.73,70707.71
2025-01-10,2025-01-10,Service payment - Customer_0027,REF67238873,0.0,25.72,70733.43
2025-01-10,2025-01-10,Invoice payment - Customer_0033,REF57827492,0.0,82.89,70816.32
2025-01-10,2025-01-10,Service payment - Customer_0052,REF24954325,0.0,83.03,70899.35
2025-01-10,2025-01-10,Invoice payment - Customer_0019,REF60536902,0.0,45.38,70944.73
2025-01-10,2025-01-10,Payment from Customer_0092,REF47983655,0.0,28.97,70973.7
2025-01-10,2025-01-10,Project payment - Customer_0072,REF38989451,0.0,37.7,71011.4
2025-01-10,2025-01-10,Invoice payment - Customer_0006,REF94900714,0.0,71.01,71082.41
2025-01-10,2025-01-10,Invoice payment - Customer_0030,REF86571647,0.0,47.32,71129.73
2025-01-10,2025-01-10,Service payment - Customer_0048,REF10748861,0.0,73.28,71203.01
2025-01-11,2025-01-11,Service payment - Customer_0016,REF42257320,0.0,13.15,71216.16
2025-01-11,2025-01-11,Payment from Customer_0073,REF33044195,0.0,28.26,71244.42
2025-01-11,2025-01-11,Payment from Customer_0049,REF40563277,0.0,83.0,71327.42
2025-01-11,2025-01-11,Project payment - Customer_0082,REF11035740,0.0,29.78,71357.2
