transaction_date,value_date,description,reference,debit,credit,balance
2012-08-21,2012-08-21,Professional software license,REF52388430,186.79,0.0,4925.86
2012-08-22,2012-08-22,Business meal,REF21278199,245.04,0.0,4680.82
2012-08-25,2012-08-25,Equipment purchase,REF21597614,99.52,0.0,4581.3
2012-08-29,2012-08-29,Accounting expense,REF66761056,105.25,0.0,4476.05
2012-08-30,2012-08-30,Marketing expenses,REF81633080,307.42,0.0,4168.63
2012-08-30,2012-08-30,Equipment purchase,REF13541062,92.97,0.0,4075.66
2012-08-30,2012-08-30,Business travel,REF68887945,496.92,0.0,3578.74
2012-09-01,2012-09-01,Accounting expense,REF46400415,197.77,0.0,3380.97
2012-09-03,2012-09-03,Training/conference,REF20524164,280.19,0.0,3100.78
2012-09-06,2012-09-06,Equipment purchase,REF47907923,147.74,0.0,2953.04
2012-09-10,2012-09-10,Coworking space rental,REF58983425,440.98,0.0,2512.06
2012-09-10,2012-09-10,Accounting expense,REF82712644,271.22,0.0,2240.84
2012-09-11,2012-09-11,Equipment purchase,REF94784253,80.23,0.0,2160.61
2012-09-13,2012-09-13,Training/conference,REF86683174,215.85,0.0,1944.76
2012-09-15,2012-09-15,"Project payment - Nguyen, Palmer and Gonzalez",REF97387921,0.0,555.15,2499.91
2012-09-15,2012-09-15,Payment from Rhodes-Jefferson,REF23673997,0.0,558.98,3058.89
2012-09-15,2012-09-15,Business insurance premium,REF97661662,149.25,0.0,2909.64
2012-09-15,2012-09-15,"Service payment - Fuentes, Stephens and Lee",REF92937677,0.0,689.02,3598.66
2012-09-15,2012-09-15,Payment from Thomas-Smith,REF42049467,0.0,477.04,4075.7
2012-09-15,2012-09-15,Project payment - Neal-Lopez,REF68531302,0.0,619.01,4694.71
2012-09-15,2012-09-15,"Payment from Rhodes, Schmidt and Benitez",REF97250569,0.0,844.75,5539.46
2012-09-15,2012-09-15,Project payment - Ayala-French,REF43538663,0.0,316.83,5856.29
2012-09-15,2012-09-15,Invoice payment - Schmidt-Moran,REF94352114,0.0,629.91,6486.2
2012-09-20,2012-09-20,Business meal,REF21653235,205.46,0.0,6280.74
2012-09-20,2012-09-20,Business travel,REF47158331,368.97,0.0,5911.77
2012-09-21,2012-09-21,Professional software license,REF94980393,226.05,0.0,5685.72
2012-10-03,2012-10-03,Accounting expense,REF42840738,315.68,0.0,5370.04
2012-10-05,2012-10-05,Business meal,REF55574447,326.4,0.0,5043.64
2012-10-06,2012-10-06,Marketing expenses,REF38693329,376.17,0.0,4667.47
2012-10-13,2012-10-13,Marketing expenses,REF98985255,456.31,0.0,4211.16
2012-10-15,2012-10-15,Invoice payment - Rhodes-Jefferson,REF86527809,0.0,626.91,4838.07
2012-10-15,2012-10-15,"Invoice payment - Nguyen, Palmer and Gonzalez",REF67034445,0.0,941.75,5779.82
2012-10-15,2012-10-15,Business insurance premium,REF83063506,179.54,0.0,5600.28
2012-10-15,2012-10-15,"Invoice payment - Rhodes, Schmidt and Benitez",REF38321572,0.0,1115.82,6716.1
2012-10-15,2012-10-15,Project payment - Thomas-Smith,REF97779410,0.0,461.26,7177.36
2012-10-15,2012-10-15,Project payment - Neal-Lopez,REF44268455,0.0,504.16,7681.52
2012-10-15,2012-10-15,"Service payment - Fuentes, Stephens and Lee",REF75599454,0.0,732.29,8413.81
2012-10-20,2012-10-20,Marketing expenses,REF38797373,478.08,0.0,7935.73
2012-10-20,2012-10-20,Coworking space rental,REF63628239,314.79,0.0,7620.94
2012-10-21,2012-10-21,Professional software license,REF36130528,223.99,0.0,7396.95
2012-10-21,2012-10-21,Equipment purchase,REF66986232,124.82,0.0,7272.13
2012-11-09,2012-11-09,Business meal,REF80810312,339.78,0.0,6932.35
2012-11-11,2012-11-11,Business travel,REF58331610,328.02,0.0,6604.33
2012-11-15,2012-11-15,Service payment - Ayala-French,REF49701816,0.0,452.82,7057.15
2012-11-15,2012-11-15,"Service payment - Nguyen, Palmer and Gonzalez",REF89025492,0.0,768.9,7826.05
2012-11-15,2012-11-15,Business insurance premium,REF47572907,152.67,0.0,7673.38
2012-11-15,2012-11-15,Service payment - Thomas-Smith,REF62494472,0.0,629.58,8302.96
2012-11-15,2012-11-15,Service payment - Neal-Lopez,REF55869359,0.0,608.83,8911.79
2012-11-15,2012-11-15,Invoice payment - Rhodes-Jefferson,REF40885741,0.0,600.91,9512.7
2012-11-15,2012-11-15,"Service payment - Rhodes, Schmidt and Benitez",REF24159321,0.0,752.3,10265.0
2012-11-15,2012-11-15,"Invoice payment - Fuentes, Stephens and Lee",REF36521701,0.0,605.89,10870.89
2012-11-15,2012-11-15,Project payment - Schmidt-Moran,REF95717664,0.0,666.44,11537.33
2012-11-16,2012-11-16,Business travel,REF32494465,395.14,0.0,11142.19
2012-11-21,2012-11-21,Professional software license,REF75670666,236.46,0.0,10905.73
2012-11-22,2012-11-22,Business travel,REF23118740,364.39,0.0,10541.34
2012-11-24,2012-11-24,Marketing expenses,REF47632379,382.73,0.0,10158.61
2012-11-26,2012-11-26,Training/conference,REF19470509,115.55,0.0,10043.06
2012-11-30,2012-11-30,Marketing expenses,REF23410997,341.51,0.0,9701.55
2012-12-01,2012-12-01,Marketing expenses,REF14083797,210.89,0.0,9490.66
2012-12-01,2012-12-01,Accounting expense,REF71708008,144.57,0.0,9346.09
2012-12-03,2012-12-03,Coworking space rental,REF54987538,111.49,0.0,9234.6
2012-12-11,2012-12-11,Accounting expense,REF85475029,164.62,0.0,9069.98
2012-12-15,2012-12-15,"Payment from Rhodes, Schmidt and Benitez",REF17002042,0.0,914.7,9984.68
2012-12-15,2012-12-15,Project payment - Neal-Lopez,REF92163603,0.0,455.18,10439.86
2012-12-15,2012-12-15,"Project payment - Nguyen, Palmer and Gonzalez",REF60604158,0.0,656.45,11096.31
2012-12-15,2012-12-15,Payment from Rhodes-Jefferson,REF44357946,0.0,492.11,11588.42
2012-12-15,2012-12-15,"Service payment - Fuentes, Stephens and Lee",REF80421001,0.0,556.98,12145.4
2012-12-15,2012-12-15,Business insurance premium,REF58835578,124.65,0.0,12020.75
2012-12-15,2012-12-15,Service payment - Schmidt-Moran,REF90902306,0.0,467.79,12488.54
2012-12-16,2012-12-16,Marketing expenses,REF93908824,265.43,0.0,12223.11
2012-12-17,2012-12-17,Business travel,REF35616077,303.16,0.0,11919.95
2012-12-19,2012-12-19,Marketing expenses,REF94560652,312.82,0.0,11607.13
2012-12-21,2012-12-21,Professional software license,REF49749079,181.59,0.0,11425.54
2012-12-22,2012-12-22,Business meal,REF41273605,191.93,0.0,11233.61
2012-12-23,2012-12-23,Coworking space rental,REF44921086,337.59,0.0,10896.02
2012-12-26,2012-12-26,Training/conference,REF22261257,176.48,0.0,10719.54
2013-01-02,2013-01-02,Business travel,REF32258011,404.54,0.0,10315.0
2013-01-05,2013-01-05,Business meal,REF96016509,292.43,0.0,10022.57
2013-01-07,2013-01-07,Business travel,REF22513376,376.77,0.0,9645.8
2013-01-15,2013-01-15,Business insurance premium,REF66717378,169.41,0.0,9476.39
2013-01-15,2013-01-15,"Payment from Nguyen, Palmer and Gonzalez",REF12886217,0.0,946.67,10423.06
2013-01-15,2013-01-15,Project payment - Neal-Lopez,REF99760207,0.0,691.07,11114.13
2013-01-15,2013-01-15,Service payment - Thomas-Smith,REF90243664,0.0,743.44,11857.57
2013-01-15,2013-01-15,"Invoice payment - Rhodes, Schmidt and Benitez",REF84499307,0.0,988.38,12845.95
2013-01-15,2013-01-15,Invoice payment - Rhodes-Jefferson,REF49092417,0.0,655.67,13501.62
2013-01-15,2013-01-15,"Service payment - Fuentes, Stephens and Lee",REF78076204,0.0,563.68,14065.3
2013-01-15,2013-01-15,Invoice payment - Schmidt-Moran,REF89452527,0.0,608.94,14674.24
2013-01-16,2013-01-16,Training/conference,REF81925674,350.93,0.0,14323.31
2013-01-20,2013-01-20,Coworking space rental,REF63994816,149.1,0.0,14174.21
2013-01-20,2013-01-20,Business travel,REF99878863,622.54,0.0,13551.67
2013-01-21,2013-01-21,Professional software license,REF99401420,262.69,0.0,13288.98
2013-02-06,2013-02-06,Training/conference,REF95064697,165.96,0.0,13123.02
2013-02-10,2013-02-10,Marketing expenses,REF46530563,225.37,0.0,12897.65
2013-02-11,2013-02-11,Coworking space rental,REF88696338,129.2,0.0,12768.45
2013-02-12,2013-02-12,Training/conference,REF50191558,239.09,0.0,12529.36
2013-02-15,2013-02-15,Payment from Schmidt-Moran,REF30750166,0.0,567.37,13096.73
2013-02-15,2013-02-15,Payment from Ayala-French,REF94602273,0.0,356.35,13453.08
2013-02-15,2013-02-15,Business insurance premium,REF81960654,163.44,0.0,13289.64
2013-02-15,2013-02-15,Service payment - Neal-Lopez,REF52081104,0.0,538.2,13827.84
2013-02-15,2013-02-15,Project payment - Rhodes-Jefferson,REF53968186,0.0,627.85,14455.69
2013-02-15,2013-02-15,"Payment from Fuentes, Stephens and Lee",REF51452551,0.0,537.95,14993.64
2013-02-15,2013-02-15,"Service payment - Rhodes, Schmidt and Benitez",REF15026413,0.0,837.71,15831.35
2013-02-15,2013-02-15,"Service payment - Nguyen, Palmer and Gonzalez",REF47811013,0.0,591.19,16422.54
2013-02-15,2013-02-15,Project payment - Thomas-Smith,REF31408502,0.0,478.15,16900.69
2013-02-16,2013-02-16,Business meal,REF62309574,361.75,0.0,16538.94
2013-02-20,2013-02-20,Marketing expenses,REF23273700,379.34,0.0,16159.6
2013-02-21,2013-02-21,Professional software license,REF97311250,252.64,0.0,15906.96
2013-03-01,2013-03-01,Business travel,REF50373348,392.43,0.0,15514.53
2013-03-02,2013-03-02,Marketing expenses,REF59761228,113.81,0.0,15400.72
2013-03-04,2013-03-04,Marketing expenses,REF76999533,283.97,0.0,15116.75
2013-03-06,2013-03-06,Marketing expenses,REF52832514,322.46,0.0,14794.29
2013-03-07,2013-03-07,Training/conference,REF24614971,88.85,0.0,14705.44
2013-03-10,2013-03-10,Coworking space rental,REF73305801,134.92,0.0,14570.52
2013-03-14,2013-03-14,Marketing expenses,REF25367279,287.38,0.0,14283.14
2013-03-15,2013-03-15,"Invoice payment - Fuentes, Stephens and Lee",REF88757373,0.0,513.86,14797.0
2013-03-15,2013-03-15,"Project payment - Rhodes, Schmidt and Benitez",REF74140438,0.0,966.12,15763.12
2013-03-15,2013-03-15,"Invoice payment - Nguyen, Palmer and Gonzalez",REF19477501,0.0,748.91,16512.03
2013-03-15,2013-03-15,Project payment - Rhodes-Jefferson,REF49994268,0.0,553.9,17065.93
2013-03-15,2013-03-15,Payment from Neal-Lopez,REF69121259,0.0,560.06,17625.99
2013-03-15,2013-03-15,Payment from Thomas-Smith,REF61365469,0.0,326.59,17952.58
2013-03-15,2013-03-15,Business insurance premium,REF39147961,149.01,0.0,17803.57
2013-03-21,2013-03-21,Marketing expenses,REF53381426,160.18,0.0,17643.39
2013-03-21,2013-03-21,Professional software license,REF28815485,187.76,0.0,17455.63
2013-03-21,2013-03-21,Coworking space rental,REF24060954,98.19,0.0,17357.44
2013-03-24,2013-03-24,Coworking space rental,REF13219212,417.02,0.0,16940.42
2013-03-29,2013-03-29,Business meal,REF28144704,342.68,0.0,16597.74
2013-04-01,2013-04-01,Business meal,REF26451732,357.36,0.0,16240.38
2013-04-12,2013-04-12,Coworking space rental,REF49453499,365.32,0.0,15875.06
2013-04-15,2013-04-15,Business insurance premium,REF51945715,135.84,0.0,15739.22
2013-04-15,2013-04-15,Payment from Thomas-Smith,REF13214419,0.0,649.67,16388.89
2013-04-15,2013-04-15,"Service payment - Nguyen, Palmer and Gonzalez",REF94753067,0.0,570.32,16959.21
2013-04-15,2013-04-15,Project payment - Ayala-French,REF86433849,0.0,283.46,17242.67
2013-04-15,2013-04-15,Invoice payment - Neal-Lopez,REF53067735,0.0,412.2,17654.87
2013-04-15,2013-04-15,"Project payment - Fuentes, Stephens and Lee",REF37372700,0.0,557.74,18212.61
2013-04-15,2013-04-15,Invoice payment - Schmidt-Moran,REF51854461,0.0,639.01,18851.62
2013-04-21,2013-04-21,Professional software license,REF38263734,181.63,0.0,18669.99
2013-04-24,2013-04-24,Accounting expense,REF39298337,179.46,0.0,18490.53
2013-05-02,2013-05-02,Business meal,REF41510869,320.92,0.0,18169.61
2013-05-02,2013-05-02,Coworking space rental,REF70536234,229.75,0.0,17939.86
2013-05-03,2013-05-03,Coworking space rental,REF52540870,414.98,0.0,17524.88
2013-05-08,2013-05-08,Business meal,REF38650554,187.19,0.0,17337.69
2013-05-15,2013-05-15,Business insurance premium,REF85916288,125.23,0.0,17212.46
2013-05-15,2013-05-15,Payment from Thomas-Smith,REF65076788,0.0,426.4,17638.86
2013-05-15,2013-05-15,Payment from Ayala-French,REF51482684,0.0,338.39,17977.25
2013-05-15,2013-05-15,"Service payment - Rhodes, Schmidt and Benitez",REF57219531,0.0,589.84,18567.09
2013-05-15,2013-05-15,Invoice payment - Schmidt-Moran,REF50491890,0.0,497.72,19064.81
2013-05-15,2013-05-15,Project payment - Rhodes-Jefferson,REF32272817,0.0,409.46,19474.27
2013-05-15,2013-05-15,"Payment from Fuentes, Stephens and Lee",REF49973367,0.0,443.68,19917.95
2013-05-15,2013-05-15,Service payment - Neal-Lopez,REF47941490,0.0,529.91,20447.86
2013-05-15,2013-05-15,"Invoice payment - Nguyen, Palmer and Gonzalez",REF59315162,0.0,525.83,20973.69
2013-05-21,2013-05-21,Professional software license,REF84995183,205.86,0.0,20767.83
2013-05-26,2013-05-26,Business travel,REF49936246,50.57,0.0,20717.26
2013-05-26,2013-05-26,Business meal,REF29454440,219.58,0.0,20497.68
2013-06-06,2013-06-06,Training/conference,REF94751349,123.38,0.0,20374.3
2013-06-13,2013-06-13,Equipment purchase,REF27466815,83.14,0.0,20291.16
2013-06-15,2013-06-15,Service payment - Schmidt-Moran,REF33234756,0.0,393.24,20684.4
2013-06-15,2013-06-15,"Service payment - Nguyen, Palmer and Gonzalez",REF56972191,0.0,484.94,21169.34
2013-06-15,2013-06-15,"Project payment - Rhodes, Schmidt and Benitez",REF69361938,0.0,658.94,21828.28
2013-06-15,2013-06-15,Payment from Rhodes-Jefferson,REF89283965,0.0,389.42,22217.7
2013-06-15,2013-06-15,Business insurance premium,REF50473325,108.84,0.0,22108.86
2013-06-15,2013-06-15,Accounting expense,REF21163612,212.24,0.0,21896.62
2013-06-15,2013-06-15,Payment from Thomas-Smith,REF96774946,0.0,378.32,22274.94
2013-06-15,2013-06-15,Payment from Neal-Lopez,REF56182885,0.0,491.66,22766.6
2013-06-15,2013-06-15,"Service payment - Fuentes, Stephens and Lee",REF38378040,0.0,446.16,23212.76
2013-06-15,2013-06-15,Service payment - Ayala-French,REF85395894,0.0,260.07,23472.83
2013-06-15,2013-06-15,Business meal,REF85797228,157.37,0.0,23315.46
2013-06-17,2013-06-17,Business travel,REF34406070,421.5,0.0,22893.96
2013-06-21,2013-06-21,Professional software license,REF16271268,180.15,0.0,22713.81
2013-06-25,2013-06-25,Business travel,REF45464210,193.05,0.0,22520.76
2013-06-27,2013-06-27,Business meal,REF46297225,171.08,0.0,22349.68
2013-06-29,2013-06-29,Training/conference,REF86518506,155.34,0.0,22194.34
2013-07-12,2013-07-12,Accounting expense,REF89642881,154.56,0.0,22039.78
2013-07-14,2013-07-14,Marketing expenses,REF18946342,250.78,0.0,21789.0
2013-07-15,2013-07-15,Business insurance premium,REF62595437,97.58,0.0,21691.42
2013-07-15,2013-07-15,"Invoice payment - Rhodes, Schmidt and Benitez",REF66884439,0.0,643.56,22334.98
2013-07-15,2013-07-15,Payment from Schmidt-Moran,REF22742537,0.0,265.33,22600.31
2013-07-15,2013-07-15,Service payment - Ayala-French,REF56453500,0.0,202.74,22803.05
2013-07-15,2013-07-15,"Service payment - Nguyen, Palmer and Gonzalez",REF40438587,0.0,501.68,23304.73
2013-07-15,2013-07-15,"Payment from Fuentes, Stephens and Lee",REF56411267,0.0,372.85,23677.58
2013-07-15,2013-07-15,Payment from Neal-Lopez,REF12908330,0.0,374.54,24052.12
2013-07-15,2013-07-15,Invoice payment - Rhodes-Jefferson,REF49258369,0.0,426.47,24478.59
2013-07-15,2013-07-15,Service payment - Thomas-Smith,REF55645588,0.0,344.1,24822.69
2013-07-16,2013-07-16,Accounting expense,REF31094262,183.19,0.0,24639.5
2013-07-16,2013-07-16,Equipment purchase,REF13157336,116.17,0.0,24523.33
2013-07-20,2013-07-20,Equipment purchase,REF56398682,109.06,0.0,24414.27
2013-07-21,2013-07-21,Professional software license,REF11030506,148.38,0.0,24265.89
2013-07-24,2013-07-24,Business meal,REF13426822,198.99,0.0,24066.9
2013-07-27,2013-07-27,Business meal,REF16143944,97.1,0.0,23969.8
2013-07-28,2013-07-28,Coworking space rental,REF98826811,182.46,0.0,23787.34
2013-08-06,2013-08-06,Business meal,REF77861899,247.56,0.0,23539.78
2013-08-08,2013-08-08,Business travel,REF70170268,379.0,0.0,23160.78
2013-08-11,2013-08-11,Marketing expenses,REF90805668,158.85,0.0,23001.93
2013-08-15,2013-08-15,Business insurance premium,REF15888116,112.34,0.0,22889.59
2013-08-15,2013-08-15,"Project payment - Rhodes, Schmidt and Benitez",REF72749630,0.0,635.35,23524.94
2013-08-15,2013-08-15,Payment from Rhodes-Jefferson,REF28347799,0.0,443.39,23968.33
2013-08-15,2013-08-15,"Payment from Fuentes, Stephens and Lee",REF87778004,0.0,376.89,24345.22
2013-08-15,2013-08-15,"Project payment - Nguyen, Palmer and Gonzalez",REF71332060,0.0,626.55,24971.77
2013-08-15,2013-08-15,Invoice payment - Neal-Lopez,REF82437743,0.0,433.91,25405.68
2013-08-15,2013-08-15,Project payment - Schmidt-Moran,REF26116511,0.0,651.86,26057.54
2013-08-15,2013-08-15,Payment from Thomas-Smith,REF44945126,0.0,275.66,26333.2
2013-08-20,2013-08-20,Accounting expense,REF21659832,188.33,0.0,26144.87
2013-08-21,2013-08-21,Professional software license,REF88520213,165.14,0.0,25979.73
2013-08-26,2013-08-26,Marketing expenses,REF61939580,217.99,0.0,25761.74
2013-08-27,2013-08-27,Business meal,REF22662243,199.6,0.0,25562.14
2013-08-29,2013-08-29,Coworking space rental,REF51674541,161.72,0.0,25400.42
2013-09-02,2013-09-02,Business travel,REF20700079,433.07,0.0,24967.35
2013-09-04,2013-09-04,Business meal,REF78728468,241.26,0.0,24726.09
2013-09-11,2013-09-11,Coworking space rental,REF11651235,173.83,0.0,24552.26
2013-09-11,2013-09-11,Equipment purchase,REF77870562,145.0,0.0,24407.26
2013-09-15,2013-09-15,Business insurance premium,REF41567116,163.74,0.0,24243.52
2013-09-15,2013-09-15,"Invoice payment - Nguyen, Palmer and Gonzalez",REF13067932,0.0,588.42,24831.94
2013-09-15,2013-09-15,Project payment - Neal-Lopez,REF46830275,0.0,663.95,25495.89
2013-09-15,2013-09-15,Project payment - Rhodes-Jefferson,REF46015899,0.0,660.71,26156.6
2013-09-15,2013-09-15,Service payment - Ayala-French,REF62200875,0.0,393.9,26550.5
2013-09-15,2013-09-15,Project payment - Thomas-Smith,REF82785242,0.0,594.19,27144.69
2013-09-15,2013-09-15,Service payment - Schmidt-Moran,REF16330672,0.0,475.91,27620.6
2013-09-15,2013-09-15,"Payment from Rhodes, Schmidt and Benitez",REF86816044,0.0,767.88,28388.48
2013-09-15,2013-09-15,"Project payment - Fuentes, Stephens and Lee",REF21992257,0.0,374.04,28762.52
2013-09-21,2013-09-21,Professional software license,REF20394879,260.45,0.0,28502.07
2013-09-22,2013-09-22,Training/conference,REF72838201,223.13,0.0,28278.94
2013-09-23,2013-09-23,Business travel,REF92166629,525.14,0.0,27753.8
2013-09-23,2013-09-23,Business meal,REF96275955,301.15,0.0,27452.65
2013-09-26,2013-09-26,Business travel,REF20850152,529.73,0.0,26922.92
2013-10-09,2013-10-09,Accounting expense,REF84985993,262.06,0.0,26660.86
2013-10-15,2013-10-15,Training/conference,REF48118105,258.22,0.0,26402.64
2013-10-15,2013-10-15,"Invoice payment - Rhodes, Schmidt and Benitez",REF59034923,0.0,1035.04,27437.68
2013-10-15,2013-10-15,Payment from Ayala-French,REF98236634,0.0,258.79,27696.47
2013-10-15,2013-10-15,Business insurance premium,REF86520314,169.8,0.0,27526.67
2013-10-15,2013-10-15,Payment from Thomas-Smith,REF14129082,0.0,811.13,28337.8
2013-10-15,2013-10-15,"Payment from Fuentes, Stephens and Lee",REF78012073,0.0,537.61,28875.41
2013-10-15,2013-10-15,Service payment - Neal-Lopez,REF35906708,0.0,725.4,29600.81
2013-10-15,2013-10-15,"Project payment - Nguyen, Palmer and Gonzalez",REF26502669,0.0,828.48,30429.29
2013-10-15,2013-10-15,Invoice payment - Schmidt-Moran,REF98833611,0.0,552.42,30981.71
2013-10-15,2013-10-15,Project payment - Rhodes-Jefferson,REF77408811,0.0,727.33,31709.04
2013-10-20,2013-10-20,Business travel,REF88580453,563.61,0.0,31145.43
2013-10-21,2013-10-21,Professional software license,REF76750096,192.92,0.0,30952.51
2013-10-22,2013-10-22,Coworking space rental,REF35147907,176.18,0.0,30776.33
2013-10-22,2013-10-22,Business travel,REF92681578,445.44,0.0,30330.89
2013-10-30,2013-10-30,Business travel,REF86102535,639.47,0.0,29691.42
2013-11-07,2013-11-07,Equipment purchase,REF28653993,226.43,0.0,29464.99
2013-11-08,2013-11-08,Accounting expense,REF78870114,266.47,0.0,29198.52
2013-11-14,2013-11-14,Marketing expenses,REF41846746,196.2,0.0,29002.32
2013-11-15,2013-11-15,Project payment - Schmidt-Moran,REF16860654,0.0,593.84,29596.16
2013-11-15,2013-11-15,Invoice payment - Thomas-Smith,REF23155024,0.0,671.4,30267.56
2013-11-15,2013-11-15,Business insurance premium,REF47074780,161.64,0.0,30105.92
2013-11-15,2013-11-15,"Payment from Rhodes, Schmidt and Benitez",REF28355128,0.0,985.65,31091.57
2013-11-15,2013-11-15,"Project payment - Fuentes, Stephens and Lee",REF35382698,0.0,432.33,31523.9
2013-11-15,2013-11-15,Service payment - Rhodes-Jefferson,REF62841662,0.0,641.9,32165.8
2013-11-15,2013-11-15,Service payment - Neal-Lopez,REF24108008,0.0,458.9,32624.7
2013-11-15,2013-11-15,"Payment from Nguyen, Palmer and Gonzalez",REF50224793,0.0,899.43,33524.13
2013-11-18,2013-11-18,Business meal,REF23598282,261.86,0.0,33262.27
2013-11-21,2013-11-21,Training/conference,REF86515949,146.47,0.0,33115.8
2013-11-21,2013-11-21,Professional software license,REF84964794,200.78,0.0,32915.02
2013-11-26,2013-11-26,Accounting expense,REF34846871,208.4,0.0,32706.62
2013-11-30,2013-11-30,Business meal,REF36512395,329.77,0.0,32376.85
2013-12-03,2013-12-03,Business meal,REF36446487,180.43,0.0,32196.42
2013-12-05,2013-12-05,Accounting expense,REF87291667,255.86,0.0,31940.56
2013-12-10,2013-12-10,Marketing expenses,REF15891586,350.52,0.0,31590.04
2013-12-11,2013-12-11,Marketing expenses,REF73716745,349.61,0.0,31240.43
2013-12-11,2013-12-11,Equipment purchase,REF10914395,160.83,0.0,31079.6
2013-12-12,2013-12-12,Business meal,REF76101243,194.86,0.0,30884.74
2013-12-15,2013-12-15,Service payment - Ayala-French,REF69551836,0.0,299.15,31183.89
2013-12-15,2013-12-15,Project payment - Neal-Lopez,REF30531995,0.0,365.55,31549.44
2013-12-15,2013-12-15,Payment from Schmidt-Moran,REF53688368,0.0,593.17,32142.61
2013-12-15,2013-12-15,Business insurance premium,REF56383375,118.79,0.0,32023.82
2013-12-15,2013-12-15,"Project payment - Fuentes, Stephens and Lee",REF44311078,0.0,532.59,32556.41
2013-12-15,2013-12-15,"Project payment - Rhodes, Schmidt and Benitez",REF35448949,0.0,627.25,33183.66
2013-12-15,2013-12-15,Invoice payment - Rhodes-Jefferson,REF41159317,0.0,482.38,33666.04
2013-12-16,2013-12-16,Training/conference,REF95177609,192.01,0.0,33474.03
2013-12-17,2013-12-17,Business meal,REF47297373,232.39,0.0,33241.64
2013-12-19,2013-12-19,Business travel,REF70686766,179.06,0.0,33062.58
2013-12-19,2013-12-19,Marketing expenses,REF21150477,281.94,0.0,32780.64
2013-12-21,2013-12-21,Professional software license,REF67547041,172.24,0.0,32608.4
2013-12-23,2013-12-23,Business travel,REF83613146,257.03,0.0,32351.37
2013-12-24,2013-12-24,Business meal,REF91817571,231.37,0.0,32120.0
2013-12-27,2013-12-27,Business meal,REF32776190,94.73,0.0,32025.27
2013-12-31,2013-12-31,Training/conference,REF76514266,182.84,0.0,31842.43
2013-12-31,2013-12-31,Business travel,REF89314050,329.21,0.0,31513.22
2014-01-09,2014-01-09,Business travel,REF67514741,428.6,0.0,31084.62
2014-01-09,2014-01-09,Marketing expenses,REF87887248,360.36,0.0,30724.26
2014-01-15,2014-01-15,Business insurance premium,REF69798534,157.34,0.0,30566.92
2014-01-15,2014-01-15,"Service payment - Rhodes, Schmidt and Benitez",REF69999432,0.0,1104.03,31670.95
2014-01-15,2014-01-15,Payment from Neal-Lopez,REF94958303,0.0,670.69,32341.64
2014-01-15,2014-01-15,Project payment - Ayala-French,REF89137025,0.0,297.19,32638.83
2014-01-15,2014-01-15,"Invoice payment - Nguyen, Palmer and Gonzalez",REF17468433,0.0,879.35,33518.18
2014-01-15,2014-01-15,"Payment from Fuentes, Stephens and Lee",REF27724000,0.0,482.62,34000.8
2014-01-15,2014-01-15,Service payment - Thomas-Smith,REF56124326,0.0,546.21,34547.01
2014-01-15,2014-01-15,Invoice payment - Schmidt-Moran,REF38069656,0.0,707.14,35254.15
2014-01-15,2014-01-15,Payment from Rhodes-Jefferson,REF35471941,0.0,553.32,35807.47
2014-01-21,2014-01-21,Professional software license,REF51574905,224.05,0.0,35583.42
2014-01-21,2014-01-21,Business meal,REF86691540,302.62,0.0,35280.8
2014-01-23,2014-01-23,Training/conference,REF11551617,207.9,0.0,35072.9
2014-01-25,2014-01-25,Equipment purchase,REF85616866,91.14,0.0,34981.76
2014-01-25,2014-01-25,Marketing expenses,REF13671527,393.96,0.0,34587.8
2014-01-26,2014-01-26,Coworking space rental,REF16274591,421.45,0.0,34166.35
2014-01-26,2014-01-26,Equipment purchase,REF56621606,177.55,0.0,33988.8
2014-02-02,2014-02-02,Accounting expense,REF67901502,202.44,0.0,33786.36
2014-02-04,2014-02-04,Marketing expenses,REF47996271,178.06,0.0,33608.3
2014-02-08,2014-02-08,Business meal,REF24795082,220.99,0.0,33387.31
2014-02-10,2014-02-10,Equipment purchase,REF79916547,256.57,0.0,33130.74
2014-02-15,2014-02-15,Business insurance premium,REF84211907,144.52,0.0,32986.22
2014-02-15,2014-02-15,Project payment - Neal-Lopez,REF51914602,0.0,539.2,33525.42
2014-02-15,2014-02-15,Payment from Schmidt-Moran,REF55601887,0.0,754.17,34279.59
2014-02-15,2014-02-15,"Project payment - Rhodes, Schmidt and Benitez",REF39484406,0.0,894.48,35174.07
2014-02-15,2014-02-15,"Service payment - Nguyen, Palmer and Gonzalez",REF22445231,0.0,964.21,36138.28
2014-02-15,2014-02-15,Service payment - Ayala-French,REF60013330,0.0,383.97,36522.25
2014-02-15,2014-02-15,Payment from Rhodes-Jefferson,REF33558610,0.0,524.37,37046.62
2014-02-15,2014-02-15,"Invoice payment - Fuentes, Stephens and Lee",REF41716806,0.0,514.94,37561.56
2014-02-15,2014-02-15,Service payment - Thomas-Smith,REF81229852,0.0,452.59,38014.15
2014-02-19,2014-02-19,Equipment purchase,REF24871021,116.5,0.0,37897.65
2014-02-20,2014-02-20,Marketing expenses,REF11347600,175.3,0.0,37722.35
2014-02-21,2014-02-21,Professional software license,REF11844608,242.99,0.0,37479.36
2014-02-27,2014-02-27,Training/conference,REF69466380,220.51,0.0,37258.85
2014-03-07,2014-03-07,Business travel,REF28792809,565.61,0.0,36693.24
2014-03-09,2014-03-09,Business travel,REF19378686,304.21,0.0,36389.03
2014-03-11,2014-03-11,Equipment purchase,REF67410403,79.26,0.0,36309.77
2014-03-13,2014-03-13,Business meal,REF59727627,213.41,0.0,36096.36
2014-03-14,2014-03-14,Training/conference,REF62102783,211.99,0.0,35884.37
2014-03-15,2014-03-15,Service payment - Neal-Lopez,REF72781658,0.0,369.91,36254.28
2014-03-15,2014-03-15,Payment from Thomas-Smith,REF94146082,0.0,363.85,36618.13
2014-03-15,2014-03-15,Business insurance premium,REF42720792,142.66,0.0,36475.47
2014-03-15,2014-03-15,Service payment - Schmidt-Moran,REF18641918,0.0,742.52,37217.99
2014-03-15,2014-03-15,"Invoice payment - Fuentes, Stephens and Lee",REF64430152,0.0,558.9,37776.89
2014-03-15,2014-03-15,Service payment - Ayala-French,REF88159886,0.0,396.11,38173.0
2014-03-15,2014-03-15,Invoice payment - Rhodes-Jefferson,REF15087622,0.0,533.53,38706.53
2014-03-15,2014-03-15,"Invoice payment - Nguyen, Palmer and Gonzalez",REF61417980,0.0,733.02,39439.55
2014-03-15,2014-03-15,"Payment from Rhodes, Schmidt and Benitez",REF84728417,0.0,883.86,40323.41
2014-03-16,2014-03-16,Equipment purchase,REF60884694,197.54,0.0,40125.87
2014-03-16,2014-03-16,Business travel,REF82243493,308.94,0.0,39816.93
2014-03-19,2014-03-19,Marketing expenses,REF18826030,169.95,0.0,39646.98
2014-03-21,2014-03-21,Professional software license,REF24508218,238.08,0.0,39408.9
2014-03-24,2014-03-24,Business meal,REF64328888,214.33,0.0,39194.57
2014-03-28,2014-03-28,Business meal,REF32076688,183.07,0.0,39011.5
2014-03-29,2014-03-29,Training/conference,REF39062444,247.61,0.0,38763.89
2014-03-29,2014-03-29,Marketing expenses,REF36229662,218.42,0.0,38545.47
2014-03-30,2014-03-30,Business meal,REF76171440,503.62,0.0,38041.85
2014-04-03,2014-04-03,Marketing expenses,REF53043638,338.88,0.0,37702.97
2014-04-05,2014-04-05,Business travel,REF43842401,623.72,0.0,37079.25
2014-04-13,2014-04-13,Marketing expenses,REF68741550,282.09,0.0,36797.16
2014-04-14,2014-04-14,Business meal,REF23740711,259.84,0.0,36537.32
2014-04-14,2014-04-14,Equipment purchase,REF84382748,172.43,0.0,36364.89
2014-04-15,2014-04-15,Business insurance premium,REF84240128,145.27,0.0,36219.62
2014-04-15,2014-04-15,"Invoice payment - Fuentes, Stephens and Lee",REF28851779,0.0,478.55,36698.17
2014-04-15,2014-04-15,Invoice payment - Neal-Lopez,REF16881104,0.0,492.86,37191.03
2014-04-15,2014-04-15,"Invoice payment - Nguyen, Palmer and Gonzalez",REF90672778,0.0,716.03,37907.06
2014-04-15,2014-04-15,Project payment - Thomas-Smith,REF57428280,0.0,576.95,38484.01
2014-04-15,2014-04-15,"Payment from Rhodes, Schmidt and Benitez",REF89903816,0.0,876.22,39360.23
2014-04-15,2014-04-15,Project payment - Ayala-French,REF91299833,0.0,348.22,39708.45
2014-04-15,2014-04-15,Service payment - Rhodes-Jefferson,REF79784674,0.0,564.97,40273.42
2014-04-15,2014-04-15,Payment from Schmidt-Moran,REF99512142,0.0,658.19,40931.61
2014-04-21,2014-04-21,Equipment purchase,REF53511478,121.06,0.0,40810.55
2014-04-21,2014-04-21,Professional software license,REF45441325,205.43,0.0,40605.12
2014-04-25,2014-04-25,Business travel,REF92605495,405.06,0.0,40200.06
2014-04-25,2014-04-25,Marketing expenses,REF12923301,379.45,0.0,39820.61
2014-05-02,2014-05-02,Training/conference,REF84550989,203.57,0.0,39617.04
2014-05-12,2014-05-12,Business meal,REF92076772,149.19,0.0,39467.85
2014-05-15,2014-05-15,"Invoice payment - Nguyen, Palmer and Gonzalez",REF60555955,0.0,672.93,40140.78
2014-05-15,2014-05-15,Business insurance premium,REF42138757,119.87,0.0,40020.91
2014-05-15,2014-05-15,Payment from Thomas-Smith,REF28193119,0.0,412.08,40432.99
2014-05-15,2014-05-15,Project payment - Ayala-French,REF77501941,0.0,244.31,40677.3
2014-05-15,2014-05-15,Invoice payment - Rhodes-Jefferson,REF40163009,0.0,468.86,41146.16
2014-05-15,2014-05-15,Payment from Schmidt-Moran,REF72454683,0.0,689.07,41835.23
2014-05-15,2014-05-15,"Service payment - Fuentes, Stephens and Lee",REF30434284,0.0,582.27,42417.5
2014-05-15,2014-05-15,"Project payment - Rhodes, Schmidt and Benitez",REF87557904,0.0,712.15,43129.65
2014-05-15,2014-05-15,Project payment - Neal-Lopez,REF43644263,0.0,462.11,43591.76
2014-05-19,2014-05-19,Business travel,REF41110796,492.71,0.0,43099.05
2014-05-21,2014-05-21,Professional software license,REF87819811,186.44,0.0,42912.61
2014-05-22,2014-05-22,Marketing expenses,REF38172513,433.65,0.0,42478.96
2014-05-26,2014-05-26,Coworking space rental,REF49510402,347.66,0.0,42131.3
2014-05-30,2014-05-30,Training/conference,REF49767859,88.84,0.0,42042.46
2014-05-30,2014-05-30,Coworking space rental,REF64051759,295.57,0.0,41746.89
2014-06-01,2014-06-01,Business meal,REF67514415,214.85,0.0,41532.04
2014-06-02,2014-06-02,Business travel,REF73411509,264.35,0.0,41267.69
2014-06-06,2014-06-06,Coworking space rental,REF88606151,264.19,0.0,41003.5
2014-06-15,2014-06-15,Invoice payment - Ayala-French,REF46534052,0.0,237.68,41241.18
2014-06-15,2014-06-15,"Payment from Fuentes, Stephens and Lee",REF93045504,0.0,341.91,41583.09
2014-06-15,2014-06-15,"Payment from Rhodes, Schmidt and Benitez",REF17144802,0.0,714.41,42297.5
2014-06-15,2014-06-15,Business insurance premium,REF43220910,120.97,0.0,42176.53
2014-06-15,2014-06-15,"Invoice payment - Nguyen, Palmer and Gonzalez",REF17739964,0.0,573.69,42750.22
2014-06-15,2014-06-15,Project payment - Schmidt-Moran,REF57860068,0.0,473.45,43223.67
2014-06-21,2014-06-21,Professional software license,REF75961945,165.06,0.0,43058.61
2014-06-25,2014-06-25,Training/conference,REF23756421,160.91,0.0,42897.7
2014-07-05,2014-07-05,Equipment purchase,REF11053275,23.6,0.0,42874.1
2014-07-15,2014-07-15,Payment from Ayala-French,REF52446175,0.0,292.36,43166.46
2014-07-15,2014-07-15,Service payment - Rhodes-Jefferson,REF20013506,0.0,437.4,43603.86
2014-07-15,2014-07-15,Project payment - Neal-Lopez,REF63723766,0.0,389.01,43992.87
2014-07-15,2014-07-15,"Payment from Fuentes, Stephens and Lee",REF43989730,0.0,398.72,44391.59
2014-07-15,2014-07-15,Business insurance premium,REF68190322,95.6,0.0,44295.99
2014-07-15,2014-07-15,"Service payment - Rhodes, Schmidt and Benitez",REF39819402,0.0,505.37,44801.36
2014-07-15,2014-07-15,Project payment - Thomas-Smith,REF21182383,0.0,411.26,45212.62
2014-07-15,2014-07-15,Payment from Schmidt-Moran,REF77228987,0.0,467.17,45679.79
2014-07-15,2014-07-15,"Invoice payment - Nguyen, Palmer and Gonzalez",REF75079881,0.0,435.16,46114.95
2014-07-21,2014-07-21,Professional software license,REF64232539,120.92,0.0,45994.03
2014-07-28,2014-07-28,Training/conference,REF32175587,176.03,0.0,45818.0
2014-07-30,2014-07-30,Business meal,REF70304901,158.88,0.0,45659.12
2014-08-02,2014-08-02,Business meal,REF43476477,217.53,0.0,45441.59
2014-08-06,2014-08-06,Business travel,REF99287944,142.31,0.0,45299.28
2014-08-15,2014-08-15,Invoice payment - Neal-Lopez,REF47537773,0.0,363.46,45662.74
2014-08-15,2014-08-15,Business insurance premium,REF24944566,108.56,0.0,45554.18
2014-08-15,2014-08-15,Project payment - Thomas-Smith,REF24717365,0.0,345.38,45899.56
2014-08-15,2014-08-15,Project payment - Rhodes-Jefferson,REF12773335,0.0,473.4,46372.96
2014-08-15,2014-08-15,Service payment - Schmidt-Moran,REF76531286,0.0,446.67,46819.63
2014-08-15,2014-08-15,Payment from Ayala-French,REF27125943,0.0,153.42,46973.05
2014-08-15,2014-08-15,"Invoice payment - Rhodes, Schmidt and Benitez",REF81873127,0.0,626.19,47599.24
2014-08-21,2014-08-21,Professional software license,REF31817339,155.8,0.0,47443.44
2014-08-23,2014-08-23,Business travel,REF32667364,301.87,0.0,47141.57
2014-09-01,2014-09-01,Business travel,REF40077647,556.88,0.0,46584.69
2014-09-09,2014-09-09,Business meal,REF58588767,397.18,0.0,46187.51
2014-09-10,2014-09-10,Coworking space rental,REF53186285,138.25,0.0,46049.26
2014-09-10,2014-09-10,Business travel,REF47538789,330.53,0.0,45718.73
2014-09-12,2014-09-12,Equipment purchase,REF63503985,151.78,0.0,45566.95
2014-09-12,2014-09-12,Coworking space rental,REF86977794,373.21,0.0,45193.74
2014-09-15,2014-09-15,Invoice payment - Neal-Lopez,REF42856731,0.0,599.71,45793.45
2014-09-15,2014-09-15,Invoice payment - Thomas-Smith,REF45797567,0.0,480.28,46273.73
2014-09-15,2014-09-15,"Project payment - Fuentes, Stephens and Lee",REF23634374,0.0,337.28,46611.01
2014-09-15,2014-09-15,"Payment from Rhodes, Schmidt and Benitez",REF37958450,0.0,630.39,47241.4
2014-09-15,2014-09-15,"Project payment - Nguyen, Palmer and Gonzalez",REF83005445,0.0,693.2,47934.6
2014-09-15,2014-09-15,Business insurance premium,REF99676951,149.42,0.0,47785.18
2014-09-15,2014-09-15,Invoice payment - Ayala-French,REF22939168,0.0,368.0,48153.18
2014-09-15,2014-09-15,Payment from Schmidt-Moran,REF68440346,0.0,734.64,48887.82
2014-09-15,2014-09-15,Project payment - Rhodes-Jefferson,REF13429417,0.0,464.65,49352.47
2014-09-21,2014-09-21,Professional software license,REF73352963,224.02,0.0,49128.45
2014-09-28,2014-09-28,Marketing expenses,REF28054868,338.93,0.0,48789.52
2014-10-09,2014-10-09,Business meal,REF41193844,337.34,0.0,48452.18
2014-10-11,2014-10-11,Coworking space rental,REF34922403,207.32,0.0,48244.86
2014-10-13,2014-10-13,Accounting expense,REF75120209,196.34,0.0,48048.52
2014-10-15,2014-10-15,Payment from Schmidt-Moran,REF57405038,0.0,713.3,48761.82
2014-10-15,2014-10-15,Invoice payment - Rhodes-Jefferson,REF39154985,0.0,599.59,49361.41
2014-10-15,2014-10-15,"Invoice payment - Rhodes, Schmidt and Benitez",REF23901460,0.0,1070.26,50431.67
2014-10-15,2014-10-15,Payment from Thomas-Smith,REF45357804,0.0,712.25,51143.92
2014-10-15,2014-10-15,"Service payment - Nguyen, Palmer and Gonzalez",REF79420233,0.0,851.21,51995.13
2014-10-15,2014-10-15,Payment from Ayala-French,REF52020580,0.0,398.34,52393.47
2014-10-15,2014-10-15,"Invoice payment - Fuentes, Stephens and Lee",REF39344012,0.0,669.56,53063.03
2014-10-15,2014-10-15,Service payment - Neal-Lopez,REF41446659,0.0,584.92,53647.95
2014-10-15,2014-10-15,Business insurance premium,REF12943824,174.52,0.0,53473.43
2014-10-19,2014-10-19,Accounting expense,REF37553668,301.94,0.0,53171.49
2014-10-20,2014-10-20,Business travel,REF54324422,414.43,0.0,52757.06
2014-10-21,2014-10-21,Professional software license,REF37239029,270.38,0.0,52486.68
2014-10-22,2014-10-22,Business travel,REF40038846,447.64,0.0,52039.04
2014-10-24,2014-10-24,Marketing expenses,REF31293022,382.03,0.0,51657.01
2014-10-26,2014-10-26,Coworking space rental,REF82034414,232.22,0.0,51424.79
2014-10-27,2014-10-27,Training/conference,REF25014851,162.18,0.0,51262.61
2014-11-08,2014-11-08,Coworking space rental,REF19770606,272.4,0.0,50990.21
2014-11-08,2014-11-08,Accounting expense,REF45738503,143.89,0.0,50846.32
2014-11-14,2014-11-14,Business travel,REF22085622,682.21,0.0,50164.11
2014-11-15,2014-11-15,Invoice payment - Thomas-Smith,REF56954116,0.0,566.77,50730.88
2014-11-15,2014-11-15,Payment from Rhodes-Jefferson,REF28730832,0.0,483.82,51214.7
2014-11-15,2014-11-15,"Service payment - Nguyen, Palmer and Gonzalez",REF69553208,0.0,756.66,51971.36
2014-11-15,2014-11-15,"Project payment - Fuentes, Stephens and Lee",REF63737117,0.0,310.61,52281.97
2014-11-15,2014-11-15,Service payment - Ayala-French,REF28547027,0.0,433.96,52715.93
2014-11-15,2014-11-15,Service payment - Neal-Lopez,REF73508725,0.0,470.4,53186.33
2014-11-15,2014-11-15,"Invoice payment - Rhodes, Schmidt and Benitez",REF40351985,0.0,984.39,54170.72
2014-11-15,2014-11-15,Service payment - Schmidt-Moran,REF16507302,0.0,903.1,55073.82
2014-11-15,2014-11-15,Business insurance premium,REF37371236,165.78,0.0,54908.04
2014-11-17,2014-11-17,Equipment purchase,REF44110795,182.23,0.0,54725.81
2014-11-20,2014-11-20,Marketing expenses,REF96749569,11.11,0.0,54714.7
2014-11-21,2014-11-21,Accounting expense,REF99894238,285.45,0.0,54429.25
2014-11-21,2014-11-21,Professional software license,REF67123888,203.49,0.0,54225.76
2014-11-22,2014-11-22,Business meal,REF80118175,349.97,0.0,53875.79
2014-11-22,2014-11-22,Accounting expense,REF81259523,155.24,0.0,53720.55
2014-11-22,2014-11-22,Training/conference,REF62890693,77.84,0.0,53642.71
2014-11-24,2014-11-24,Business meal,REF66511375,310.14,0.0,53332.57
2014-11-26,2014-11-26,Business meal,REF13213418,186.68,0.0,53145.89
2014-11-29,2014-11-29,Business meal,REF84442758,289.67,0.0,52856.22
2014-11-30,2014-11-30,Training/conference,REF21497387,60.36,0.0,52795.86
2014-12-15,2014-12-15,Business insurance premium,REF73440151,113.6,0.0,52682.26
2014-12-15,2014-12-15,Invoice payment - Rhodes-Jefferson,REF72119968,0.0,383.3,53065.56
2014-12-15,2014-12-15,"Project payment - Nguyen, Palmer and Gonzalez",REF90091217,0.0,524.14,53589.7
2014-12-15,2014-12-15,Service payment - Neal-Lopez,REF72430044,0.0,454.72,54044.42
2014-12-15,2014-12-15,"Payment from Rhodes, Schmidt and Benitez",REF59433175,0.0,702.62,54747.04
2014-12-15,2014-12-15,Service payment - Thomas-Smith,REF47277274,0.0,360.42,55107.46
2014-12-15,2014-12-15,Project payment - Ayala-French,REF37228871,0.0,279.42,55386.88
2014-12-15,2014-12-15,"Payment from Fuentes, Stephens and Lee",REF10311805,0.0,457.4,55844.28
2014-12-15,2014-12-15,Payment from Schmidt-Moran,REF87077177,0.0,556.83,56401.11
2014-12-18,2014-12-18,Coworking space rental,REF21487116,442.65,0.0,55958.46
2014-12-20,2014-12-20,Training/conference,REF54309196,174.66,0.0,55783.8
2014-12-21,2014-12-21,Professional software license,REF97032486,173.58,0.0,55610.22
2014-12-22,2014-12-22,Accounting expense,REF76527131,199.78,0.0,55410.44
2015-01-01,2015-01-01,Business meal,REF72193837,448.79,0.0,54961.65
2015-01-08,2015-01-08,Training/conference,REF34303679,215.56,0.0,54746.09
2015-01-09,2015-01-09,Business meal,REF41593874,302.19,0.0,54443.9
2015-01-15,2015-01-15,Business insurance premium,REF49355987,177.63,0.0,54266.27
2015-01-15,2015-01-15,"Payment from Rhodes, Schmidt and Benitez",REF79333508,0.0,1269.68,55535.95
2015-01-15,2015-01-15,"Service payment - Fuentes, Stephens and Lee",REF21431780,0.0,585.57,56121.52
2015-01-15,2015-01-15,Payment from Rhodes-Jefferson,REF27985622,0.0,614.84,56736.36
2015-01-15,2015-01-15,"Service payment - Nguyen, Palmer and Gonzalez",REF33685731,0.0,576.24,57312.6
2015-01-15,2015-01-15,Project payment - Ayala-French,REF73763786,0.0,507.33,57819.93
2015-01-15,2015-01-15,Project payment - Neal-Lopez,REF86586154,0.0,760.77,58580.7
2015-01-15,2015-01-15,Service payment - Thomas-Smith,REF66766343,0.0,662.78,59243.48
2015-01-15,2015-01-15,Payment from Schmidt-Moran,REF39672636,0.0,767.57,60011.05
2015-01-21,2015-01-21,Equipment purchase,REF86037067,209.39,0.0,59801.66
2015-01-21,2015-01-21,Professional software license,REF70322339,209.18,0.0,59592.48
2015-01-22,2015-01-22,Equipment purchase,REF65801000,126.58,0.0,59465.9
2015-01-25,2015-01-25,Business meal,REF98016330,353.71,0.0,59112.19
2015-01-26,2015-01-26,Marketing expenses,REF18238043,237.99,0.0,58874.2
2015-02-02,2015-02-02,Business travel,REF51894982,285.96,0.0,58588.24
2015-02-02,2015-02-02,Equipment purchase,REF48834344,120.88,0.0,58467.36
2015-02-06,2015-02-06,Accounting expense,REF33460973,227.77,0.0,58239.59
2015-02-10,2015-02-10,Coworking space rental,REF85009906,350.81,0.0,57888.78
2015-02-15,2015-02-15,Service payment - Thomas-Smith,REF90919831,0.0,428.73,58317.51
2015-02-15,2015-02-15,Payment from Schmidt-Moran,REF21065877,0.0,582.35,58899.86
2015-02-15,2015-02-15,Invoice payment - Ayala-French,REF22916662,0.0,238.71,59138.57
2015-02-15,2015-02-15,"Payment from Fuentes, Stephens and Lee",REF26837511,0.0,643.34,59781.91
2015-02-15,2015-02-15,Service payment - Neal-Lopez,REF87944099,0.0,568.27,60350.18
2015-02-15,2015-02-15,Business insurance premium,REF86675928,156.71,0.0,60193.47
2015-02-15,2015-02-15,Project payment - Rhodes-Jefferson,REF13483046,0.0,592.56,60786.03
2015-02-15,2015-02-15,"Service payment - Nguyen, Palmer and Gonzalez",REF39054897,0.0,941.3,61727.33
2015-02-15,2015-02-15,"Payment from Rhodes, Schmidt and Benitez",REF94226414,0.0,924.11,62651.44
2015-02-21,2015-02-21,Professional software license,REF80412180,229.17,0.0,62422.27
2015-02-28,2015-02-28,Coworking space rental,REF66520881,385.62,0.0,62036.65
2015-03-06,2015-03-06,Marketing expenses,REF41860748,351.49,0.0,61685.16
2015-03-07,2015-03-07,Business meal,REF36484221,216.05,0.0,61469.11
2015-03-14,2015-03-14,Equipment purchase,REF11136546,129.07,0.0,61340.04
2015-03-15,2015-03-15,Service payment - Thomas-Smith,REF14756747,0.0,428.35,61768.39
2015-03-15,2015-03-15,Payment from Rhodes-Jefferson,REF94813327,0.0,549.0,62317.39
2015-03-15,2015-03-15,Business insurance premium,REF27167673,136.98,0.0,62180.41
2015-03-15,2015-03-15,"Invoice payment - Rhodes, Schmidt and Benitez",REF11599117,0.0,867.68,63048.09
2015-03-15,2015-03-15,Service payment - Neal-Lopez,REF42648366,0.0,544.31,63592.4
2015-03-15,2015-03-15,"Invoice payment - Fuentes, Stephens and Lee",REF44977819,0.0,463.05,64055.45
2015-03-15,2015-03-15,"Project payment - Nguyen, Palmer and Gonzalez",REF11556809,0.0,771.17,64826.62
2015-03-15,2015-03-15,Invoice payment - Ayala-French,REF41683369,0.0,302.93,65129.55
2015-03-21,2015-03-21,Professional software license,REF37285632,212.29,0.0,64917.26
2015-03-23,2015-03-23,Business meal,REF77967761,390.87,0.0,64526.39
2015-03-24,2015-03-24,Marketing expenses,REF40350762,192.47,0.0,64333.92
2015-03-25,2015-03-25,Business meal,REF79825363,302.18,0.0,64031.74
2015-03-30,2015-03-30,Accounting expense,REF86695131,62.22,0.0,63969.52
2015-04-02,2015-04-02,Training/conference,REF91967446,109.41,0.0,63860.11
2015-04-02,2015-04-02,Accounting expense,REF91283580,264.66,0.0,63595.45
2015-04-03,2015-04-03,Business travel,REF69436692,358.27,0.0,63237.18
2015-04-04,2015-04-04,Business meal,REF77806191,186.37,0.0,63050.81
2015-04-15,2015-04-15,"Payment from Nguyen, Palmer and Gonzalez",REF45952787,0.0,713.5,63764.31
2015-04-15,2015-04-15,Project payment - Thomas-Smith,REF10833982,0.0,462.03,64226.34
2015-04-15,2015-04-15,"Project payment - Rhodes, Schmidt and Benitez",REF48345073,0.0,1128.42,65354.76
2015-04-15,2015-04-15,Project payment - Schmidt-Moran,REF54080813,0.0,690.75,66045.51
2015-04-15,2015-04-15,Service payment - Ayala-French,REF19726187,0.0,344.81,66390.32
2015-04-15,2015-04-15,"Payment from Fuentes, Stephens and Lee",REF31079846,0.0,456.82,66847.14
2015-04-15,2015-04-15,Payment from Rhodes-Jefferson,REF68282760,0.0,517.67,67364.81
2015-04-15,2015-04-15,Business insurance premium,REF13237514,155.77,0.0,67209.04
2015-04-21,2015-04-21,Professional software license,REF85851006,207.96,0.0,67001.08
2015-05-01,2015-05-01,Accounting expense,REF20684034,167.79,0.0,66833.29
2015-05-03,2015-05-03,Equipment purchase,REF94180340,138.06,0.0,66695.23
2015-05-07,2015-05-07,Training/conference,REF99394349,230.48,0.0,66464.75
2015-05-13,2015-05-13,Business meal,REF78894290,211.45,0.0,66253.3
2015-05-15,2015-05-15,Business insurance premium,REF49572848,122.24,0.0,66131.06
2015-05-15,2015-05-15,Invoice payment - Neal-Lopez,REF43322753,0.0,653.6,66784.66
2015-05-15,2015-05-15,Invoice payment - Schmidt-Moran,REF14612067,0.0,639.99,67424.65
2015-05-15,2015-05-15,"Payment from Nguyen, Palmer and Gonzalez",REF37892119,0.0,620.9,68045.55
2015-05-15,2015-05-15,Service payment - Rhodes-Jefferson,REF10055071,0.0,452.12,68497.67
2015-05-15,2015-05-15,"Invoice payment - Fuentes, Stephens and Lee",REF15458971,0.0,357.72,68855.39
2015-05-15,2015-05-15,Service payment - Thomas-Smith,REF54598466,0.0,448.66,69304.05
2015-05-15,2015-05-15,"Service payment - Rhodes, Schmidt and Benitez",REF21654295,0.0,510.74,69814.79
2015-05-15,2015-05-15,Service payment - Ayala-French,REF93001196,0.0,247.69,70062.48
2015-05-18,2015-05-18,Business travel,REF75760819,242.0,0.0,69820.48
2015-05-19,2015-05-19,Training/conference,REF99059890,198.24,0.0,69622.24
2015-05-21,2015-05-21,Professional software license,REF31201024,176.93,0.0,69445.31
2015-05-23,2015-05-23,Business travel,REF46653456,412.26,0.0,69033.05
2015-05-24,2015-05-24,Accounting expense,REF89788106,147.18,0.0,68885.87
2015-05-25,2015-05-25,Training/conference,REF93933337,191.65,0.0,68694.22
2015-06-02,2015-06-02,Accounting expense,REF78205015,142.85,0.0,68551.37
2015-06-10,2015-06-10,Business travel,REF99201259,451.91,0.0,68099.46
2015-06-15,2015-06-15,Business insurance premium,REF38253990,116.17,0.0,67983.29
2015-06-15,2015-06-15,"Invoice payment - Fuentes, Stephens and Lee",REF21401459,0.0,357.1,68340.39
2015-06-15,2015-06-15,Project payment - Thomas-Smith,REF92774364,0.0,342.09,68682.48
2015-06-15,2015-06-15,"Payment from Rhodes, Schmidt and Benitez",REF38114086,0.0,681.3,69363.78
2015-06-15,2015-06-15,"Payment from Nguyen, Palmer and Gonzalez",REF13164817,0.0,549.52,69913.3
2015-06-15,2015-06-15,Project payment - Ayala-French,REF22366601,0.0,262.32,70175.62
2015-06-15,2015-06-15,Invoice payment - Rhodes-Jefferson,REF40058720,0.0,578.98,70754.6
2015-06-15,2015-06-15,Service payment - Schmidt-Moran,REF64858152,0.0,561.12,71315.72
2015-06-15,2015-06-15,Project payment - Neal-Lopez,REF61988854,0.0,444.51,71760.23
2015-06-21,2015-06-21,Professional software license,REF85832569,144.99,0.0,71615.24
2015-06-29,2015-06-29,Accounting expense,REF82967284,127.01,0.0,71488.23
2015-06-30,2015-06-30,Business meal,REF68298777,170.85,0.0,71317.38
2015-07-07,2015-07-07,Business meal,REF40920091,195.97,0.0,71121.41
2015-07-07,2015-07-07,Accounting expense,REF57289630,256.73,0.0,70864.68
2015-07-08,2015-07-08,Business travel,REF83615522,236.54,0.0,70628.14
2015-07-10,2015-07-10,Business meal,REF27014300,173.35,0.0,70454.79
2015-07-15,2015-07-15,Business insurance premium,REF71392953,99.77,0.0,70355.02
2015-07-15,2015-07-15,"Invoice payment - Rhodes, Schmidt and Benitez",REF78593768,0.0,593.21,70948.23
2015-07-15,2015-07-15,"Project payment - Fuentes, Stephens and Lee",REF60792000,0.0,325.3,71273.53
2015-07-15,2015-07-15,Project payment - Rhodes-Jefferson,REF21901495,0.0,433.31,71706.84
2015-07-15,2015-07-15,Project payment - Schmidt-Moran,REF96640591,0.0,432.84,72139.68
2015-07-15,2015-07-15,Payment from Neal-Lopez,REF86053774,0.0,390.65,72530.33
2015-07-15,2015-07-15,"Invoice payment - Nguyen, Palmer and Gonzalez",REF23907478,0.0,470.82,73001.15
2015-07-15,2015-07-15,Invoice payment - Thomas-Smith,REF44136349,0.0,320.68,73321.83
2015-07-15,2015-07-15,Payment from Ayala-French,REF85406320,0.0,247.75,73569.58
2015-07-21,2015-07-21,Professional software license,REF46357271,133.95,0.0,73435.63
2015-07-21,2015-07-21,Equipment purchase,REF34063498,121.55,0.0,73314.08
2015-07-22,2015-07-22,Accounting expense,REF73321682,92.68,0.0,73221.4
2015-07-28,2015-07-28,Equipment purchase,REF86607714,66.52,0.0,73154.88
2015-07-30,2015-07-30,Coworking space rental,REF34672709,193.87,0.0,72961.01
2015-08-01,2015-08-01,Coworking space rental,REF38565063,235.77,0.0,72725.24
2015-08-01,2015-08-01,Marketing expenses,REF10692327,147.81,0.0,72577.43
2015-08-03,2015-08-03,Business travel,REF52472266,394.6,0.0,72182.83
2015-08-09,2015-08-09,Accounting expense,REF18708135,140.56,0.0,72042.27
2015-08-11,2015-08-11,Accounting expense,REF66721516,160.67,0.0,71881.6
2015-08-12,2015-08-12,Accounting expense,REF45737503,82.68,0.0,71798.92
2015-08-14,2015-08-14,Business travel,REF75717888,473.72,0.0,71325.2
2015-08-15,2015-08-15,Project payment - Neal-Lopez,REF14639610,0.0,391.11,71716.31
2015-08-15,2015-08-15,"Payment from Fuentes, Stephens and Lee",REF50270771,0.0,433.92,72150.23
2015-08-15,2015-08-15,"Service payment - Nguyen, Palmer and Gonzalez",REF47749925,0.0,498.63,72648.86
2015-08-15,2015-08-15,Invoice payment - Thomas-Smith,REF83530414,0.0,418.24,73067.1
2015-08-15,2015-08-15,Accounting expense,REF91506109,194.68,0.0,72872.42
2015-08-15,2015-08-15,Business insurance premium,REF65783442,114.44,0.0,72757.98
2015-08-15,2015-08-15,Payment from Schmidt-Moran,REF10958362,0.0,430.69,73188.67
2015-08-15,2015-08-15,"Invoice payment - Rhodes, Schmidt and Benitez",REF77386970,0.0,552.04,73740.71
2015-08-15,2015-08-15,Project payment - Rhodes-Jefferson,REF30553436,0.0,380.11,74120.82
2015-08-16,2015-08-16,Coworking space rental,REF83937686,277.26,0.0,73843.56
2015-08-20,2015-08-20,Equipment purchase,REF65459085,122.54,0.0,73721.02
2015-08-21,2015-08-21,Professional software license,REF61000561,191.58,0.0,73529.44
2015-08-22,2015-08-22,Training/conference,REF17908958,179.6,0.0,73349.84
2015-08-31,2015-08-31,Business meal,REF67094832,143.36,0.0,73206.48
2015-09-10,2015-09-10,Marketing expenses,REF66181729,381.36,0.0,72825.12
2015-09-11,2015-09-11,Business travel,REF54412259,254.2,0.0,72570.92
2015-09-13,2015-09-13,Business meal,REF66521793,209.38,0.0,72361.54
2015-09-15,2015-09-15,"Project payment - Fuentes, Stephens and Lee",REF19065631,0.0,547.71,72909.25
2015-09-15,2015-09-15,Payment from Thomas-Smith,REF89422009,0.0,463.72,73372.97
2015-09-15,2015-09-15,Service payment - Neal-Lopez,REF52018521,0.0,644.24,74017.21
2015-09-15,2015-09-15,Service payment - Rhodes-Jefferson,REF31377973,0.0,497.77,74514.98
2015-09-15,2015-09-15,Business insurance premium,REF79228439,163.14,0.0,74351.84
2015-09-15,2015-09-15,Payment from Schmidt-Moran,REF12449189,0.0,647.34,74999.18
2015-09-15,2015-09-15,"Invoice payment - Nguyen, Palmer and Gonzalez",REF70788088,0.0,754.64,75753.82
2015-09-15,2015-09-15,Service payment - Ayala-French,REF76183048,0.0,337.12,76090.94
2015-09-18,2015-09-18,Training/conference,REF56027446,216.03,0.0,75874.91
2015-09-19,2015-09-19,Equipment purchase,REF53276995,44.62,0.0,75830.29
2015-09-21,2015-09-21,Professional software license,REF78114286,236.64,0.0,75593.65
2015-09-22,2015-09-22,Equipment purchase,REF18783458,215.01,0.0,75378.64
2015-09-23,2015-09-23,Marketing expenses,REF60632718,289.34,0.0,75089.3
2015-09-24,2015-09-24,Marketing expenses,REF25498768,309.28,0.0,74780.02
2015-09-24,2015-09-24,Equipment purchase,REF55533618,143.27,0.0,74636.75
2015-09-25,2015-09-25,Coworking space rental,REF38467406,531.8,0.0,74104.95
2015-10-02,2015-10-02,Business meal,REF75634044,409.88,0.0,73695.07
2015-10-05,2015-10-05,Business meal,REF34014884,432.14,0.0,73262.93
2015-10-07,2015-10-07,Business travel,REF76201954,590.27,0.0,72672.66
2015-10-08,2015-10-08,Business travel,REF70646125,550.0,0.0,72122.66
2015-10-11,2015-10-11,Equipment purchase,REF27257438,208.72,0.0,71913.94
2015-10-12,2015-10-12,Marketing expenses,REF88440336,268.95,0.0,71644.99
2015-10-12,2015-10-12,Business travel,REF15721725,716.67,0.0,70928.32
2015-10-15,2015-10-15,"Invoice payment - Nguyen, Palmer and Gonzalez",REF24280931,0.0,793.19,71721.51
2015-10-15,2015-10-15,"Payment from Fuentes, Stephens and Lee",REF42122228,0.0,646.0,72367.51
2015-10-15,2015-10-15,Invoice payment - Rhodes-Jefferson,REF59971690,0.0,533.38,72900.89
2015-10-15,2015-10-15,Project payment - Ayala-French,REF78322165,0.0,496.9,73397.79
2015-10-15,2015-10-15,Service payment - Schmidt-Moran,REF88366949,0.0,810.95,74208.74
2015-10-15,2015-10-15,Project payment - Neal-Lopez,REF74775763,0.0,838.09,75046.83
2015-10-15,2015-10-15,Business insurance premium,REF14631332,166.55,0.0,74880.28
2015-10-21,2015-10-21,Professional software license,REF82770120,252.27,0.0,74628.01
2015-10-22,2015-10-22,Equipment purchase,REF38109827,42.63,0.0,74585.38
2015-10-23,2015-10-23,Business meal,REF10716021,504.7,0.0,74080.68
2015-11-07,2015-11-07,Business meal,REF52726773,320.61,0.0,73760.07
2015-11-10,2015-11-10,Equipment purchase,REF96842077,144.37,0.0,73615.7
2015-11-15,2015-11-15,Business insurance premium,REF42326252,147.45,0.0,73468.25
2015-11-15,2015-11-15,"Invoice payment - Nguyen, Palmer and Gonzalez",REF88761766,0.0,705.89,74174.14
2015-11-15,2015-11-15,Project payment - Schmidt-Moran,REF18367110,0.0,629.16,74803.3
2015-11-15,2015-11-15,Payment from Ayala-French,REF49679095,0.0,302.15,75105.45
2015-11-15,2015-11-15,Project payment - Rhodes-Jefferson,REF83685295,0.0,517.38,75622.83
2015-11-15,2015-11-15,"Payment from Rhodes, Schmidt and Benitez",REF21069218,0.0,894.42,76517.25
2015-11-15,2015-11-15,"Service payment - Fuentes, Stephens and Lee",REF10626574,0.0,545.96,77063.21
2015-11-15,2015-11-15,Payment from Neal-Lopez,REF58026302,0.0,669.75,77732.96
2015-11-15,2015-11-15,Training/conference,REF26452713,136.2,0.0,77596.76
2015-11-18,2015-11-18,Marketing expenses,REF88412466,269.98,0.0,77326.78
2015-11-21,2015-11-21,Business meal,REF75931082,305.24,0.0,77021.54
2015-11-21,2015-11-21,Professional software license,REF36177866,196.79,0.0,76824.75
2015-11-24,2015-11-24,Business meal,REF21187666,347.87,0.0,76476.88
2015-11-29,2015-11-29,Marketing expenses,REF22702175,378.92,0.0,76097.96
2015-12-02,2015-12-02,Training/conference,REF72256619,209.99,0.0,75887.97
2015-12-07,2015-12-07,Business travel,REF39264593,292.91,0.0,75595.06
2015-12-11,2015-12-11,Business meal,REF50393191,286.63,0.0,75308.43
2015-12-15,2015-12-15,Invoice payment - Ayala-French,REF62753838,0.0,299.69,75608.12
2015-12-15,2015-12-15,"Payment from Rhodes, Schmidt and Benitez",REF91256664,0.0,656.0,76264.12
2015-12-15,2015-12-15,Business insurance premium,REF36534504,123.9,0.0,76140.22
2015-12-15,2015-12-15,Payment from Rhodes-Jefferson,REF74874175,0.0,517.86,76658.08
2015-12-15,2015-12-15,Service payment - Neal-Lopez,REF70755680,0.0,497.43,77155.51
2015-12-15,2015-12-15,Service payment - Schmidt-Moran,REF87634854,0.0,558.03,77713.54
2015-12-15,2015-12-15,"Invoice payment - Fuentes, Stephens and Lee",REF63706987,0.0,412.39,78125.93
2015-12-15,2015-12-15,Project payment - Thomas-Smith,REF17624220,0.0,402.68,78528.61
2015-12-15,2015-12-15,"Payment from Nguyen, Palmer and Gonzalez",REF58473030,0.0,662.15,79190.76
2015-12-16,2015-12-16,Business travel,REF96603665,301.23,0.0,78889.53
2015-12-21,2015-12-21,Professional software license,REF86181779,163.57,0.0,78725.96
2015-12-26,2015-12-26,Marketing expenses,REF60070401,461.16,0.0,78264.8
2015-12-27,2015-12-27,Equipment purchase,REF81614408,128.14,0.0,78136.66
2015-12-27,2015-12-27,Business travel,REF18695934,449.48,0.0,77687.18
2015-12-27,2015-12-27,Accounting expense,REF47457447,174.73,0.0,77512.45
2015-12-31,2015-12-31,Coworking space rental,REF73881912,186.54,0.0,77325.91
2016-01-02,2016-01-02,Business meal,REF18856640,353.9,0.0,76972.01
2016-01-04,2016-01-04,Business travel,REF18902615,534.23,0.0,76437.78
2016-01-10,2016-01-10,Coworking space rental,REF76005959,290.07,0.0,76147.71
2016-01-12,2016-01-12,Business travel,REF87796533,381.96,0.0,75765.75
2016-01-15,2016-01-15,Payment from Thomas-Smith,REF28293400,0.0,579.31,76345.06
2016-01-15,2016-01-15,Business insurance premium,REF95799584,183.59,0.0,76161.47
2016-01-15,2016-01-15,Invoice payment - Rhodes-Jefferson,REF29961875,0.0,716.89,76878.36
2016-01-15,2016-01-15,"Project payment - Nguyen, Palmer and Gonzalez",REF97801672,0.0,902.91,77781.27
2016-01-15,2016-01-15,"Project payment - Rhodes, Schmidt and Benitez",REF33145035,0.0,1052.35,78833.62
2016-01-15,2016-01-15,Project payment - Schmidt-Moran,REF25383424,0.0,664.88,79498.5
2016-01-15,2016-01-15,"Payment from Fuentes, Stephens and Lee",REF60350799,0.0,514.17,80012.67
2016-01-15,2016-01-15,Service payment - Ayala-French,REF67136314,0.0,316.71,80329.38
2016-01-15,2016-01-15,Payment from Neal-Lopez,REF41979041,0.0,695.1,81024.48
2016-01-21,2016-01-21,Professional software license,REF96436851,226.67,0.0,80797.81
2016-01-23,2016-01-23,Accounting expense,REF72897165,290.94,0.0,80506.87
2016-02-07,2016-02-07,Business travel,REF46120253,413.2,0.0,80093.67
2016-02-08,2016-02-08,Equipment purchase,REF75204862,182.82,0.0,79910.85
2016-02-14,2016-02-14,Coworking space rental,REF93613893,320.15,0.0,79590.7
2016-02-15,2016-02-15,"Service payment - Nguyen, Palmer and Gonzalez",REF56043431,0.0,790.07,80380.77
2016-02-15,2016-02-15,Service payment - Schmidt-Moran,REF42093203,0.0,390.31,80771.08
2016-02-15,2016-02-15,Business insurance premium,REF70613086,152.6,0.0,80618.48
2016-02-15,2016-02-15,"Payment from Fuentes, Stephens and Lee",REF10815660,0.0,582.99,81201.47
2016-02-15,2016-02-15,Service payment - Neal-Lopez,REF77144394,0.0,679.59,81881.06
2016-02-15,2016-02-15,Invoice payment - Thomas-Smith,REF92393951,0.0,725.42,82606.48
2016-02-15,2016-02-15,Service payment - Ayala-French,REF67286444,0.0,422.86,83029.34
2016-02-15,2016-02-15,"Invoice payment - Rhodes, Schmidt and Benitez",REF78627794,0.0,877.14,83906.48
2016-02-17,2016-02-17,Business meal,REF44768867,172.59,0.0,83733.89
2016-02-21,2016-02-21,Professional software license,REF33388297,249.1,0.0,83484.79
2016-03-01,2016-03-01,Accounting expense,REF71169640,197.18,0.0,83287.61
2016-03-02,2016-03-02,Business travel,REF53906069,364.44,0.0,82923.17
2016-03-03,2016-03-03,Marketing expenses,REF42076837,182.78,0.0,82740.39
2016-03-05,2016-03-05,Business travel,REF90959722,385.42,0.0,82354.97
2016-03-15,2016-03-15,Business meal,REF35194401,270.47,0.0,82084.5
2016-03-15,2016-03-15,"Project payment - Rhodes, Schmidt and Benitez",REF76473067,0.0,960.86,83045.36
2016-03-15,2016-03-15,Project payment - Thomas-Smith,REF67688319,0.0,510.74,83556.1
2016-03-15,2016-03-15,"Service payment - Nguyen, Palmer and Gonzalez",REF97834686,0.0,457.74,84013.84
2016-03-15,2016-03-15,Payment from Ayala-French,REF41519325,0.0,311.08,84324.92
2016-03-15,2016-03-15,Business insurance premium,REF56357139,130.02,0.0,84194.9
2016-03-15,2016-03-15,"Payment from Fuentes, Stephens and Lee",REF87983952,0.0,499.07,84693.97
2016-03-15,2016-03-15,Project payment - Neal-Lopez,REF99295624,0.0,528.06,85222.03
2016-03-15,2016-03-15,Project payment - Schmidt-Moran,REF65193268,0.0,621.12,85843.15
2016-03-21,2016-03-21,Professional software license,REF99298725,184.65,0.0,85658.5
2016-03-21,2016-03-21,Accounting expense,REF93133839,186.97,0.0,85471.53
2016-03-28,2016-03-28,Marketing expenses,REF14318679,235.35,0.0,85236.18
2016-03-31,2016-03-31,Training/conference,REF14046219,208.43,0.0,85027.75
2016-04-06,2016-04-06,Business travel,REF32147211,346.83,0.0,84680.92
2016-04-15,2016-04-15,"Payment from Rhodes, Schmidt and Benitez",REF16433134,0.0,597.53,85278.45
2016-04-15,2016-04-15,Service payment - Schmidt-Moran,REF14472861,0.0,704.24,85982.69
2016-04-15,2016-04-15,Invoice payment - Rhodes-Jefferson,REF70049465,0.0,390.38,86373.07
2016-04-15,2016-04-15,"Service payment - Fuentes, Stephens and Lee",REF46543532,0.0,458.64,86831.71
2016-04-15,2016-04-15,Business insurance premium,REF66121305,151.91,0.0,86679.8
2016-04-15,2016-04-15,"Invoice payment - Nguyen, Palmer and Gonzalez",REF58476869,0.0,601.91,87281.71
2016-04-15,2016-04-15,Payment from Thomas-Smith,REF95376373,0.0,510.14,87791.85
2016-04-15,2016-04-15,Service payment - Ayala-French,REF38629093,0.0,342.23,88134.08
2016-04-16,2016-04-16,Business travel,REF71946897,587.08,0.0,87547.0
2016-04-19,2016-04-19,Training/conference,REF79899114,211.77,0.0,87335.23
2016-04-21,2016-04-21,Training/conference,REF44748182,87.59,0.0,87247.64
2016-04-21,2016-04-21,Professional software license,REF15352861,198.15,0.0,87049.49
2016-04-23,2016-04-23,Marketing expenses,REF86202650,358.03,0.0,86691.46
2016-04-29,2016-04-29,Training/conference,REF53096885,61.05,0.0,86630.41
2016-05-02,2016-05-02,Accounting expense,REF56287530,210.15,0.0,86420.26
2016-05-15,2016-05-15,"Project payment - Rhodes, Schmidt and Benitez",REF81151949,0.0,831.05,87251.31
2016-05-15,2016-05-15,"Invoice payment - Nguyen, Palmer and Gonzalez",REF14261756,0.0,645.76,87897.07
2016-05-15,2016-05-15,Project payment - Thomas-Smith,REF69201472,0.0,399.01,88296.08
2016-05-15,2016-05-15,"Payment from Fuentes, Stephens and Lee",REF41670460,0.0,448.82,88744.9
2016-05-15,2016-05-15,Invoice payment - Schmidt-Moran,REF18829782,0.0,704.58,89449.48
2016-05-15,2016-05-15,Invoice payment - Neal-Lopez,REF10114400,0.0,567.8,90017.28
2016-05-15,2016-05-15,Invoice payment - Rhodes-Jefferson,REF36307280,0.0,461.1,90478.38
2016-05-15,2016-05-15,Payment from Ayala-French,REF69635478,0.0,258.92,90737.3
2016-05-15,2016-05-15,Business insurance premium,REF81963917,127.73,0.0,90609.57
2016-05-16,2016-05-16,Business travel,REF77701221,288.68,0.0,90320.89
2016-05-17,2016-05-17,Accounting expense,REF19316105,182.99,0.0,90137.9
2016-05-21,2016-05-21,Professional software license,REF42729718,187.35,0.0,89950.55
2016-05-27,2016-05-27,Accounting expense,REF37994543,129.93,0.0,89820.62
2016-06-06,2016-06-06,Business travel,REF68560099,399.25,0.0,89421.37
2016-06-07,2016-06-07,Business meal,REF50269351,258.0,0.0,89163.37
2016-06-09,2016-06-09,Accounting expense,REF60176042,59.54,0.0,89103.83
2016-06-11,2016-06-11,Marketing expenses,REF17683937,110.66,0.0,88993.17
2016-06-15,2016-06-15,"Invoice payment - Rhodes, Schmidt and Benitez",REF55376632,0.0,656.03,89649.2
2016-06-15,2016-06-15,Service payment - Ayala-French,REF51009076,0.0,263.91,89913.11
2016-06-15,2016-06-15,Invoice payment - Neal-Lopez,REF19292642,0.0,595.1,90508.21
2016-06-15,2016-06-15,Invoice payment - Rhodes-Jefferson,REF36118396,0.0,376.39,90884.6
2016-06-15,2016-06-15,"Payment from Nguyen, Palmer and Gonzalez",REF51561096,0.0,540.38,91424.98
2016-06-15,2016-06-15,"Project payment - Fuentes, Stephens and Lee",REF19481073,0.0,394.81,91819.79
2016-06-15,2016-06-15,Business insurance premium,REF66623129,111.53,0.0,91708.26
2016-06-15,2016-06-15,Payment from Thomas-Smith,REF48135109,0.0,382.12,92090.38
2016-06-21,2016-06-21,Professional software license,REF62678287,178.74,0.0,91911.64
2016-06-25,2016-06-25,Business meal,REF74918038,148.26,0.0,91763.38
2016-07-15,2016-07-15,Business insurance premium,REF99379542,103.13,0.0,91660.25
2016-07-15,2016-07-15,"Project payment - Rhodes, Schmidt and Benitez",REF63482162,0.0,483.34,92143.59
2016-07-15,2016-07-15,Invoice payment - Rhodes-Jefferson,REF27999852,0.0,291.51,92435.1
2016-07-15,2016-07-15,Project payment - Thomas-Smith,REF38373277,0.0,457.5,92892.6
2016-07-15,2016-07-15,"Service payment - Fuentes, Stephens and Lee",REF48621524,0.0,308.28,93200.88
2016-07-15,2016-07-15,Service payment - Neal-Lopez,REF82452139,0.0,341.46,93542.34
2016-07-15,2016-07-15,Payment from Schmidt-Moran,REF50170743,0.0,364.07,93906.41
2016-07-17,2016-07-17,Business travel,REF14362805,395.45,0.0,93510.96
2016-07-21,2016-07-21,Professional software license,REF58451928,144.82,0.0,93366.14
2016-07-25,2016-07-25,Coworking space rental,REF49415996,177.53,0.0,93188.61
2016-07-25,2016-07-25,Business travel,REF32664552,295.61,0.0,92893.0
2016-08-01,2016-08-01,Training/conference,REF10516510,129.57,0.0,92763.43
2016-08-03,2016-08-03,Marketing expenses,REF35404831,209.85,0.0,92553.58
2016-08-07,2016-08-07,Equipment purchase,REF19157144,158.6,0.0,92394.98
2016-08-09,2016-08-09,Coworking space rental,REF23139813,398.79,0.0,91996.19
2016-08-11,2016-08-11,Business meal,REF45230823,126.87,0.0,91869.32
2016-08-12,2016-08-12,Training/conference,REF18237406,136.3,0.0,91733.02
2016-08-12,2016-08-12,Equipment purchase,REF58620048,5.0,0.0,91728.02
2016-08-15,2016-08-15,Project payment - Rhodes-Jefferson,REF99781382,0.0,404.99,92133.01
2016-08-15,2016-08-15,Payment from Neal-Lopez,REF70200326,0.0,437.66,92570.67
2016-08-15,2016-08-15,Project payment - Ayala-French,REF71425668,0.0,294.62,92865.29
2016-08-15,2016-08-15,Invoice payment - Thomas-Smith,REF41525665,0.0,482.55,93347.84
2016-08-15,2016-08-15,Project payment - Schmidt-Moran,REF75758290,0.0,724.71,94072.55
2016-08-15,2016-08-15,"Payment from Rhodes, Schmidt and Benitez",REF45472841,0.0,498.74,94571.29
2016-08-15,2016-08-15,Business insurance premium,REF75024130,110.43,0.0,94460.86
2016-08-15,2016-08-15,"Project payment - Nguyen, Palmer and Gonzalez",REF37549514,0.0,679.5,95140.36
2016-08-16,2016-08-16,Business travel,REF25364289,197.45,0.0,94942.91
2016-08-16,2016-08-16,Accounting expense,REF68946114,108.6,0.0,94834.31
2016-08-18,2016-08-18,Business travel,REF63380683,371.17,0.0,94463.14
2016-08-20,2016-08-20,Accounting expense,REF46083996,209.35,0.0,94253.79
2016-08-21,2016-08-21,Professional software license,REF24155754,174.28,0.0,94079.51
2016-08-23,2016-08-23,Business meal,REF98306875,213.44,0.0,93866.07
2016-08-30,2016-08-30,Training/conference,REF36722363,90.41,0.0,93775.66
2016-08-30,2016-08-30,Business meal,REF28907369,124.58,0.0,93651.08
2016-09-04,2016-09-04,Marketing expenses,REF63894090,216.43,0.0,93434.65
2016-09-08,2016-09-08,Marketing expenses,REF61836864,288.03,0.0,93146.62
2016-09-08,2016-09-08,Equipment purchase,REF74227517,151.03,0.0,92995.59
2016-09-11,2016-09-11,Equipment purchase,REF90157004,139.09,0.0,92856.5
2016-09-12,2016-09-12,Coworking space rental,REF10839196,330.39,0.0,92526.11
2016-09-15,2016-09-15,Invoice payment - Schmidt-Moran,REF72078864,0.0,808.92,93335.03
2016-09-15,2016-09-15,Business insurance premium,REF67743234,155.27,0.0,93179.76
2016-09-15,2016-09-15,"Project payment - Rhodes, Schmidt and Benitez",REF64683395,0.0,912.23,94091.99
2016-09-15,2016-09-15,Invoice payment - Rhodes-Jefferson,REF38073950,0.0,592.3,94684.29
2016-09-15,2016-09-15,Invoice payment - Neal-Lopez,REF53693859,0.0,612.02,95296.31
2016-09-15,2016-09-15,"Payment from Nguyen, Palmer and Gonzalez",REF17688919,0.0,791.23,96087.54
2016-09-15,2016-09-15,Invoice payment - Thomas-Smith,REF66644242,0.0,532.63,96620.17
2016-09-15,2016-09-15,Project payment - Ayala-French,REF47422496,0.0,414.72,97034.89
2016-09-18,2016-09-18,Equipment purchase,REF89664119,156.29,0.0,96878.6
2016-09-21,2016-09-21,Professional software license,REF33035132,230.66,0.0,96647.94
2016-09-28,2016-09-28,Coworking space rental,REF36448846,385.16,0.0,96262.78
2016-09-30,2016-09-30,Business meal,REF60321311,278.18,0.0,95984.6
2016-10-09,2016-10-09,Marketing expenses,REF95234555,387.16,0.0,95597.44
2016-10-13,2016-10-13,Business meal,REF50984131,142.56,0.0,95454.88
2016-10-15,2016-10-15,Marketing expenses,REF90924406,408.03,0.0,95046.85
2016-10-15,2016-10-15,Project payment - Schmidt-Moran,REF75761805,0.0,730.27,95777.12
2016-10-15,2016-10-15,"Project payment - Rhodes, Schmidt and Benitez",REF20649254,0.0,960.0,96737.12
2016-10-15,2016-10-15,Project payment - Neal-Lopez,REF24217703,0.0,687.98,97425.1
2016-10-15,2016-10-15,Service payment - Ayala-French,REF92892062,0.0,346.11,97771.21
2016-10-15,2016-10-15,"Invoice payment - Fuentes, Stephens and Lee",REF80323650,0.0,720.92,98492.13
2016-10-15,2016-10-15,Invoice payment - Rhodes-Jefferson,REF35075306,0.0,785.33,99277.46
2016-10-15,2016-10-15,"Payment from Nguyen, Palmer and Gonzalez",REF57584012,0.0,792.91,100070.37
2016-10-15,2016-10-15,Business insurance premium,REF24210637,172.82,0.0,99897.55
2016-10-15,2016-10-15,Service payment - Thomas-Smith,REF81402595,0.0,598.87,100496.42
2016-10-21,2016-10-21,Professional software license,REF85097529,240.94,0.0,100255.48
2016-10-24,2016-10-24,Coworking space rental,REF51393594,270.99,0.0,99984.49
2016-10-25,2016-10-25,Business meal,REF50570535,233.52,0.0,99750.97
2016-10-28,2016-10-28,Marketing expenses,REF88220642,371.07,0.0,99379.9
2016-10-28,2016-10-28,Training/conference,REF88843054,148.55,0.0,99231.35
2016-10-31,2016-10-31,Coworking space rental,REF68456648,381.25,0.0,98850.1
2016-11-06,2016-11-06,Accounting expense,REF78669115,307.39,0.0,98542.71
2016-11-08,2016-11-08,Coworking space rental,REF47420063,336.1,0.0,98206.61
2016-11-12,2016-11-12,Coworking space rental,REF65565126,139.4,0.0,98067.21
2016-11-12,2016-11-12,Training/conference,REF38001357,261.17,0.0,97806.04
2016-11-15,2016-11-15,Business insurance premium,REF94525043,150.54,0.0,97655.5
2016-11-15,2016-11-15,"Project payment - Fuentes, Stephens and Lee",REF19962669,0.0,545.82,98201.32
2016-11-15,2016-11-15,Invoice payment - Ayala-French,REF73788250,0.0,431.56,98632.88
2016-11-15,2016-11-15,Payment from Rhodes-Jefferson,REF52593040,0.0,657.98,99290.86
2016-11-15,2016-11-15,Service payment - Neal-Lopez,REF93119813,0.0,601.37,99892.23
2016-11-15,2016-11-15,Invoice payment - Thomas-Smith,REF74363672,0.0,498.78,100391.01
2016-11-15,2016-11-15,"Service payment - Nguyen, Palmer and Gonzalez",REF33062414,0.0,816.3,101207.31
2016-11-21,2016-11-21,Business travel,REF22907053,692.07,0.0,100515.24
2016-11-21,2016-11-21,Professional software license,REF79964156,220.56,0.0,100294.68
2016-11-22,2016-11-22,Business travel,REF29484385,442.68,0.0,99852.0
2016-11-23,2016-11-23,Equipment purchase,REF97179563,232.36,0.0,99619.64
2016-11-25,2016-11-25,Coworking space rental,REF26795218,409.32,0.0,99210.32
2016-11-27,2016-11-27,Coworking space rental,REF73077696,396.29,0.0,98814.03
2016-11-27,2016-11-27,Business meal,REF68507736,388.94,0.0,98425.09
2016-11-28,2016-11-28,Business meal,REF41885763,239.1,0.0,98185.99
2016-12-03,2016-12-03,Business meal,REF87307991,238.08,0.0,97947.91
2016-12-04,2016-12-04,Accounting expense,REF26783577,72.99,0.0,97874.92
2016-12-05,2016-12-05,Business meal,REF49253109,338.6,0.0,97536.32
2016-12-06,2016-12-06,Business meal,REF19736907,214.53,0.0,97321.79
2016-12-07,2016-12-07,Business travel,REF79159789,442.76,0.0,96879.03
2016-12-09,2016-12-09,Coworking space rental,REF51928497,387.29,0.0,96491.74
2016-12-09,2016-12-09,Business travel,REF21970877,172.11,0.0,96319.63
2016-12-13,2016-12-13,Training/conference,REF12691630,130.5,0.0,96189.13
2016-12-15,2016-12-15,Project payment - Schmidt-Moran,REF85777756,0.0,637.31,96826.44
2016-12-15,2016-12-15,Payment from Neal-Lopez,REF54476764,0.0,515.89,97342.33
2016-12-15,2016-12-15,"Payment from Fuentes, Stephens and Lee",REF78135320,0.0,396.65,97738.98
2016-12-15,2016-12-15,Project payment - Thomas-Smith,REF77503187,0.0,371.92,98110.9
2016-12-15,2016-12-15,Business insurance premium,REF22104477,120.46,0.0,97990.44
2016-12-15,2016-12-15,"Service payment - Rhodes, Schmidt and Benitez",REF24976660,0.0,708.85,98699.29
2016-12-15,2016-12-15,Payment from Rhodes-Jefferson,REF22707424,0.0,508.03,99207.32
2016-12-15,2016-12-15,"Project payment - Nguyen, Palmer and Gonzalez",REF40385172,0.0,444.27,99651.59
2016-12-17,2016-12-17,Equipment purchase,REF38413877,126.52,0.0,99525.07
2016-12-19,2016-12-19,Training/conference,REF62024027,223.88,0.0,99301.19
2016-12-21,2016-12-21,Professional software license,REF36851002,176.77,0.0,99124.42
2016-12-27,2016-12-27,Business meal,REF67794009,307.28,0.0,98817.14
2016-12-30,2016-12-30,Equipment purchase,REF69382738,148.84,0.0,98668.3
2016-12-30,2016-12-30,Business meal,REF91113978,212.74,0.0,98455.56
2016-12-31,2016-12-31,Accounting expense,REF73366119,181.49,0.0,98274.07
2017-01-05,2017-01-05,Equipment purchase,REF17142330,94.1,0.0,98179.97
2017-01-10,2017-01-10,Marketing expenses,REF41763259,275.51,0.0,97904.46
2017-01-14,2017-01-14,Business meal,REF72549402,112.86,0.0,97791.6
2017-01-15,2017-01-15,Payment from Neal-Lopez,REF30765978,0.0,761.61,98553.21
2017-01-15,2017-01-15,Service payment - Thomas-Smith,REF50579373,0.0,655.01,99208.22
2017-01-15,2017-01-15,Payment from Ayala-French,REF17354868,0.0,342.58,99550.8
2017-01-15,2017-01-15,"Payment from Rhodes, Schmidt and Benitez",REF49036043,0.0,758.04,100308.84
2017-01-15,2017-01-15,Business insurance premium,REF78903198,180.93,0.0,100127.91
2017-01-15,2017-01-15,Project payment - Schmidt-Moran,REF86016394,0.0,791.73,100919.64
2017-01-15,2017-01-15,"Service payment - Fuentes, Stephens and Lee",REF18594031,0.0,858.53,101778.17
2017-01-15,2017-01-15,"Invoice payment - Nguyen, Palmer and Gonzalez",REF80856055,0.0,696.53,102474.7
2017-01-15,2017-01-15,Invoice payment - Rhodes-Jefferson,REF35919838,0.0,587.51,103062.21
2017-01-16,2017-01-16,Business meal,REF72956785,377.08,0.0,102685.13
2017-01-19,2017-01-19,Marketing expenses,REF35677646,381.82,0.0,102303.31
2017-01-21,2017-01-21,Professional software license,REF77958879,266.8,0.0,102036.51
2017-01-23,2017-01-23,Accounting expense,REF30206386,311.57,0.0,101724.94
2017-02-02,2017-02-02,Equipment purchase,REF93066516,143.22,0.0,101581.72
2017-02-06,2017-02-06,Business meal,REF82371296,428.04,0.0,101153.68
2017-02-06,2017-02-06,Marketing expenses,REF71418225,453.48,0.0,100700.2
2017-02-08,2017-02-08,Equipment purchase,REF43320653,226.21,0.0,100473.99
2017-02-13,2017-02-13,Coworking space rental,REF66839214,294.86,0.0,100179.13
2017-02-15,2017-02-15,"Service payment - Fuentes, Stephens and Lee",REF26714956,0.0,414.16,100593.29
2017-02-15,2017-02-15,Business insurance premium,REF22776008,152.35,0.0,100440.94
2017-02-15,2017-02-15,Project payment - Neal-Lopez,REF62307827,0.0,623.79,101064.73
2017-02-15,2017-02-15,"Project payment - Rhodes, Schmidt and Benitez",REF47246671,0.0,707.97,101772.7
2017-02-15,2017-02-15,Payment from Ayala-French,REF68596226,0.0,272.78,102045.48
2017-02-15,2017-02-15,Payment from Schmidt-Moran,REF90650765,0.0,562.89,102608.37
2017-02-15,2017-02-15,"Project payment - Nguyen, Palmer and Gonzalez",REF81502325,0.0,533.94,103142.31
2017-02-15,2017-02-15,Payment from Rhodes-Jefferson,REF70314913,0.0,652.95,103795.26
2017-02-15,2017-02-15,Service payment - Thomas-Smith,REF96054442,0.0,546.5,104341.76
2017-02-16,2017-02-16,Coworking space rental,REF47238479,370.47,0.0,103971.29
2017-02-20,2017-02-20,Training/conference,REF80691473,299.0,0.0,103672.29
2017-02-21,2017-02-21,Professional software license,REF12930676,157.56,0.0,103514.73
2017-02-21,2017-02-21,Business meal,REF40482471,296.56,0.0,103218.17
2017-02-24,2017-02-24,Marketing expenses,REF79918789,364.12,0.0,102854.05
2017-02-26,2017-02-26,Coworking space rental,REF39670886,276.52,0.0,102577.53
2017-02-28,2017-02-28,Training/conference,REF18046842,185.79,0.0,102391.74
2017-03-03,2017-03-03,Business meal,REF15858782,403.63,0.0,101988.11
2017-03-12,2017-03-12,Business meal,REF80016108,194.18,0.0,101793.93
2017-03-15,2017-03-15,Project payment - Rhodes-Jefferson,REF62520380,0.0,607.24,102401.17
2017-03-15,2017-03-15,"Invoice payment - Nguyen, Palmer and Gonzalez",REF50300756,0.0,851.4,103252.57
2017-03-15,2017-03-15,Invoice payment - Neal-Lopez,REF11151574,0.0,399.54,103652.11
2017-03-15,2017-03-15,"Invoice payment - Rhodes, Schmidt and Benitez",REF85071941,0.0,718.72,104370.83
2017-03-15,2017-03-15,Business insurance premium,REF13880922,148.8,0.0,104222.03
2017-03-15,2017-03-15,"Service payment - Fuentes, Stephens and Lee",REF54345686,0.0,471.5,104693.53
2017-03-15,2017-03-15,Payment from Thomas-Smith,REF24663707,0.0,551.09,105244.62
2017-03-15,2017-03-15,Service payment - Ayala-French,REF78892018,0.0,383.2,105627.82
2017-03-15,2017-03-15,Payment from Schmidt-Moran,REF59377457,0.0,574.73,106202.55
2017-03-16,2017-03-16,Business meal,REF16945669,178.17,0.0,106024.38
2017-03-19,2017-03-19,Business meal,REF34260331,272.91,0.0,105751.47
2017-03-21,2017-03-21,Professional software license,REF32352696,207.5,0.0,105543.97
2017-03-31,2017-03-31,Accounting expense,REF90585917,177.21,0.0,105366.76
2017-03-31,2017-03-31,Business meal,REF47729918,238.87,0.0,105127.89
2017-04-01,2017-04-01,Equipment purchase,REF84297053,239.44,0.0,104888.45
2017-04-02,2017-04-02,Business travel,REF42920617,371.99,0.0,104516.46
2017-04-03,2017-04-03,Coworking space rental,REF58669155,364.35,0.0,104152.11
2017-04-11,2017-04-11,Training/conference,REF84437097,163.39,0.0,103988.72
2017-04-13,2017-04-13,Equipment purchase,REF28683586,107.6,0.0,103881.12
2017-04-15,2017-04-15,"Project payment - Nguyen, Palmer and Gonzalez",REF59461253,0.0,691.28,104572.4
2017-04-15,2017-04-15,Service payment - Ayala-French,REF71664950,0.0,216.17,104788.57
2017-04-15,2017-04-15,Project payment - Neal-Lopez,REF37220351,0.0,658.8,105447.37
2017-04-15,2017-04-15,"Project payment - Rhodes, Schmidt and Benitez",REF39784660,0.0,868.56,106315.93
2017-04-15,2017-04-15,Service payment - Schmidt-Moran,REF38964235,0.0,528.13,106844.06
2017-04-15,2017-04-15,Invoice payment - Thomas-Smith,REF51529247,0.0,527.27,107371.33
2017-04-15,2017-04-15,Business insurance premium,REF35713523,138.2,0.0,107233.13
2017-04-15,2017-04-15,Payment from Rhodes-Jefferson,REF73094889,0.0,506.25,107739.38
2017-04-21,2017-04-21,Professional software license,REF48025869,178.52,0.0,107560.86
2017-04-30,2017-04-30,Business travel,REF37910704,333.11,0.0,107227.75
2017-05-07,2017-05-07,Accounting expense,REF31405118,79.65,0.0,107148.1
2017-05-15,2017-05-15,Business insurance premium,REF53244870,109.68,0.0,107038.42
2017-05-15,2017-05-15,Invoice payment - Ayala-French,REF71284564,0.0,281.94,107320.36
2017-05-15,2017-05-15,Invoice payment - Schmidt-Moran,REF76896642,0.0,519.33,107839.69
2017-05-15,2017-05-15,"Service payment - Fuentes, Stephens and Lee",REF29713821,0.0,402.85,108242.54
2017-05-15,2017-05-15,Project payment - Neal-Lopez,REF74875677,0.0,521.54,108764.08
2017-05-15,2017-05-15,"Invoice payment - Nguyen, Palmer and Gonzalez",REF57876779,0.0,463.86,109227.94
2017-05-15,2017-05-15,Invoice payment - Thomas-Smith,REF65882952,0.0,403.04,109630.98
2017-05-15,2017-05-15,"Invoice payment - Rhodes, Schmidt and Benitez",REF34924953,0.0,772.82,110403.8
2017-05-15,2017-05-15,Service payment - Rhodes-Jefferson,REF14107795,0.0,568.54,110972.34
2017-05-21,2017-05-21,Professional software license,REF92619685,211.87,0.0,110760.47
2017-05-26,2017-05-26,Marketing expenses,REF18552824,176.12,0.0,110584.35
2017-06-01,2017-06-01,Business meal,REF74761647,332.77,0.0,110251.58
2017-06-05,2017-06-05,Business meal,REF98426334,73.06,0.0,110178.52
2017-06-06,2017-06-06,Business meal,REF73187713,247.37,0.0,109931.15
2017-06-07,2017-06-07,Accounting expense,REF38340181,263.25,0.0,109667.9
2017-06-15,2017-06-15,Service payment - Thomas-Smith,REF14280722,0.0,351.24,110019.14
2017-06-15,2017-06-15,Business insurance premium,REF38926493,100.09,0.0,109919.05
2017-06-15,2017-06-15,Service payment - Schmidt-Moran,REF77511870,0.0,513.6,110432.65
2017-06-15,2017-06-15,"Service payment - Nguyen, Palmer and Gonzalez",REF96476985,0.0,502.54,110935.19
2017-06-15,2017-06-15,"Service payment - Fuentes, Stephens and Lee",REF35269128,0.0,478.31,111413.5
2017-06-15,2017-06-15,"Project payment - Rhodes, Schmidt and Benitez",REF83826399,0.0,596.8,112010.3
2017-06-15,2017-06-15,Equipment purchase,REF84519540,37.11,0.0,111973.19
2017-06-15,2017-06-15,Project payment - Ayala-French,REF84908757,0.0,308.54,112281.73
2017-06-15,2017-06-15,Project payment - Rhodes-Jefferson,REF61164741,0.0,532.5,112814.23
2017-06-15,2017-06-15,Payment from Neal-Lopez,REF87366292,0.0,507.13,113321.36
2017-06-16,2017-06-16,Accounting expense,REF96355802,170.63,0.0,113150.73
2017-06-21,2017-06-21,Professional software license,REF73932796,194.85,0.0,112955.88
2017-06-24,2017-06-24,Business travel,REF33861179,287.24,0.0,112668.64
2017-06-25,2017-06-25,Training/conference,REF13286601,157.54,0.0,112511.1
2017-06-30,2017-06-30,Marketing expenses,REF51344542,255.95,0.0,112255.15
2017-07-08,2017-07-08,Coworking space rental,REF58244415,274.89,0.0,111980.26
2017-07-14,2017-07-14,Training/conference,REF87466167,106.72,0.0,111873.54
2017-07-15,2017-07-15,Business insurance premium,REF20237165,88.96,0.0,111784.58
2017-07-15,2017-07-15,Project payment - Ayala-French,REF22960114,0.0,294.1,112078.68
2017-07-15,2017-07-15,"Invoice payment - Nguyen, Palmer and Gonzalez",REF54539439,0.0,469.5,112548.18
2017-07-15,2017-07-15,"Service payment - Fuentes, Stephens and Lee",REF25182476,0.0,357.58,112905.76
2017-07-15,2017-07-15,Service payment - Neal-Lopez,REF57547453,0.0,409.96,113315.72
2017-07-15,2017-07-15,Project payment - Schmidt-Moran,REF81222689,0.0,436.68,113752.4
2017-07-15,2017-07-15,"Invoice payment - Rhodes, Schmidt and Benitez",REF15895622,0.0,484.28,114236.68
2017-07-15,2017-07-15,Payment from Rhodes-Jefferson,REF68536840,0.0,438.82,114675.5
2017-07-15,2017-07-15,Payment from Thomas-Smith,REF64438786,0.0,298.66,114974.16
2017-07-15,2017-07-15,Business travel,REF14906940,288.82,0.0,114685.34
2017-07-21,2017-07-21,Professional software license,REF76566866,136.01,0.0,114549.33
2017-07-23,2017-07-23,Business travel,REF23997470,190.99,0.0,114358.34
2017-07-27,2017-07-27,Marketing expenses,REF25543628,333.09,0.0,114025.25
2017-07-30,2017-07-30,Business meal,REF83540342,142.46,0.0,113882.79
2017-08-07,2017-08-07,Training/conference,REF96514372,221.34,0.0,113661.45
2017-08-08,2017-08-08,Marketing expenses,REF62618200,359.0,0.0,113302.45
2017-08-14,2017-08-14,Training/conference,REF62366364,222.36,0.0,113080.09
2017-08-15,2017-08-15,Business insurance premium,REF14846077,121.14,0.0,112958.95
2017-08-15,2017-08-15,Business travel,REF32460394,264.49,0.0,112694.46
2017-08-15,2017-08-15,"Service payment - Nguyen, Palmer and Gonzalez",REF39384686,0.0,617.12,113311.58
2017-08-15,2017-08-15,Invoice payment - Thomas-Smith,REF85128154,0.0,354.61,113666.19
2017-08-15,2017-08-15,Invoice payment - Rhodes-Jefferson,REF40715215,0.0,530.04,114196.23
2017-08-15,2017-08-15,Service payment - Schmidt-Moran,REF80070941,0.0,478.18,114674.41
2017-08-15,2017-08-15,"Project payment - Rhodes, Schmidt and Benitez",REF42619757,0.0,737.95,115412.36
2017-08-15,2017-08-15,"Service payment - Fuentes, Stephens and Lee",REF12400204,0.0,346.99,115759.35
2017-08-15,2017-08-15,Service payment - Neal-Lopez,REF72375028,0.0,362.03,116121.38
2017-08-16,2017-08-16,Business meal,REF59041851,263.84,0.0,115857.54
2017-08-21,2017-08-21,Professional software license,REF13524809,171.67,0.0,115685.87
2017-08-24,2017-08-24,Training/conference,REF33495834,154.37,0.0,115531.5
2017-08-25,2017-08-25,Coworking space rental,REF82608321,284.92,0.0,115246.58
2017-08-31,2017-08-31,Business meal,REF37553232,240.31,0.0,115006.27
2017-09-02,2017-09-02,Marketing expenses,REF13689478,357.05,0.0,114649.22
2017-09-03,2017-09-03,Accounting expense,REF87278438,194.16,0.0,114455.06
2017-09-05,2017-09-05,Marketing expenses,REF25235536,240.09,0.0,114214.97
2017-09-06,2017-09-06,Accounting expense,REF45430319,163.28,0.0,114051.69
2017-09-07,2017-09-07,Accounting expense,REF86321004,256.98,0.0,113794.71
2017-09-11,2017-09-11,Business travel,REF81264089,343.6,0.0,113451.11
2017-09-12,2017-09-12,Coworking space rental,REF81951198,311.49,0.0,113139.62
2017-09-15,2017-09-15,Invoice payment - Rhodes-Jefferson,REF73826212,0.0,604.25,113743.87
2017-09-15,2017-09-15,Invoice payment - Thomas-Smith,REF30357705,0.0,586.15,114330.02
2017-09-15,2017-09-15,"Payment from Fuentes, Stephens and Lee",REF28718081,0.0,645.73,114975.75
2017-09-15,2017-09-15,"Payment from Nguyen, Palmer and Gonzalez",REF45700692,0.0,697.31,115673.06
2017-09-15,2017-09-15,"Service payment - Rhodes, Schmidt and Benitez",REF56308888,0.0,674.57,116347.63
2017-09-15,2017-09-15,Business insurance premium,REF51811397,173.21,0.0,116174.42
2017-09-17,2017-09-17,Accounting expense,REF96690197,176.76,0.0,115997.66
2017-09-19,2017-09-19,Business travel,REF15334927,529.25,0.0,115468.41
2017-09-20,2017-09-20,Marketing expenses,REF38671448,365.68,0.0,115102.73
2017-09-21,2017-09-21,Professional software license,REF15353670,216.18,0.0,114886.55
2017-09-26,2017-09-26,Accounting expense,REF51651922,253.19,0.0,114633.36
2017-09-28,2017-09-28,Business meal,REF94945380,344.45,0.0,114288.91
2017-10-03,2017-10-03,Coworking space rental,REF91612078,40.28,0.0,114248.63
2017-10-07,2017-10-07,Business meal,REF47061884,338.79,0.0,113909.84
2017-10-10,2017-10-10,Coworking space rental,REF89136072,436.1,0.0,113473.74
2017-10-12,2017-10-12,Training/conference,REF17278106,204.33,0.0,113269.41
2017-10-15,2017-10-15,Marketing expenses,REF57352566,250.24,0.0,113019.17
2017-10-15,2017-10-15,"Service payment - Fuentes, Stephens and Lee",REF34636383,0.0,476.99,113496.16
2017-10-15,2017-10-15,Service payment - Schmidt-Moran,REF31813197,0.0,832.17,114328.33
2017-10-15,2017-10-15,Service payment - Ayala-French,REF25910343,0.0,354.63,114682.96
2017-10-15,2017-10-15,"Project payment - Nguyen, Palmer and Gonzalez",REF35839619,0.0,888.88,115571.84
2017-10-15,2017-10-15,Payment from Neal-Lopez,REF84705539,0.0,569.87,116141.71
2017-10-15,2017-10-15,Business insurance premium,REF55557781,171.95,0.0,115969.76
2017-10-15,2017-10-15,Payment from Rhodes-Jefferson,REF32164795,0.0,538.41,116508.17
2017-10-15,2017-10-15,Project payment - Thomas-Smith,REF60996521,0.0,507.84,117016.01
2017-10-15,2017-10-15,"Service payment - Rhodes, Schmidt and Benitez",REF74819218,0.0,869.66,117885.67
2017-10-20,2017-10-20,Equipment purchase,REF76510240,224.47,0.0,117661.2
2017-10-21,2017-10-21,Professional software license,REF57991752,187.78,0.0,117473.42
2017-10-25,2017-10-25,Business travel,REF52119160,672.63,0.0,116800.79
2017-10-27,2017-10-27,Business travel,REF43998365,483.92,0.0,116316.87
2017-11-04,2017-11-04,Business meal,REF17989985,266.97,0.0,116049.9
2017-11-05,2017-11-05,Business travel,REF98028307,441.85,0.0,115608.05
2017-11-06,2017-11-06,Business travel,REF50147790,339.26,0.0,115268.79
2017-11-06,2017-11-06,Training/conference,REF80748672,175.57,0.0,115093.22
2017-11-07,2017-11-07,Business meal,REF10226914,253.82,0.0,114839.4
2017-11-10,2017-11-10,Business travel,REF46745554,324.01,0.0,114515.39
2017-11-11,2017-11-11,Business meal,REF43531377,196.09,0.0,114319.3
2017-11-11,2017-11-11,Coworking space rental,REF54916795,307.61,0.0,114011.69
2017-11-15,2017-11-15,Payment from Schmidt-Moran,REF99842056,0.0,808.39,114820.08
2017-11-15,2017-11-15,Service payment - Thomas-Smith,REF37513307,0.0,500.61,115320.69
2017-11-15,2017-11-15,Business insurance premium,REF77621647,163.37,0.0,115157.32
2017-11-15,2017-11-15,"Service payment - Nguyen, Palmer and Gonzalez",REF27343504,0.0,805.25,115962.57
2017-11-15,2017-11-15,Service payment - Ayala-French,REF32593116,0.0,316.72,116279.29
2017-11-15,2017-11-15,"Project payment - Rhodes, Schmidt and Benitez",REF44222512,0.0,829.81,117109.1
2017-11-15,2017-11-15,Service payment - Neal-Lopez,REF44277441,0.0,505.47,117614.57
2017-11-15,2017-11-15,"Service payment - Fuentes, Stephens and Lee",REF95443748,0.0,477.21,118091.78
2017-11-15,2017-11-15,Project payment - Rhodes-Jefferson,REF86270587,0.0,567.53,118659.31
2017-11-16,2017-11-16,Marketing expenses,REF54719689,432.27,0.0,118227.04
2017-11-21,2017-11-21,Professional software license,REF34179679,245.34,0.0,117981.7
2017-12-06,2017-12-06,Marketing expenses,REF29874342,179.62,0.0,117802.08
2017-12-07,2017-12-07,Training/conference,REF61540863,160.1,0.0,117641.98
2017-12-10,2017-12-10,Business meal,REF44711339,144.04,0.0,117497.94
2017-12-11,2017-12-11,Coworking space rental,REF95369205,229.39,0.0,117268.55
2017-12-12,2017-12-12,Business travel,REF94270799,505.01,0.0,116763.54
2017-12-14,2017-12-14,Equipment purchase,REF73423910,62.82,0.0,116700.72
2017-12-15,2017-12-15,Business insurance premium,REF83977071,128.22,0.0,116572.5
2017-12-15,2017-12-15,Service payment - Thomas-Smith,REF29094884,0.0,420.61,116993.11
2017-12-15,2017-12-15,Service payment - Rhodes-Jefferson,REF33097110,0.0,573.59,117566.7
2017-12-15,2017-12-15,Service payment - Schmidt-Moran,REF71273131,0.0,611.31,118178.01
2017-12-15,2017-12-15,"Service payment - Nguyen, Palmer and Gonzalez",REF81776765,0.0,483.96,118661.97
2017-12-15,2017-12-15,"Payment from Fuentes, Stephens and Lee",REF28492959,0.0,506.79,119168.76
2017-12-15,2017-12-15,Service payment - Ayala-French,REF45454436,0.0,301.32,119470.08
2017-12-21,2017-12-21,Professional software license,REF20174330,224.26,0.0,119245.82
2017-12-22,2017-12-22,Coworking space rental,REF26982778,380.55,0.0,118865.27
2017-12-23,2017-12-23,Business meal,REF77553726,166.99,0.0,118698.28
2017-12-23,2017-12-23,Marketing expenses,REF39005265,195.44,0.0,118502.84
2017-12-24,2017-12-24,Business meal,REF89132403,151.69,0.0,118351.15
2017-12-24,2017-12-24,Business travel,REF16808803,309.3,0.0,118041.85
2017-12-25,2017-12-25,Business travel,REF51539621,549.15,0.0,117492.7
2017-12-25,2017-12-25,Marketing expenses,REF85740387,112.57,0.0,117380.13
2017-12-27,2017-12-27,Business meal,REF93267100,69.25,0.0,117310.88
2017-12-31,2017-12-31,Business meal,REF80141672,259.68,0.0,117051.2
2018-01-03,2018-01-03,Accounting expense,REF34398810,354.19,0.0,116697.01
2018-01-04,2018-01-04,Business meal,REF33497825,317.62,0.0,116379.39
2018-01-07,2018-01-07,Business meal,REF33190733,252.46,0.0,116126.93
2018-01-12,2018-01-12,Training/conference,REF29271923,324.7,0.0,115802.23
2018-01-13,2018-01-13,Training/conference,REF84520375,253.87,0.0,115548.36
2018-01-15,2018-01-15,"Project payment - Rhodes, Schmidt and Benitez",REF12330150,0.0,1286.1,116834.46
2018-01-15,2018-01-15,Payment from Schmidt-Moran,REF28829101,0.0,690.03,117524.49
2018-01-15,2018-01-15,"Project payment - Fuentes, Stephens and Lee",REF10084286,0.0,592.37,118116.86
2018-01-15,2018-01-15,Service payment - Thomas-Smith,REF70287676,0.0,610.74,118727.6
2018-01-15,2018-01-15,Invoice payment - Neal-Lopez,REF41737076,0.0,508.17,119235.77
2018-01-15,2018-01-15,Business insurance premium,REF37412196,164.56,0.0,119071.21
2018-01-15,2018-01-15,"Payment from Nguyen, Palmer and Gonzalez",REF42108534,0.0,804.8,119876.01
2018-01-15,2018-01-15,Project payment - Ayala-French,REF66336058,0.0,323.72,120199.73
2018-01-18,2018-01-18,Marketing expenses,REF73790832,546.52,0.0,119653.21
2018-01-21,2018-01-21,Professional software license,REF29971416,218.03,0.0,119435.18
2018-01-23,2018-01-23,Business travel,REF43151637,424.39,0.0,119010.79
2018-01-24,2018-01-24,Training/conference,REF71116621,139.45,0.0,118871.34
2018-01-25,2018-01-25,Coworking space rental,REF20989055,258.37,0.0,118612.97
2018-01-29,2018-01-29,Accounting expense,REF99906619,248.9,0.0,118364.07
2018-01-29,2018-01-29,Business travel,REF95041588,342.93,0.0,118021.14
2018-01-30,2018-01-30,Business meal,REF64046155,274.97,0.0,117746.17
2018-02-06,2018-02-06,Marketing expenses,REF87957297,124.4,0.0,117621.77
2018-02-06,2018-02-06,Accounting expense,REF33078650,191.48,0.0,117430.29
2018-02-08,2018-02-08,Marketing expenses,REF86065277,360.76,0.0,117069.53
2018-02-11,2018-02-11,Business meal,REF39372454,446.52,0.0,116623.01
2018-02-15,2018-02-15,Service payment - Rhodes-Jefferson,REF63337951,0.0,580.23,117203.24
2018-02-15,2018-02-15,Payment from Schmidt-Moran,REF46465261,0.0,708.99,117912.23
2018-02-15,2018-02-15,Project payment - Thomas-Smith,REF90914846,0.0,497.04,118409.27
2018-02-15,2018-02-15,"Payment from Nguyen, Palmer and Gonzalez",REF60075101,0.0,829.12,119238.39
2018-02-15,2018-02-15,Invoice payment - Ayala-French,REF96507323,0.0,397.22,119635.61
2018-02-15,2018-02-15,Business insurance premium,REF74241422,152.24,0.0,119483.37
2018-02-15,2018-02-15,"Service payment - Fuentes, Stephens and Lee",REF66974198,0.0,717.81,120201.18
2018-02-15,2018-02-15,Project payment - Neal-Lopez,REF92943156,0.0,518.66,120719.84
2018-02-15,2018-02-15,"Service payment - Rhodes, Schmidt and Benitez",REF61039648,0.0,1066.45,121786.29
2018-02-20,2018-02-20,Coworking space rental,REF25148937,378.29,0.0,121408.0
2018-02-21,2018-02-21,Professional software license,REF66940999,241.55,0.0,121166.45
2018-02-25,2018-02-25,Accounting expense,REF60203253,148.2,0.0,121018.25
2018-02-25,2018-02-25,Business meal,REF14313206,190.02,0.0,120828.23
2018-02-27,2018-02-27,Marketing expenses,REF80149075,355.81,0.0,120472.42
2018-02-27,2018-02-27,Business meal,REF36611795,217.73,0.0,120254.69
2018-03-04,2018-03-04,Equipment purchase,REF77424936,83.42,0.0,120171.27
2018-03-08,2018-03-08,Business travel,REF24923228,271.07,0.0,119900.2
2018-03-08,2018-03-08,Equipment purchase,REF87134086,266.68,0.0,119633.52
2018-03-15,2018-03-15,Invoice payment - Neal-Lopez,REF41774299,0.0,540.51,120174.03
2018-03-15,2018-03-15,Service payment - Rhodes-Jefferson,REF75519473,0.0,633.62,120807.65
2018-03-15,2018-03-15,Project payment - Ayala-French,REF93507354,0.0,348.67,121156.32
2018-03-15,2018-03-15,"Service payment - Fuentes, Stephens and Lee",REF14350468,0.0,444.94,121601.26
2018-03-15,2018-03-15,"Project payment - Nguyen, Palmer and Gonzalez",REF84476798,0.0,684.09,122285.35
2018-03-15,2018-03-15,Service payment - Schmidt-Moran,REF54206744,0.0,519.72,122805.07
2018-03-15,2018-03-15,"Project payment - Rhodes, Schmidt and Benitez",REF10258041,0.0,660.99,123466.06
2018-03-15,2018-03-15,Business insurance premium,REF66181065,140.15,0.0,123325.91
2018-03-15,2018-03-15,Project payment - Thomas-Smith,REF99734581,0.0,485.25,123811.16
2018-03-20,2018-03-20,Accounting expense,REF50786153,300.53,0.0,123510.63
2018-03-21,2018-03-21,Professional software license,REF70369660,175.12,0.0,123335.51
2018-04-01,2018-04-01,Equipment purchase,REF11638276,117.73,0.0,123217.78
2018-04-02,2018-04-02,Business travel,REF59076471,436.35,0.0,122781.43
2018-04-04,2018-04-04,Marketing expenses,REF92613877,174.83,0.0,122606.6
2018-04-04,2018-04-04,Training/conference,REF58581430,209.18,0.0,122397.42
2018-04-10,2018-04-10,Business travel,REF24590866,565.16,0.0,121832.26
2018-04-11,2018-04-11,Accounting expense,REF26562268,252.39,0.0,121579.87
2018-04-14,2018-04-14,Business meal,REF65496749,232.23,0.0,121347.64
2018-04-15,2018-04-15,Project payment - Neal-Lopez,REF47705601,0.0,651.15,121998.79
2018-04-15,2018-04-15,Project payment - Ayala-French,REF26637435,0.0,260.4,122259.19
2018-04-15,2018-04-15,"Service payment - Nguyen, Palmer and Gonzalez",REF38451180,0.0,758.16,123017.35
2018-04-15,2018-04-15,Invoice payment - Schmidt-Moran,REF14473878,0.0,536.9,123554.25
2018-04-15,2018-04-15,"Service payment - Rhodes, Schmidt and Benitez",REF89395924,0.0,862.41,124416.66
2018-04-15,2018-04-15,Payment from Thomas-Smith,REF80742104,0.0,533.82,124950.48
2018-04-15,2018-04-15,Invoice payment - Rhodes-Jefferson,REF96188986,0.0,434.8,125385.28
2018-04-15,2018-04-15,Business insurance premium,REF29696512,141.15,0.0,125244.13
2018-04-21,2018-04-21,Professional software license,REF23958293,188.12,0.0,125056.01
2018-04-30,2018-04-30,Training/conference,REF89723502,254.67,0.0,124801.34
2018-05-01,2018-05-01,Business travel,REF63504355,339.91,0.0,124461.43
2018-05-12,2018-05-12,Marketing expenses,REF39985518,193.7,0.0,124267.73
2018-05-15,2018-05-15,Business insurance premium,REF11982664,113.8,0.0,124153.93
2018-05-15,2018-05-15,Service payment - Ayala-French,REF84307591,0.0,297.71,124451.64
2018-05-15,2018-05-15,"Payment from Fuentes, Stephens and Lee",REF95353113,0.0,418.78,124870.42
2018-05-15,2018-05-15,Service payment - Neal-Lopez,REF87346252,0.0,487.9,125358.32
2018-05-15,2018-05-15,"Project payment - Rhodes, Schmidt and Benitez",REF26948888,0.0,766.94,126125.26
2018-05-15,2018-05-15,Invoice payment - Thomas-Smith,REF13312477,0.0,419.5,126544.76
2018-05-15,2018-05-15,Marketing expenses,REF15012980,240.35,0.0,126304.41
2018-05-15,2018-05-15,"Project payment - Nguyen, Palmer and Gonzalez",REF32809858,0.0,628.94,126933.35
2018-05-19,2018-05-19,Equipment purchase,REF33346536,148.1,0.0,126785.25
2018-05-21,2018-05-21,Professional software license,REF94379404,180.64,0.0,126604.61
2018-05-22,2018-05-22,Marketing expenses,REF90159037,153.16,0.0,126451.45
2018-05-25,2018-05-25,Accounting expense,REF15423631,183.68,0.0,126267.77
2018-05-30,2018-05-30,Marketing expenses,REF75771377,367.53,0.0,125900.24
2018-06-03,2018-06-03,Business meal,REF69958413,257.55,0.0,125642.69
2018-06-04,2018-06-04,Equipment purchase,REF37628104,176.51,0.0,125466.18
2018-06-08,2018-06-08,Business travel,REF34971009,279.09,0.0,125187.09
2018-06-13,2018-06-13,Business travel,REF16997174,358.34,0.0,124828.75
2018-06-15,2018-06-15,Payment from Ayala-French,REF90928825,0.0,216.44,125045.19
2018-06-15,2018-06-15,Project payment - Rhodes-Jefferson,REF26361525,0.0,350.85,125396.04
2018-06-15,2018-06-15,Service payment - Neal-Lopez,REF99256573,0.0,501.08,125897.12
2018-06-15,2018-06-15,"Invoice payment - Nguyen, Palmer and Gonzalez",REF55933992,0.0,614.96,126512.08
2018-06-15,2018-06-15,Business insurance premium,REF49161027,113.24,0.0,126398.84
2018-06-15,2018-06-15,Service payment - Thomas-Smith,REF13804334,0.0,409.44,126808.28
2018-06-15,2018-06-15,Service payment - Schmidt-Moran,REF17067604,0.0,460.22,127268.5
2018-06-15,2018-06-15,"Project payment - Rhodes, Schmidt and Benitez",REF40508518,0.0,347.52,127616.02
2018-06-17,2018-06-17,Business meal,REF15595154,138.01,0.0,127478.01
2018-06-21,2018-06-21,Professional software license,REF29513480,160.05,0.0,127317.96
2018-06-23,2018-06-23,Marketing expenses,REF62694649,250.57,0.0,127067.39
2018-06-25,2018-06-25,Equipment purchase,REF97278112,119.31,0.0,126948.08
2018-06-27,2018-06-27,Coworking space rental,REF34590192,282.46,0.0,126665.62
2018-07-01,2018-07-01,Training/conference,REF45935464,151.7,0.0,126513.92
2018-07-03,2018-07-03,Business travel,REF63183833,276.6,0.0,126237.32
2018-07-04,2018-07-04,Business meal,REF65705275,194.68,0.0,126042.64
2018-07-09,2018-07-09,Marketing expenses,REF81989932,166.7,0.0,125875.94
2018-07-10,2018-07-10,Equipment purchase,REF92895089,100.7,0.0,125775.24
2018-07-15,2018-07-15,Service payment - Thomas-Smith,REF80486786,0.0,295.84,126071.08
2018-07-15,2018-07-15,"Payment from Rhodes, Schmidt and Benitez",REF62398257,0.0,574.39,126645.47
2018-07-15,2018-07-15,Project payment - Ayala-French,REF51219904,0.0,287.54,126933.01
2018-07-15,2018-07-15,Service payment - Rhodes-Jefferson,REF45700904,0.0,387.44,127320.45
2018-07-15,2018-07-15,Invoice payment - Schmidt-Moran,REF18705093,0.0,477.08,127797.53
2018-07-15,2018-07-15,Invoice payment - Neal-Lopez,REF74654594,0.0,331.19,128128.72
2018-07-15,2018-07-15,"Project payment - Nguyen, Palmer and Gonzalez",REF36297211,0.0,493.46,128622.18
2018-07-15,2018-07-15,"Service payment - Fuentes, Stephens and Lee",REF49610290,0.0,403.59,129025.77
2018-07-15,2018-07-15,Business insurance premium,REF84693449,93.17,0.0,128932.6
2018-07-18,2018-07-18,Equipment purchase,REF17645506,136.67,0.0,128795.93
2018-07-21,2018-07-21,Professional software license,REF21915906,123.2,0.0,128672.73
2018-07-23,2018-07-23,Marketing expenses,REF23117385,246.42,0.0,128426.31
2018-07-27,2018-07-27,Marketing expenses,REF42039454,304.83,0.0,128121.48
2018-07-30,2018-07-30,Training/conference,REF17880270,107.31,0.0,128014.17
2018-08-03,2018-08-03,Business travel,REF31332451,269.11,0.0,127745.06
2018-08-04,2018-08-04,Accounting expense,REF58564351,192.61,0.0,127552.45
2018-08-14,2018-08-14,Business meal,REF67328343,129.74,0.0,127422.71
2018-08-14,2018-08-14,Equipment purchase,REF31412505,45.64,0.0,127377.07
2018-08-15,2018-08-15,Business insurance premium,REF85325017,112.98,0.0,127264.09
2018-08-15,2018-08-15,Service payment - Rhodes-Jefferson,REF45546553,0.0,422.38,127686.47
2018-08-15,2018-08-15,Service payment - Thomas-Smith,REF48134328,0.0,447.51,128133.98
2018-08-15,2018-08-15,"Project payment - Rhodes, Schmidt and Benitez",REF11509540,0.0,778.28,128912.26
2018-08-15,2018-08-15,"Service payment - Nguyen, Palmer and Gonzalez",REF12123071,0.0,576.02,129488.28
2018-08-15,2018-08-15,"Project payment - Fuentes, Stephens and Lee",REF70338931,0.0,571.13,130059.41
2018-08-16,2018-08-16,Accounting expense,REF56912654,213.65,0.0,129845.76
2018-08-18,2018-08-18,Business meal,REF59747017,242.37,0.0,129603.39
2018-08-21,2018-08-21,Professional software license,REF61601944,159.66,0.0,129443.73
2018-08-28,2018-08-28,Business meal,REF41773957,199.68,0.0,129244.05
2018-08-31,2018-08-31,Business travel,REF10618828,338.42,0.0,128905.63
2018-09-03,2018-09-03,Accounting expense,REF69371116,218.4,0.0,128687.23
2018-09-11,2018-09-11,Training/conference,REF45876720,256.68,0.0,128430.55
2018-09-12,2018-09-12,Business travel,REF55239664,328.8,0.0,128101.75
2018-09-15,2018-09-15,"Payment from Rhodes, Schmidt and Benitez",REF79956705,0.0,1005.7,129107.45
2018-09-15,2018-09-15,Service payment - Neal-Lopez,REF52186028,0.0,522.59,129630.04
2018-09-15,2018-09-15,"Service payment - Nguyen, Palmer and Gonzalez",REF19965073,0.0,979.74,130609.78
2018-09-15,2018-09-15,Project payment - Schmidt-Moran,REF82719557,0.0,630.99,131240.77
2018-09-15,2018-09-15,Project payment - Ayala-French,REF75291690,0.0,322.68,131563.45
2018-09-15,2018-09-15,Service payment - Thomas-Smith,REF41529481,0.0,458.62,132022.07
2018-09-15,2018-09-15,Business insurance premium,REF38270214,152.36,0.0,131869.71
2018-09-16,2018-09-16,Training/conference,REF30065753,176.56,0.0,131693.15
2018-09-18,2018-09-18,Training/conference,REF97781715,160.18,0.0,131532.97
2018-09-21,2018-09-21,Professional software license,REF54785065,224.68,0.0,131308.29
2018-09-25,2018-09-25,Equipment purchase,REF67440391,136.98,0.0,131171.31
2018-10-05,2018-10-05,Business travel,REF31220142,406.68,0.0,130764.63
2018-10-15,2018-10-15,Business insurance premium,REF40232866,169.15,0.0,130595.48
2018-10-15,2018-10-15,Invoice payment - Ayala-French,REF42777152,0.0,430.33,131025.81
2018-10-15,2018-10-15,Service payment - Schmidt-Moran,REF14459849,0.0,587.46,131613.27
2018-10-15,2018-10-15,Payment from Neal-Lopez,REF82677493,0.0,630.77,132244.04
2018-10-15,2018-10-15,Invoice payment - Thomas-Smith,REF54744499,0.0,657.65,132901.69
2018-10-15,2018-10-15,Payment from Rhodes-Jefferson,REF47518310,0.0,592.6,133494.29
2018-10-16,2018-10-16,Business meal,REF46241419,227.45,0.0,133266.84
2018-10-21,2018-10-21,Professional software license,REF35879520,238.28,0.0,133028.56
2018-11-03,2018-11-03,Business travel,REF57144578,447.99,0.0,132580.57
2018-11-03,2018-11-03,Marketing expenses,REF12997640,254.48,0.0,132326.09
2018-11-05,2018-11-05,Business meal,REF78695929,133.21,0.0,132192.88
2018-11-15,2018-11-15,Payment from Ayala-French,REF84391929,0.0,324.52,132517.4
2018-11-15,2018-11-15,Project payment - Thomas-Smith,REF72626193,0.0,760.11,133277.51
2018-11-15,2018-11-15,"Service payment - Fuentes, Stephens and Lee",REF18750473,0.0,469.01,133746.52
2018-11-15,2018-11-15,Business insurance premium,REF10800784,158.16,0.0,133588.36
2018-11-15,2018-11-15,Payment from Schmidt-Moran,REF34092913,0.0,879.57,134467.93
2018-11-15,2018-11-15,Service payment - Rhodes-Jefferson,REF47981209,0.0,679.89,135147.82
2018-11-15,2018-11-15,Payment from Neal-Lopez,REF63001882,0.0,645.93,135793.75
2018-11-19,2018-11-19,Training/conference,REF15120062,267.06,0.0,135526.69
2018-11-21,2018-11-21,Professional software license,REF18356279,213.24,0.0,135313.45
2018-11-24,2018-11-24,Business meal,REF43629977,222.92,0.0,135090.53
2018-11-29,2018-11-29,Business meal,REF65869494,215.5,0.0,134875.03
2018-11-30,2018-11-30,Accounting expense,REF42177578,266.18,0.0,134608.85
2018-12-02,2018-12-02,Business travel,REF32130135,306.69,0.0,134302.16
2018-12-03,2018-12-03,Accounting expense,REF12417896,228.12,0.0,134074.04
2018-12-07,2018-12-07,Equipment purchase,REF81938353,135.91,0.0,133938.13
2018-12-10,2018-12-10,Coworking space rental,REF85847749,334.23,0.0,133603.9
2018-12-11,2018-12-11,Accounting expense,REF88664159,239.77,0.0,133364.13
2018-12-13,2018-12-13,Training/conference,REF73097521,186.36,0.0,133177.77
2018-12-14,2018-12-14,Business meal,REF20939234,354.81,0.0,132822.96
2018-12-14,2018-12-14,Training/conference,REF30239838,157.5,0.0,132665.46
2018-12-15,2018-12-15,Invoice payment - Thomas-Smith,REF22078064,0.0,404.66,133070.12
2018-12-15,2018-12-15,Service payment - Schmidt-Moran,REF46972939,0.0,575.44,133645.56
2018-12-15,2018-12-15,"Invoice payment - Fuentes, Stephens and Lee",REF97036165,0.0,556.81,134202.37
2018-12-15,2018-12-15,Coworking space rental,REF40773994,370.25,0.0,133832.12
2018-12-15,2018-12-15,Invoice payment - Neal-Lopez,REF22838477,0.0,463.1,134295.22
2018-12-15,2018-12-15,"Invoice payment - Rhodes, Schmidt and Benitez",REF65709476,0.0,786.7,135081.92
2018-12-15,2018-12-15,Invoice payment - Ayala-French,REF28212126,0.0,328.42,135410.34
2018-12-15,2018-12-15,Payment from Rhodes-Jefferson,REF24034296,0.0,549.62,135959.96
2018-12-15,2018-12-15,"Invoice payment - Nguyen, Palmer and Gonzalez",REF94034276,0.0,685.98,136645.94
2018-12-15,2018-12-15,Business insurance premium,REF73611308,132.61,0.0,136513.33
2018-12-17,2018-12-17,Business travel,REF68141663,373.88,0.0,136139.45
2018-12-17,2018-12-17,Business meal,REF40220777,189.34,0.0,135950.11
2018-12-21,2018-12-21,Business meal,REF95177477,228.78,0.0,135721.33
2018-12-21,2018-12-21,Professional software license,REF85297786,186.58,0.0,135534.75
2018-12-21,2018-12-21,Training/conference,REF93135445,233.32,0.0,135301.43
2018-12-28,2018-12-28,Coworking space rental,REF65061267,305.86,0.0,134995.57
2018-12-28,2018-12-28,Marketing expenses,REF21955578,228.76,0.0,134766.81
2018-12-30,2018-12-30,Business travel,REF25885185,283.85,0.0,134482.96
2019-01-01,2019-01-01,Coworking space rental,REF38216110,395.8,0.0,134087.16
2019-01-12,2019-01-12,Marketing expenses,REF18651507,284.63,0.0,133802.53
2019-01-14,2019-01-14,Training/conference,REF36428832,181.2,0.0,133621.33
2019-01-15,2019-01-15,Business insurance premium,REF61083263,183.97,0.0,133437.36
2019-01-15,2019-01-15,Equipment purchase,REF66679742,59.9,0.0,133377.46
2019-01-15,2019-01-15,Project payment - Neal-Lopez,REF44956364,0.0,537.63,133915.09
2019-01-15,2019-01-15,"Project payment - Fuentes, Stephens and Lee",REF18289618,0.0,561.59,134476.68
2019-01-15,2019-01-15,Payment from Schmidt-Moran,REF48667059,0.0,710.22,135186.9
2019-01-15,2019-01-15,Payment from Rhodes-Jefferson,REF70001413,0.0,528.48,135715.38
2019-01-15,2019-01-15,"Invoice payment - Nguyen, Palmer and Gonzalez",REF71416794,0.0,757.4,136472.78
2019-01-15,2019-01-15,"Invoice payment - Rhodes, Schmidt and Benitez",REF15441868,0.0,880.23,137353.01
2019-01-21,2019-01-21,Professional software license,REF58387878,220.05,0.0,137132.96
2019-01-25,2019-01-25,Business meal,REF41303312,399.01,0.0,136733.95
2019-02-02,2019-02-02,Business travel,REF18534116,417.28,0.0,136316.67
2019-02-05,2019-02-05,Business travel,REF86140778,511.21,0.0,135805.46
2019-02-06,2019-02-06,Business travel,REF33283122,394.87,0.0,135410.59
2019-02-10,2019-02-10,Coworking space rental,REF43193874,76.48,0.0,135334.11
2019-02-14,2019-02-14,Training/conference,REF37536391,226.17,0.0,135107.94
2019-02-15,2019-02-15,Payment from Thomas-Smith,REF64686489,0.0,530.9,135638.84
2019-02-15,2019-02-15,Service payment - Neal-Lopez,REF14600384,0.0,398.53,136037.37
2019-02-15,2019-02-15,"Project payment - Rhodes, Schmidt and Benitez",REF13578936,0.0,873.93,136911.3
2019-02-15,2019-02-15,Business insurance premium,REF10973261,159.72,0.0,136751.58
2019-02-15,2019-02-15,Invoice payment - Schmidt-Moran,REF19456376,0.0,665.65,137417.23
2019-02-15,2019-02-15,Project payment - Ayala-French,REF98559963,0.0,318.66,137735.89
2019-02-15,2019-02-15,"Payment from Nguyen, Palmer and Gonzalez",REF91036987,0.0,763.93,138499.82
2019-02-15,2019-02-15,Project payment - Rhodes-Jefferson,REF39960433,0.0,467.85,138967.67
2019-02-15,2019-02-15,"Invoice payment - Fuentes, Stephens and Lee",REF71037027,0.0,566.27,139533.94
2019-02-18,2019-02-18,Business travel,REF99846858,146.69,0.0,139387.25
2019-02-21,2019-02-21,Professional software license,REF46017732,203.34,0.0,139183.91
2019-02-21,2019-02-21,Business meal,REF12136566,352.32,0.0,138831.59
2019-02-22,2019-02-22,Coworking space rental,REF83987696,389.5,0.0,138442.09
2019-02-24,2019-02-24,Accounting expense,REF54401789,448.54,0.0,137993.55
2019-02-24,2019-02-24,Business meal,REF52289453,272.88,0.0,137720.67
2019-02-26,2019-02-26,Business meal,REF50640873,308.09,0.0,137412.58
2019-03-05,2019-03-05,Equipment purchase,REF64366013,178.47,0.0,137234.11
2019-03-08,2019-03-08,Training/conference,REF50617432,181.79,0.0,137052.32
2019-03-11,2019-03-11,Marketing expenses,REF39551770,246.7,0.0,136805.62
2019-03-12,2019-03-12,Business meal,REF33822196,258.85,0.0,136546.77
2019-03-15,2019-03-15,Invoice payment - Thomas-Smith,REF94056359,0.0,529.29,137076.06
2019-03-15,2019-03-15,"Invoice payment - Rhodes, Schmidt and Benitez",REF67059912,0.0,1031.48,138107.54
2019-03-15,2019-03-15,Business insurance premium,REF82248225,141.95,0.0,137965.59
2019-03-15,2019-03-15,"Payment from Nguyen, Palmer and Gonzalez",REF74053100,0.0,731.71,138697.3
2019-03-15,2019-03-15,Invoice payment - Ayala-French,REF27494697,0.0,318.43,139015.73
2019-03-15,2019-03-15,Service payment - Neal-Lopez,REF63055871,0.0,583.93,139599.66
2019-03-15,2019-03-15,"Service payment - Fuentes, Stephens and Lee",REF36783398,0.0,503.7,140103.36
2019-03-15,2019-03-15,Invoice payment - Rhodes-Jefferson,REF95361374,0.0,649.59,140752.95
2019-03-17,2019-03-17,Business travel,REF61932243,486.05,0.0,140266.9
2019-03-21,2019-03-21,Professional software license,REF28048526,218.3,0.0,140048.6
2019-03-27,2019-03-27,Coworking space rental,REF62472967,400.69,0.0,139647.91
2019-03-29,2019-03-29,Accounting expense,REF33459680,123.27,0.0,139524.64
2019-03-31,2019-03-31,Marketing expenses,REF61737538,504.06,0.0,139020.58
2019-04-02,2019-04-02,Training/conference,REF29569042,149.0,0.0,138871.58
2019-04-08,2019-04-08,Business meal,REF27156260,152.66,0.0,138718.92
2019-04-15,2019-04-15,Business insurance premium,REF71057091,132.19,0.0,138586.73
2019-04-15,2019-04-15,Payment from Thomas-Smith,REF49251269,0.0,416.54,139003.27
2019-04-15,2019-04-15,Service payment - Schmidt-Moran,REF75102556,0.0,512.31,139515.58
2019-04-15,2019-04-15,"Service payment - Fuentes, Stephens and Lee",REF86738637,0.0,580.84,140096.42
2019-04-15,2019-04-15,Service payment - Rhodes-Jefferson,REF36450760,0.0,510.42,140606.84
2019-04-15,2019-04-15,Invoice payment - Ayala-French,REF89624521,0.0,198.23,140805.07
2019-04-15,2019-04-15,"Payment from Rhodes, Schmidt and Benitez",REF83186127,0.0,784.7,141589.77
2019-04-15,2019-04-15,"Invoice payment - Nguyen, Palmer and Gonzalez",REF41236865,0.0,709.55,142299.32
2019-04-21,2019-04-21,Professional software license,REF54074820,186.35,0.0,142112.97
2019-04-23,2019-04-23,Business travel,REF17726249,430.12,0.0,141682.85
2019-04-24,2019-04-24,Coworking space rental,REF23887823,386.86,0.0,141295.99
2019-05-04,2019-05-04,Business travel,REF92257245,343.13,0.0,140952.86
2019-05-11,2019-05-11,Business meal,REF15539523,288.26,0.0,140664.6
2019-05-12,2019-05-12,Equipment purchase,REF28802873,67.21,0.0,140597.39
2019-05-13,2019-05-13,Business meal,REF73901951,232.68,0.0,140364.71
2019-05-13,2019-05-13,Coworking space rental,REF69373799,142.07,0.0,140222.64
2019-05-15,2019-05-15,Business insurance premium,REF74363777,126.24,0.0,140096.4
2019-05-15,2019-05-15,Project payment - Ayala-French,REF25697475,0.0,264.01,140360.41
2019-05-15,2019-05-15,"Payment from Nguyen, Palmer and Gonzalez",REF85315295,0.0,448.63,140809.04
2019-05-15,2019-05-15,Payment from Schmidt-Moran,REF99587933,0.0,494.53,141303.57
2019-05-15,2019-05-15,Payment from Thomas-Smith,REF10929397,0.0,360.14,141663.71
2019-05-15,2019-05-15,"Project payment - Fuentes, Stephens and Lee",REF25829390,0.0,382.73,142046.44
2019-05-15,2019-05-15,Business travel,REF18616076,203.36,0.0,141843.08
2019-05-15,2019-05-15,Project payment - Neal-Lopez,REF20133125,0.0,499.63,142342.71
2019-05-15,2019-05-15,Invoice payment - Rhodes-Jefferson,REF27791813,0.0,513.84,142856.55
2019-05-19,2019-05-19,Business meal,REF58386749,229.5,0.0,142627.05
2019-05-19,2019-05-19,Training/conference,REF29282666,150.63,0.0,142476.42
2019-05-21,2019-05-21,Professional software license,REF24859894,190.3,0.0,142286.12
2019-05-21,2019-05-21,Business travel,REF14670691,340.63,0.0,141945.49
2019-05-22,2019-05-22,Accounting expense,REF54172586,152.72,0.0,141792.77
2019-05-27,2019-05-27,Accounting expense,REF26691377,204.61,0.0,141588.16
2019-05-29,2019-05-29,Marketing expenses,REF92571783,125.17,0.0,141462.99
2019-05-31,2019-05-31,Business travel,REF53875881,350.32,0.0,141112.67
2019-06-04,2019-06-04,Business meal,REF26707119,269.3,0.0,140843.37
2019-06-04,2019-06-04,Marketing expenses,REF56820108,221.68,0.0,140621.69
2019-06-09,2019-06-09,Training/conference,REF68423517,121.32,0.0,140500.37
2019-06-11,2019-06-11,Coworking space rental,REF39091366,102.84,0.0,140397.53
2019-06-13,2019-06-13,Training/conference,REF47324586,151.19,0.0,140246.34
2019-06-15,2019-06-15,Service payment - Rhodes-Jefferson,REF88231704,0.0,397.99,140644.33
2019-06-15,2019-06-15,"Project payment - Nguyen, Palmer and Gonzalez",REF19822384,0.0,472.36,141116.69
2019-06-15,2019-06-15,Business insurance premium,REF35528062,105.52,0.0,141011.17
2019-06-15,2019-06-15,Invoice payment - Neal-Lopez,REF78246239,0.0,405.35,141416.52
2019-06-15,2019-06-15,"Invoice payment - Fuentes, Stephens and Lee",REF79990355,0.0,438.11,141854.63
2019-06-15,2019-06-15,Service payment - Schmidt-Moran,REF45214179,0.0,531.15,142385.78
2019-06-15,2019-06-15,Project payment - Thomas-Smith,REF30482919,0.0,377.2,142762.98
2019-06-18,2019-06-18,Business meal,REF28806784,242.57,0.0,142520.41
2019-06-19,2019-06-19,Coworking space rental,REF23482406,163.18,0.0,142357.23
2019-06-21,2019-06-21,Professional software license,REF31173538,165.71,0.0,142191.52
2019-06-26,2019-06-26,Coworking space rental,REF40477626,177.17,0.0,142014.35
2019-06-29,2019-06-29,Business meal,REF75697690,244.33,0.0,141770.02
2019-07-01,2019-07-01,Business meal,REF43700885,197.16,0.0,141572.86
2019-07-09,2019-07-09,Equipment purchase,REF71390358,113.61,0.0,141459.25
2019-07-10,2019-07-10,Accounting expense,REF89816072,141.76,0.0,141317.49
2019-07-14,2019-07-14,Business meal,REF83858769,200.15,0.0,141117.34
2019-07-15,2019-07-15,Service payment - Ayala-French,REF23478361,0.0,219.85,141337.19
2019-07-15,2019-07-15,"Payment from Nguyen, Palmer and Gonzalez",REF44843851,0.0,465.63,141802.82
2019-07-15,2019-07-15,Payment from Neal-Lopez,REF36218857,0.0,367.1,142169.92
2019-07-15,2019-07-15,Service payment - Thomas-Smith,REF26140579,0.0,439.2,142609.12
2019-07-15,2019-07-15,Business insurance premium,REF40334143,108.01,0.0,142501.11
2019-07-15,2019-07-15,Project payment - Rhodes-Jefferson,REF24858222,0.0,398.98,142900.09
2019-07-15,2019-07-15,"Project payment - Rhodes, Schmidt and Benitez",REF30473652,0.0,549.07,143449.16
2019-07-15,2019-07-15,Service payment - Schmidt-Moran,REF80654979,0.0,314.77,143763.93
2019-07-16,2019-07-16,Accounting expense,REF28679034,198.39,0.0,143565.54
2019-07-19,2019-07-19,Business travel,REF62402962,260.01,0.0,143305.53
2019-07-21,2019-07-21,Professional software license,REF91029819,142.58,0.0,143162.95
2019-07-24,2019-07-24,Training/conference,REF39193118,125.74,0.0,143037.21
2019-07-25,2019-07-25,Business travel,REF44366176,320.32,0.0,142716.89
2019-07-28,2019-07-28,Training/conference,REF90498003,113.68,0.0,142603.21
2019-07-30,2019-07-30,Business travel,REF65211517,339.97,0.0,142263.24
2019-07-30,2019-07-30,Equipment purchase,REF18118605,99.05,0.0,142164.19
2019-08-04,2019-08-04,Accounting expense,REF20100685,246.84,0.0,141917.35
2019-08-11,2019-08-11,Coworking space rental,REF36798695,237.2,0.0,141680.15
2019-08-15,2019-08-15,Service payment - Ayala-French,REF14371745,0.0,253.67,141933.82
2019-08-15,2019-08-15,"Service payment - Fuentes, Stephens and Lee",REF82216772,0.0,314.0,142247.82
2019-08-15,2019-08-15,Payment from Thomas-Smith,REF23480258,0.0,350.87,142598.69
2019-08-15,2019-08-15,"Payment from Nguyen, Palmer and Gonzalez",REF69833585,0.0,406.38,143005.07
2019-08-15,2019-08-15,Invoice payment - Rhodes-Jefferson,REF94082696,0.0,493.56,143498.63
2019-08-15,2019-08-15,Business insurance premium,REF23366504,119.64,0.0,143378.99
2019-08-15,2019-08-15,Invoice payment - Schmidt-Moran,REF69193163,0.0,589.95,143968.94
2019-08-15,2019-08-15,"Invoice payment - Rhodes, Schmidt and Benitez",REF56033502,0.0,976.39,144945.33
2019-08-18,2019-08-18,Business travel,REF15915226,221.78,0.0,144723.55
2019-08-19,2019-08-19,Marketing expenses,REF80793666,300.33,0.0,144423.22
2019-08-21,2019-08-21,Accounting expense,REF40108397,242.08,0.0,144181.14
2019-08-21,2019-08-21,Marketing expenses,REF79253284,203.54,0.0,143977.6
2019-08-21,2019-08-21,Professional software license,REF70513136,127.34,0.0,143850.26
2019-08-26,2019-08-26,Equipment purchase,REF72771496,82.29,0.0,143767.97
2019-09-02,2019-09-02,Accounting expense,REF81739121,135.26,0.0,143632.71
2019-09-04,2019-09-04,Equipment purchase,REF83897580,208.82,0.0,143423.89
2019-09-10,2019-09-10,Business travel,REF83766318,552.74,0.0,142871.15
2019-09-11,2019-09-11,Equipment purchase,REF66363484,186.85,0.0,142684.3
2019-09-15,2019-09-15,"Project payment - Nguyen, Palmer and Gonzalez",REF48729272,0.0,699.38,143383.68
2019-09-15,2019-09-15,Invoice payment - Ayala-French,REF18759451,0.0,350.11,143733.79
2019-09-15,2019-09-15,Payment from Schmidt-Moran,REF90283978,0.0,689.35,144423.14
2019-09-15,2019-09-15,Project payment - Thomas-Smith,REF17283700,0.0,569.58,144992.72
2019-09-15,2019-09-15,Business insurance premium,REF77628144,141.2,0.0,144851.52
2019-09-15,2019-09-15,Project payment - Neal-Lopez,REF73178558,0.0,739.25,145590.77
2019-09-15,2019-09-15,Invoice payment - Rhodes-Jefferson,REF80513242,0.0,578.81,146169.58
2019-09-15,2019-09-15,"Payment from Fuentes, Stephens and Lee",REF33463074,0.0,344.77,146514.35
2019-09-21,2019-09-21,Professional software license,REF11425518,224.34,0.0,146290.01
2019-09-21,2019-09-21,Business meal,REF83341131,308.86,0.0,145981.15
2019-09-25,2019-09-25,Business travel,REF59907802,373.51,0.0,145607.64
2019-09-27,2019-09-27,Business meal,REF97210809,266.4,0.0,145341.24
2019-10-03,2019-10-03,Accounting expense,REF28781858,252.64,0.0,145088.6
2019-10-03,2019-10-03,Training/conference,REF70708148,246.41,0.0,144842.19
2019-10-09,2019-10-09,Marketing expenses,REF95615361,322.35,0.0,144519.84
2019-10-15,2019-10-15,Project payment - Neal-Lopez,REF37758941,0.0,500.77,145020.61
2019-10-15,2019-10-15,"Payment from Nguyen, Palmer and Gonzalez",REF25372489,0.0,883.53,145904.14
2019-10-15,2019-10-15,"Service payment - Rhodes, Schmidt and Benitez",REF56807723,0.0,936.15,146840.29
2019-10-15,2019-10-15,Business insurance premium,REF56405312,161.12,0.0,146679.17
2019-10-15,2019-10-15,"Payment from Fuentes, Stephens and Lee",REF67602952,0.0,549.17,147228.34
2019-10-15,2019-10-15,Payment from Thomas-Smith,REF62864478,0.0,539.46,147767.8
2019-10-15,2019-10-15,Project payment - Rhodes-Jefferson,REF38691068,0.0,636.54,148404.34
2019-10-20,2019-10-20,Accounting expense,REF80614711,275.64,0.0,148128.7
2019-10-21,2019-10-21,Professional software license,REF78787571,266.09,0.0,147862.61
2019-10-25,2019-10-25,Coworking space rental,REF94426647,696.59,0.0,147166.02
2019-11-04,2019-11-04,Business meal,REF34255992,320.74,0.0,146845.28
2019-11-05,2019-11-05,Business meal,REF70174151,304.51,0.0,146540.77
2019-11-10,2019-11-10,Coworking space rental,REF28301706,311.39,0.0,146229.38
2019-11-15,2019-11-15,Project payment - Neal-Lopez,REF33196170,0.0,521.1,146750.48
2019-11-15,2019-11-15,Service payment - Schmidt-Moran,REF66103003,0.0,619.95,147370.43
2019-11-15,2019-11-15,"Invoice payment - Fuentes, Stephens and Lee",REF94277866,0.0,453.5,147823.93
2019-11-15,2019-11-15,Service payment - Thomas-Smith,REF75398244,0.0,418.4,148242.33
2019-11-15,2019-11-15,Business insurance premium,REF16395680,170.66,0.0,148071.67
2019-11-15,2019-11-15,Project payment - Ayala-French,REF87152653,0.0,442.24,148513.91
2019-11-15,2019-11-15,"Payment from Nguyen, Palmer and Gonzalez",REF78851682,0.0,485.47,148999.38
2019-11-15,2019-11-15,Payment from Rhodes-Jefferson,REF25952804,0.0,525.68,149525.06
2019-11-15,2019-11-15,"Project payment - Rhodes, Schmidt and Benitez",REF20143423,0.0,793.8,150318.86
2019-11-21,2019-11-21,Professional software license,REF95009909,244.2,0.0,150074.66
2019-11-23,2019-11-23,Business travel,REF29843492,615.51,0.0,149459.15
2019-11-25,2019-11-25,Business meal,REF67171178,277.75,0.0,149181.4
2019-11-26,2019-11-26,Accounting expense,REF71618851,250.66,0.0,148930.74
2019-12-01,2019-12-01,Business meal,REF29713948,81.04,0.0,148849.7
2019-12-03,2019-12-03,Equipment purchase,REF19531619,139.93,0.0,148709.77
2019-12-04,2019-12-04,Coworking space rental,REF17891143,177.56,0.0,148532.21
2019-12-06,2019-12-06,Business meal,REF60592346,156.77,0.0,148375.44
2019-12-08,2019-12-08,Coworking space rental,REF19461148,236.39,0.0,148139.05
2019-12-08,2019-12-08,Equipment purchase,REF73581311,120.22,0.0,148018.83
2019-12-08,2019-12-08,Marketing expenses,REF20055352,277.8,0.0,147741.03
2019-12-11,2019-12-11,Business travel,REF40873759,298.7,0.0,147442.33
2019-12-13,2019-12-13,Business travel,REF46322493,348.34,0.0,147093.99
2019-12-15,2019-12-15,Project payment - Ayala-French,REF98817996,0.0,271.38,147365.37
2019-12-15,2019-12-15,Business insurance premium,REF18982876,128.2,0.0,147237.17
2019-12-15,2019-12-15,"Project payment - Fuentes, Stephens and Lee",REF14112911,0.0,509.16,147746.33
2019-12-15,2019-12-15,Payment from Rhodes-Jefferson,REF20728313,0.0,464.19,148210.52
2019-12-15,2019-12-15,"Project payment - Nguyen, Palmer and Gonzalez",REF90748435,0.0,574.5,148785.02
2019-12-15,2019-12-15,"Service payment - Rhodes, Schmidt and Benitez",REF52821736,0.0,820.69,149605.71
2019-12-15,2019-12-15,Service payment - Neal-Lopez,REF39887846,0.0,472.95,150078.66
2019-12-15,2019-12-15,Payment from Thomas-Smith,REF16106674,0.0,380.11,150458.77
2019-12-15,2019-12-15,Payment from Schmidt-Moran,REF70176260,0.0,452.3,150911.07
2019-12-15,2019-12-15,Equipment purchase,REF94377134,149.76,0.0,150761.31
2019-12-21,2019-12-21,Professional software license,REF72505562,148.82,0.0,150612.49
2019-12-22,2019-12-22,Coworking space rental,REF53655794,260.03,0.0,150352.46
2019-12-22,2019-12-22,Business meal,REF34523972,227.57,0.0,150124.89
2019-12-25,2019-12-25,Marketing expenses,REF18563042,212.97,0.0,149911.92
2020-01-03,2020-01-03,Accounting expense,REF58330158,331.56,0.0,149580.36
2020-01-05,2020-01-05,Business travel,REF49160756,608.32,0.0,148972.04
2020-01-07,2020-01-07,Coworking space rental,REF30394010,410.02,0.0,148562.02
2020-01-08,2020-01-08,Business travel,REF96246507,592.0,0.0,147970.02
2020-01-11,2020-01-11,Business meal,REF24138616,360.01,0.0,147610.01
2020-01-13,2020-01-13,Marketing expenses,REF49823119,519.83,0.0,147090.18
2020-01-14,2020-01-14,Accounting expense,REF79690938,222.06,0.0,146868.12
2020-01-15,2020-01-15,Business insurance premium,REF92290276,168.01,0.0,146700.11
2020-01-15,2020-01-15,Service payment - Thomas-Smith,REF55328632,0.0,608.7,147308.81
2020-01-15,2020-01-15,"Service payment - Nguyen, Palmer and Gonzalez",REF65791561,0.0,798.32,148107.13
2020-01-15,2020-01-15,Project payment - Ayala-French,REF43667135,0.0,351.21,148458.34
2020-01-15,2020-01-15,Service payment - Schmidt-Moran,REF80583078,0.0,638.83,149097.17
2020-01-15,2020-01-15,"Payment from Fuentes, Stephens and Lee",REF25526345,0.0,706.54,149803.71
2020-01-15,2020-01-15,Project payment - Neal-Lopez,REF83130911,0.0,706.34,150510.05
2020-01-15,2020-01-15,"Payment from Rhodes, Schmidt and Benitez",REF62202681,0.0,1183.53,151693.58
2020-01-17,2020-01-17,Marketing expenses,REF22930026,342.15,0.0,151351.43
2020-01-20,2020-01-20,Business meal,REF37149649,258.63,0.0,151092.8
2020-01-21,2020-01-21,Professional software license,REF71908299,227.65,0.0,150865.15
2020-01-23,2020-01-23,Accounting expense,REF12303548,248.69,0.0,150616.46
2020-01-30,2020-01-30,Business travel,REF88078389,494.82,0.0,150121.64
2020-02-01,2020-02-01,Accounting expense,REF87041463,246.64,0.0,149875.0
2020-02-01,2020-02-01,Marketing expenses,REF61731204,477.69,0.0,149397.31
2020-02-03,2020-02-03,Business meal,REF34588118,93.08,0.0,149304.23
2020-02-09,2020-02-09,Equipment purchase,REF80633288,244.59,0.0,149059.64
2020-02-15,2020-02-15,Business insurance premium,REF49896364,151.65,0.0,148907.99
2020-02-15,2020-02-15,Payment from Schmidt-Moran,REF23624507,0.0,863.02,149771.01
2020-02-15,2020-02-15,Invoice payment - Rhodes-Jefferson,REF80629255,0.0,552.19,150323.2
2020-02-15,2020-02-15,Project payment - Thomas-Smith,REF54362847,0.0,393.42,150716.62
2020-02-15,2020-02-15,Payment from Ayala-French,REF71494707,0.0,242.71,150959.33
2020-02-15,2020-02-15,"Invoice payment - Nguyen, Palmer and Gonzalez",REF65069634,0.0,768.68,151728.01
2020-02-15,2020-02-15,"Service payment - Rhodes, Schmidt and Benitez",REF52156331,0.0,1051.92,152779.93
2020-02-15,2020-02-15,"Invoice payment - Fuentes, Stephens and Lee",REF56840848,0.0,572.3,153352.23
2020-02-15,2020-02-15,Project payment - Neal-Lopez,REF64327468,0.0,428.81,153781.04
2020-02-20,2020-02-20,Marketing expenses,REF76836842,347.73,0.0,153433.31
2020-02-21,2020-02-21,Professional software license,REF81223466,205.01,0.0,153228.3
2020-02-22,2020-02-22,Training/conference,REF38816799,188.74,0.0,153039.56
2020-02-26,2020-02-26,Marketing expenses,REF46940675,294.18,0.0,152745.38
2020-02-26,2020-02-26,Business meal,REF48825094,426.21,0.0,152319.17
2020-02-28,2020-02-28,Business travel,REF93887496,446.05,0.0,151873.12
2020-03-09,2020-03-09,Marketing expenses,REF50173519,323.5,0.0,151549.62
2020-03-12,2020-03-12,Accounting expense,REF98868072,209.53,0.0,151340.09
2020-03-15,2020-03-15,Business insurance premium,REF64338499,146.68,0.0,151193.41
2020-03-15,2020-03-15,Service payment - Ayala-French,REF22504533,0.0,308.29,151501.7
2020-03-15,2020-03-15,Invoice payment - Neal-Lopez,REF40584236,0.0,543.69,152045.39
2020-03-15,2020-03-15,"Invoice payment - Rhodes, Schmidt and Benitez",REF89333439,0.0,646.48,152691.87
2020-03-15,2020-03-15,"Project payment - Nguyen, Palmer and Gonzalez",REF83322555,0.0,623.84,153315.71
2020-03-15,2020-03-15,"Payment from Fuentes, Stephens and Lee",REF15441967,0.0,512.69,153828.4
2020-03-15,2020-03-15,Payment from Schmidt-Moran,REF39004322,0.0,658.04,154486.44
2020-03-15,2020-03-15,Payment from Rhodes-Jefferson,REF28641815,0.0,712.89,155199.33
2020-03-16,2020-03-16,Accounting expense,REF83109809,192.62,0.0,155006.71
2020-03-21,2020-03-21,Professional software license,REF35856880,232.25,0.0,154774.46
2020-03-27,2020-03-27,Marketing expenses,REF18986817,312.78,0.0,154461.68
2020-03-29,2020-03-29,Business travel,REF83167459,179.11,0.0,154282.57
2020-03-31,2020-03-31,Marketing expenses,REF11719102,373.14,0.0,153909.43
2020-04-05,2020-04-05,Business meal,REF78793643,210.78,0.0,153698.65
2020-04-06,2020-04-06,Accounting expense,REF13462182,97.67,0.0,153600.98
2020-04-07,2020-04-07,Marketing expenses,REF64452097,308.98,0.0,153292.0
2020-04-13,2020-04-13,Business meal,REF96266366,177.76,0.0,153114.24
2020-04-15,2020-04-15,"Service payment - Nguyen, Palmer and Gonzalez",REF83295822,0.0,576.77,153691.01
2020-04-15,2020-04-15,Service payment - Thomas-Smith,REF45410902,0.0,568.93,154259.94
2020-04-15,2020-04-15,Marketing expenses,REF79341738,362.21,0.0,153897.73
2020-04-15,2020-04-15,Service payment - Ayala-French,REF62146939,0.0,309.46,154207.19
2020-04-15,2020-04-15,Payment from Neal-Lopez,REF88933256,0.0,640.74,154847.93
2020-04-15,2020-04-15,Payment from Rhodes-Jefferson,REF87060788,0.0,522.39,155370.32
2020-04-15,2020-04-15,"Project payment - Rhodes, Schmidt and Benitez",REF90462022,0.0,908.82,156279.14
2020-04-15,2020-04-15,Business insurance premium,REF11001813,134.62,0.0,156144.52
2020-04-16,2020-04-16,Business meal,REF49572908,244.74,0.0,155899.78
2020-04-17,2020-04-17,Equipment purchase,REF33756794,149.48,0.0,155750.3
2020-04-18,2020-04-18,Marketing expenses,REF98517141,244.64,0.0,155505.66
2020-04-21,2020-04-21,Professional software license,REF64784729,202.61,0.0,155303.05
2020-04-22,2020-04-22,Equipment purchase,REF16836497,86.46,0.0,155216.59
2020-04-23,2020-04-23,Business travel,REF74221897,96.72,0.0,155119.87
2020-04-25,2020-04-25,Business travel,REF14375753,400.36,0.0,154719.51
2020-04-26,2020-04-26,Accounting expense,REF47765796,153.14,0.0,154566.37
2020-05-01,2020-05-01,Business travel,REF87453445,222.33,0.0,154344.04
2020-05-06,2020-05-06,Marketing expenses,REF37959062,128.68,0.0,154215.36
2020-05-07,2020-05-07,Training/conference,REF36252236,145.01,0.0,154070.35
2020-05-15,2020-05-15,Service payment - Rhodes-Jefferson,REF18278992,0.0,596.99,154667.34
2020-05-15,2020-05-15,Service payment - Schmidt-Moran,REF63133778,0.0,593.81,155261.15
2020-05-15,2020-05-15,Project payment - Neal-Lopez,REF58290967,0.0,486.61,155747.76
2020-05-15,2020-05-15,"Service payment - Nguyen, Palmer and Gonzalez",REF20665592,0.0,491.42,156239.18
2020-05-15,2020-05-15,Business insurance premium,REF59608743,136.45,0.0,156102.73
2020-05-15,2020-05-15,Project payment - Ayala-French,REF38175858,0.0,262.99,156365.72
2020-05-21,2020-05-21,Coworking space rental,REF59358401,194.35,0.0,156171.37
2020-05-21,2020-05-21,Professional software license,REF69861224,187.6,0.0,155983.77
2020-05-22,2020-05-22,Equipment purchase,REF83622873,159.35,0.0,155824.42
2020-05-24,2020-05-24,Marketing expenses,REF97960089,174.6,0.0,155649.82
2020-06-01,2020-06-01,Business travel,REF73722348,385.81,0.0,155264.01
2020-06-05,2020-06-05,Business meal,REF42885934,189.52,0.0,155074.49
2020-06-07,2020-06-07,Business meal,REF72350611,281.69,0.0,154792.8
2020-06-08,2020-06-08,Business travel,REF45744590,333.9,0.0,154458.9
2020-06-10,2020-06-10,Accounting expense,REF57113535,8.86,0.0,154450.04
2020-06-15,2020-06-15,Business insurance premium,REF91388682,102.91,0.0,154347.13
2020-06-15,2020-06-15,"Service payment - Fuentes, Stephens and Lee",REF31404325,0.0,527.73,154874.86
2020-06-15,2020-06-15,Service payment - Rhodes-Jefferson,REF60610019,0.0,490.52,155365.38
2020-06-15,2020-06-15,Project payment - Ayala-French,REF47002636,0.0,210.58,155575.96
2020-06-15,2020-06-15,Payment from Schmidt-Moran,REF79588347,0.0,425.75,156001.71
2020-06-15,2020-06-15,"Invoice payment - Rhodes, Schmidt and Benitez",REF75872038,0.0,644.9,156646.61
2020-06-15,2020-06-15,"Project payment - Nguyen, Palmer and Gonzalez",REF12026325,0.0,465.05,157111.66
2020-06-15,2020-06-15,Invoice payment - Thomas-Smith,REF74603214,0.0,441.53,157553.19
2020-06-15,2020-06-15,Payment from Neal-Lopez,REF18951819,0.0,476.7,158029.89
2020-06-16,2020-06-16,Business meal,REF52487945,150.67,0.0,157879.22
2020-06-20,2020-06-20,Business travel,REF10761103,347.46,0.0,157531.76
2020-06-21,2020-06-21,Professional software license,REF96048839,132.82,0.0,157398.94
2020-06-24,2020-06-24,Marketing expenses,REF87454455,184.23,0.0,157214.71
2020-06-26,2020-06-26,Equipment purchase,REF47562070,171.36,0.0,157043.35
2020-06-30,2020-06-30,Equipment purchase,REF38836546,108.56,0.0,156934.79
2020-07-09,2020-07-09,Training/conference,REF30868167,229.02,0.0,156705.77
2020-07-13,2020-07-13,Accounting expense,REF95522739,194.13,0.0,156511.64
2020-07-15,2020-07-15,Business insurance premium,REF24543678,94.22,0.0,156417.42
2020-07-15,2020-07-15,Service payment - Rhodes-Jefferson,REF78084400,0.0,366.72,156784.14
2020-07-15,2020-07-15,Service payment - Ayala-French,REF31443816,0.0,229.06,157013.2
2020-07-15,2020-07-15,"Payment from Rhodes, Schmidt and Benitez",REF42040355,0.0,423.58,157436.78
2020-07-15,2020-07-15,"Service payment - Fuentes, Stephens and Lee",REF42969926,0.0,352.55,157789.33
2020-07-15,2020-07-15,"Service payment - Nguyen, Palmer and Gonzalez",REF94308637,0.0,394.02,158183.35
2020-07-15,2020-07-15,Service payment - Neal-Lopez,REF70165346,0.0,342.81,158526.16
2020-07-15,2020-07-15,Invoice payment - Thomas-Smith,REF19344460,0.0,399.54,158925.7
2020-07-17,2020-07-17,Coworking space rental,REF34071196,179.16,0.0,158746.54
2020-07-21,2020-07-21,Professional software license,REF49990981,156.58,0.0,158589.96
2020-07-26,2020-07-26,Training/conference,REF40506715,22.75,0.0,158567.21
2020-07-27,2020-07-27,Accounting expense,REF37487141,113.55,0.0,158453.66
2020-07-28,2020-07-28,Equipment purchase,REF44720562,83.94,0.0,158369.72
2020-07-31,2020-07-31,Business travel,REF64402340,196.07,0.0,158173.65
2020-08-01,2020-08-01,Training/conference,REF34269006,256.97,0.0,157916.68
2020-08-03,2020-08-03,Business travel,REF52009453,274.36,0.0,157642.32
2020-08-04,2020-08-04,Training/conference,REF94203603,50.32,0.0,157592.0
2020-08-06,2020-08-06,Training/conference,REF85452351,162.39,0.0,157429.61
2020-08-06,2020-08-06,Accounting expense,REF21824442,147.2,0.0,157282.41
2020-08-06,2020-08-06,Equipment purchase,REF90741144,113.06,0.0,157169.35
2020-08-07,2020-08-07,Accounting expense,REF42276487,191.74,0.0,156977.61
2020-08-15,2020-08-15,"Service payment - Rhodes, Schmidt and Benitez",REF28767970,0.0,860.47,157838.08
2020-08-15,2020-08-15,Invoice payment - Schmidt-Moran,REF55400530,0.0,517.21,158355.29
2020-08-15,2020-08-15,Service payment - Neal-Lopez,REF45696466,0.0,377.01,158732.3
2020-08-15,2020-08-15,Project payment - Rhodes-Jefferson,REF13176221,0.0,457.63,159189.93
2020-08-15,2020-08-15,Service payment - Ayala-French,REF72637927,0.0,210.11,159400.04
2020-08-15,2020-08-15,"Payment from Fuentes, Stephens and Lee",REF30297799,0.0,405.27,159805.31
2020-08-15,2020-08-15,Business insurance premium,REF39891237,113.63,0.0,159691.68
2020-08-17,2020-08-17,Business meal,REF20356009,217.75,0.0,159473.93
2020-08-21,2020-08-21,Professional software license,REF56016102,165.48,0.0,159308.45
2020-08-24,2020-08-24,Training/conference,REF13482520,251.54,0.0,159056.91
2020-08-24,2020-08-24,Marketing expenses,REF16105842,277.67,0.0,158779.24
2020-08-28,2020-08-28,Business travel,REF87942331,273.4,0.0,158505.84
2020-08-31,2020-08-31,Marketing expenses,REF33680109,93.66,0.0,158412.18
2020-09-01,2020-09-01,Marketing expenses,REF12679106,249.47,0.0,158162.71
2020-09-06,2020-09-06,Coworking space rental,REF81039643,234.55,0.0,157928.16
2020-09-07,2020-09-07,Business meal,REF79311925,226.33,0.0,157701.83
2020-09-08,2020-09-08,Business travel,REF32852018,427.19,0.0,157274.64
2020-09-14,2020-09-14,Accounting expense,REF78861123,218.3,0.0,157056.34
2020-09-15,2020-09-15,Business insurance premium,REF80439869,151.2,0.0,156905.14
2020-09-15,2020-09-15,"Invoice payment - Rhodes, Schmidt and Benitez",REF31060361,0.0,803.8,157708.94
2020-09-15,2020-09-15,Project payment - Ayala-French,REF28797506,0.0,319.03,158027.97
2020-09-15,2020-09-15,Payment from Thomas-Smith,REF82070328,0.0,615.96,158643.93
2020-09-15,2020-09-15,"Project payment - Nguyen, Palmer and Gonzalez",REF54976336,0.0,682.65,159326.58
2020-09-15,2020-09-15,"Payment from Fuentes, Stephens and Lee",REF39311093,0.0,497.82,159824.4
2020-09-15,2020-09-15,Payment from Schmidt-Moran,REF66743733,0.0,718.58,160542.98
2020-09-15,2020-09-15,Invoice payment - Neal-Lopez,REF80333058,0.0,662.19,161205.17
2020-09-16,2020-09-16,Marketing expenses,REF75299490,315.31,0.0,160889.86
2020-09-20,2020-09-20,Business meal,REF71690888,386.27,0.0,160503.59
2020-09-21,2020-09-21,Professional software license,REF17000985,244.9,0.0,160258.69
2020-09-25,2020-09-25,Coworking space rental,REF19146919,304.23,0.0,159954.46
2020-09-27,2020-09-27,Business travel,REF36055063,466.17,0.0,159488.29
2020-10-03,2020-10-03,Training/conference,REF82034966,198.53,0.0,159289.76
2020-10-05,2020-10-05,Training/conference,REF60722648,305.47,0.0,158984.29
2020-10-07,2020-10-07,Business meal,REF58155502,206.82,0.0,158777.47
2020-10-09,2020-10-09,Training/conference,REF75220299,320.62,0.0,158456.85
2020-10-11,2020-10-11,Business meal,REF80865058,326.41,0.0,158130.44
2020-10-15,2020-10-15,Business insurance premium,REF16648425,173.34,0.0,157957.1
2020-10-15,2020-10-15,Project payment - Schmidt-Moran,REF97074341,0.0,694.96,158652.06
2020-10-15,2020-10-15,Payment from Neal-Lopez,REF55786899,0.0,685.45,159337.51
2020-10-15,2020-10-15,Invoice payment - Thomas-Smith,REF48318598,0.0,606.23,159943.74
2020-10-15,2020-10-15,"Service payment - Fuentes, Stephens and Lee",REF58890859,0.0,715.38,160659.12
2020-10-15,2020-10-15,"Service payment - Nguyen, Palmer and Gonzalez",REF67502671,0.0,628.03,161287.15
2020-10-15,2020-10-15,"Project payment - Rhodes, Schmidt and Benitez",REF68148095,0.0,1131.54,162418.69
2020-10-15,2020-10-15,Invoice payment - Ayala-French,REF48494089,0.0,421.7,162840.39
2020-10-18,2020-10-18,Business meal,REF47843735,73.88,0.0,162766.51
2020-10-20,2020-10-20,Equipment purchase,REF78489037,120.23,0.0,162646.28
2020-10-21,2020-10-21,Professional software license,REF92707812,267.73,0.0,162378.55
2020-10-27,2020-10-27,Training/conference,REF66195075,240.06,0.0,162138.49
2020-11-07,2020-11-07,Business travel,REF49251906,440.93,0.0,161697.56
2020-11-10,2020-11-10,Accounting expense,REF37343286,151.87,0.0,161545.69
2020-11-12,2020-11-12,Training/conference,REF70296791,179.44,0.0,161366.25
2020-11-12,2020-11-12,Business travel,REF15164846,485.32,0.0,160880.93
2020-11-15,2020-11-15,"Invoice payment - Rhodes, Schmidt and Benitez",REF10699619,0.0,909.92,161790.85
2020-11-15,2020-11-15,Invoice payment - Schmidt-Moran,REF20053536,0.0,510.25,162301.1
2020-11-15,2020-11-15,Payment from Neal-Lopez,REF33952327,0.0,616.31,162917.41
2020-11-15,2020-11-15,Business insurance premium,REF23429916,146.23,0.0,162771.18
2020-11-15,2020-11-15,Payment from Thomas-Smith,REF71328790,0.0,607.3,163378.48
2020-11-15,2020-11-15,Payment from Ayala-French,REF99310820,0.0,331.21,163709.69
2020-11-15,2020-11-15,"Payment from Fuentes, Stephens and Lee",REF37237685,0.0,589.97,164299.66
2020-11-15,2020-11-15,Project payment - Rhodes-Jefferson,REF42457134,0.0,422.29,164721.95
2020-11-15,2020-11-15,"Service payment - Nguyen, Palmer and Gonzalez",REF25106066,0.0,750.2,165472.15
2020-11-16,2020-11-16,Accounting expense,REF73988639,123.79,0.0,165348.36
2020-11-19,2020-11-19,Business meal,REF98737845,225.88,0.0,165122.48
2020-11-21,2020-11-21,Professional software license,REF14611010,200.26,0.0,164922.22
2020-11-22,2020-11-22,Accounting expense,REF54518385,240.24,0.0,164681.98
2020-11-30,2020-11-30,Training/conference,REF85080756,249.56,0.0,164432.42
2020-12-04,2020-12-04,Equipment purchase,REF53635999,116.97,0.0,164315.45
2020-12-05,2020-12-05,Business meal,REF59140057,316.64,0.0,163998.81
2020-12-06,2020-12-06,Equipment purchase,REF38860538,107.4,0.0,163891.41
2020-12-06,2020-12-06,Coworking space rental,REF99584336,236.84,0.0,163654.57
2020-12-08,2020-12-08,Training/conference,REF93838841,142.0,0.0,163512.57
2020-12-13,2020-12-13,Business meal,REF25609325,266.81,0.0,163245.76
2020-12-14,2020-12-14,Business meal,REF66590486,151.79,0.0,163093.97
2020-12-15,2020-12-15,Payment from Thomas-Smith,REF81391692,0.0,331.82,163425.79
2020-12-15,2020-12-15,Payment from Schmidt-Moran,REF93604482,0.0,542.99,163968.78
2020-12-15,2020-12-15,Payment from Ayala-French,REF21584316,0.0,295.79,164264.57
2020-12-15,2020-12-15,Invoice payment - Rhodes-Jefferson,REF85602725,0.0,427.62,164692.19
2020-12-15,2020-12-15,"Payment from Fuentes, Stephens and Lee",REF84948584,0.0,480.93,165173.12
2020-12-15,2020-12-15,Project payment - Neal-Lopez,REF19872154,0.0,488.12,165661.24
2020-12-15,2020-12-15,Business insurance premium,REF56740090,114.22,0.0,165547.02
2020-12-15,2020-12-15,"Project payment - Nguyen, Palmer and Gonzalez",REF67761102,0.0,590.71,166137.73
2020-12-15,2020-12-15,"Payment from Rhodes, Schmidt and Benitez",REF21078178,0.0,755.77,166893.5
2020-12-21,2020-12-21,Accounting expense,REF85703524,199.45,0.0,166694.05
2020-12-21,2020-12-21,Professional software license,REF19937141,210.26,0.0,166483.79
2020-12-22,2020-12-22,Training/conference,REF25133110,243.6,0.0,166240.19
2021-01-03,2021-01-03,Training/conference,REF97463397,329.16,0.0,165911.03
2021-01-08,2021-01-08,Accounting expense,REF56924164,230.38,0.0,165680.65
2021-01-08,2021-01-08,Training/conference,REF69292014,250.14,0.0,165430.51
2021-01-13,2021-01-13,Accounting expense,REF40001103,193.28,0.0,165237.23
2021-01-13,2021-01-13,Business travel,REF30989524,448.77,0.0,164788.46
2021-01-15,2021-01-15,Payment from Thomas-Smith,REF89728836,0.0,566.05,165354.51
2021-01-15,2021-01-15,Business insurance premium,REF63683589,164.28,0.0,165190.23
2021-01-15,2021-01-15,"Payment from Fuentes, Stephens and Lee",REF31464081,0.0,541.47,165731.7
2021-01-15,2021-01-15,Payment from Neal-Lopez,REF51634739,0.0,723.28,166454.98
2021-01-15,2021-01-15,"Service payment - Rhodes, Schmidt and Benitez",REF73161096,0.0,990.96,167445.94
2021-01-15,2021-01-15,"Project payment - Nguyen, Palmer and Gonzalez",REF18239388,0.0,875.91,168321.85
2021-01-15,2021-01-15,Project payment - Rhodes-Jefferson,REF55056675,0.0,716.88,169038.73
2021-01-15,2021-01-15,Payment from Schmidt-Moran,REF54025064,0.0,675.9,169714.63
2021-01-15,2021-01-15,Project payment - Ayala-French,REF58330663,0.0,372.48,170087.11
2021-01-17,2021-01-17,Business travel,REF13662444,365.11,0.0,169722.0
2021-01-20,2021-01-20,Business meal,REF31526504,314.53,0.0,169407.47
2021-01-21,2021-01-21,Professional software license,REF70283946,212.89,0.0,169194.58
2021-02-09,2021-02-09,Coworking space rental,REF65257502,505.04,0.0,168689.54
2021-02-13,2021-02-13,Marketing expenses,REF51152790,350.48,0.0,168339.06
2021-02-15,2021-02-15,"Project payment - Fuentes, Stephens and Lee",REF14776726,0.0,658.27,168997.33
2021-02-15,2021-02-15,"Payment from Rhodes, Schmidt and Benitez",REF47175106,0.0,1024.09,170021.42
2021-02-15,2021-02-15,"Invoice payment - Nguyen, Palmer and Gonzalez",REF15106902,0.0,697.54,170718.96
2021-02-15,2021-02-15,Payment from Neal-Lopez,REF67333148,0.0,647.62,171366.58
2021-02-15,2021-02-15,Payment from Thomas-Smith,REF50222915,0.0,498.8,171865.38
2021-02-15,2021-02-15,Project payment - Rhodes-Jefferson,REF46936481,0.0,557.92,172423.3
2021-02-15,2021-02-15,Business insurance premium,REF31435660,165.31,0.0,172257.99
2021-02-20,2021-02-20,Business travel,REF78233112,753.38,0.0,171504.61
2021-02-20,2021-02-20,Training/conference,REF21087474,251.96,0.0,171252.65
2021-02-21,2021-02-21,Professional software license,REF19162196,240.31,0.0,171012.34
2021-02-27,2021-02-27,Training/conference,REF76233560,251.1,0.0,170761.24
2021-03-02,2021-03-02,Training/conference,REF27375670,179.1,0.0,170582.14
2021-03-05,2021-03-05,Marketing expenses,REF10771451,240.91,0.0,170341.23
2021-03-05,2021-03-05,Business meal,REF14812598,72.2,0.0,170269.03
2021-03-08,2021-03-08,Marketing expenses,REF85069595,381.33,0.0,169887.7
2021-03-10,2021-03-10,Business meal,REF75867306,214.23,0.0,169673.47
2021-03-15,2021-03-15,Project payment - Rhodes-Jefferson,REF36718594,0.0,417.86,170091.33
2021-03-15,2021-03-15,"Invoice payment - Nguyen, Palmer and Gonzalez",REF24825950,0.0,640.19,170731.52
2021-03-15,2021-03-15,Invoice payment - Neal-Lopez,REF39206681,0.0,687.42,171418.94
2021-03-15,2021-03-15,"Payment from Rhodes, Schmidt and Benitez",REF74125742,0.0,984.47,172403.41
2021-03-15,2021-03-15,Invoice payment - Ayala-French,REF43264731,0.0,326.64,172730.05
2021-03-15,2021-03-15,Project payment - Thomas-Smith,REF70327470,0.0,479.71,173209.76
2021-03-15,2021-03-15,Invoice payment - Schmidt-Moran,REF85974836,0.0,597.13,173806.89
2021-03-15,2021-03-15,Business insurance premium,REF37779115,153.67,0.0,173653.22
2021-03-21,2021-03-21,Professional software license,REF33692563,221.8,0.0,173431.42
2021-03-26,2021-03-26,Accounting expense,REF24975255,205.74,0.0,173225.68
2021-03-31,2021-03-31,Coworking space rental,REF23926382,370.37,0.0,172855.31
2021-04-03,2021-04-03,Business meal,REF95732998,292.77,0.0,172562.54
2021-04-06,2021-04-06,Coworking space rental,REF11260114,229.05,0.0,172333.49
2021-04-15,2021-04-15,Business insurance premium,REF98224021,134.5,0.0,172198.99
2021-04-15,2021-04-15,Project payment - Rhodes-Jefferson,REF14345344,0.0,641.63,172840.62
2021-04-15,2021-04-15,Coworking space rental,REF46856842,194.22,0.0,172646.4
2021-04-15,2021-04-15,"Payment from Rhodes, Schmidt and Benitez",REF67673459,0.0,802.3,173448.7
2021-04-15,2021-04-15,Project payment - Schmidt-Moran,REF77202625,0.0,609.55,174058.25
2021-04-15,2021-04-15,"Payment from Fuentes, Stephens and Lee",REF23708337,0.0,489.54,174547.79
2021-04-15,2021-04-15,Invoice payment - Thomas-Smith,REF55019151,0.0,403.22,174951.01
2021-04-15,2021-04-15,Service payment - Neal-Lopez,REF76800295,0.0,523.49,175474.5
2021-04-15,2021-04-15,Payment from Ayala-French,REF44943805,0.0,276.86,175751.36
2021-04-15,2021-04-15,"Invoice payment - Nguyen, Palmer and Gonzalez",REF67128876,0.0,834.83,176586.19
2021-04-19,2021-04-19,Business meal,REF31553792,423.09,0.0,176163.1
2021-04-21,2021-04-21,Professional software license,REF75334446,208.36,0.0,175954.74
2021-04-22,2021-04-22,Business travel,REF38247335,599.51,0.0,175355.23
2021-04-23,2021-04-23,Coworking space rental,REF36885624,420.23,0.0,174935.0
2021-04-23,2021-04-23,Business travel,REF61094956,457.49,0.0,174477.51
2021-04-28,2021-04-28,Business travel,REF51692675,135.23,0.0,174342.28
2021-05-02,2021-05-02,Business travel,REF13175806,329.67,0.0,174012.61
2021-05-08,2021-05-08,Marketing expenses,REF35111575,256.11,0.0,173756.5
2021-05-10,2021-05-10,Marketing expenses,REF95618098,345.74,0.0,173410.76
2021-05-11,2021-05-11,Business meal,REF97091392,257.25,0.0,173153.51
2021-05-12,2021-05-12,Training/conference,REF65387521,199.29,0.0,172954.22
2021-05-15,2021-05-15,Invoice payment - Neal-Lopez,REF79011757,0.0,409.66,173363.88
2021-05-15,2021-05-15,Project payment - Schmidt-Moran,REF51048037,0.0,541.56,173905.44
2021-05-15,2021-05-15,"Service payment - Nguyen, Palmer and Gonzalez",REF17954359,0.0,562.12,174467.56
2021-05-15,2021-05-15,"Invoice payment - Rhodes, Schmidt and Benitez",REF52362344,0.0,769.33,175236.89
2021-05-15,2021-05-15,Project payment - Ayala-French,REF71961759,0.0,344.38,175581.27
2021-05-15,2021-05-15,"Invoice payment - Fuentes, Stephens and Lee",REF92955550,0.0,550.31,176131.58
2021-05-15,2021-05-15,Business insurance premium,REF41548568,127.83,0.0,176003.75
2021-05-21,2021-05-21,Professional software license,REF38614889,173.32,0.0,175830.43
2021-05-24,2021-05-24,Training/conference,REF15931146,94.07,0.0,175736.36
2021-05-27,2021-05-27,Business meal,REF96246893,180.44,0.0,175555.92
2021-05-27,2021-05-27,Accounting expense,REF60769963,272.43,0.0,175283.49
2021-05-28,2021-05-28,Training/conference,REF49133684,125.6,0.0,175157.89
2021-06-04,2021-06-04,Training/conference,REF82838864,159.23,0.0,174998.66
2021-06-05,2021-06-05,Accounting expense,REF45078274,189.15,0.0,174809.51
2021-06-07,2021-06-07,Business meal,REF15616684,208.98,0.0,174600.53
2021-06-07,2021-06-07,Coworking space rental,REF27673246,294.83,0.0,174305.7
2021-06-11,2021-06-11,Equipment purchase,REF30769173,100.16,0.0,174205.54
2021-06-15,2021-06-15,Business insurance premium,REF77898626,108.03,0.0,174097.51
2021-06-15,2021-06-15,"Invoice payment - Rhodes, Schmidt and Benitez",REF40120597,0.0,517.56,174615.07
2021-06-15,2021-06-15,Service payment - Rhodes-Jefferson,REF20553240,0.0,479.67,175094.74
2021-06-15,2021-06-15,Service payment - Schmidt-Moran,REF81778217,0.0,617.99,175712.73
2021-06-15,2021-06-15,Invoice payment - Ayala-French,REF34348086,0.0,288.85,176001.58
2021-06-15,2021-06-15,Payment from Thomas-Smith,REF68659991,0.0,376.7,176378.28
2021-06-15,2021-06-15,"Invoice payment - Nguyen, Palmer and Gonzalez",REF34497869,0.0,478.4,176856.68
2021-06-15,2021-06-15,Training/conference,REF29626318,72.21,0.0,176784.47
2021-06-15,2021-06-15,"Project payment - Fuentes, Stephens and Lee",REF46013765,0.0,432.52,177216.99
2021-06-15,2021-06-15,Project payment - Neal-Lopez,REF42115201,0.0,350.4,177567.39
2021-06-17,2021-06-17,Business travel,REF22320525,333.43,0.0,177233.96
2021-06-21,2021-06-21,Professional software license,REF77298914,146.66,0.0,177087.3
2021-06-28,2021-06-28,Equipment purchase,REF62730035,122.31,0.0,176964.99
2021-06-30,2021-06-30,Accounting expense,REF62396514,191.15,0.0,176773.84
2021-07-02,2021-07-02,Business meal,REF84594980,202.28,0.0,176571.56
2021-07-03,2021-07-03,Business travel,REF80024311,268.62,0.0,176302.94
2021-07-09,2021-07-09,Training/conference,REF68649299,145.94,0.0,176157.0
2021-07-10,2021-07-10,Training/conference,REF52312017,167.17,0.0,175989.83
2021-07-11,2021-07-11,Equipment purchase,REF76557033,107.09,0.0,175882.74
2021-07-14,2021-07-14,Equipment purchase,REF10844055,71.35,0.0,175811.39
2021-07-15,2021-07-15,Business insurance premium,REF53983351,92.02,0.0,175719.37
2021-07-15,2021-07-15,Invoice payment - Rhodes-Jefferson,REF63821087,0.0,471.97,176191.34
2021-07-15,2021-07-15,Payment from Thomas-Smith,REF88611109,0.0,377.84,176569.18
2021-07-15,2021-07-15,Payment from Neal-Lopez,REF89714966,0.0,429.94,176999.12
2021-07-15,2021-07-15,"Service payment - Nguyen, Palmer and Gonzalez",REF38886161,0.0,538.45,177537.57
2021-07-15,2021-07-15,"Invoice payment - Fuentes, Stephens and Lee",REF91893597,0.0,309.76,177847.33
2021-07-15,2021-07-15,Project payment - Schmidt-Moran,REF55821966,0.0,382.28,178229.61
2021-07-19,2021-07-19,Coworking space rental,REF41560958,166.24,0.0,178063.37
2021-07-21,2021-07-21,Professional software license,REF86671164,154.29,0.0,177909.08
2021-07-23,2021-07-23,Marketing expenses,REF35059113,291.16,0.0,177617.92
2021-07-25,2021-07-25,Business travel,REF50060463,128.07,0.0,177489.85
2021-07-26,2021-07-26,Equipment purchase,REF85423565,79.56,0.0,177410.29
2021-07-27,2021-07-27,Training/conference,REF11884386,199.38,0.0,177210.91
2021-07-30,2021-07-30,Business meal,REF24656881,199.17,0.0,177011.74
2021-08-01,2021-08-01,Business meal,REF63928043,303.5,0.0,176708.24
2021-08-03,2021-08-03,Business meal,REF74479596,193.58,0.0,176514.66
2021-08-04,2021-08-04,Business travel,REF99772187,478.94,0.0,176035.72
2021-08-07,2021-08-07,Business travel,REF22498967,469.75,0.0,175565.97
2021-08-10,2021-08-10,Equipment purchase,REF97928409,149.49,0.0,175416.48
2021-08-15,2021-08-15,"Invoice payment - Fuentes, Stephens and Lee",REF22863137,0.0,398.87,175815.35
2021-08-15,2021-08-15,Business insurance premium,REF82958918,105.34,0.0,175710.01
2021-08-15,2021-08-15,Service payment - Neal-Lopez,REF81705420,0.0,427.11,176137.12
2021-08-15,2021-08-15,Service payment - Schmidt-Moran,REF95985821,0.0,520.46,176657.58
2021-08-15,2021-08-15,"Project payment - Nguyen, Palmer and Gonzalez",REF71439149,0.0,498.28,177155.86
2021-08-15,2021-08-15,Invoice payment - Ayala-French,REF95308002,0.0,261.9,177417.76
2021-08-18,2021-08-18,Accounting expense,REF12295842,122.44,0.0,177295.32
2021-08-18,2021-08-18,Training/conference,REF26206893,255.31,0.0,177040.01
2021-08-20,2021-08-20,Coworking space rental,REF17112105,355.8,0.0,176684.21
2021-08-21,2021-08-21,Professional software license,REF27987247,161.18,0.0,176523.03
2021-08-21,2021-08-21,Training/conference,REF13978962,118.91,0.0,176404.12
2021-08-23,2021-08-23,Business travel,REF56492861,257.48,0.0,176146.64
2021-08-27,2021-08-27,Business meal,REF66778479,127.43,0.0,176019.21
2021-08-30,2021-08-30,Business travel,REF12587205,330.39,0.0,175688.82
2021-09-01,2021-09-01,Business travel,REF73313168,386.94,0.0,175301.88
2021-09-10,2021-09-10,Business travel,REF65057405,328.73,0.0,174973.15
2021-09-15,2021-09-15,Invoice payment - Rhodes-Jefferson,REF94199226,0.0,416.73,175389.88
2021-09-15,2021-09-15,"Service payment - Rhodes, Schmidt and Benitez",REF73922089,0.0,773.77,176163.65
2021-09-15,2021-09-15,Business insurance premium,REF82135472,150.58,0.0,176013.07
2021-09-15,2021-09-15,Service payment - Neal-Lopez,REF94136650,0.0,616.41,176629.48
2021-09-15,2021-09-15,Service payment - Schmidt-Moran,REF10485543,0.0,772.11,177401.59
2021-09-15,2021-09-15,Payment from Ayala-French,REF30117375,0.0,372.84,177774.43
2021-09-15,2021-09-15,"Invoice payment - Fuentes, Stephens and Lee",REF50044890,0.0,449.61,178224.04
2021-09-15,2021-09-15,Payment from Thomas-Smith,REF80541692,0.0,506.89,178730.93
2021-09-15,2021-09-15,"Service payment - Nguyen, Palmer and Gonzalez",REF12446131,0.0,747.18,179478.11
2021-09-16,2021-09-16,Marketing expenses,REF69659052,334.07,0.0,179144.04
2021-09-19,2021-09-19,Training/conference,REF66440972,196.36,0.0,178947.68
2021-09-21,2021-09-21,Business travel,REF26583127,420.22,0.0,178527.46
2021-09-21,2021-09-21,Professional software license,REF66291533,203.78,0.0,178323.68
2021-09-24,2021-09-24,Equipment purchase,REF23712934,221.38,0.0,178102.3
2021-09-27,2021-09-27,Business travel,REF29222368,618.5,0.0,177483.8
2021-09-28,2021-09-28,Business travel,REF91135422,539.69,0.0,176944.11
2021-10-06,2021-10-06,Training/conference,REF28712511,163.44,0.0,176780.67
2021-10-09,2021-10-09,Equipment purchase,REF52661929,161.04,0.0,176619.63
2021-10-15,2021-10-15,Invoice payment - Ayala-French,REF63496430,0.0,480.97,177100.6
2021-10-15,2021-10-15,Business insurance premium,REF78414544,179.51,0.0,176921.09
2021-10-15,2021-10-15,Invoice payment - Thomas-Smith,REF26313900,0.0,537.56,177458.65
2021-10-15,2021-10-15,Invoice payment - Rhodes-Jefferson,REF35033106,0.0,650.17,178108.82
2021-10-15,2021-10-15,Project payment - Neal-Lopez,REF33123655,0.0,568.19,178677.01
2021-10-15,2021-10-15,"Invoice payment - Rhodes, Schmidt and Benitez",REF27706735,0.0,714.71,179391.72
2021-10-15,2021-10-15,"Invoice payment - Nguyen, Palmer and Gonzalez",REF18945209,0.0,889.14,180280.86
2021-10-20,2021-10-20,Equipment purchase,REF98624327,139.05,0.0,180141.81
2021-10-20,2021-10-20,Business travel,REF98513613,532.95,0.0,179608.86
2021-10-21,2021-10-21,Professional software license,REF25004724,209.68,0.0,179399.18
2021-10-23,2021-10-23,Business meal,REF81726501,367.8,0.0,179031.38
2021-10-27,2021-10-27,Training/conference,REF45334511,100.88,0.0,178930.5
2021-11-06,2021-11-06,Business travel,REF79010177,179.33,0.0,178751.17
2021-11-11,2021-11-11,Business meal,REF55203820,323.22,0.0,178427.95
2021-11-14,2021-11-14,Business meal,REF47819912,356.01,0.0,178071.94
2021-11-15,2021-11-15,Business insurance premium,REF46012859,156.21,0.0,177915.73
2021-11-15,2021-11-15,Service payment - Neal-Lopez,REF26674517,0.0,641.11,178556.84
2021-11-15,2021-11-15,"Invoice payment - Fuentes, Stephens and Lee",REF14502621,0.0,502.85,179059.69
2021-11-15,2021-11-15,Payment from Schmidt-Moran,REF59346439,0.0,739.71,179799.4
2021-11-15,2021-11-15,"Payment from Rhodes, Schmidt and Benitez",REF43341564,0.0,977.39,180776.79
2021-11-15,2021-11-15,Payment from Rhodes-Jefferson,REF13567916,0.0,538.91,181315.7
2021-11-15,2021-11-15,Invoice payment - Thomas-Smith,REF21672459,0.0,637.06,181952.76
2021-11-15,2021-11-15,Invoice payment - Ayala-French,REF42662653,0.0,324.03,182276.79
2021-11-15,2021-11-15,"Service payment - Nguyen, Palmer and Gonzalez",REF19717866,0.0,886.83,183163.62
2021-11-16,2021-11-16,Business meal,REF28260169,153.09,0.0,183010.53
2021-11-21,2021-11-21,Professional software license,REF85791379,209.82,0.0,182800.71
2021-11-28,2021-11-28,Accounting expense,REF52792624,94.11,0.0,182706.6
2021-11-28,2021-11-28,Business travel,REF54166864,523.7,0.0,182182.9
2021-12-01,2021-12-01,Accounting expense,REF39700982,184.41,0.0,181998.49
2021-12-02,2021-12-02,Training/conference,REF15032570,180.53,0.0,181817.96
2021-12-03,2021-12-03,Business meal,REF65614937,245.76,0.0,181572.2
2021-12-12,2021-12-12,Marketing expenses,REF30237752,141.68,0.0,181430.52
2021-12-15,2021-12-15,Project payment - Neal-Lopez,REF50586552,0.0,627.53,182058.05
2021-12-15,2021-12-15,"Project payment - Fuentes, Stephens and Lee",REF50573019,0.0,433.28,182491.33
2021-12-15,2021-12-15,"Project payment - Nguyen, Palmer and Gonzalez",REF59497639,0.0,729.06,183220.39
2021-12-15,2021-12-15,Business insurance premium,REF28234755,133.24,0.0,183087.15
2021-12-15,2021-12-15,Service payment - Thomas-Smith,REF36159384,0.0,458.47,183545.62
2021-12-15,2021-12-15,Service payment - Rhodes-Jefferson,REF94810003,0.0,613.92,184159.54
2021-12-15,2021-12-15,Payment from Ayala-French,REF84966982,0.0,303.1,184462.64
2021-12-15,2021-12-15,Service payment - Schmidt-Moran,REF70361991,0.0,519.46,184982.1
2021-12-15,2021-12-15,"Service payment - Rhodes, Schmidt and Benitez",REF74883380,0.0,741.82,185723.92
2021-12-16,2021-12-16,Business travel,REF77566391,549.07,0.0,185174.85
2021-12-21,2021-12-21,Professional software license,REF50512758,193.58,0.0,184981.27
2021-12-31,2021-12-31,Business travel,REF18830241,455.31,0.0,184525.96
2022-01-04,2022-01-04,Business meal,REF94331251,242.24,0.0,184283.72
2022-01-04,2022-01-04,Training/conference,REF34745351,227.77,0.0,184055.95
2022-01-06,2022-01-06,Business travel,REF25035984,139.42,0.0,183916.53
2022-01-12,2022-01-12,Training/conference,REF60962040,218.01,0.0,183698.52
2022-01-14,2022-01-14,Business travel,REF70045888,445.97,0.0,183252.55
2022-01-15,2022-01-15,Business insurance premium,REF66810340,170.99,0.0,183081.56
2022-01-15,2022-01-15,Project payment - Neal-Lopez,REF46200480,0.0,680.86,183762.42
2022-01-15,2022-01-15,Service payment - Thomas-Smith,REF38012442,0.0,597.38,184359.8
2022-01-15,2022-01-15,Service payment - Rhodes-Jefferson,REF41900887,0.0,785.84,185145.64
2022-01-15,2022-01-15,"Project payment - Fuentes, Stephens and Lee",REF13018142,0.0,523.84,185669.48
2022-01-15,2022-01-15,"Service payment - Nguyen, Palmer and Gonzalez",REF31336267,0.0,600.54,186270.02
2022-01-15,2022-01-15,Payment from Schmidt-Moran,REF75576927,0.0,867.49,187137.51
2022-01-15,2022-01-15,"Invoice payment - Rhodes, Schmidt and Benitez",REF65603255,0.0,1021.49,188159.0
2022-01-15,2022-01-15,Invoice payment - Ayala-French,REF16678633,0.0,363.8,188522.8
2022-01-18,2022-01-18,Business meal,REF52140089,294.3,0.0,188228.5
2022-01-20,2022-01-20,Business meal,REF25526596,292.98,0.0,187935.52
2022-01-21,2022-01-21,Professional software license,REF74447076,255.41,0.0,187680.11
2022-01-24,2022-01-24,Business travel,REF40479995,538.04,0.0,187142.07
2022-01-31,2022-01-31,Business travel,REF17086203,745.86,0.0,186396.21
2022-02-03,2022-02-03,Equipment purchase,REF48081145,158.44,0.0,186237.77
2022-02-10,2022-02-10,Coworking space rental,REF32134749,210.94,0.0,186026.83
2022-02-15,2022-02-15,Business insurance premium,REF58000561,164.79,0.0,185862.04
2022-02-15,2022-02-15,Payment from Ayala-French,REF68802616,0.0,366.14,186228.18
2022-02-15,2022-02-15,"Payment from Fuentes, Stephens and Lee",REF22220599,0.0,596.77,186824.95
2022-02-15,2022-02-15,Invoice payment - Schmidt-Moran,REF92925697,0.0,334.21,187159.16
2022-02-15,2022-02-15,Invoice payment - Rhodes-Jefferson,REF84684948,0.0,606.68,187765.84
2022-02-15,2022-02-15,Payment from Neal-Lopez,REF15961367,0.0,487.77,188253.61
2022-02-15,2022-02-15,"Payment from Nguyen, Palmer and Gonzalez",REF75021970,0.0,660.73,188914.34
2022-02-15,2022-02-15,"Payment from Rhodes, Schmidt and Benitez",REF32298237,0.0,1124.98,190039.32
2022-02-15,2022-02-15,Payment from Thomas-Smith,REF48299096,0.0,427.22,190466.54
2022-02-17,2022-02-17,Marketing expenses,REF90907721,254.92,0.0,190211.62
2022-02-21,2022-02-21,Professional software license,REF51382588,217.76,0.0,189993.86
2022-02-22,2022-02-22,Business meal,REF65966759,290.46,0.0,189703.4
2022-02-25,2022-02-25,Accounting expense,REF14277840,255.16,0.0,189448.24
2022-02-26,2022-02-26,Accounting expense,REF49467496,204.3,0.0,189243.94
2022-03-02,2022-03-02,Coworking space rental,REF93233309,171.1,0.0,189072.84
2022-03-04,2022-03-04,Business meal,REF66241967,280.8,0.0,188792.04
2022-03-05,2022-03-05,Marketing expenses,REF39261253,336.95,0.0,188455.09
2022-03-08,2022-03-08,Business travel,REF52470789,668.62,0.0,187786.47
2022-03-09,2022-03-09,Business travel,REF19998530,481.78,0.0,187304.69
2022-03-15,2022-03-15,Business insurance premium,REF78531202,135.51,0.0,187169.18
2022-03-15,2022-03-15,Invoice payment - Schmidt-Moran,REF62100720,0.0,475.68,187644.86
2022-03-15,2022-03-15,"Project payment - Nguyen, Palmer and Gonzalez",REF37560513,0.0,613.24,188258.1
2022-03-15,2022-03-15,"Project payment - Rhodes, Schmidt and Benitez",REF13182927,0.0,901.55,189159.65
2022-03-15,2022-03-15,"Project payment - Fuentes, Stephens and Lee",REF94337520,0.0,573.26,189732.91
2022-03-15,2022-03-15,Project payment - Neal-Lopez,REF94819681,0.0,380.41,190113.32
2022-03-15,2022-03-15,Service payment - Thomas-Smith,REF50065741,0.0,604.58,190717.9
2022-03-15,2022-03-15,Service payment - Rhodes-Jefferson,REF32112236,0.0,581.08,191298.98
2022-03-21,2022-03-21,Professional software license,REF84535526,210.86,0.0,191088.12
2022-03-24,2022-03-24,Training/conference,REF52344814,207.09,0.0,190881.03
2022-04-05,2022-04-05,Business meal,REF93069153,224.52,0.0,190656.51
2022-04-07,2022-04-07,Training/conference,REF73977318,91.49,0.0,190565.02
2022-04-08,2022-04-08,Business meal,REF31677200,297.4,0.0,190267.62
2022-04-10,2022-04-10,Coworking space rental,REF72398321,223.44,0.0,190044.18
2022-04-15,2022-04-15,"Payment from Nguyen, Palmer and Gonzalez",REF31003328,0.0,665.36,190709.54
2022-04-15,2022-04-15,Service payment - Neal-Lopez,REF34700228,0.0,598.89,191308.43
2022-04-15,2022-04-15,"Project payment - Rhodes, Schmidt and Benitez",REF79891576,0.0,685.35,191993.78
2022-04-15,2022-04-15,"Invoice payment - Fuentes, Stephens and Lee",REF31170165,0.0,490.2,192483.98
2022-04-15,2022-04-15,Project payment - Schmidt-Moran,REF48692553,0.0,757.24,193241.22
2022-04-15,2022-04-15,Service payment - Thomas-Smith,REF63007880,0.0,363.06,193604.28
2022-04-15,2022-04-15,Project payment - Rhodes-Jefferson,REF95739540,0.0,516.42,194120.7
2022-04-15,2022-04-15,Business insurance premium,REF10759768,130.37,0.0,193990.33
2022-04-16,2022-04-16,Business meal,REF82813748,272.18,0.0,193718.15
2022-04-17,2022-04-17,Business meal,REF12151977,350.34,0.0,193367.81
2022-04-17,2022-04-17,Coworking space rental,REF90072752,198.11,0.0,193169.7
2022-04-19,2022-04-19,Marketing expenses,REF97920233,301.86,0.0,192867.84
2022-04-20,2022-04-20,Accounting expense,REF51751814,157.99,0.0,192709.85
2022-04-21,2022-04-21,Professional software license,REF23187168,198.05,0.0,192511.8
2022-04-24,2022-04-24,Business travel,REF55749848,459.25,0.0,192052.55
2022-04-24,2022-04-24,Marketing expenses,REF88309789,265.19,0.0,191787.36
2022-04-24,2022-04-24,Business meal,REF49664842,287.11,0.0,191500.25
2022-04-26,2022-04-26,Business travel,REF16901336,427.43,0.0,191072.82
2022-04-29,2022-04-29,Coworking space rental,REF77506727,293.59,0.0,190779.23
2022-05-02,2022-05-02,Business travel,REF67473156,344.34,0.0,190434.89
2022-05-03,2022-05-03,Business meal,REF26253063,130.75,0.0,190304.14
2022-05-03,2022-05-03,Marketing expenses,REF91663229,377.16,0.0,189926.98
2022-05-09,2022-05-09,Coworking space rental,REF76035729,291.86,0.0,189635.12
2022-05-15,2022-05-15,Business insurance premium,REF99764261,123.87,0.0,189511.25
2022-05-15,2022-05-15,Payment from Ayala-French,REF82014354,0.0,265.48,189776.73
2022-05-15,2022-05-15,Payment from Thomas-Smith,REF40997701,0.0,432.0,190208.73
2022-05-15,2022-05-15,Service payment - Rhodes-Jefferson,REF67389102,0.0,411.04,190619.77
2022-05-15,2022-05-15,"Service payment - Rhodes, Schmidt and Benitez",REF53068167,0.0,732.39,191352.16
2022-05-15,2022-05-15,Service payment - Schmidt-Moran,REF44196614,0.0,554.38,191906.54
2022-05-15,2022-05-15,"Service payment - Nguyen, Palmer and Gonzalez",REF35154540,0.0,460.39,192366.93
2022-05-15,2022-05-15,Payment from Neal-Lopez,REF54169524,0.0,495.95,192862.88
2022-05-15,2022-05-15,"Project payment - Fuentes, Stephens and Lee",REF88211900,0.0,403.67,193266.55
2022-05-16,2022-05-16,Business meal,REF12939906,158.82,0.0,193107.73
2022-05-20,2022-05-20,Accounting expense,REF34728085,256.36,0.0,192851.37
2022-05-21,2022-05-21,Training/conference,REF21512328,155.9,0.0,192695.47
2022-05-21,2022-05-21,Professional software license,REF34125295,164.07,0.0,192531.4
2022-05-28,2022-05-28,Coworking space rental,REF10755385,181.74,0.0,192349.66
2022-06-06,2022-06-06,Business travel,REF91561195,490.23,0.0,191859.43
2022-06-08,2022-06-08,Accounting expense,REF26201155,167.02,0.0,191692.41
2022-06-13,2022-06-13,Training/conference,REF70706384,153.4,0.0,191539.01
2022-06-15,2022-06-15,Service payment - Thomas-Smith,REF63531587,0.0,432.23,191971.24
2022-06-15,2022-06-15,Project payment - Neal-Lopez,REF56850363,0.0,437.29,192408.53
2022-06-15,2022-06-15,"Payment from Fuentes, Stephens and Lee",REF83252300,0.0,448.19,192856.72
2022-06-15,2022-06-15,Payment from Schmidt-Moran,REF72687649,0.0,558.07,193414.79
2022-06-15,2022-06-15,Payment from Rhodes-Jefferson,REF95491849,0.0,486.99,193901.78
2022-06-15,2022-06-15,Business insurance premium,REF24472546,120.25,0.0,193781.53
2022-06-15,2022-06-15,"Payment from Nguyen, Palmer and Gonzalez",REF94065246,0.0,575.46,194356.99
2022-06-15,2022-06-15,Payment from Ayala-French,REF60958232,0.0,252.67,194609.66
2022-06-17,2022-06-17,Business meal,REF92766964,136.69,0.0,194472.97
2022-06-21,2022-06-21,Professional software license,REF99492448,168.95,0.0,194304.02
2022-06-24,2022-06-24,Business meal,REF43819030,299.56,0.0,194004.46
2022-06-28,2022-06-28,Coworking space rental,REF76173719,320.46,0.0,193684.0
2022-07-03,2022-07-03,Coworking space rental,REF36639192,119.47,0.0,193564.53
2022-07-09,2022-07-09,Equipment purchase,REF25590456,69.69,0.0,193494.84
2022-07-13,2022-07-13,Coworking space rental,REF68473251,376.43,0.0,193118.41
2022-07-13,2022-07-13,Business travel,REF77849185,249.83,0.0,192868.58
2022-07-15,2022-07-15,Payment from Thomas-Smith,REF98301953,0.0,378.79,193247.37
2022-07-15,2022-07-15,Service payment - Rhodes-Jefferson,REF70449546,0.0,402.52,193649.89
2022-07-15,2022-07-15,Service payment - Schmidt-Moran,REF27839835,0.0,476.67,194126.56
2022-07-15,2022-07-15,Business insurance premium,REF56324557,94.98,0.0,194031.58
2022-07-15,2022-07-15,"Payment from Nguyen, Palmer and Gonzalez",REF75396907,0.0,398.78,194430.36
2022-07-15,2022-07-15,Invoice payment - Ayala-French,REF36634175,0.0,290.43,194720.79
2022-07-15,2022-07-15,Service payment - Neal-Lopez,REF75856007,0.0,413.84,195134.63
2022-07-15,2022-07-15,"Payment from Fuentes, Stephens and Lee",REF51719064,0.0,399.9,195534.53
2022-07-15,2022-07-15,"Payment from Rhodes, Schmidt and Benitez",REF70116251,0.0,533.61,196068.14
2022-07-17,2022-07-17,Business travel,REF53857129,376.27,0.0,195691.87
2022-07-18,2022-07-18,Accounting expense,REF56966196,157.87,0.0,195534.0
2022-07-21,2022-07-21,Marketing expenses,REF83018548,194.59,0.0,195339.41
2022-07-21,2022-07-21,Professional software license,REF66175574,141.12,0.0,195198.29
2022-07-28,2022-07-28,Business travel,REF38923541,305.92,0.0,194892.37
2022-07-28,2022-07-28,Coworking space rental,REF77548943,273.25,0.0,194619.12
2022-07-31,2022-07-31,Coworking space rental,REF80076366,149.7,0.0,194469.42
2022-08-01,2022-08-01,Equipment purchase,REF44724335,79.47,0.0,194389.95
2022-08-03,2022-08-03,Equipment purchase,REF79100700,168.65,0.0,194221.3
2022-08-03,2022-08-03,Training/conference,REF37781826,183.14,0.0,194038.16
2022-08-04,2022-08-04,Training/conference,REF62583183,102.9,0.0,193935.26
2022-08-08,2022-08-08,Business meal,REF28936209,136.19,0.0,193799.07
2022-08-09,2022-08-09,Business travel,REF61684662,399.05,0.0,193400.02
2022-08-09,2022-08-09,Accounting expense,REF38713488,197.21,0.0,193202.81
2022-08-13,2022-08-13,Business travel,REF75337948,449.6,0.0,192753.21
2022-08-14,2022-08-14,Business travel,REF58956550,410.57,0.0,192342.64
2022-08-15,2022-08-15,"Invoice payment - Rhodes, Schmidt and Benitez",REF55341792,0.0,594.89,192937.53
2022-08-15,2022-08-15,Payment from Neal-Lopez,REF22047103,0.0,515.86,193453.39
2022-08-15,2022-08-15,Business insurance premium,REF10146300,110.75,0.0,193342.64
2022-08-15,2022-08-15,Invoice payment - Rhodes-Jefferson,REF19109404,0.0,435.27,193777.91
2022-08-15,2022-08-15,"Payment from Nguyen, Palmer and Gonzalez",REF58545251,0.0,691.66,194469.57
2022-08-15,2022-08-15,Service payment - Thomas-Smith,REF19169309,0.0,311.65,194781.22
2022-08-15,2022-08-15,Service payment - Ayala-French,REF24614313,0.0,265.59,195046.81
2022-08-21,2022-08-21,Professional software license,REF82291524,162.64,0.0,194884.17
2022-08-24,2022-08-24,Marketing expenses,REF32238360,179.53,0.0,194704.64
2022-08-26,2022-08-26,Training/conference,REF31173877,190.91,0.0,194513.73
2022-08-27,2022-08-27,Accounting expense,REF85640016,140.45,0.0,194373.28
2022-08-27,2022-08-27,Business meal,REF51359517,238.69,0.0,194134.59
2022-08-29,2022-08-29,Training/conference,REF60450665,188.58,0.0,193946.01
2022-08-29,2022-08-29,Coworking space rental,REF10923491,262.1,0.0,193683.91
2022-08-30,2022-08-30,Marketing expenses,REF13062269,118.92,0.0,193564.99
2022-09-04,2022-09-04,Coworking space rental,REF59304394,339.49,0.0,193225.5
2022-09-07,2022-09-07,Business travel,REF37251364,317.98,0.0,192907.52
2022-09-10,2022-09-10,Training/conference,REF79392769,236.36,0.0,192671.16
2022-09-14,2022-09-14,Accounting expense,REF63783798,150.54,0.0,192520.62
2022-09-15,2022-09-15,Service payment - Ayala-French,REF80176051,0.0,313.34,192833.96
2022-09-15,2022-09-15,Invoice payment - Neal-Lopez,REF49784570,0.0,773.05,193607.01
2022-09-15,2022-09-15,"Invoice payment - Rhodes, Schmidt and Benitez",REF18897426,0.0,891.97,194498.98
2022-09-15,2022-09-15,"Project payment - Nguyen, Palmer and Gonzalez",REF39289794,0.0,814.6,195313.58
2022-09-15,2022-09-15,Project payment - Rhodes-Jefferson,REF40294081,0.0,767.72,196081.3
2022-09-15,2022-09-15,"Service payment - Fuentes, Stephens and Lee",REF67278340,0.0,557.77,196639.07
2022-09-15,2022-09-15,Payment from Thomas-Smith,REF81283532,0.0,591.17,197230.24
2022-09-15,2022-09-15,Service payment - Schmidt-Moran,REF59976511,0.0,662.03,197892.27
2022-09-15,2022-09-15,Business insurance premium,REF44668914,153.18,0.0,197739.09
2022-09-16,2022-09-16,Business meal,REF21705846,286.36,0.0,197452.73
2022-09-17,2022-09-17,Training/conference,REF24183697,242.97,0.0,197209.76
2022-09-18,2022-09-18,Business travel,REF27417409,147.17,0.0,197062.59
2022-09-18,2022-09-18,Business meal,REF30398988,290.72,0.0,196771.87
2022-09-21,2022-09-21,Professional software license,REF87147919,187.36,0.0,196584.51
2022-09-22,2022-09-22,Marketing expenses,REF60376843,135.02,0.0,196449.49
2022-09-23,2022-09-23,Marketing expenses,REF24255041,403.77,0.0,196045.72
2022-09-26,2022-09-26,Business travel,REF96736293,342.22,0.0,195703.5
2022-09-26,2022-09-26,Equipment purchase,REF28925515,194.88,0.0,195508.62
2022-10-04,2022-10-04,Training/conference,REF35269275,213.24,0.0,195295.38
2022-10-10,2022-10-10,Coworking space rental,REF22052849,419.84,0.0,194875.54
2022-10-13,2022-10-13,Marketing expenses,REF74765534,460.63,0.0,194414.91
2022-10-15,2022-10-15,"Project payment - Fuentes, Stephens and Lee",REF40459618,0.0,687.81,195102.72
2022-10-15,2022-10-15,Business insurance premium,REF91238978,177.92,0.0,194924.8
2022-10-15,2022-10-15,Payment from Neal-Lopez,REF65030385,0.0,568.07,195492.87
2022-10-15,2022-10-15,"Payment from Rhodes, Schmidt and Benitez",REF54612765,0.0,878.98,196371.85
2022-10-15,2022-10-15,"Service payment - Nguyen, Palmer and Gonzalez",REF93216319,0.0,662.22,197034.07
2022-10-15,2022-10-15,Service payment - Ayala-French,REF91119492,0.0,422.73,197456.8
2022-10-15,2022-10-15,Invoice payment - Schmidt-Moran,REF32331854,0.0,592.81,198049.61
2022-10-15,2022-10-15,Project payment - Thomas-Smith,REF10966987,0.0,551.18,198600.79
2022-10-15,2022-10-15,Coworking space rental,REF80495379,347.0,0.0,198253.79
2022-10-21,2022-10-21,Professional software license,REF41572825,272.87,0.0,197980.92
2022-10-23,2022-10-23,Coworking space rental,REF24343100,276.52,0.0,197704.4
2022-10-24,2022-10-24,Coworking space rental,REF69514387,247.55,0.0,197456.85
2022-11-08,2022-11-08,Business travel,REF25831293,517.62,0.0,196939.23
2022-11-09,2022-11-09,Business meal,REF13848843,361.08,0.0,196578.15
2022-11-09,2022-11-09,Training/conference,REF47652407,207.47,0.0,196370.68
2022-11-10,2022-11-10,Business travel,REF79221296,404.88,0.0,195965.8
2022-11-15,2022-11-15,Service payment - Neal-Lopez,REF24722215,0.0,566.92,196532.72
2022-11-15,2022-11-15,Invoice payment - Thomas-Smith,REF71333410,0.0,477.41,197010.13
2022-11-15,2022-11-15,"Invoice payment - Fuentes, Stephens and Lee",REF51026646,0.0,664.44,197674.57
2022-11-15,2022-11-15,Business insurance premium,REF92944815,159.49,0.0,197515.08
2022-11-15,2022-11-15,Payment from Rhodes-Jefferson,REF46408247,0.0,468.28,197983.36
2022-11-15,2022-11-15,Service payment - Schmidt-Moran,REF47767398,0.0,976.39,198959.75
2022-11-15,2022-11-15,"Service payment - Nguyen, Palmer and Gonzalez",REF44634109,0.0,724.8,199684.55
2022-11-15,2022-11-15,"Service payment - Rhodes, Schmidt and Benitez",REF24890579,0.0,958.7,200643.25
2022-11-18,2022-11-18,Coworking space rental,REF43993816,181.02,0.0,200462.23
2022-11-21,2022-11-21,Professional software license,REF77307682,231.41,0.0,200230.82
2022-11-26,2022-11-26,Marketing expenses,REF22343926,212.24,0.0,200018.58
2022-11-27,2022-11-27,Marketing expenses,REF20239774,560.47,0.0,199458.11
2022-11-27,2022-11-27,Business meal,REF81340887,199.33,0.0,199258.78
2022-12-02,2022-12-02,Accounting expense,REF45449607,136.6,0.0,199122.18
2022-12-07,2022-12-07,Business meal,REF29176510,143.68,0.0,198978.5
2022-12-09,2022-12-09,Training/conference,REF31527889,148.92,0.0,198829.58
2022-12-12,2022-12-12,Marketing expenses,REF45595863,234.77,0.0,198594.81
2022-12-15,2022-12-15,Business insurance premium,REF17318753,129.48,0.0,198465.33
2022-12-15,2022-12-15,"Project payment - Fuentes, Stephens and Lee",REF81108156,0.0,287.03,198752.36
2022-12-15,2022-12-15,"Invoice payment - Nguyen, Palmer and Gonzalez",REF88518812,0.0,514.23,199266.59
2022-12-15,2022-12-15,Invoice payment - Schmidt-Moran,REF10359152,0.0,522.24,199788.83
2022-12-15,2022-12-15,"Service payment - Rhodes, Schmidt and Benitez",REF21342223,0.0,769.4,200558.23
2022-12-15,2022-12-15,Project payment - Ayala-French,REF69059037,0.0,268.94,200827.17
2022-12-15,2022-12-15,Invoice payment - Neal-Lopez,REF95202061,0.0,460.34,201287.51
2022-12-15,2022-12-15,Project payment - Thomas-Smith,REF49757889,0.0,342.96,201630.47
2022-12-21,2022-12-21,Professional software license,REF47396245,205.5,0.0,201424.97
2022-12-21,2022-12-21,Business meal,REF66676203,258.48,0.0,201166.49
2022-12-22,2022-12-22,Marketing expenses,REF10911860,339.98,0.0,200826.51
2022-12-28,2022-12-28,Equipment purchase,REF55916988,175.52,0.0,200650.99
2022-12-30,2022-12-30,Coworking space rental,REF69555672,131.79,0.0,200519.2
2022-12-31,2022-12-31,Equipment purchase,REF85317941,150.7,0.0,200368.5
2023-01-07,2023-01-07,Marketing expenses,REF52608366,420.56,0.0,199947.94
2023-01-14,2023-01-14,Business travel,REF59998886,488.14,0.0,199459.8
2023-01-15,2023-01-15,Project payment - Rhodes-Jefferson,REF36102341,0.0,707.93,200167.73
2023-01-15,2023-01-15,Project payment - Schmidt-Moran,REF54123161,0.0,855.53,201023.26
2023-01-15,2023-01-15,Payment from Thomas-Smith,REF81912497,0.0,633.58,201656.84
2023-01-15,2023-01-15,"Invoice payment - Nguyen, Palmer and Gonzalez",REF55568924,0.0,666.09,202322.93
2023-01-15,2023-01-15,Payment from Neal-Lopez,REF93576578,0.0,706.04,203028.97
2023-01-15,2023-01-15,Invoice payment - Ayala-French,REF50991910,0.0,359.79,203388.76
2023-01-15,2023-01-15,"Project payment - Fuentes, Stephens and Lee",REF47965135,0.0,539.12,203927.88
2023-01-15,2023-01-15,Business insurance premium,REF98849329,166.57,0.0,203761.31
2023-01-15,2023-01-15,"Invoice payment - Rhodes, Schmidt and Benitez",REF55699144,0.0,1146.12,204907.43
2023-01-19,2023-01-19,Accounting expense,REF80886343,295.32,0.0,204612.11
2023-01-21,2023-01-21,Professional software license,REF55384928,229.71,0.0,204382.4
2023-01-21,2023-01-21,Training/conference,REF35017642,375.67,0.0,204006.73
2023-02-08,2023-02-08,Accounting expense,REF60960221,132.22,0.0,203874.51
2023-02-09,2023-02-09,Business meal,REF97413330,196.35,0.0,203678.16
2023-02-10,2023-02-10,Business travel,REF27737499,590.28,0.0,203087.88
2023-02-10,2023-02-10,Marketing expenses,REF65755841,302.97,0.0,202784.91
2023-02-15,2023-02-15,Business insurance premium,REF68899922,152.24,0.0,202632.67
2023-02-15,2023-02-15,"Service payment - Fuentes, Stephens and Lee",REF65688838,0.0,614.14,203246.81
2023-02-15,2023-02-15,"Service payment - Nguyen, Palmer and Gonzalez",REF51236347,0.0,871.5,204118.31
2023-02-15,2023-02-15,"Payment from Rhodes, Schmidt and Benitez",REF89652680,0.0,840.47,204958.78
2023-02-15,2023-02-15,Service payment - Schmidt-Moran,REF14144507,0.0,691.99,205650.77
2023-02-15,2023-02-15,Invoice payment - Neal-Lopez,REF29717551,0.0,700.96,206351.73
2023-02-15,2023-02-15,Service payment - Ayala-French,REF40057033,0.0,442.63,206794.36
2023-02-15,2023-02-15,Project payment - Rhodes-Jefferson,REF58717163,0.0,536.79,207331.15
2023-02-19,2023-02-19,Accounting expense,REF20828748,305.63,0.0,207025.52
2023-02-21,2023-02-21,Professional software license,REF48067045,232.64,0.0,206792.88
2023-02-22,2023-02-22,Business travel,REF78700697,463.62,0.0,206329.26
2023-02-24,2023-02-24,Business meal,REF29913680,239.07,0.0,206090.19
2023-02-28,2023-02-28,Business travel,REF78704576,325.41,0.0,205764.78
2023-03-09,2023-03-09,Equipment purchase,REF23758102,183.33,0.0,205581.45
2023-03-14,2023-03-14,Business travel,REF70230164,584.74,0.0,204996.71
2023-03-15,2023-03-15,Invoice payment - Ayala-French,REF37205550,0.0,379.57,205376.28
2023-03-15,2023-03-15,Invoice payment - Thomas-Smith,REF16033485,0.0,460.18,205836.46
2023-03-15,2023-03-15,Invoice payment - Rhodes-Jefferson,REF59877652,0.0,539.64,206376.1
2023-03-15,2023-03-15,Payment from Schmidt-Moran,REF53432232,0.0,609.22,206985.32
2023-03-15,2023-03-15,Service payment - Neal-Lopez,REF71888746,0.0,562.11,207547.43
2023-03-15,2023-03-15,"Project payment - Fuentes, Stephens and Lee",REF58460347,0.0,589.13,208136.56
2023-03-15,2023-03-15,Business insurance premium,REF48252328,124.04,0.0,208012.52
2023-03-15,2023-03-15,"Service payment - Nguyen, Palmer and Gonzalez",REF27536555,0.0,833.14,208845.66
2023-03-15,2023-03-15,"Payment from Rhodes, Schmidt and Benitez",REF64806677,0.0,835.45,209681.11
2023-03-21,2023-03-21,Professional software license,REF38780715,216.58,0.0,209464.53
2023-03-24,2023-03-24,Business meal,REF69007720,140.46,0.0,209324.07
2023-03-25,2023-03-25,Business meal,REF66476656,198.51,0.0,209125.56
2023-03-30,2023-03-30,Business meal,REF35171523,177.84,0.0,208947.72
2023-04-02,2023-04-02,Equipment purchase,REF13797228,174.01,0.0,208773.71
2023-04-10,2023-04-10,Business travel,REF79311391,652.4,0.0,208121.31
2023-04-11,2023-04-11,Equipment purchase,REF69162751,79.48,0.0,208041.83
2023-04-15,2023-04-15,"Service payment - Rhodes, Schmidt and Benitez",REF55062230,0.0,963.51,209005.34
2023-04-15,2023-04-15,"Project payment - Nguyen, Palmer and Gonzalez",REF78659180,0.0,627.15,209632.49
2023-04-15,2023-04-15,Service payment - Ayala-French,REF24581717,0.0,426.02,210058.51
2023-04-15,2023-04-15,Service payment - Neal-Lopez,REF51084918,0.0,562.22,210620.73
2023-04-15,2023-04-15,Invoice payment - Rhodes-Jefferson,REF43349423,0.0,567.78,211188.51
2023-04-15,2023-04-15,Invoice payment - Thomas-Smith,REF98344795,0.0,546.68,211735.19
2023-04-15,2023-04-15,Business insurance premium,REF67318178,141.27,0.0,211593.92
2023-04-15,2023-04-15,"Invoice payment - Fuentes, Stephens and Lee",REF94424520,0.0,488.6,212082.52
2023-04-17,2023-04-17,Accounting expense,REF36228342,135.15,0.0,211947.37
2023-04-21,2023-04-21,Professional software license,REF52071010,216.53,0.0,211730.84
2023-04-28,2023-04-28,Training/conference,REF51518235,276.76,0.0,211454.08
2023-04-30,2023-04-30,Accounting expense,REF69801985,271.06,0.0,211183.02
2023-05-03,2023-05-03,Business meal,REF22484194,257.06,0.0,210925.96
2023-05-11,2023-05-11,Business travel,REF80077461,514.95,0.0,210411.01
2023-05-15,2023-05-15,Project payment - Schmidt-Moran,REF11749197,0.0,604.0,211015.01
2023-05-15,2023-05-15,Business insurance premium,REF66713087,128.45,0.0,210886.56
2023-05-15,2023-05-15,Service payment - Neal-Lopez,REF27279898,0.0,512.49,211399.05
2023-05-15,2023-05-15,"Service payment - Rhodes, Schmidt and Benitez",REF72420553,0.0,671.08,212070.13
2023-05-15,2023-05-15,Project payment - Thomas-Smith,REF74868204,0.0,500.49,212570.62
2023-05-15,2023-05-15,Payment from Ayala-French,REF90284648,0.0,328.39,212899.01
2023-05-15,2023-05-15,"Project payment - Nguyen, Palmer and Gonzalez",REF66178998,0.0,709.79,213608.8
2023-05-15,2023-05-15,Payment from Rhodes-Jefferson,REF66498689,0.0,423.19,214031.99
2023-05-15,2023-05-15,Business meal,REF10853800,227.94,0.0,213804.05
2023-05-20,2023-05-20,Accounting expense,REF69493695,97.85,0.0,213706.2
2023-05-21,2023-05-21,Professional software license,REF48405029,164.34,0.0,213541.86
2023-05-23,2023-05-23,Business meal,REF25198543,195.31,0.0,213346.55
2023-05-28,2023-05-28,Accounting expense,REF41117166,147.72,0.0,213198.83
2023-05-29,2023-05-29,Business travel,REF41805734,486.98,0.0,212711.85
2023-05-30,2023-05-30,Marketing expenses,REF65160840,308.46,0.0,212403.39
2023-06-08,2023-06-08,Business travel,REF17126329,345.28,0.0,212058.11
2023-06-10,2023-06-10,Business meal,REF60502819,226.16,0.0,211831.95
2023-06-11,2023-06-11,Business travel,REF27217992,290.62,0.0,211541.33
2023-06-13,2023-06-13,Business meal,REF69216034,174.2,0.0,211367.13
2023-06-15,2023-06-15,Payment from Rhodes-Jefferson,REF45338724,0.0,475.9,211843.03
2023-06-15,2023-06-15,Payment from Thomas-Smith,REF13117541,0.0,406.49,212249.52
2023-06-15,2023-06-15,"Invoice payment - Rhodes, Schmidt and Benitez",REF65749526,0.0,781.4,213030.92
2023-06-15,2023-06-15,Payment from Schmidt-Moran,REF82659103,0.0,337.74,213368.66
2023-06-15,2023-06-15,Invoice payment - Neal-Lopez,REF37263294,0.0,485.94,213854.6
2023-06-15,2023-06-15,Business insurance premium,REF60417393,112.81,0.0,213741.79
2023-06-15,2023-06-15,"Project payment - Fuentes, Stephens and Lee",REF24912422,0.0,360.98,214102.77
2023-06-18,2023-06-18,Business meal,REF58748725,288.38,0.0,213814.39
2023-06-19,2023-06-19,Equipment purchase,REF64815985,157.48,0.0,213656.91
2023-06-19,2023-06-19,Business meal,REF42272228,270.53,0.0,213386.38
2023-06-19,2023-06-19,Business travel,REF96885261,374.86,0.0,213011.52
2023-06-21,2023-06-21,Professional software license,REF31616861,129.99,0.0,212881.53
2023-06-26,2023-06-26,Business meal,REF87513214,300.27,0.0,212581.26
2023-07-04,2023-07-04,Coworking space rental,REF42584608,190.46,0.0,212390.8
2023-07-09,2023-07-09,Coworking space rental,REF41808440,307.51,0.0,212083.29
2023-07-15,2023-07-15,Business insurance premium,REF65534717,94.6,0.0,211988.69
2023-07-15,2023-07-15,Invoice payment - Rhodes-Jefferson,REF23959725,0.0,394.39,212383.08
2023-07-15,2023-07-15,Project payment - Neal-Lopez,REF48168761,0.0,464.4,212847.48
2023-07-15,2023-07-15,Project payment - Schmidt-Moran,REF18242780,0.0,288.64,213136.12
2023-07-15,2023-07-15,Payment from Ayala-French,REF39833984,0.0,235.01,213371.13
2023-07-15,2023-07-15,"Project payment - Nguyen, Palmer and Gonzalez",REF74020355,0.0,487.08,213858.21
2023-07-15,2023-07-15,"Project payment - Fuentes, Stephens and Lee",REF63728932,0.0,380.22,214238.43
2023-07-15,2023-07-15,"Service payment - Rhodes, Schmidt and Benitez",REF35926611,0.0,609.3,214847.73
2023-07-19,2023-07-19,Training/conference,REF86984149,119.1,0.0,214728.63
2023-07-20,2023-07-20,Coworking space rental,REF13937865,235.69,0.0,214492.94
2023-07-20,2023-07-20,Equipment purchase,REF96930689,153.62,0.0,214339.32
2023-07-21,2023-07-21,Professional software license,REF80114195,140.58,0.0,214198.74
2023-07-22,2023-07-22,Accounting expense,REF65136737,198.52,0.0,214000.22
2023-07-22,2023-07-22,Business travel,REF61404032,213.17,0.0,213787.05
2023-07-24,2023-07-24,Marketing expenses,REF26772595,147.42,0.0,213639.63
2023-07-25,2023-07-25,Accounting expense,REF16714418,64.48,0.0,213575.15
2023-07-28,2023-07-28,Equipment purchase,REF35456510,129.63,0.0,213445.52
2023-07-29,2023-07-29,Marketing expenses,REF15665791,195.95,0.0,213249.57
2023-08-03,2023-08-03,Business travel,REF42001598,289.31,0.0,212960.26
2023-08-13,2023-08-13,Accounting expense,REF96465806,312.06,0.0,212648.2
2023-08-15,2023-08-15,Service payment - Ayala-French,REF21796479,0.0,303.59,212951.79
2023-08-15,2023-08-15,"Invoice payment - Fuentes, Stephens and Lee",REF55916355,0.0,525.45,213477.24
2023-08-15,2023-08-15,Service payment - Rhodes-Jefferson,REF66287662,0.0,425.29,213902.53
2023-08-15,2023-08-15,"Project payment - Nguyen, Palmer and Gonzalez",REF47525087,0.0,475.25,214377.78
2023-08-15,2023-08-15,Service payment - Schmidt-Moran,REF39024889,0.0,470.27,214848.05
2023-08-15,2023-08-15,Business insurance premium,REF53999082,116.64,0.0,214731.41
2023-08-15,2023-08-15,"Project payment - Rhodes, Schmidt and Benitez",REF47709503,0.0,817.19,215548.6
2023-08-15,2023-08-15,Invoice payment - Neal-Lopez,REF61240053,0.0,531.88,216080.48
2023-08-15,2023-08-15,Service payment - Thomas-Smith,REF94190147,0.0,495.29,216575.77
2023-08-16,2023-08-16,Coworking space rental,REF17675234,153.09,0.0,216422.68
2023-08-18,2023-08-18,Business meal,REF30552008,250.47,0.0,216172.21
2023-08-21,2023-08-21,Professional software license,REF46017531,170.08,0.0,216002.13
2023-08-23,2023-08-23,Marketing expenses,REF49820333,245.44,0.0,215756.69
2023-08-26,2023-08-26,Coworking space rental,REF18908946,231.85,0.0,215524.84
2023-08-27,2023-08-27,Training/conference,REF13792370,270.71,0.0,215254.13
2023-09-03,2023-09-03,Business travel,REF75344832,341.36,0.0,214912.77
2023-09-08,2023-09-08,Business meal,REF36585256,314.43,0.0,214598.34
2023-09-11,2023-09-11,Equipment purchase,REF16105220,126.72,0.0,214471.62
2023-09-13,2023-09-13,Business meal,REF20467344,146.37,0.0,214325.25
2023-09-13,2023-09-13,Business travel,REF81846802,287.41,0.0,214037.84
2023-09-14,2023-09-14,Business travel,REF97366770,526.95,0.0,213510.89
2023-09-15,2023-09-15,Invoice payment - Rhodes-Jefferson,REF98815617,0.0,596.06,214106.95
2023-09-15,2023-09-15,Invoice payment - Thomas-Smith,REF79702151,0.0,664.72,214771.67
2023-09-15,2023-09-15,"Project payment - Rhodes, Schmidt and Benitez",REF80562839,0.0,1044.43,215816.1
2023-09-15,2023-09-15,Business insurance premium,REF60346249,144.42,0.0,215671.68
2023-09-15,2023-09-15,"Invoice payment - Fuentes, Stephens and Lee",REF12038284,0.0,631.22,216302.9
2023-09-15,2023-09-15,"Payment from Nguyen, Palmer and Gonzalez",REF98408766,0.0,667.46,216970.36
2023-09-15,2023-09-15,Service payment - Neal-Lopez,REF69262607,0.0,672.24,217642.6
2023-09-15,2023-09-15,Project payment - Schmidt-Moran,REF61769857,0.0,557.59,218200.19
2023-09-21,2023-09-21,Professional software license,REF66343428,222.04,0.0,217978.15
2023-10-04,2023-10-04,Business meal,REF97071828,327.43,0.0,217650.72
2023-10-05,2023-10-05,Business travel,REF89409715,180.35,0.0,217470.37
2023-10-10,2023-10-10,Business travel,REF48088866,585.87,0.0,216884.5
2023-10-12,2023-10-12,Business meal,REF11193595,251.96,0.0,216632.54
2023-10-14,2023-10-14,Marketing expenses,REF55257028,351.63,0.0,216280.91
2023-10-15,2023-10-15,"Payment from Nguyen, Palmer and Gonzalez",REF73517716,0.0,615.87,216896.78
2023-10-15,2023-10-15,Business insurance premium,REF30162367,161.04,0.0,216735.74
2023-10-15,2023-10-15,Payment from Thomas-Smith,REF34112450,0.0,602.9,217338.64
2023-10-15,2023-10-15,"Invoice payment - Rhodes, Schmidt and Benitez",REF47601903,0.0,1010.15,218348.79
2023-10-15,2023-10-15,Service payment - Rhodes-Jefferson,REF40620357,0.0,715.58,219064.37
2023-10-15,2023-10-15,Invoice payment - Schmidt-Moran,REF15978305,0.0,854.25,219918.62
2023-10-15,2023-10-15,Service payment - Ayala-French,REF80021402,0.0,420.82,220339.44
2023-10-21,2023-10-21,Professional software license,REF78595309,243.33,0.0,220096.11
2023-10-22,2023-10-22,Business travel,REF74854879,397.55,0.0,219698.56
2023-10-24,2023-10-24,Business travel,REF58689490,632.0,0.0,219066.56
2023-11-03,2023-11-03,Marketing expenses,REF39772566,422.01,0.0,218644.55
2023-11-05,2023-11-05,Marketing expenses,REF28154915,332.54,0.0,218312.01
2023-11-14,2023-11-14,Coworking space rental,REF11555233,364.32,0.0,217947.69
2023-11-14,2023-11-14,Training/conference,REF60936718,327.9,0.0,217619.79
2023-11-15,2023-11-15,"Payment from Nguyen, Palmer and Gonzalez",REF81296228,0.0,758.24,218378.03
2023-11-15,2023-11-15,Invoice payment - Ayala-French,REF46669566,0.0,355.85,218733.88
2023-11-15,2023-11-15,Project payment - Rhodes-Jefferson,REF83955025,0.0,551.2,219285.08
2023-11-15,2023-11-15,"Service payment - Rhodes, Schmidt and Benitez",REF33489439,0.0,1016.02,220301.1
2023-11-15,2023-11-15,"Payment from Fuentes, Stephens and Lee",REF95825234,0.0,630.57,220931.67
2023-11-15,2023-11-15,Invoice payment - Thomas-Smith,REF34788413,0.0,552.27,221483.94
2023-11-15,2023-11-15,Payment from Schmidt-Moran,REF76469323,0.0,579.71,222063.65
2023-11-15,2023-11-15,Business insurance premium,REF97997795,155.52,0.0,221908.13
2023-11-21,2023-11-21,Professional software license,REF22648048,221.9,0.0,221686.23
2023-11-27,2023-11-27,Coworking space rental,REF87504548,211.03,0.0,221475.2
2023-11-30,2023-11-30,Equipment purchase,REF47496245,124.41,0.0,221350.79
2023-12-05,2023-12-05,Business meal,REF70939812,329.72,0.0,221021.07
2023-12-11,2023-12-11,Training/conference,REF87202711,220.33,0.0,220800.74
2023-12-13,2023-12-13,Equipment purchase,REF34257989,100.58,0.0,220700.16
2023-12-15,2023-12-15,Invoice payment - Thomas-Smith,REF98406731,0.0,408.77,221108.93
2023-12-15,2023-12-15,Service payment - Neal-Lopez,REF41742172,0.0,469.19,221578.12
2023-12-15,2023-12-15,"Invoice payment - Rhodes, Schmidt and Benitez",REF85497234,0.0,956.81,222534.93
2023-12-15,2023-12-15,Project payment - Schmidt-Moran,REF18330766,0.0,615.45,223150.38
2023-12-15,2023-12-15,Training/conference,REF67373107,242.61,0.0,222907.77
2023-12-15,2023-12-15,Invoice payment - Rhodes-Jefferson,REF44626683,0.0,506.23,223414.0
2023-12-15,2023-12-15,Service payment - Ayala-French,REF89234137,0.0,307.94,223721.94
2023-12-15,2023-12-15,"Payment from Nguyen, Palmer and Gonzalez",REF19136601,0.0,497.29,224219.23
2023-12-15,2023-12-15,"Service payment - Fuentes, Stephens and Lee",REF16034021,0.0,453.5,224672.73
2023-12-15,2023-12-15,Business insurance premium,REF87880304,130.51,0.0,224542.22
2023-12-17,2023-12-17,Business meal,REF34038423,384.53,0.0,224157.69
2023-12-18,2023-12-18,Business meal,REF54153288,149.02,0.0,224008.67
2023-12-19,2023-12-19,Business travel,REF65151965,266.41,0.0,223742.26
2023-12-21,2023-12-21,Professional software license,REF12763514,174.77,0.0,223567.49
2023-12-28,2023-12-28,Coworking space rental,REF83131667,273.23,0.0,223294.26
2023-12-30,2023-12-30,Business travel,REF74481562,295.78,0.0,222998.48
2024-01-04,2024-01-04,Business travel,REF69703357,664.01,0.0,222334.47
2024-01-07,2024-01-07,Business meal,REF80339498,198.9,0.0,222135.57
2024-01-13,2024-01-13,Marketing expenses,REF47243769,391.4,0.0,221744.17
2024-01-15,2024-01-15,"Project payment - Rhodes, Schmidt and Benitez",REF47514710,0.0,1012.69,222756.86
2024-01-15,2024-01-15,"Project payment - Nguyen, Palmer and Gonzalez",REF11364042,0.0,598.87,223355.73
2024-01-15,2024-01-15,Project payment - Ayala-French,REF35317661,0.0,429.48,223785.21
2024-01-15,2024-01-15,Business insurance premium,REF86779892,165.64,0.0,223619.57
2024-01-15,2024-01-15,Invoice payment - Schmidt-Moran,REF16153704,0.0,717.08,224336.65
2024-01-15,2024-01-15,Project payment - Neal-Lopez,REF79620883,0.0,557.72,224894.37
2024-01-15,2024-01-15,"Payment from Fuentes, Stephens and Lee",REF75481743,0.0,625.13,225519.5
2024-01-15,2024-01-15,Project payment - Thomas-Smith,REF41764813,0.0,488.47,226007.97
2024-01-15,2024-01-15,Payment from Rhodes-Jefferson,REF60190132,0.0,551.84,226559.81
2024-01-21,2024-01-21,Professional software license,REF84143414,249.25,0.0,226310.56
2024-01-23,2024-01-23,Training/conference,REF76915438,162.46,0.0,226148.1
2024-01-23,2024-01-23,Business travel,REF60342919,511.26,0.0,225636.84
2024-01-27,2024-01-27,Marketing expenses,REF70661201,540.39,0.0,225096.45
2024-01-30,2024-01-30,Equipment purchase,REF13405348,173.12,0.0,224923.33
2024-02-03,2024-02-03,Marketing expenses,REF31882673,281.85,0.0,224641.48
2024-02-10,2024-02-10,Business travel,REF42058310,385.01,0.0,224256.47
2024-02-10,2024-02-10,Business meal,REF69310359,299.45,0.0,223957.02
2024-02-12,2024-02-12,Business travel,REF93192647,572.64,0.0,223384.38
2024-02-13,2024-02-13,Business travel,REF88471736,304.4,0.0,223079.98
2024-02-15,2024-02-15,Business insurance premium,REF10299316,153.53,0.0,222926.45
2024-02-15,2024-02-15,"Service payment - Fuentes, Stephens and Lee",REF24043565,0.0,544.58,223471.03
2024-02-15,2024-02-15,"Invoice payment - Nguyen, Palmer and Gonzalez",REF69348728,0.0,738.19,224209.22
2024-02-15,2024-02-15,Service payment - Thomas-Smith,REF76213644,0.0,362.19,224571.41
2024-02-15,2024-02-15,Project payment - Ayala-French,REF47881121,0.0,339.41,224910.82
2024-02-15,2024-02-15,Invoice payment - Neal-Lopez,REF75602952,0.0,588.1,225498.92
2024-02-15,2024-02-15,Invoice payment - Schmidt-Moran,REF76290678,0.0,811.13,226310.05
2024-02-15,2024-02-15,Service payment - Rhodes-Jefferson,REF75482933,0.0,533.46,226843.51
2024-02-16,2024-02-16,Business travel,REF69657723,280.34,0.0,226563.17
2024-02-17,2024-02-17,Marketing expenses,REF24208880,250.05,0.0,226313.12
2024-02-21,2024-02-21,Professional software license,REF99855918,226.98,0.0,226086.14
2024-02-23,2024-02-23,Business travel,REF77370994,301.08,0.0,225785.06
2024-02-24,2024-02-24,Accounting expense,REF51284838,244.01,0.0,225541.05
2024-03-06,2024-03-06,Marketing expenses,REF55211851,423.81,0.0,225117.24
2024-03-08,2024-03-08,Business travel,REF88678087,403.14,0.0,224714.1
2024-03-10,2024-03-10,Equipment purchase,REF31269326,125.08,0.0,224589.02
2024-03-12,2024-03-12,Marketing expenses,REF45132713,159.37,0.0,224429.65
2024-03-15,2024-03-15,Service payment - Ayala-French,REF18774210,0.0,349.55,224779.2
2024-03-15,2024-03-15,Service payment - Neal-Lopez,REF71072785,0.0,583.03,225362.23
2024-03-15,2024-03-15,"Project payment - Rhodes, Schmidt and Benitez",REF69854144,0.0,943.34,226305.57
2024-03-15,2024-03-15,Project payment - Rhodes-Jefferson,REF66920408,0.0,534.02,226839.59
2024-03-15,2024-03-15,Payment from Schmidt-Moran,REF24327666,0.0,606.09,227445.68
2024-03-15,2024-03-15,"Project payment - Nguyen, Palmer and Gonzalez",REF65510193,0.0,611.27,228056.95
2024-03-15,2024-03-15,Project payment - Thomas-Smith,REF72355013,0.0,458.61,228515.56
2024-03-15,2024-03-15,"Payment from Fuentes, Stephens and Lee",REF26606142,0.0,471.85,228987.41
2024-03-15,2024-03-15,Business insurance premium,REF84381158,144.6,0.0,228842.81
2024-03-19,2024-03-19,Business meal,REF71010223,252.9,0.0,228589.91
2024-03-21,2024-03-21,Professional software license,REF17218317,202.53,0.0,228387.38
2024-03-27,2024-03-27,Business travel,REF51254107,248.52,0.0,228138.86
2024-03-30,2024-03-30,Equipment purchase,REF95143004,123.37,0.0,228015.49
2024-04-02,2024-04-02,Equipment purchase,REF99459833,117.6,0.0,227897.89
2024-04-03,2024-04-03,Equipment purchase,REF62336559,123.85,0.0,227774.04
2024-04-08,2024-04-08,Marketing expenses,REF99880315,244.7,0.0,227529.34
2024-04-08,2024-04-08,Business meal,REF45964174,188.89,0.0,227340.45
2024-04-10,2024-04-10,Business meal,REF22933882,303.27,0.0,227037.18
2024-04-13,2024-04-13,Business travel,REF43278179,574.56,0.0,226462.62
2024-04-14,2024-04-14,Business meal,REF83937741,97.82,0.0,226364.8
2024-04-14,2024-04-14,Equipment purchase,REF31256878,207.48,0.0,226157.32
2024-04-15,2024-04-15,Project payment - Rhodes-Jefferson,REF43730929,0.0,616.61,226773.93
2024-04-15,2024-04-15,"Project payment - Nguyen, Palmer and Gonzalez",REF78065054,0.0,743.58,227517.51
2024-04-15,2024-04-15,Business insurance premium,REF18368292,138.22,0.0,227379.29
2024-04-15,2024-04-15,"Service payment - Rhodes, Schmidt and Benitez",REF51121442,0.0,880.88,228260.17
2024-04-15,2024-04-15,Project payment - Schmidt-Moran,REF80036724,0.0,724.08,228984.25
2024-04-15,2024-04-15,Equipment purchase,REF53031609,252.83,0.0,228731.42
2024-04-15,2024-04-15,Invoice payment - Neal-Lopez,REF88495725,0.0,676.18,229407.6
2024-04-15,2024-04-15,"Project payment - Fuentes, Stephens and Lee",REF80159799,0.0,551.75,229959.35
2024-04-15,2024-04-15,Project payment - Ayala-French,REF37518383,0.0,289.1,230248.45
2024-04-17,2024-04-17,Business meal,REF54466371,339.74,0.0,229908.71
2024-04-20,2024-04-20,Accounting expense,REF45646822,118.08,0.0,229790.63
2024-04-21,2024-04-21,Professional software license,REF21903412,227.35,0.0,229563.28
2024-04-21,2024-04-21,Coworking space rental,REF61488930,261.16,0.0,229302.12
2024-04-27,2024-04-27,Marketing expenses,REF45828198,197.11,0.0,229105.01
2024-04-28,2024-04-28,Business travel,REF29933814,428.94,0.0,228676.07
2024-05-06,2024-05-06,Business travel,REF47258800,294.27,0.0,228381.8
2024-05-07,2024-05-07,Business travel,REF81297050,84.0,0.0,228297.8
2024-05-07,2024-05-07,Marketing expenses,REF40451874,191.35,0.0,228106.45
2024-05-08,2024-05-08,Training/conference,REF24659092,81.34,0.0,228025.11
2024-05-11,2024-05-11,Training/conference,REF69883908,262.56,0.0,227762.55
2024-05-12,2024-05-12,Marketing expenses,REF37353539,260.01,0.0,227502.54
2024-05-12,2024-05-12,Business meal,REF68767758,32.22,0.0,227470.32
2024-05-15,2024-05-15,Business insurance premium,REF78923059,138.92,0.0,227331.4
2024-05-15,2024-05-15,Payment from Neal-Lopez,REF27248050,0.0,347.45,227678.85
2024-05-15,2024-05-15,Project payment - Thomas-Smith,REF38884847,0.0,462.77,228141.62
2024-05-15,2024-05-15,Payment from Ayala-French,REF76601327,0.0,232.9,228374.52
2024-05-15,2024-05-15,Project payment - Rhodes-Jefferson,REF75819065,0.0,462.21,228836.73
2024-05-15,2024-05-15,"Payment from Nguyen, Palmer and Gonzalez",REF56648486,0.0,579.86,229416.59
2024-05-15,2024-05-15,Payment from Schmidt-Moran,REF82810517,0.0,603.94,230020.53
2024-05-15,2024-05-15,"Invoice payment - Rhodes, Schmidt and Benitez",REF79411513,0.0,504.42,230524.95
2024-05-21,2024-05-21,Professional software license,REF75990147,164.32,0.0,230360.63
2024-05-25,2024-05-25,Marketing expenses,REF45012580,429.85,0.0,229930.78
2024-06-02,2024-06-02,Business travel,REF79239679,164.85,0.0,229765.93
2024-06-03,2024-06-03,Accounting expense,REF70190665,207.05,0.0,229558.88
2024-06-03,2024-06-03,Business meal,REF24041275,142.7,0.0,229416.18
2024-06-10,2024-06-10,Equipment purchase,REF31421053,5.0,0.0,229411.18
2024-06-15,2024-06-15,Project payment - Thomas-Smith,REF51034432,0.0,340.73,229751.91
2024-06-15,2024-06-15,Invoice payment - Schmidt-Moran,REF57502100,0.0,523.31,230275.22
2024-06-15,2024-06-15,Business insurance premium,REF86571039,104.05,0.0,230171.17
2024-06-15,2024-06-15,"Payment from Fuentes, Stephens and Lee",REF36426824,0.0,426.68,230597.85
2024-06-15,2024-06-15,"Project payment - Nguyen, Palmer and Gonzalez",REF26892571,0.0,479.53,231077.38
2024-06-15,2024-06-15,Payment from Neal-Lopez,REF11548377,0.0,458.01,231535.39
2024-06-15,2024-06-15,Service payment - Rhodes-Jefferson,REF30756582,0.0,359.78,231895.17
2024-06-15,2024-06-15,Payment from Ayala-French,REF19393468,0.0,172.06,232067.23
2024-06-17,2024-06-17,Equipment purchase,REF48692252,126.13,0.0,231941.1
2024-06-21,2024-06-21,Professional software license,REF49041146,176.96,0.0,231764.14
2024-06-22,2024-06-22,Training/conference,REF91381565,67.12,0.0,231697.02
2024-06-22,2024-06-22,Business travel,REF66091787,445.72,0.0,231251.3
2024-06-26,2024-06-26,Business travel,REF17053443,517.01,0.0,230734.29
2024-07-02,2024-07-02,Business meal,REF21519315,227.52,0.0,230506.77
2024-07-05,2024-07-05,Accounting expense,REF18253469,119.17,0.0,230387.6
2024-07-09,2024-07-09,Business meal,REF26959419,152.68,0.0,230234.92
2024-07-10,2024-07-10,Business travel,REF99072068,351.27,0.0,229883.65
2024-07-12,2024-07-12,Business meal,REF48944107,140.2,0.0,229743.45
2024-07-13,2024-07-13,Accounting expense,REF23744447,84.17,0.0,229659.28
2024-07-15,2024-07-15,"Payment from Fuentes, Stephens and Lee",REF90642923,0.0,348.35,230007.63
2024-07-15,2024-07-15,Payment from Schmidt-Moran,REF75934032,0.0,433.29,230440.92
2024-07-15,2024-07-15,Invoice payment - Ayala-French,REF98873917,0.0,270.12,230711.04
2024-07-15,2024-07-15,Service payment - Thomas-Smith,REF95864388,0.0,251.93,230962.97
2024-07-15,2024-07-15,Invoice payment - Rhodes-Jefferson,REF97007745,0.0,379.34,231342.31
2024-07-15,2024-07-15,Payment from Neal-Lopez,REF58877749,0.0,333.26,231675.57
2024-07-15,2024-07-15,"Project payment - Rhodes, Schmidt and Benitez",REF19052994,0.0,635.01,232310.58
2024-07-15,2024-07-15,Business insurance premium,REF94908092,98.49,0.0,232212.09
2024-07-20,2024-07-20,Business travel,REF10556308,263.11,0.0,231948.98
2024-07-21,2024-07-21,Business travel,REF18532071,443.84,0.0,231505.14
2024-07-21,2024-07-21,Professional software license,REF35087827,134.76,0.0,231370.38
2024-07-22,2024-07-22,Coworking space rental,REF61636024,208.93,0.0,231161.45
2024-07-24,2024-07-24,Training/conference,REF92827543,214.91,0.0,230946.54
2024-08-04,2024-08-04,Marketing expenses,REF66217038,282.69,0.0,230663.85
2024-08-14,2024-08-14,Business travel,REF63288018,518.86,0.0,230144.99
2024-08-15,2024-08-15,"Project payment - Fuentes, Stephens and Lee",REF38242256,0.0,427.31,230572.3
2024-08-15,2024-08-15,Payment from Ayala-French,REF12528088,0.0,257.07,230829.37
2024-08-15,2024-08-15,Service payment - Schmidt-Moran,REF79071664,0.0,536.05,231365.42
2024-08-15,2024-08-15,Payment from Neal-Lopez,REF80048993,0.0,575.92,231941.34
2024-08-15,2024-08-15,"Service payment - Rhodes, Schmidt and Benitez",REF61252056,0.0,690.81,232632.15
2024-08-15,2024-08-15,Invoice payment - Thomas-Smith,REF12904687,0.0,496.36,233128.51
2024-08-15,2024-08-15,Service payment - Rhodes-Jefferson,REF71048495,0.0,508.22,233636.73
2024-08-15,2024-08-15,"Project payment - Nguyen, Palmer and Gonzalez",REF88652192,0.0,425.39,234062.12
2024-08-15,2024-08-15,Business insurance premium,REF82414210,112.34,0.0,233949.78
2013-08-21,2013-08-21,Coworking space rental,REF67304389,260.61,0.0,3853.07
2013-08-21,2013-08-21,Professional software license,REF30600021,163.52,0.0,3689.55
2013-08-23,2013-08-23,Business travel,REF99687067,303.8,0.0,3385.75
2013-08-25,2013-08-25,Marketing expenses,REF51945085,263.05,0.0,3122.7
2013-08-25,2013-08-25,Accounting expense,REF97904584,131.55,0.0,2991.15
2013-08-29,2013-08-29,Marketing expenses,REF17349991,195.75,0.0,2795.4
2013-08-29,2013-08-29,Business meal,REF49772442,254.8,0.0,2540.6
2013-08-30,2013-08-30,Accounting expense,REF54898378,92.2,0.0,2448.4
2013-08-30,2013-08-30,Coworking space rental,REF46226254,254.67,0.0,2193.73
2013-09-02,2013-09-02,Coworking space rental,REF78365736,392.23,0.0,1801.5
2013-09-05,2013-09-05,Training/conference,REF59209960,326.03,0.0,1475.47
2013-09-09,2013-09-09,Marketing expenses,REF89327650,296.71,0.0,1178.76
2013-09-14,2013-09-14,Marketing expenses,REF91601104,313.26,0.0,865.5
2013-09-15,2013-09-15,"Payment from Meyers, Thompson and Cobb",REF64778906,0.0,553.84,1419.34
2013-09-15,2013-09-15,Business insurance premium,REF18612984,171.79,0.0,1247.55
2013-09-15,2013-09-15,Service payment - Wilkins Ltd,REF74597310,0.0,784.15,2031.7
2013-09-15,2013-09-15,Project payment - Benton-Mcdonald,REF82459845,0.0,867.32,2899.02
2013-09-15,2013-09-15,Invoice payment - Green-Reed,REF42233337,0.0,809.67,3708.69
2013-09-15,2013-09-15,Service payment - Miller-Ruiz,REF52593863,0.0,692.78,4401.47
2013-09-15,2013-09-15,"Project payment - Davis, Coleman and Rice",REF52768422,0.0,337.56,4739.03
2013-09-15,2013-09-15,Project payment - Smith and Sons,REF52989871,0.0,1048.88,5787.91
2013-09-15,2013-09-15,"Payment from Parsons, Hamilton and Roberts",REF27085070,0.0,674.25,6462.16
2013-09-17,2013-09-17,Coworking space rental,REF37552671,389.98,0.0,6072.18
2013-09-21,2013-09-21,Professional software license,REF63209732,237.59,0.0,5834.59
2013-09-24,2013-09-24,Business travel,REF73545017,552.7,0.0,5281.89
2013-09-30,2013-09-30,Coworking space rental,REF57360422,273.88,0.0,5008.01
2013-10-01,2013-10-01,Business travel,REF40434878,499.81,0.0,4508.2
2013-10-15,2013-10-15,Business insurance premium,REF24092496,175.51,0.0,4332.69
2013-10-15,2013-10-15,Invoice payment - Miller-Ruiz,REF57998666,0.0,757.08,5089.77
2013-10-15,2013-10-15,Payment from Benton-Mcdonald,REF74287726,0.0,1006.38,6096.15
2013-10-18,2013-10-18,Training/conference,REF30210091,269.91,0.0,5826.24
2013-10-20,2013-10-20,Business meal,REF67710377,450.46,0.0,5375.78
2013-10-21,2013-10-21,Professional software license,REF22169350,228.65,0.0,5147.13
2013-10-27,2013-10-27,Coworking space rental,REF16952102,365.76,0.0,4781.37
2013-10-28,2013-10-28,Business travel,REF41045887,567.91,0.0,4213.46
2013-11-04,2013-11-04,Coworking space rental,REF64849902,359.18,0.0,3854.28
2013-11-05,2013-11-05,Business travel,REF44172566,425.0,0.0,3429.28
2013-11-07,2013-11-07,Business meal,REF71339616,326.11,0.0,3103.17
2013-11-15,2013-11-15,Service payment - Benton-Mcdonald,REF80051036,0.0,1136.95,4240.12
2013-11-15,2013-11-15,Service payment - Smith and Sons,REF11308132,0.0,783.47,5023.59
2013-11-15,2013-11-15,Project payment - Wilkins Ltd,REF15406924,0.0,913.33,5936.92
2013-11-15,2013-11-15,"Payment from Davis, Coleman and Rice",REF74568828,0.0,320.33,6257.25
2013-11-15,2013-11-15,Payment from Miller-Ruiz,REF38478244,0.0,685.01,6942.26
2013-11-15,2013-11-15,Business insurance premium,REF94433331,150.56,0.0,6791.7
2013-11-15,2013-11-15,"Project payment - Meyers, Thompson and Cobb",REF21021473,0.0,494.45,7286.15
2013-11-15,2013-11-15,"Service payment - Parsons, Hamilton and Roberts",REF22925543,0.0,759.1,8045.25
2013-11-18,2013-11-18,Business travel,REF30113697,482.43,0.0,7562.82
2013-11-18,2013-11-18,Training/conference,REF31034239,130.74,0.0,7432.08
2013-11-21,2013-11-21,Professional software license,REF47447614,226.8,0.0,7205.28
2013-11-24,2013-11-24,Training/conference,REF72836649,229.69,0.0,6975.59
2013-11-28,2013-11-28,Training/conference,REF76565424,258.05,0.0,6717.54
2013-12-10,2013-12-10,Business meal,REF44762738,58.39,0.0,6659.15
2013-12-12,2013-12-12,Coworking space rental,REF37384066,313.27,0.0,6345.88
2013-12-15,2013-12-15,Business insurance premium,REF68101953,118.44,0.0,6227.44
2013-12-15,2013-12-15,Project payment - Wilkins Ltd,REF76103801,0.0,1013.47,7240.91
2013-12-15,2013-12-15,Invoice payment - Green-Reed,REF24081102,0.0,563.5,7804.41
2013-12-15,2013-12-15,Invoice payment - Smith and Sons,REF90091841,0.0,844.01,8648.42
2013-12-15,2013-12-15,"Project payment - Davis, Coleman and Rice",REF86014043,0.0,253.75,8902.17
2013-12-15,2013-12-15,"Payment from Meyers, Thompson and Cobb",REF10085349,0.0,500.97,9403.14
2013-12-15,2013-12-15,"Invoice payment - Parsons, Hamilton and Roberts",REF73977029,0.0,723.22,10126.36
2013-12-15,2013-12-15,Invoice payment - Benton-Mcdonald,REF15287007,0.0,681.32,10807.68
2013-12-17,2013-12-17,Coworking space rental,REF48969614,264.16,0.0,10543.52
2013-12-18,2013-12-18,Marketing expenses,REF85068453,201.68,0.0,10341.84
2013-12-18,2013-12-18,Equipment purchase,REF14671275,173.25,0.0,10168.59
2013-12-20,2013-12-20,Business meal,REF51038422,201.84,0.0,9966.75
2013-12-21,2013-12-21,Professional software license,REF35283647,186.34,0.0,9780.41
2013-12-22,2013-12-22,Business meal,REF45302092,282.05,0.0,9498.36
2013-12-24,2013-12-24,Business travel,REF80099862,250.46,0.0,9247.9
2013-12-25,2013-12-25,Business travel,REF48080213,312.97,0.0,8934.93
2013-12-28,2013-12-28,Business meal,REF52303697,226.33,0.0,8708.6
2013-12-28,2013-12-28,Accounting expense,REF59558514,78.04,0.0,8630.56
2013-12-29,2013-12-29,Business travel,REF72677782,462.31,0.0,8168.25
2014-01-04,2014-01-04,Coworking space rental,REF92143803,359.94,0.0,7808.31
2014-01-05,2014-01-05,Equipment purchase,REF20713142,164.84,0.0,7643.47
2014-01-11,2014-01-11,Marketing expenses,REF79763069,293.42,0.0,7350.05
2014-01-15,2014-01-15,Business insurance premium,REF89501029,166.66,0.0,7183.39
2014-01-15,2014-01-15,Payment from Benton-Mcdonald,REF84615306,0.0,754.73,7938.12
2014-01-15,2014-01-15,"Invoice payment - Meyers, Thompson and Cobb",REF10063468,0.0,501.03,8439.15
2014-01-15,2014-01-15,Business meal,REF32837420,260.02,0.0,8179.13
2014-01-15,2014-01-15,Invoice payment - Miller-Ruiz,REF80057182,0.0,810.27,8989.4
2014-01-15,2014-01-15,"Project payment - Davis, Coleman and Rice",REF38368615,0.0,523.32,9512.72
2014-01-15,2014-01-15,"Service payment - Parsons, Hamilton and Roberts",REF25393802,0.0,996.64,10509.36
2014-01-15,2014-01-15,Invoice payment - Wilkins Ltd,REF57188202,0.0,823.18,11332.54
2014-01-15,2014-01-15,Project payment - Green-Reed,REF43500140,0.0,835.13,12167.67
2014-01-15,2014-01-15,Invoice payment - Smith and Sons,REF70708201,0.0,977.87,13145.54
2014-01-18,2014-01-18,Equipment purchase,REF26608943,223.78,0.0,12921.76
2014-01-20,2014-01-20,Coworking space rental,REF46919626,259.75,0.0,12662.01
2014-01-21,2014-01-21,Coworking space rental,REF23417631,397.19,0.0,12264.82
2014-01-21,2014-01-21,Professional software license,REF22168881,235.99,0.0,12028.83
2014-01-22,2014-01-22,Business travel,REF40029281,372.35,0.0,11656.48
2014-01-26,2014-01-26,Accounting expense,REF92598266,254.5,0.0,11401.98
2014-01-27,2014-01-27,Accounting expense,REF57180137,179.15,0.0,11222.83
2014-01-28,2014-01-28,Business travel,REF96606363,272.45,0.0,10950.38
2014-01-31,2014-01-31,Business travel,REF16351969,583.33,0.0,10367.05
2014-02-02,2014-02-02,Business meal,REF88038689,337.06,0.0,10029.99
2014-02-15,2014-02-15,"Payment from Davis, Coleman and Rice",REF41313014,0.0,165.12,10195.11
2014-02-15,2014-02-15,"Service payment - Parsons, Hamilton and Roberts",REF74424627,0.0,852.77,11047.88
2014-02-15,2014-02-15,Invoice payment - Green-Reed,REF65535407,0.0,726.06,11773.94
2014-02-15,2014-02-15,Invoice payment - Benton-Mcdonald,REF37507753,0.0,773.43,12547.37
2014-02-15,2014-02-15,Business insurance premium,REF29291335,159.69,0.0,12387.68
2014-02-15,2014-02-15,Service payment - Miller-Ruiz,REF63326239,0.0,715.25,13102.93
2014-02-15,2014-02-15,Payment from Smith and Sons,REF24546412,0.0,765.7,13868.63
2014-02-15,2014-02-15,Service payment - Wilkins Ltd,REF93780896,0.0,699.96,14568.59
2014-02-15,2014-02-15,"Service payment - Meyers, Thompson and Cobb",REF12971043,0.0,450.11,15018.7
2014-02-19,2014-02-19,Equipment purchase,REF18633970,217.24,0.0,14801.46
2014-02-21,2014-02-21,Professional software license,REF66744414,228.6,0.0,14572.86
2014-02-23,2014-02-23,Business travel,REF75607943,438.95,0.0,14133.91
2014-03-02,2014-03-02,Business meal,REF16753866,77.34,0.0,14056.57
2014-03-03,2014-03-03,Accounting expense,REF54384795,185.65,0.0,13870.92
2014-03-03,2014-03-03,Business travel,REF65868152,223.15,0.0,13647.77
2014-03-09,2014-03-09,Training/conference,REF46698299,147.64,0.0,13500.13
2014-03-12,2014-03-12,Business meal,REF34340915,278.74,0.0,13221.39
2014-03-13,2014-03-13,Business travel,REF73589667,487.88,0.0,12733.51
2014-03-13,2014-03-13,Training/conference,REF70501592,214.96,0.0,12518.55
2014-03-14,2014-03-14,Business meal,REF68351975,251.02,0.0,12267.53
2014-03-15,2014-03-15,Project payment - Smith and Sons,REF26289430,0.0,704.0,12971.53
2014-03-15,2014-03-15,"Invoice payment - Meyers, Thompson and Cobb",REF29279579,0.0,535.36,13506.89
2014-03-15,2014-03-15,Business insurance premium,REF36331144,130.83,0.0,13376.06
2014-03-15,2014-03-15,Payment from Benton-Mcdonald,REF61927648,0.0,1015.96,14392.02
2014-03-15,2014-03-15,"Project payment - Davis, Coleman and Rice",REF62090419,0.0,312.6,14704.62
2014-03-15,2014-03-15,"Service payment - Parsons, Hamilton and Roberts",REF71712877,0.0,1083.15,15787.77
2014-03-15,2014-03-15,Service payment - Wilkins Ltd,REF49208749,0.0,854.08,16641.85
2014-03-15,2014-03-15,Payment from Green-Reed,REF59070031,0.0,708.53,17350.38
2014-03-15,2014-03-15,Coworking space rental,REF67477269,282.52,0.0,17067.86
2014-03-17,2014-03-17,Business meal,REF46293259,188.12,0.0,16879.74
2014-03-21,2014-03-21,Professional software license,REF84737453,198.73,0.0,16681.01
2014-03-22,2014-03-22,Marketing expenses,REF27816818,282.67,0.0,16398.34
2014-03-29,2014-03-29,Equipment purchase,REF15482908,128.26,0.0,16270.08
2014-04-04,2014-04-04,Accounting expense,REF18520249,169.3,0.0,16100.78
2014-04-11,2014-04-11,Coworking space rental,REF95166417,254.63,0.0,15846.15
2014-04-15,2014-04-15,"Payment from Davis, Coleman and Rice",REF81020932,0.0,349.21,16195.36
2014-04-15,2014-04-15,Invoice payment - Smith and Sons,REF51116042,0.0,738.8,16934.16
2014-04-15,2014-04-15,Business insurance premium,REF80009093,134.51,0.0,16799.65
2014-04-15,2014-04-15,Project payment - Benton-Mcdonald,REF58036814,0.0,839.63,17639.28
2014-04-15,2014-04-15,"Payment from Meyers, Thompson and Cobb",REF75374596,0.0,479.54,18118.82
2014-04-15,2014-04-15,Project payment - Miller-Ruiz,REF56631999,0.0,632.07,18750.89
2014-04-15,2014-04-15,Project payment - Green-Reed,REF94076065,0.0,789.51,19540.4
2014-04-15,2014-04-15,"Invoice payment - Parsons, Hamilton and Roberts",REF74284124,0.0,920.34,20460.74
2014-04-15,2014-04-15,Service payment - Wilkins Ltd,REF60122888,0.0,810.43,21271.17
2014-04-16,2014-04-16,Coworking space rental,REF42289482,393.47,0.0,20877.7
2014-04-21,2014-04-21,Professional software license,REF32706412,218.29,0.0,20659.41
2014-04-21,2014-04-21,Business travel,REF37789539,314.78,0.0,20344.63
2014-04-26,2014-04-26,Coworking space rental,REF89290651,288.65,0.0,20055.98
2014-04-28,2014-04-28,Business meal,REF10778747,244.39,0.0,19811.59
2014-04-30,2014-04-30,Training/conference,REF24115504,96.05,0.0,19715.54
2014-04-30,2014-04-30,Business travel,REF27961377,417.32,0.0,19298.22
2014-04-30,2014-04-30,Equipment purchase,REF61223670,178.69,0.0,19119.53
2014-05-01,2014-05-01,Business travel,REF55308996,394.78,0.0,18724.75
2014-05-12,2014-05-12,Business travel,REF13335485,358.48,0.0,18366.27
2014-05-15,2014-05-15,Business insurance premium,REF35690263,122.28,0.0,18243.99
2014-05-15,2014-05-15,Invoice payment - Miller-Ruiz,REF56889775,0.0,661.56,18905.55
2014-05-15,2014-05-15,Payment from Green-Reed,REF79476724,0.0,484.4,19389.95
2014-05-15,2014-05-15,"Service payment - Meyers, Thompson and Cobb",REF34610326,0.0,480.75,19870.7
2014-05-15,2014-05-15,Invoice payment - Wilkins Ltd,REF86021667,0.0,723.29,20593.99
2014-05-15,2014-05-15,"Invoice payment - Davis, Coleman and Rice",REF37851194,0.0,360.36,20954.35
2014-05-15,2014-05-15,Service payment - Benton-Mcdonald,REF74690868,0.0,718.52,21672.87
2014-05-15,2014-05-15,Payment from Smith and Sons,REF24394266,0.0,605.55,22278.42
2014-05-15,2014-05-15,"Payment from Parsons, Hamilton and Roberts",REF81076367,0.0,707.58,22986.0
2014-05-16,2014-05-16,Equipment purchase,REF87709796,122.84,0.0,22863.16
2014-05-21,2014-05-21,Professional software license,REF33179272,205.9,0.0,22657.26
2014-05-29,2014-05-29,Business travel,REF45918967,525.78,0.0,22131.48
2014-05-29,2014-05-29,Equipment purchase,REF56139584,132.62,0.0,21998.86
2014-05-30,2014-05-30,Training/conference,REF38649126,150.71,0.0,21848.15
2014-06-08,2014-06-08,Training/conference,REF96069698,73.02,0.0,21775.13
2014-06-09,2014-06-09,Accounting expense,REF14784623,93.01,0.0,21682.12
2014-06-13,2014-06-13,Accounting expense,REF90306525,227.17,0.0,21454.95
2014-06-14,2014-06-14,Business travel,REF14598467,465.67,0.0,20989.28
2014-06-15,2014-06-15,Business insurance premium,REF23264628,105.33,0.0,20883.95
2014-06-15,2014-06-15,"Project payment - Parsons, Hamilton and Roberts",REF31198779,0.0,831.22,21715.17
2014-06-15,2014-06-15,Project payment - Wilkins Ltd,REF11988142,0.0,726.11,22441.28
2014-06-15,2014-06-15,"Invoice payment - Meyers, Thompson and Cobb",REF71381329,0.0,255.34,22696.62
2014-06-15,2014-06-15,Project payment - Benton-Mcdonald,REF59933386,0.0,683.09,23379.71
2014-06-15,2014-06-15,Payment from Smith and Sons,REF56872285,0.0,721.4,24101.11
2014-06-15,2014-06-15,Project payment - Miller-Ruiz,REF81797639,0.0,581.46,24682.57
2014-06-15,2014-06-15,"Service payment - Davis, Coleman and Rice",REF66559772,0.0,323.45,25006.02
2014-06-16,2014-06-16,Equipment purchase,REF46138906,110.75,0.0,24895.27
2014-06-17,2014-06-17,Training/conference,REF96569058,147.57,0.0,24747.7
2014-06-18,2014-06-18,Business travel,REF46595889,275.3,0.0,24472.4
2014-06-19,2014-06-19,Training/conference,REF82396165,101.67,0.0,24370.73
2014-06-21,2014-06-21,Professional software license,REF32054073,177.97,0.0,24192.76
2014-07-05,2014-07-05,Training/conference,REF80255493,170.91,0.0,24021.85
2014-07-08,2014-07-08,Accounting expense,REF11734924,141.96,0.0,23879.89
2014-07-15,2014-07-15,Project payment - Benton-Mcdonald,REF75478219,0.0,652.02,24531.91
2014-07-15,2014-07-15,Project payment - Miller-Ruiz,REF61161929,0.0,538.11,25070.02
2014-07-15,2014-07-15,Business insurance premium,REF60532951,89.15,0.0,24980.87
2014-07-15,2014-07-15,Business travel,REF23499466,238.93,0.0,24741.94
2014-07-15,2014-07-15,"Payment from Davis, Coleman and Rice",REF48518364,0.0,287.22,25029.16
2014-07-15,2014-07-15,"Payment from Meyers, Thompson and Cobb",REF36238264,0.0,318.36,25347.52
2014-07-15,2014-07-15,Project payment - Green-Reed,REF96871846,0.0,549.23,25896.75
2014-07-15,2014-07-15,"Invoice payment - Parsons, Hamilton and Roberts",REF76327933,0.0,509.38,26406.13
2014-07-15,2014-07-15,Project payment - Wilkins Ltd,REF52332694,0.0,547.79,26953.92
2014-07-17,2014-07-17,Business meal,REF92635922,145.82,0.0,26808.1
2014-07-20,2014-07-20,Accounting expense,REF61144182,88.39,0.0,26719.71
2014-07-21,2014-07-21,Professional software license,REF60293065,149.95,0.0,26569.76
2014-07-28,2014-07-28,Accounting expense,REF85654150,108.83,0.0,26460.93
2014-07-28,2014-07-28,Coworking space rental,REF35621835,284.95,0.0,26175.98
2014-07-29,2014-07-29,Equipment purchase,REF77739772,95.06,0.0,26080.92
2014-07-30,2014-07-30,Training/conference,REF34097210,158.17,0.0,25922.75
2014-08-05,2014-08-05,Accounting expense,REF45250693,179.43,0.0,25743.32
2014-08-07,2014-08-07,Coworking space rental,REF37952151,299.65,0.0,25443.67
2014-08-09,2014-08-09,Business meal,REF18837834,265.86,0.0,25177.81
2014-08-15,2014-08-15,"Project payment - Parsons, Hamilton and Roberts",REF36776459,0.0,793.02,25970.83
2014-08-15,2014-08-15,Business insurance premium,REF19060916,108.99,0.0,25861.84
2014-08-15,2014-08-15,"Invoice payment - Davis, Coleman and Rice",REF95574271,0.0,300.55,26162.39
2014-08-15,2014-08-15,"Invoice payment - Meyers, Thompson and Cobb",REF93925782,0.0,392.96,26555.35
2014-08-15,2014-08-15,Payment from Green-Reed,REF45179373,0.0,420.83,26976.18
2014-08-15,2014-08-15,Payment from Benton-Mcdonald,REF41150103,0.0,656.56,27632.74
2014-08-15,2014-08-15,Invoice payment - Miller-Ruiz,REF93930462,0.0,503.53,28136.27
2014-08-15,2014-08-15,Service payment - Smith and Sons,REF74319529,0.0,593.98,28730.25
2014-08-15,2014-08-15,Invoice payment - Wilkins Ltd,REF40628289,0.0,541.03,29271.28
2014-08-21,2014-08-21,Professional software license,REF18538938,142.92,0.0,29128.36
2014-08-30,2014-08-30,Business travel,REF22599173,402.91,0.0,28725.45
2014-09-09,2014-09-09,Business meal,REF91041282,250.17,0.0,28475.28
2014-09-09,2014-09-09,Marketing expenses,REF36886397,218.29,0.0,28256.99
2014-09-10,2014-09-10,Business travel,REF16372191,453.13,0.0,27803.86
2014-09-14,2014-09-14,Business travel,REF99500211,494.28,0.0,27309.58
2014-09-15,2014-09-15,Invoice payment - Benton-Mcdonald,REF68418538,0.0,868.81,28178.39
2014-09-15,2014-09-15,Payment from Miller-Ruiz,REF76866714,0.0,731.07,28909.46
2014-09-15,2014-09-15,Invoice payment - Green-Reed,REF57801051,0.0,776.84,29686.3
2014-09-15,2014-09-15,"Service payment - Parsons, Hamilton and Roberts",REF36594411,0.0,981.0,30667.3
2014-09-15,2014-09-15,"Invoice payment - Davis, Coleman and Rice",REF13117497,0.0,406.53,31073.83
2014-09-15,2014-09-15,Business insurance premium,REF23186758,162.55,0.0,30911.28
2014-09-15,2014-09-15,Payment from Wilkins Ltd,REF57141731,0.0,702.42,31613.7
2014-09-15,2014-09-15,Service payment - Smith and Sons,REF97501911,0.0,757.6,32371.3
2014-09-15,2014-09-15,"Service payment - Meyers, Thompson and Cobb",REF66333348,0.0,470.49,32841.79
2014-09-21,2014-09-21,Training/conference,REF73476878,187.83,0.0,32653.96
2014-09-21,2014-09-21,Professional software license,REF59434101,223.98,0.0,32429.98
2014-09-22,2014-09-22,Marketing expenses,REF41909444,347.92,0.0,32082.06
2014-09-23,2014-09-23,Accounting expense,REF53443108,347.36,0.0,31734.7
2014-09-23,2014-09-23,Training/conference,REF90693635,219.0,0.0,31515.7
2014-09-24,2014-09-24,Business travel,REF84105086,378.83,0.0,31136.87
2014-09-30,2014-09-30,Training/conference,REF11992529,91.67,0.0,31045.2
2014-10-01,2014-10-01,Marketing expenses,REF83951595,360.89,0.0,30684.31
2014-10-06,2014-10-06,Accounting expense,REF64606940,389.04,0.0,30295.27
2014-10-07,2014-10-07,Equipment purchase,REF15790020,167.53,0.0,30127.74
2014-10-11,2014-10-11,Equipment purchase,REF48992045,251.09,0.0,29876.65
2014-10-11,2014-10-11,Business travel,REF12697861,403.03,0.0,29473.62
2014-10-14,2014-10-14,Business meal,REF59658591,318.16,0.0,29155.46
2014-10-15,2014-10-15,Coworking space rental,REF46657531,437.68,0.0,28717.78
2014-10-15,2014-10-15,"Payment from Meyers, Thompson and Cobb",REF50099490,0.0,710.15,29427.93
2014-10-15,2014-10-15,Payment from Green-Reed,REF25387941,0.0,909.83,30337.76
2014-10-15,2014-10-15,Project payment - Miller-Ruiz,REF90084618,0.0,709.11,31046.87
2014-10-15,2014-10-15,Service payment - Smith and Sons,REF19946602,0.0,980.92,32027.79
2014-10-15,2014-10-15,Business insurance premium,REF62546527,165.36,0.0,31862.43
2014-10-15,2014-10-15,"Project payment - Parsons, Hamilton and Roberts",REF12237195,0.0,824.3,32686.73
2014-10-15,2014-10-15,Service payment - Wilkins Ltd,REF29593405,0.0,854.34,33541.07
2014-10-15,2014-10-15,"Service payment - Davis, Coleman and Rice",REF18961658,0.0,530.35,34071.42
2014-10-19,2014-10-19,Training/conference,REF83609477,306.01,0.0,33765.41
2014-10-20,2014-10-20,Training/conference,REF47330142,124.84,0.0,33640.57
2014-10-21,2014-10-21,Professional software license,REF47750108,242.93,0.0,33397.64
2014-10-23,2014-10-23,Accounting expense,REF13951252,216.73,0.0,33180.91
2014-10-23,2014-10-23,Business travel,REF41683851,436.99,0.0,32743.92
2014-10-28,2014-10-28,Training/conference,REF27757379,312.33,0.0,32431.59
2014-10-30,2014-10-30,Accounting expense,REF36190135,54.69,0.0,32376.9
2014-11-04,2014-11-04,Business meal,REF84314173,153.85,0.0,32223.05
2014-11-15,2014-11-15,Project payment - Smith and Sons,REF81767350,0.0,916.69,33139.74
2014-11-15,2014-11-15,Invoice payment - Benton-Mcdonald,REF24730895,0.0,729.46,33869.2
2014-11-15,2014-11-15,Business insurance premium,REF14707683,150.05,0.0,33719.15
2014-11-15,2014-11-15,"Service payment - Davis, Coleman and Rice",REF68754811,0.0,363.63,34082.78
2014-11-15,2014-11-15,Invoice payment - Miller-Ruiz,REF99785892,0.0,807.09,34889.87
2014-11-15,2014-11-15,"Service payment - Parsons, Hamilton and Roberts",REF96388226,0.0,1192.19,36082.06
2014-11-15,2014-11-15,Payment from Green-Reed,REF52720468,0.0,528.29,36610.35
2014-11-15,2014-11-15,Business meal,REF35410856,183.49,0.0,36426.86
2014-11-16,2014-11-16,Equipment purchase,REF41633253,199.3,0.0,36227.56
2014-11-17,2014-11-17,Equipment purchase,REF64868777,162.63,0.0,36064.93
2014-11-21,2014-11-21,Professional software license,REF29094045,248.3,0.0,35816.63
2014-11-24,2014-11-24,Business travel,REF95703886,478.86,0.0,35337.77
2014-11-24,2014-11-24,Coworking space rental,REF76451966,346.96,0.0,34990.81
2014-11-25,2014-11-25,Accounting expense,REF48937325,188.65,0.0,34802.16
2014-11-25,2014-11-25,Training/conference,REF86784738,282.61,0.0,34519.55
2014-11-28,2014-11-28,Marketing expenses,REF20785162,507.25,0.0,34012.3
2014-12-03,2014-12-03,Business travel,REF27959963,198.89,0.0,33813.41
2014-12-09,2014-12-09,Business meal,REF63976943,324.02,0.0,33489.39
2014-12-12,2014-12-12,Business travel,REF77853421,398.91,0.0,33090.48
2014-12-12,2014-12-12,Business meal,REF15637926,244.5,0.0,32845.98
2014-12-12,2014-12-12,Training/conference,REF63317180,220.45,0.0,32625.53
2014-12-15,2014-12-15,Marketing expenses,REF52054286,206.02,0.0,32419.51
2014-12-15,2014-12-15,Business insurance premium,REF72509640,123.8,0.0,32295.71
2014-12-15,2014-12-15,Payment from Miller-Ruiz,REF83047861,0.0,482.29,32778.0
2014-12-15,2014-12-15,Project payment - Wilkins Ltd,REF57099386,0.0,863.64,33641.64
2014-12-15,2014-12-15,"Invoice payment - Davis, Coleman and Rice",REF41742596,0.0,338.58,33980.22
2014-12-15,2014-12-15,"Service payment - Meyers, Thompson and Cobb",REF93612628,0.0,388.82,34369.04
2014-12-15,2014-12-15,Invoice payment - Smith and Sons,REF68132765,0.0,626.73,34995.77
2014-12-15,2014-12-15,Service payment - Green-Reed,REF86312073,0.0,560.73,35556.5
2014-12-15,2014-12-15,"Invoice payment - Parsons, Hamilton and Roberts",REF43882417,0.0,621.16,36177.66
2014-12-15,2014-12-15,Service payment - Benton-Mcdonald,REF61523002,0.0,558.21,36735.87
2014-12-21,2014-12-21,Professional software license,REF30127961,175.13,0.0,36560.74
2014-12-21,2014-12-21,Coworking space rental,REF32801531,242.65,0.0,36318.09
2014-12-22,2014-12-22,Training/conference,REF17828261,130.52,0.0,36187.57
2014-12-23,2014-12-23,Equipment purchase,REF16573129,88.15,0.0,36099.42
2014-12-26,2014-12-26,Coworking space rental,REF42859337,331.89,0.0,35767.53
2015-01-03,2015-01-03,Business meal,REF82456962,171.71,0.0,35595.82
2015-01-15,2015-01-15,Business insurance premium,REF68563406,172.99,0.0,35422.83
2015-01-15,2015-01-15,Payment from Benton-Mcdonald,REF96270407,0.0,980.77,36403.6
2015-01-15,2015-01-15,Service payment - Miller-Ruiz,REF94063603,0.0,696.14,37099.74
2015-01-15,2015-01-15,"Service payment - Davis, Coleman and Rice",REF97946841,0.0,461.19,37560.93
2015-01-15,2015-01-15,Service payment - Smith and Sons,REF37981322,0.0,1051.33,38612.26
2015-01-15,2015-01-15,Project payment - Green-Reed,REF15120301,0.0,748.38,39360.64
2015-01-15,2015-01-15,"Service payment - Meyers, Thompson and Cobb",REF44839735,0.0,473.94,39834.58
2015-01-15,2015-01-15,"Invoice payment - Parsons, Hamilton and Roberts",REF69100350,0.0,1413.36,41247.94
2015-01-15,2015-01-15,Service payment - Wilkins Ltd,REF55028603,0.0,1113.33,42361.27
2015-01-21,2015-01-21,Professional software license,REF12353427,223.24,0.0,42138.03
2015-02-04,2015-02-04,Marketing expenses,REF92263595,222.22,0.0,41915.81
2015-02-08,2015-02-08,Equipment purchase,REF91817496,80.08,0.0,41835.73
2015-02-13,2015-02-13,Marketing expenses,REF87107356,115.89,0.0,41719.84
2015-02-15,2015-02-15,"Invoice payment - Meyers, Thompson and Cobb",REF39362111,0.0,512.65,42232.49
2015-02-15,2015-02-15,Project payment - Wilkins Ltd,REF69722660,0.0,988.59,43221.08
2015-02-15,2015-02-15,Invoice payment - Green-Reed,REF73701995,0.0,867.88,44088.96
2015-02-15,2015-02-15,Invoice payment - Benton-Mcdonald,REF65482127,0.0,823.91,44912.87
2015-02-15,2015-02-15,Project payment - Miller-Ruiz,REF86823837,0.0,709.85,45622.72
2015-02-15,2015-02-15,"Project payment - Parsons, Hamilton and Roberts",REF58984908,0.0,978.41,46601.13
2015-02-15,2015-02-15,Project payment - Smith and Sons,REF90763439,0.0,886.25,47487.38
2015-02-15,2015-02-15,"Project payment - Davis, Coleman and Rice",REF73103097,0.0,363.02,47850.4
2015-02-15,2015-02-15,Business insurance premium,REF16129212,163.25,0.0,47687.15
2015-02-21,2015-02-21,Business meal,REF25191153,299.65,0.0,47387.5
2015-02-21,2015-02-21,Professional software license,REF57263168,221.59,0.0,47165.91
2015-03-03,2015-03-03,Business travel,REF68458561,284.58,0.0,46881.33
2015-03-14,2015-03-14,Coworking space rental,REF13847304,358.1,0.0,46523.23
2015-03-15,2015-03-15,Service payment - Wilkins Ltd,REF33828503,0.0,779.66,47302.89
2015-03-15,2015-03-15,Payment from Green-Reed,REF38711689,0.0,724.49,48027.38
2015-03-15,2015-03-15,"Service payment - Davis, Coleman and Rice",REF73586323,0.0,297.48,48324.86
2015-03-15,2015-03-15,Invoice payment - Smith and Sons,REF60911067,0.0,622.19,48947.05
2015-03-15,2015-03-15,Business insurance premium,REF60459847,139.11,0.0,48807.94
2015-03-15,2015-03-15,"Payment from Parsons, Hamilton and Roberts",REF75520541,0.0,1091.39,49899.33
2015-03-15,2015-03-15,Invoice payment - Miller-Ruiz,REF81289667,0.0,632.35,50531.68
2015-03-15,2015-03-15,Payment from Benton-Mcdonald,REF21241571,0.0,1001.71,51533.39
2015-03-15,2015-03-15,"Payment from Meyers, Thompson and Cobb",REF23254181,0.0,584.02,52117.41
2015-03-21,2015-03-21,Marketing expenses,REF46042535,404.99,0.0,51712.42
2015-03-21,2015-03-21,Professional software license,REF33432089,227.12,0.0,51485.3
2015-03-30,2015-03-30,Business meal,REF59127192,233.9,0.0,51251.4
2015-04-01,2015-04-01,Equipment purchase,REF31636316,144.92,0.0,51106.48
2015-04-06,2015-04-06,Coworking space rental,REF67520789,400.51,0.0,50705.97
2015-04-09,2015-04-09,Training/conference,REF35393490,314.76,0.0,50391.21
2015-04-09,2015-04-09,Coworking space rental,REF22807918,387.39,0.0,50003.82
2015-04-09,2015-04-09,Marketing expenses,REF17989285,261.4,0.0,49742.42
2015-04-09,2015-04-09,Equipment purchase,REF12506135,167.27,0.0,49575.15
2015-04-10,2015-04-10,Equipment purchase,REF58116012,138.66,0.0,49436.49
2015-04-15,2015-04-15,Service payment - Miller-Ruiz,REF90044841,0.0,575.94,50012.43
2015-04-15,2015-04-15,"Project payment - Parsons, Hamilton and Roberts",REF52299208,0.0,991.8,51004.23
2015-04-15,2015-04-15,Business insurance premium,REF99762234,147.06,0.0,50857.17
2015-04-15,2015-04-15,Project payment - Wilkins Ltd,REF26351888,0.0,889.85,51747.02
2015-04-15,2015-04-15,Payment from Smith and Sons,REF84832563,0.0,909.59,52656.61
2015-04-15,2015-04-15,"Service payment - Davis, Coleman and Rice",REF55165000,0.0,385.9,53042.51
2015-04-15,2015-04-15,"Invoice payment - Meyers, Thompson and Cobb",REF85806557,0.0,404.42,53446.93
2015-04-15,2015-04-15,Service payment - Green-Reed,REF45644678,0.0,765.88,54212.81
2015-04-19,2015-04-19,Training/conference,REF94528136,243.28,0.0,53969.53
2015-04-21,2015-04-21,Professional software license,REF21041093,221.06,0.0,53748.47
2015-05-01,2015-05-01,Equipment purchase,REF83966820,178.75,0.0,53569.72
2015-05-01,2015-05-01,Coworking space rental,REF58967614,107.76,0.0,53461.96
2015-05-06,2015-05-06,Business travel,REF37063950,412.67,0.0,53049.29
2015-05-09,2015-05-09,Coworking space rental,REF48651164,264.89,0.0,52784.4
2015-05-11,2015-05-11,Business travel,REF60968647,292.39,0.0,52492.01
2015-05-15,2015-05-15,Business insurance premium,REF29094914,133.0,0.0,52359.01
2015-05-15,2015-05-15,Payment from Benton-Mcdonald,REF60719717,0.0,684.72,53043.73
2015-05-15,2015-05-15,Project payment - Green-Reed,REF72548307,0.0,751.76,53795.49
2015-05-15,2015-05-15,"Payment from Davis, Coleman and Rice",REF25899637,0.0,236.95,54032.44
2015-05-15,2015-05-15,Service payment - Miller-Ruiz,REF17624712,0.0,551.37,54583.81
2015-05-15,2015-05-15,"Project payment - Meyers, Thompson and Cobb",REF37399342,0.0,541.97,55125.78
2015-05-17,2015-05-17,Business meal,REF43126413,226.41,0.0,54899.37
2015-05-21,2015-05-21,Professional software license,REF48570274,162.22,0.0,54737.15
2015-05-24,2015-05-24,Training/conference,REF75543886,148.46,0.0,54588.69
2015-05-29,2015-05-29,Business travel,REF55280126,452.78,0.0,54135.91
2015-06-01,2015-06-01,Accounting expense,REF93830226,179.19,0.0,53956.72
2015-06-09,2015-06-09,Equipment purchase,REF56242619,133.44,0.0,53823.28
2015-06-11,2015-06-11,Business travel,REF29958638,486.29,0.0,53336.99
2015-06-12,2015-06-12,Training/conference,REF36870146,133.16,0.0,53203.83
2015-06-13,2015-06-13,Coworking space rental,REF71755630,247.76,0.0,52956.07
2015-06-15,2015-06-15,Payment from Wilkins Ltd,REF33718145,0.0,719.44,53675.51
2015-06-15,2015-06-15,"Project payment - Meyers, Thompson and Cobb",REF10556726,0.0,397.23,54072.74
2015-06-15,2015-06-15,"Invoice payment - Parsons, Hamilton and Roberts",REF83769532,0.0,930.18,55002.92
2015-06-15,2015-06-15,"Invoice payment - Davis, Coleman and Rice",REF65881016,0.0,279.55,55282.47
2015-06-15,2015-06-15,Project payment - Green-Reed,REF62615399,0.0,587.43,55869.9
2015-06-15,2015-06-15,Service payment - Benton-Mcdonald,REF19685823,0.0,636.3,56506.2
2015-06-15,2015-06-15,Business insurance premium,REF68484033,111.79,0.0,56394.41
2015-06-15,2015-06-15,Invoice payment - Miller-Ruiz,REF44888029,0.0,553.8,56948.21
2015-06-15,2015-06-15,Service payment - Smith and Sons,REF76271900,0.0,713.91,57662.12
2015-06-21,2015-06-21,Professional software license,REF10848563,169.1,0.0,57493.02
2015-06-21,2015-06-21,Business travel,REF17523228,464.89,0.0,57028.13
2015-06-25,2015-06-25,Coworking space rental,REF19218103,187.83,0.0,56840.3
2015-06-26,2015-06-26,Business meal,REF83941249,282.63,0.0,56557.67
2015-06-27,2015-06-27,Business travel,REF59716763,358.68,0.0,56198.99
2015-07-02,2015-07-02,Marketing expenses,REF52497676,286.5,0.0,55912.49
2015-07-05,2015-07-05,Business meal,REF10664320,155.02,0.0,55757.47
2015-07-09,2015-07-09,Accounting expense,REF42676937,128.63,0.0,55628.84
2015-07-10,2015-07-10,Accounting expense,REF85015987,116.7,0.0,55512.14
2015-07-12,2015-07-12,Business travel,REF14829003,251.25,0.0,55260.89
2015-07-15,2015-07-15,Training/conference,REF77634058,128.18,0.0,55132.71
2015-07-15,2015-07-15,Business meal,REF93888202,205.17,0.0,54927.54
2015-07-15,2015-07-15,"Service payment - Davis, Coleman and Rice",REF58889930,0.0,213.26,55140.8
2015-07-15,2015-07-15,Project payment - Green-Reed,REF60358848,0.0,453.02,55593.82
2015-07-15,2015-07-15,Invoice payment - Smith and Sons,REF88381009,0.0,526.89,56120.71
2015-07-15,2015-07-15,Service payment - Benton-Mcdonald,REF86936639,0.0,660.64,56781.35
2015-07-15,2015-07-15,"Payment from Parsons, Hamilton and Roberts",REF49380999,0.0,699.6,57480.95
2015-07-15,2015-07-15,Payment from Miller-Ruiz,REF61479382,0.0,448.08,57929.03
2015-07-15,2015-07-15,Business insurance premium,REF33513382,101.31,0.0,57827.72
2015-07-19,2015-07-19,Business meal,REF13549918,135.87,0.0,57691.85
2015-07-21,2015-07-21,Professional software license,REF50145971,148.32,0.0,57543.53
2015-07-25,2015-07-25,Marketing expenses,REF86847840,157.83,0.0,57385.7
2015-07-28,2015-07-28,Marketing expenses,REF77070885,237.69,0.0,57148.01
2015-07-29,2015-07-29,Business meal,REF44792827,221.29,0.0,56926.72
2015-08-01,2015-08-01,Coworking space rental,REF18026594,226.07,0.0,56700.65
2015-08-02,2015-08-02,Training/conference,REF44277306,170.49,0.0,56530.16
2015-08-09,2015-08-09,Business meal,REF65159674,216.37,0.0,56313.79
2015-08-11,2015-08-11,Training/conference,REF49970334,313.83,0.0,55999.96
2015-08-13,2015-08-13,Marketing expenses,REF77702329,228.05,0.0,55771.91
2015-08-15,2015-08-15,"Invoice payment - Meyers, Thompson and Cobb",REF33584471,0.0,496.08,56267.99
2015-08-15,2015-08-15,Project payment - Miller-Ruiz,REF12482759,0.0,441.55,56709.54
2015-08-15,2015-08-15,Payment from Green-Reed,REF62904345,0.0,580.55,57290.09
2015-08-15,2015-08-15,"Payment from Parsons, Hamilton and Roberts",REF65569964,0.0,707.84,57997.93
2015-08-15,2015-08-15,Service payment - Benton-Mcdonald,REF98730662,0.0,549.11,58547.04
2015-08-15,2015-08-15,"Invoice payment - Davis, Coleman and Rice",REF82070937,0.0,263.14,58810.18
2015-08-15,2015-08-15,Project payment - Wilkins Ltd,REF59377576,0.0,574.21,59384.39
2015-08-15,2015-08-15,Invoice payment - Smith and Sons,REF90294523,0.0,599.65,59984.04
2015-08-15,2015-08-15,Business insurance premium,REF85695967,98.42,0.0,59885.62
2015-08-21,2015-08-21,Professional software license,REF12842159,146.27,0.0,59739.35
2015-08-27,2015-08-27,Marketing expenses,REF83848027,194.05,0.0,59545.3
2015-09-05,2015-09-05,Business travel,REF35944769,255.04,0.0,59290.26
2015-09-08,2015-09-08,Coworking space rental,REF94354674,295.45,0.0,58994.81
2015-09-15,2015-09-15,"Service payment - Davis, Coleman and Rice",REF75230495,0.0,427.98,59422.79
2015-09-15,2015-09-15,Service payment - Green-Reed,REF66983074,0.0,888.68,60311.47
2015-09-15,2015-09-15,"Invoice payment - Parsons, Hamilton and Roberts",REF65573811,0.0,981.0,61292.47
2015-09-15,2015-09-15,Payment from Wilkins Ltd,REF29566970,0.0,785.7,62078.17
2015-09-15,2015-09-15,"Payment from Meyers, Thompson and Cobb",REF10055635,0.0,522.97,62601.14
2015-09-15,2015-09-15,Business insurance premium,REF95908439,154.66,0.0,62446.48
2015-09-15,2015-09-15,Payment from Benton-Mcdonald,REF83644219,0.0,909.08,63355.56
2015-09-15,2015-09-15,Project payment - Smith and Sons,REF29388389,0.0,766.39,64121.95
2015-09-15,2015-09-15,Invoice payment - Miller-Ruiz,REF21464465,0.0,649.99,64771.94
2015-09-20,2015-09-20,Training/conference,REF32676182,274.01,0.0,64497.93
2015-09-21,2015-09-21,Professional software license,REF66739829,249.98,0.0,64247.95
2015-09-22,2015-09-22,Marketing expenses,REF76528491,454.06,0.0,63793.89
2015-09-26,2015-09-26,Business travel,REF16107087,464.55,0.0,63329.34
2015-09-28,2015-09-28,Business meal,REF83718430,295.19,0.0,63034.15
2015-09-29,2015-09-29,Business meal,REF36693733,81.16,0.0,62952.99
2015-09-30,2015-09-30,Business travel,REF68431707,287.51,0.0,62665.48
2015-10-01,2015-10-01,Business travel,REF97835192,613.95,0.0,62051.53
2015-10-06,2015-10-06,Business meal,REF51555313,284.5,0.0,61767.03
2015-10-09,2015-10-09,Marketing expenses,REF42380854,499.7,0.0,61267.33
2015-10-11,2015-10-11,Business travel,REF37959366,626.35,0.0,60640.98
2015-10-11,2015-10-11,Business meal,REF95098822,303.89,0.0,60337.09
2015-10-14,2015-10-14,Training/conference,REF60007560,288.93,0.0,60048.16
2015-10-15,2015-10-15,"Invoice payment - Davis, Coleman and Rice",REF18215133,0.0,373.8,60421.96
2015-10-15,2015-10-15,Project payment - Green-Reed,REF77655123,0.0,818.46,61240.42
2015-10-15,2015-10-15,Payment from Benton-Mcdonald,REF47168429,0.0,878.8,62119.22
2015-10-15,2015-10-15,Service payment - Miller-Ruiz,REF13556660,0.0,982.94,63102.16
2015-10-15,2015-10-15,Invoice payment - Smith and Sons,REF81970093,0.0,786.69,63888.85
2015-10-15,2015-10-15,"Service payment - Parsons, Hamilton and Roberts",REF23912972,0.0,1197.27,65086.12
2015-10-15,2015-10-15,Invoice payment - Wilkins Ltd,REF16129290,0.0,871.13,65957.25
2015-10-15,2015-10-15,"Service payment - Meyers, Thompson and Cobb",REF30091292,0.0,733.6,66690.85
2015-10-15,2015-10-15,Business insurance premium,REF75534346,156.69,0.0,66534.16
2015-10-16,2015-10-16,Business meal,REF44021761,181.88,0.0,66352.28
2015-10-18,2015-10-18,Equipment purchase,REF99269305,219.24,0.0,66133.04
2015-10-21,2015-10-21,Professional software license,REF50222070,291.04,0.0,65842.0
2015-10-26,2015-10-26,Coworking space rental,REF79829073,386.6,0.0,65455.4
2015-11-03,2015-11-03,Business meal,REF37298233,310.91,0.0,65144.49
2015-11-06,2015-11-06,Business travel,REF18797209,413.09,0.0,64731.4
2015-11-10,2015-11-10,Business meal,REF16049390,239.55,0.0,64491.85
2015-11-13,2015-11-13,Business meal,REF36937159,354.11,0.0,64137.74
2015-11-13,2015-11-13,Marketing expenses,REF16207098,214.98,0.0,63922.76
2015-11-14,2015-11-14,Equipment purchase,REF71968633,187.78,0.0,63734.98
2015-11-15,2015-11-15,Project payment - Green-Reed,REF98029003,0.0,951.8,64686.78
2015-11-15,2015-11-15,Payment from Smith and Sons,REF19518124,0.0,822.02,65508.8
2015-11-15,2015-11-15,Business insurance premium,REF29108363,155.96,0.0,65352.84
2015-11-15,2015-11-15,"Invoice payment - Meyers, Thompson and Cobb",REF34605525,0.0,514.15,65866.99
2015-11-15,2015-11-15,"Invoice payment - Parsons, Hamilton and Roberts",REF44871744,0.0,1032.09,66899.08
2015-11-15,2015-11-15,Payment from Wilkins Ltd,REF98500406,0.0,959.94,67859.02
2015-11-15,2015-11-15,"Project payment - Davis, Coleman and Rice",REF19814131,0.0,368.46,68227.48
2015-11-15,2015-11-15,Project payment - Miller-Ruiz,REF81530671,0.0,808.32,69035.8
2015-11-17,2015-11-17,Business meal,REF30228349,341.63,0.0,68694.17
2015-11-21,2015-11-21,Professional software license,REF19327905,261.05,0.0,68433.12
2015-11-30,2015-11-30,Equipment purchase,REF93282779,177.97,0.0,68255.15
2015-12-02,2015-12-02,Coworking space rental,REF26345281,226.28,0.0,68028.87
2015-12-02,2015-12-02,Equipment purchase,REF48729726,65.26,0.0,67963.61
2015-12-02,2015-12-02,Accounting expense,REF23525722,181.98,0.0,67781.63
2015-12-05,2015-12-05,Equipment purchase,REF24220268,56.13,0.0,67725.5
2015-12-09,2015-12-09,Business meal,REF44504533,320.71,0.0,67404.79
2015-12-10,2015-12-10,Business travel,REF11086703,418.63,0.0,66986.16
2015-12-12,2015-12-12,Business travel,REF76824445,259.73,0.0,66726.43
2015-12-15,2015-12-15,"Service payment - Davis, Coleman and Rice",REF81901996,0.0,363.23,67089.66
2015-12-15,2015-12-15,Service payment - Benton-Mcdonald,REF38350682,0.0,625.2,67714.86
2015-12-15,2015-12-15,Service payment - Green-Reed,REF18115172,0.0,641.61,68356.47
2015-12-15,2015-12-15,Project payment - Smith and Sons,REF57590575,0.0,570.57,68927.04
2015-12-15,2015-12-15,Business insurance premium,REF98509158,129.36,0.0,68797.68
2015-12-15,2015-12-15,"Service payment - Parsons, Hamilton and Roberts",REF17246818,0.0,928.78,69726.46
2015-12-15,2015-12-15,Service payment - Wilkins Ltd,REF63465482,0.0,933.56,70660.02
2015-12-15,2015-12-15,Invoice payment - Miller-Ruiz,REF75382127,0.0,654.17,71314.19
2015-12-15,2015-12-15,"Service payment - Meyers, Thompson and Cobb",REF91913029,0.0,489.62,71803.81
2015-12-20,2015-12-20,Equipment purchase,REF78222221,84.42,0.0,71719.39
2015-12-21,2015-12-21,Professional software license,REF63171877,218.32,0.0,71501.07
2015-12-24,2015-12-24,Training/conference,REF92270208,93.93,0.0,71407.14
2015-12-24,2015-12-24,Business meal,REF76102150,136.6,0.0,71270.54
2015-12-24,2015-12-24,Coworking space rental,REF30786416,246.56,0.0,71023.98
2015-12-30,2015-12-30,Accounting expense,REF36215623,172.28,0.0,70851.7
2015-12-31,2015-12-31,Business travel,REF71552622,556.32,0.0,70295.38
2016-01-02,2016-01-02,Equipment purchase,REF76317182,96.29,0.0,70199.09
2016-01-03,2016-01-03,Training/conference,REF50141823,403.95,0.0,69795.14
2016-01-03,2016-01-03,Business travel,REF73412718,714.37,0.0,69080.77
2016-01-05,2016-01-05,Accounting expense,REF33109181,263.88,0.0,68816.89
2016-01-06,2016-01-06,Training/conference,REF81780937,232.67,0.0,68584.22
2016-01-08,2016-01-08,Business meal,REF64425308,151.03,0.0,68433.19
2016-01-10,2016-01-10,Coworking space rental,REF95461012,463.29,0.0,67969.9
2016-01-12,2016-01-12,Business travel,REF52622987,498.3,0.0,67471.6
2016-01-12,2016-01-12,Equipment purchase,REF48684563,216.09,0.0,67255.51
2016-01-13,2016-01-13,Equipment purchase,REF56984828,212.44,0.0,67043.07
2016-01-15,2016-01-15,Invoice payment - Benton-Mcdonald,REF42074569,0.0,872.79,67915.86
2016-01-15,2016-01-15,Invoice payment - Green-Reed,REF94138483,0.0,793.56,68709.42
2016-01-15,2016-01-15,Invoice payment - Miller-Ruiz,REF69345364,0.0,696.48,69405.9
2016-01-15,2016-01-15,"Project payment - Parsons, Hamilton and Roberts",REF54900933,0.0,1160.67,70566.57
2016-01-15,2016-01-15,Business insurance premium,REF42240016,159.65,0.0,70406.92
2016-01-15,2016-01-15,Project payment - Smith and Sons,REF78302694,0.0,916.46,71323.38
2016-01-15,2016-01-15,Payment from Wilkins Ltd,REF50303295,0.0,1126.24,72449.62
2016-01-15,2016-01-15,"Invoice payment - Davis, Coleman and Rice",REF94022698,0.0,447.28,72896.9
2016-01-18,2016-01-18,Accounting expense,REF65339633,199.37,0.0,72697.53
2016-01-19,2016-01-19,Business meal,REF73955569,456.96,0.0,72240.57
2016-01-21,2016-01-21,Professional software license,REF83722685,265.85,0.0,71974.72
2016-01-24,2016-01-24,Business travel,REF46065049,362.1,0.0,71612.62
2016-01-30,2016-01-30,Business meal,REF20474326,366.52,0.0,71246.1
2016-01-30,2016-01-30,Business travel,REF97135551,637.08,0.0,70609.02
2016-02-03,2016-02-03,Business meal,REF17812115,289.78,0.0,70319.24
2016-02-05,2016-02-05,Marketing expenses,REF53849032,185.46,0.0,70133.78
2016-02-05,2016-02-05,Training/conference,REF69872604,230.72,0.0,69903.06
2016-02-10,2016-02-10,Business meal,REF11929550,243.48,0.0,69659.58
2016-02-15,2016-02-15,"Payment from Meyers, Thompson and Cobb",REF63728775,0.0,446.29,70105.87
2016-02-15,2016-02-15,Project payment - Miller-Ruiz,REF55472920,0.0,749.15,70855.02
2016-02-15,2016-02-15,Invoice payment - Benton-Mcdonald,REF93835855,0.0,706.29,71561.31
2016-02-15,2016-02-15,"Payment from Davis, Coleman and Rice",REF41278922,0.0,464.88,72026.19
2016-02-15,2016-02-15,Payment from Smith and Sons,REF93525594,0.0,949.43,72975.62
2016-02-15,2016-02-15,Project payment - Wilkins Ltd,REF48767125,0.0,1123.56,74099.18
2016-02-15,2016-02-15,"Payment from Parsons, Hamilton and Roberts",REF73056557,0.0,827.39,74926.57
2016-02-15,2016-02-15,Business insurance premium,REF52067097,156.35,0.0,74770.22
2016-02-15,2016-02-15,Business meal,REF80992725,190.08,0.0,74580.14
2016-02-21,2016-02-21,Accounting expense,REF27045138,253.56,0.0,74326.58
2016-02-21,2016-02-21,Professional software license,REF31254005,215.08,0.0,74111.5
2016-02-22,2016-02-22,Accounting expense,REF61854058,245.75,0.0,73865.75
2016-02-23,2016-02-23,Equipment purchase,REF62724593,185.09,0.0,73680.66
2016-03-03,2016-03-03,Coworking space rental,REF95948684,217.81,0.0,73462.85
2016-03-10,2016-03-10,Business travel,REF57145402,121.69,0.0,73341.16
2016-03-14,2016-03-14,Accounting expense,REF68761656,223.47,0.0,73117.69
2016-03-15,2016-03-15,Business insurance premium,REF90279437,132.96,0.0,72984.73
2016-03-15,2016-03-15,Training/conference,REF80687865,184.77,0.0,72799.96
2016-03-15,2016-03-15,Service payment - Wilkins Ltd,REF30402007,0.0,665.78,73465.74
2016-03-15,2016-03-15,Invoice payment - Smith and Sons,REF79583645,0.0,756.91,74222.65
2016-03-15,2016-03-15,Payment from Benton-Mcdonald,REF91902232,0.0,994.61,75217.26
2016-03-15,2016-03-15,"Payment from Parsons, Hamilton and Roberts",REF73348003,0.0,753.64,75970.9
2016-03-15,2016-03-15,Payment from Miller-Ruiz,REF21226253,0.0,814.75,76785.65
2016-03-20,2016-03-20,Coworking space rental,REF73171139,134.39,0.0,76651.26
2016-03-21,2016-03-21,Professional software license,REF12257662,223.14,0.0,76428.12
2016-03-23,2016-03-23,Business travel,REF82322441,502.81,0.0,75925.31
2016-03-26,2016-03-26,Business meal,REF32262748,202.41,0.0,75722.9
2016-04-15,2016-04-15,Project payment - Miller-Ruiz,REF90692113,0.0,655.52,76378.42
2016-04-15,2016-04-15,"Invoice payment - Meyers, Thompson and Cobb",REF40231820,0.0,644.8,77023.22
2016-04-15,2016-04-15,Payment from Benton-Mcdonald,REF37649916,0.0,622.32,77645.54
2016-04-15,2016-04-15,"Invoice payment - Davis, Coleman and Rice",REF21290646,0.0,437.18,78082.72
2016-04-15,2016-04-15,Business insurance premium,REF47605318,138.95,0.0,77943.77
2016-04-15,2016-04-15,"Project payment - Parsons, Hamilton and Roberts",REF96766665,0.0,870.74,78814.51
2016-04-15,2016-04-15,Project payment - Wilkins Ltd,REF24345556,0.0,777.05,79591.56
2016-04-15,2016-04-15,Service payment - Smith and Sons,REF82290564,0.0,763.55,80355.11
2016-04-16,2016-04-16,Marketing expenses,REF91640715,402.55,0.0,79952.56
2016-04-18,2016-04-18,Business meal,REF79722648,244.73,0.0,79707.83
2016-04-21,2016-04-21,Professional software license,REF51187706,214.55,0.0,79493.28
2016-04-21,2016-04-21,Marketing expenses,REF92035700,281.89,0.0,79211.39
2016-04-23,2016-04-23,Business travel,REF21952919,377.91,0.0,78833.48
2016-04-24,2016-04-24,Equipment purchase,REF40963509,161.96,0.0,78671.52
2016-04-26,2016-04-26,Business travel,REF87219874,302.43,0.0,78369.09
2016-04-29,2016-04-29,Training/conference,REF70546135,190.63,0.0,78178.46
2016-05-08,2016-05-08,Business meal,REF39617147,269.69,0.0,77908.77
2016-05-08,2016-05-08,Business travel,REF80729138,264.55,0.0,77644.22
2016-05-09,2016-05-09,Accounting expense,REF79611605,296.02,0.0,77348.2
2016-05-11,2016-05-11,Accounting expense,REF28371915,140.18,0.0,77208.02
2016-05-15,2016-05-15,Business insurance premium,REF78985401,121.93,0.0,77086.09
2016-05-15,2016-05-15,Equipment purchase,REF50644127,93.77,0.0,76992.32
2016-05-15,2016-05-15,"Payment from Davis, Coleman and Rice",REF64354578,0.0,321.42,77313.74
2016-05-15,2016-05-15,Payment from Green-Reed,REF48418619,0.0,661.56,77975.3
2016-05-15,2016-05-15,Invoice payment - Benton-Mcdonald,REF59309412,0.0,733.63,78708.93
2016-05-15,2016-05-15,Service payment - Miller-Ruiz,REF29321977,0.0,513.53,79222.46
2016-05-15,2016-05-15,Project payment - Wilkins Ltd,REF74863276,0.0,855.35,80077.81
2016-05-15,2016-05-15,"Payment from Parsons, Hamilton and Roberts",REF19306485,0.0,787.73,80865.54
2016-05-15,2016-05-15,"Payment from Meyers, Thompson and Cobb",REF98708798,0.0,242.7,81108.24
2016-05-15,2016-05-15,Project payment - Smith and Sons,REF16278639,0.0,737.31,81845.55
2016-05-21,2016-05-21,Marketing expenses,REF58502209,376.99,0.0,81468.56
2016-05-21,2016-05-21,Training/conference,REF66655649,162.42,0.0,81306.14
2016-05-21,2016-05-21,Professional software license,REF37370137,165.24,0.0,81140.9
2016-05-27,2016-05-27,Training/conference,REF30923898,149.55,0.0,80991.35
2016-05-28,2016-05-28,Accounting expense,REF68056913,230.68,0.0,80760.67
2016-05-28,2016-05-28,Business meal,REF23134282,235.63,0.0,80525.04
2016-05-30,2016-05-30,Business meal,REF97237351,249.14,0.0,80275.9
2016-05-31,2016-05-31,Training/conference,REF77916520,156.57,0.0,80119.33
2016-05-31,2016-05-31,Business travel,REF21682867,456.69,0.0,79662.64
2016-06-04,2016-06-04,Coworking space rental,REF37201812,5.0,0.0,79657.64
2016-06-07,2016-06-07,Business travel,REF43819693,329.25,0.0,79328.39
2016-06-08,2016-06-08,Business travel,REF68889944,352.87,0.0,78975.52
2016-06-09,2016-06-09,Business travel,REF48406193,321.78,0.0,78653.74
2016-06-13,2016-06-13,Business meal,REF94780828,265.51,0.0,78388.23
2016-06-13,2016-06-13,Training/conference,REF83246409,150.55,0.0,78237.68
2016-06-15,2016-06-15,"Payment from Davis, Coleman and Rice",REF81911043,0.0,277.56,78515.24
2016-06-15,2016-06-15,Invoice payment - Miller-Ruiz,REF63808394,0.0,599.82,79115.06
2016-06-15,2016-06-15,"Service payment - Parsons, Hamilton and Roberts",REF23731642,0.0,598.83,79713.89
2016-06-15,2016-06-15,Project payment - Smith and Sons,REF70577106,0.0,665.26,80379.15
2016-06-15,2016-06-15,Project payment - Wilkins Ltd,REF25655600,0.0,771.91,81151.06
2016-06-15,2016-06-15,Business insurance premium,REF34123557,109.86,0.0,81041.2
2016-06-15,2016-06-15,Service payment - Green-Reed,REF62943811,0.0,315.48,81356.68
2016-06-15,2016-06-15,Project payment - Benton-Mcdonald,REF35021201,0.0,848.17,82204.85
2016-06-15,2016-06-15,"Project payment - Meyers, Thompson and Cobb",REF99019363,0.0,317.32,82522.17
2016-06-19,2016-06-19,Coworking space rental,REF84877832,317.82,0.0,82204.35
2016-06-21,2016-06-21,Business meal,REF85630313,225.31,0.0,81979.04
2016-06-21,2016-06-21,Professional software license,REF27048291,184.18,0.0,81794.86
2016-06-24,2016-06-24,Business meal,REF34139417,256.17,0.0,81538.69
2016-06-26,2016-06-26,Business travel,REF89988444,153.08,0.0,81385.61
2016-06-29,2016-06-29,Coworking space rental,REF71319633,218.05,0.0,81167.56
2016-07-02,2016-07-02,Coworking space rental,REF64103106,202.83,0.0,80964.73
2016-07-07,2016-07-07,Accounting expense,REF99418178,196.67,0.0,80768.06
2016-07-10,2016-07-10,Accounting expense,REF62690868,194.34,0.0,80573.72
2016-07-15,2016-07-15,"Invoice payment - Parsons, Hamilton and Roberts",REF49423371,0.0,725.69,81299.41
2016-07-15,2016-07-15,Payment from Green-Reed,REF86824718,0.0,543.94,81843.35
2016-07-15,2016-07-15,Project payment - Miller-Ruiz,REF13951907,0.0,454.97,82298.32
2016-07-15,2016-07-15,Business insurance premium,REF98705085,94.71,0.0,82203.61
2016-07-15,2016-07-15,"Invoice payment - Meyers, Thompson and Cobb",REF53144497,0.0,288.5,82492.11
2016-07-15,2016-07-15,Payment from Wilkins Ltd,REF92696704,0.0,542.58,83034.69
2016-07-15,2016-07-15,Project payment - Benton-Mcdonald,REF31140298,0.0,664.25,83698.94
2016-07-15,2016-07-15,"Invoice payment - Davis, Coleman and Rice",REF31288252,0.0,209.99,83908.93
2016-07-15,2016-07-15,Invoice payment - Smith and Sons,REF62743441,0.0,627.82,84536.75
2016-07-17,2016-07-17,Business meal,REF76596139,112.42,0.0,84424.33
2016-07-20,2016-07-20,Coworking space rental,REF85024974,196.06,0.0,84228.27
2016-07-21,2016-07-21,Professional software license,REF50731425,144.82,0.0,84083.45
2016-07-22,2016-07-22,Accounting expense,REF39105484,181.34,0.0,83902.11
2016-07-24,2016-07-24,Training/conference,REF89252015,133.97,0.0,83768.14
2016-07-31,2016-07-31,Business travel,REF28311765,217.77,0.0,83550.37
2016-08-02,2016-08-02,Accounting expense,REF59257113,157.7,0.0,83392.67
2016-08-03,2016-08-03,Coworking space rental,REF41671606,264.23,0.0,83128.44
2016-08-05,2016-08-05,Equipment purchase,REF37593239,42.2,0.0,83086.24
2016-08-09,2016-08-09,Business travel,REF80237480,140.16,0.0,82946.08
2016-08-15,2016-08-15,"Project payment - Davis, Coleman and Rice",REF14815614,0.0,274.22,83220.3
2016-08-15,2016-08-15,Project payment - Miller-Ruiz,REF35032677,0.0,517.92,83738.22
2016-08-15,2016-08-15,Payment from Green-Reed,REF34238770,0.0,476.74,84214.96
2016-08-15,2016-08-15,"Invoice payment - Parsons, Hamilton and Roberts",REF30879891,0.0,674.41,84889.37
2016-08-15,2016-08-15,Project payment - Benton-Mcdonald,REF75955875,0.0,674.21,85563.58
2016-08-15,2016-08-15,Project payment - Smith and Sons,REF62822858,0.0,639.71,86203.29
2016-08-15,2016-08-15,Business insurance premium,REF21815357,109.18,0.0,86094.11
2016-08-17,2016-08-17,Equipment purchase,REF44511247,44.57,0.0,86049.54
2016-08-17,2016-08-17,Business meal,REF54831103,143.61,0.0,85905.93
2016-08-21,2016-08-21,Professional software license,REF60742199,138.35,0.0,85767.58
2016-08-26,2016-08-26,Equipment purchase,REF88589831,90.0,0.0,85677.58
2016-08-28,2016-08-28,Business travel,REF65084736,332.1,0.0,85345.48
2016-09-06,2016-09-06,Equipment purchase,REF91602945,211.51,0.0,85133.97
2016-09-08,2016-09-08,Marketing expenses,REF10972268,393.95,0.0,84740.02
2016-09-09,2016-09-09,Marketing expenses,REF48689149,487.67,0.0,84252.35
2016-09-11,2016-09-11,Equipment purchase,REF58224170,235.59,0.0,84016.76
2016-09-15,2016-09-15,Business insurance premium,REF18348909,161.24,0.0,83855.52
2016-09-15,2016-09-15,Project payment - Green-Reed,REF45223754,0.0,776.44,84631.96
2016-09-15,2016-09-15,"Invoice payment - Meyers, Thompson and Cobb",REF65697228,0.0,496.35,85128.31
2016-09-15,2016-09-15,"Service payment - Parsons, Hamilton and Roberts",REF47681437,0.0,1090.47,86218.78
2016-09-15,2016-09-15,Invoice payment - Benton-Mcdonald,REF95265556,0.0,966.76,87185.54
2016-09-15,2016-09-15,"Project payment - Davis, Coleman and Rice",REF22861488,0.0,401.42,87586.96
2016-09-21,2016-09-21,Professional software license,REF94447520,204.7,0.0,87382.26
2016-09-21,2016-09-21,Business meal,REF97732008,125.97,0.0,87256.29
2016-09-25,2016-09-25,Business meal,REF87577391,434.16,0.0,86822.13
2016-09-30,2016-09-30,Marketing expenses,REF87626369,264.05,0.0,86558.08
2016-10-02,2016-10-02,Business meal,REF10574759,446.52,0.0,86111.56
2016-10-09,2016-10-09,Marketing expenses,REF85937681,331.17,0.0,85780.39
2016-10-10,2016-10-10,Equipment purchase,REF98402121,186.89,0.0,85593.5
2016-10-14,2016-10-14,Marketing expenses,REF87383318,336.23,0.0,85257.27
2016-10-15,2016-10-15,Business insurance premium,REF96809428,170.81,0.0,85086.46
2016-10-15,2016-10-15,"Payment from Meyers, Thompson and Cobb",REF60424854,0.0,534.1,85620.56
2016-10-15,2016-10-15,Service payment - Benton-Mcdonald,REF25795706,0.0,1085.87,86706.43
2016-10-15,2016-10-15,"Payment from Davis, Coleman and Rice",REF47272674,0.0,364.27,87070.7
2016-10-15,2016-10-15,Payment from Smith and Sons,REF19713869,0.0,747.47,87818.17
2016-10-15,2016-10-15,Invoice payment - Miller-Ruiz,REF94722781,0.0,661.35,88479.52
2016-10-15,2016-10-15,Equipment purchase,REF38167150,228.09,0.0,88251.43
2016-10-15,2016-10-15,Invoice payment - Green-Reed,REF42982067,0.0,744.28,88995.71
2016-10-15,2016-10-15,"Service payment - Parsons, Hamilton and Roberts",REF70564178,0.0,1038.78,90034.49
2016-10-16,2016-10-16,Coworking space rental,REF17943085,243.34,0.0,89791.15
2016-10-17,2016-10-17,Business travel,REF76239780,460.86,0.0,89330.29
2016-10-18,2016-10-18,Training/conference,REF94123788,183.19,0.0,89147.1
2016-10-20,2016-10-20,Business meal,REF19104579,321.31,0.0,88825.79
2016-10-21,2016-10-21,Professional software license,REF66714750,212.49,0.0,88613.3
2016-10-26,2016-10-26,Business meal,REF92453146,321.57,0.0,88291.73
2016-10-30,2016-10-30,Business travel,REF84687563,511.54,0.0,87780.19
2016-11-03,2016-11-03,Training/conference,REF55095720,188.24,0.0,87591.95
2016-11-09,2016-11-09,Training/conference,REF73543906,214.65,0.0,87377.3
2016-11-11,2016-11-11,Training/conference,REF29492353,178.65,0.0,87198.65
2016-11-12,2016-11-12,Marketing expenses,REF49308772,391.71,0.0,86806.94
2016-11-14,2016-11-14,Marketing expenses,REF90968751,280.22,0.0,86526.72
2016-11-15,2016-11-15,Business insurance premium,REF98329362,159.54,0.0,86367.18
2016-11-15,2016-11-15,"Project payment - Davis, Coleman and Rice",REF32672465,0.0,358.24,86725.42
2016-11-15,2016-11-15,"Invoice payment - Parsons, Hamilton and Roberts",REF48754895,0.0,1065.99,87791.41
2016-11-15,2016-11-15,Payment from Green-Reed,REF93799968,0.0,723.31,88514.72
2016-11-15,2016-11-15,Project payment - Benton-Mcdonald,REF88754606,0.0,1156.11,89670.83
2016-11-15,2016-11-15,"Payment from Meyers, Thompson and Cobb",REF62248581,0.0,461.77,90132.6
2016-11-15,2016-11-15,Service payment - Miller-Ruiz,REF17025126,0.0,717.13,90849.73
2016-11-15,2016-11-15,Invoice payment - Smith and Sons,REF18584599,0.0,881.48,91731.21
2016-11-18,2016-11-18,Coworking space rental,REF25550256,405.91,0.0,91325.3
2016-11-19,2016-11-19,Training/conference,REF86959854,299.58,0.0,91025.72
2016-11-20,2016-11-20,Business travel,REF23682578,403.1,0.0,90622.62
2016-11-21,2016-11-21,Professional software license,REF97812683,200.79,0.0,90421.83
2016-11-24,2016-11-24,Business meal,REF54018733,321.8,0.0,90100.03
2016-11-25,2016-11-25,Business meal,REF58536417,360.71,0.0,89739.32
2016-12-02,2016-12-02,Business meal,REF57353752,174.65,0.0,89564.67
2016-12-06,2016-12-06,Coworking space rental,REF63799946,271.05,0.0,89293.62
2016-12-07,2016-12-07,Equipment purchase,REF76487891,137.49,0.0,89156.13
2016-12-09,2016-12-09,Business meal,REF24820438,390.42,0.0,88765.71
2016-12-15,2016-12-15,Payment from Benton-Mcdonald,REF39526126,0.0,628.76,89394.47
2016-12-15,2016-12-15,Payment from Wilkins Ltd,REF48882579,0.0,695.27,90089.74
2016-12-15,2016-12-15,Invoice payment - Miller-Ruiz,REF42914301,0.0,673.18,90762.92
2016-12-15,2016-12-15,Project payment - Smith and Sons,REF92304204,0.0,707.9,91470.82
2016-12-15,2016-12-15,"Service payment - Davis, Coleman and Rice",REF80235371,0.0,287.54,91758.36
2016-12-15,2016-12-15,Business insurance premium,REF41057998,128.35,0.0,91630.01
2016-12-20,2016-12-20,Equipment purchase,REF63144220,167.45,0.0,91462.56
2016-12-20,2016-12-20,Business travel,REF75013202,298.75,0.0,91163.81
2016-12-21,2016-12-21,Professional software license,REF62897848,165.82,0.0,90997.99
2016-12-28,2016-12-28,Coworking space rental,REF13357343,321.16,0.0,90676.83
2017-01-05,2017-01-05,Marketing expenses,REF42857490,432.14,0.0,90244.69
2017-01-10,2017-01-10,Marketing expenses,REF35201768,536.82,0.0,89707.87
2017-01-14,2017-01-14,Coworking space rental,REF60841976,367.78,0.0,89340.09
2017-01-15,2017-01-15,Business insurance premium,REF53942826,155.0,0.0,89185.09
2017-01-15,2017-01-15,Service payment - Miller-Ruiz,REF41894910,0.0,590.63,89775.72
2017-01-15,2017-01-15,Service payment - Green-Reed,REF12735628,0.0,975.28,90751.0
2017-01-15,2017-01-15,"Payment from Parsons, Hamilton and Roberts",REF21602957,0.0,1235.55,91986.55
2017-01-15,2017-01-15,"Invoice payment - Davis, Coleman and Rice",REF91075706,0.0,486.38,92472.93
2017-01-15,2017-01-15,Service payment - Benton-Mcdonald,REF48453548,0.0,1097.39,93570.32
2017-01-15,2017-01-15,"Invoice payment - Meyers, Thompson and Cobb",REF31460315,0.0,589.14,94159.46
2017-01-15,2017-01-15,Project payment - Smith and Sons,REF12047358,0.0,1000.89,95160.35
2017-01-15,2017-01-15,Invoice payment - Wilkins Ltd,REF18510616,0.0,877.76,96038.11
2017-01-16,2017-01-16,Business meal,REF88827122,257.73,0.0,95780.38
2017-01-19,2017-01-19,Business meal,REF58317683,289.43,0.0,95490.95
2017-01-21,2017-01-21,Professional software license,REF38813391,228.64,0.0,95262.31
2017-01-28,2017-01-28,Marketing expenses,REF16905842,278.66,0.0,94983.65
2017-02-02,2017-02-02,Coworking space rental,REF36612053,383.5,0.0,94600.15
2017-02-09,2017-02-09,Business meal,REF56670995,270.84,0.0,94329.31
2017-02-11,2017-02-11,Marketing expenses,REF68535600,328.13,0.0,94001.18
2017-02-13,2017-02-13,Equipment purchase,REF85775171,172.04,0.0,93829.14
2017-02-15,2017-02-15,Service payment - Benton-Mcdonald,REF16180618,0.0,1084.49,94913.63
2017-02-15,2017-02-15,"Service payment - Davis, Coleman and Rice",REF80527662,0.0,443.49,95357.12
2017-02-15,2017-02-15,Invoice payment - Wilkins Ltd,REF86002887,0.0,1157.56,96514.68
2017-02-15,2017-02-15,Business meal,REF82500991,276.59,0.0,96238.09
2017-02-15,2017-02-15,"Project payment - Meyers, Thompson and Cobb",REF24196211,0.0,494.91,96733.0
2017-02-15,2017-02-15,Project payment - Green-Reed,REF96049086,0.0,958.1,97691.1
2017-02-15,2017-02-15,Service payment - Smith and Sons,REF79236065,0.0,822.21,98513.31
2017-02-15,2017-02-15,Business insurance premium,REF58575204,159.46,0.0,98353.85
2017-02-15,2017-02-15,"Service payment - Parsons, Hamilton and Roberts",REF18052724,0.0,1143.71,99497.56
2017-02-15,2017-02-15,Invoice payment - Miller-Ruiz,REF90726744,0.0,603.53,100101.09
2017-02-18,2017-02-18,Business meal,REF53466649,273.16,0.0,99827.93
2017-02-21,2017-02-21,Professional software license,REF61838788,186.56,0.0,99641.37
2017-02-22,2017-02-22,Equipment purchase,REF62566160,56.0,0.0,99585.37
2017-03-12,2017-03-12,Business travel,REF25089864,510.11,0.0,99075.26
2017-03-14,2017-03-14,Business meal,REF90471008,248.79,0.0,98826.47
2017-03-15,2017-03-15,"Project payment - Davis, Coleman and Rice",REF38558004,0.0,270.86,99097.33
2017-03-15,2017-03-15,Payment from Smith and Sons,REF57448246,0.0,775.17,99872.5
2017-03-15,2017-03-15,Service payment - Miller-Ruiz,REF53581058,0.0,618.02,100490.52
2017-03-15,2017-03-15,"Payment from Meyers, Thompson and Cobb",REF78253529,0.0,301.96,100792.48
2017-03-15,2017-03-15,Service payment - Wilkins Ltd,REF66440482,0.0,911.76,101704.24
2017-03-15,2017-03-15,Service payment - Green-Reed,REF44231623,0.0,553.15,102257.39
2017-03-15,2017-03-15,"Service payment - Parsons, Hamilton and Roberts",REF65502515,0.0,633.34,102890.73
2017-03-15,2017-03-15,Business insurance premium,REF70135754,137.35,0.0,102753.38
2017-03-15,2017-03-15,Invoice payment - Benton-Mcdonald,REF38602823,0.0,864.87,103618.25
2017-03-18,2017-03-18,Business travel,REF52310538,454.33,0.0,103163.92
2017-03-21,2017-03-21,Professional software license,REF83896415,197.62,0.0,102966.3
2017-03-22,2017-03-22,Business travel,REF11973464,272.93,0.0,102693.37
2017-03-22,2017-03-22,Business meal,REF14331125,388.59,0.0,102304.78
2017-03-25,2017-03-25,Business travel,REF51334012,340.46,0.0,101964.32
2017-03-27,2017-03-27,Marketing expenses,REF31827835,368.76,0.0,101595.56
2017-04-03,2017-04-03,Marketing expenses,REF85763064,328.96,0.0,101266.6
2017-04-09,2017-04-09,Accounting expense,REF68852932,345.32,0.0,100921.28
2017-04-14,2017-04-14,Coworking space rental,REF73257317,245.94,0.0,100675.34
2017-04-15,2017-04-15,"Invoice payment - Davis, Coleman and Rice",REF45294417,0.0,276.79,100952.13
2017-04-15,2017-04-15,Invoice payment - Green-Reed,REF29476696,0.0,801.14,101753.27
2017-04-15,2017-04-15,Project payment - Smith and Sons,REF61362779,0.0,630.9,102384.17
2017-04-15,2017-04-15,Business insurance premium,REF78300117,144.8,0.0,102239.37
2017-04-15,2017-04-15,"Project payment - Parsons, Hamilton and Roberts",REF43281928,0.0,980.65,103220.02
2017-04-15,2017-04-15,Project payment - Benton-Mcdonald,REF67744723,0.0,949.36,104169.38
2017-04-15,2017-04-15,"Payment from Meyers, Thompson and Cobb",REF84622520,0.0,358.52,104527.9
2017-04-15,2017-04-15,Payment from Wilkins Ltd,REF91656311,0.0,1092.78,105620.68
2017-04-15,2017-04-15,Service payment - Miller-Ruiz,REF43194675,0.0,613.33,106234.01
2017-04-16,2017-04-16,Equipment purchase,REF29385099,159.45,0.0,106074.56
2017-04-19,2017-04-19,Marketing expenses,REF64887638,297.64,0.0,105776.92
2017-04-21,2017-04-21,Professional software license,REF55516958,206.02,0.0,105570.9
2017-04-25,2017-04-25,Marketing expenses,REF24841462,350.05,0.0,105220.85
2017-05-07,2017-05-07,Equipment purchase,REF33276949,143.55,0.0,105077.3
2017-05-12,2017-05-12,Marketing expenses,REF20042857,277.65,0.0,104799.65
2017-05-14,2017-05-14,Marketing expenses,REF79894009,181.03,0.0,104618.62
2017-05-15,2017-05-15,Business insurance premium,REF66219077,123.91,0.0,104494.71
2017-05-15,2017-05-15,"Payment from Meyers, Thompson and Cobb",REF23197924,0.0,332.52,104827.23
2017-05-15,2017-05-15,Invoice payment - Green-Reed,REF11987709,0.0,605.1,105432.33
2017-05-15,2017-05-15,"Payment from Davis, Coleman and Rice",REF81975378,0.0,335.78,105768.11
2017-05-15,2017-05-15,Equipment purchase,REF58399953,219.81,0.0,105548.3
2017-05-15,2017-05-15,Service payment - Benton-Mcdonald,REF19770961,0.0,673.8,106222.1
2017-05-15,2017-05-15,"Invoice payment - Parsons, Hamilton and Roberts",REF10782172,0.0,839.67,107061.77
2017-05-15,2017-05-15,Invoice payment - Miller-Ruiz,REF59965454,0.0,547.72,107609.49
2017-05-21,2017-05-21,Professional software license,REF85821276,169.91,0.0,107439.58
2017-05-25,2017-05-25,Coworking space rental,REF53399144,217.59,0.0,107221.99
2017-05-29,2017-05-29,Business meal,REF76827513,232.51,0.0,106989.48
2017-06-01,2017-06-01,Business meal,REF76892100,140.09,0.0,106849.39
2017-06-05,2017-06-05,Business travel,REF56935855,344.84,0.0,106504.55
2017-06-15,2017-06-15,"Project payment - Davis, Coleman and Rice",REF58081577,0.0,354.74,106859.29
2017-06-15,2017-06-15,Payment from Green-Reed,REF25538177,0.0,592.37,107451.66
2017-06-15,2017-06-15,Payment from Miller-Ruiz,REF59851309,0.0,633.95,108085.61
2017-06-15,2017-06-15,"Project payment - Meyers, Thompson and Cobb",REF94125512,0.0,371.23,108456.84
2017-06-15,2017-06-15,Business insurance premium,REF99427650,110.75,0.0,108346.09
2017-06-15,2017-06-15,Project payment - Smith and Sons,REF85308095,0.0,623.72,108969.81
2017-06-15,2017-06-15,Service payment - Benton-Mcdonald,REF65357358,0.0,604.31,109574.12
2017-06-15,2017-06-15,Service payment - Wilkins Ltd,REF93837907,0.0,595.87,110169.99
2017-06-16,2017-06-16,Coworking space rental,REF88853120,218.9,0.0,109951.09
2017-06-20,2017-06-20,Marketing expenses,REF99757456,318.97,0.0,109632.12
2017-06-21,2017-06-21,Professional software license,REF32038240,142.57,0.0,109489.55
2017-06-24,2017-06-24,Business travel,REF56045903,284.67,0.0,109204.88
2017-06-29,2017-06-29,Accounting expense,REF25342149,155.26,0.0,109049.62
2017-07-06,2017-07-06,Business meal,REF32003086,131.74,0.0,108917.88
2017-07-14,2017-07-14,Training/conference,REF57748469,160.09,0.0,108757.79
2017-07-15,2017-07-15,Invoice payment - Benton-Mcdonald,REF32197717,0.0,581.4,109339.19
2017-07-15,2017-07-15,"Invoice payment - Parsons, Hamilton and Roberts",REF35578009,0.0,688.73,110027.92
2017-07-15,2017-07-15,Service payment - Wilkins Ltd,REF19517508,0.0,604.68,110632.6
2017-07-15,2017-07-15,"Service payment - Meyers, Thompson and Cobb",REF76157093,0.0,336.86,110969.46
2017-07-15,2017-07-15,Payment from Smith and Sons,REF60022754,0.0,566.1,111535.56
2017-07-15,2017-07-15,Payment from Miller-Ruiz,REF18357714,0.0,518.94,112054.5
2017-07-15,2017-07-15,"Invoice payment - Davis, Coleman and Rice",REF76614918,0.0,262.8,112317.3
2017-07-15,2017-07-15,Business insurance premium,REF49839011,97.76,0.0,112219.54
2017-07-21,2017-07-21,Professional software license,REF17626292,139.51,0.0,112080.03
2017-07-26,2017-07-26,Training/conference,REF44790637,116.59,0.0,111963.44
2017-07-26,2017-07-26,Business meal,REF96772964,76.75,0.0,111886.69
2017-08-02,2017-08-02,Coworking space rental,REF79654036,193.74,0.0,111692.95
2017-08-05,2017-08-05,Marketing expenses,REF21888596,264.41,0.0,111428.54
2017-08-09,2017-08-09,Business travel,REF18165592,125.05,0.0,111303.49
2017-08-15,2017-08-15,Invoice payment - Smith and Sons,REF31291421,0.0,587.67,111891.16
2017-08-15,2017-08-15,"Project payment - Davis, Coleman and Rice",REF58613499,0.0,257.1,112148.26
2017-08-15,2017-08-15,"Invoice payment - Meyers, Thompson and Cobb",REF78300503,0.0,431.98,112580.24
2017-08-15,2017-08-15,Invoice payment - Wilkins Ltd,REF68366571,0.0,588.3,113168.54
2017-08-15,2017-08-15,"Payment from Parsons, Hamilton and Roberts",REF17340379,0.0,524.01,113692.55
2017-08-15,2017-08-15,Payment from Green-Reed,REF59594791,0.0,571.68,114264.23
2017-08-15,2017-08-15,Equipment purchase,REF35180171,125.49,0.0,114138.74
2017-08-15,2017-08-15,Business insurance premium,REF46648216,118.66,0.0,114020.08
2017-08-15,2017-08-15,Project payment - Benton-Mcdonald,REF16712784,0.0,735.72,114755.8
2017-08-20,2017-08-20,Business meal,REF43809382,171.71,0.0,114584.09
2017-08-21,2017-08-21,Professional software license,REF39132871,185.83,0.0,114398.26
2017-08-21,2017-08-21,Accounting expense,REF91878114,119.47,0.0,114278.79
2017-08-22,2017-08-22,Accounting expense,REF44027537,162.53,0.0,114116.26
2017-08-23,2017-08-23,Coworking space rental,REF20255475,263.75,0.0,113852.51
2017-08-23,2017-08-23,Business travel,REF20365694,282.23,0.0,113570.28
2017-08-25,2017-08-25,Business meal,REF49263902,140.55,0.0,113429.73
2017-08-26,2017-08-26,Business meal,REF75639507,263.1,0.0,113166.63
2017-09-12,2017-09-12,Accounting expense,REF84460340,80.0,0.0,113086.63
2017-09-15,2017-09-15,Business insurance premium,REF68088399,147.31,0.0,112939.32
2017-09-15,2017-09-15,"Invoice payment - Parsons, Hamilton and Roberts",REF40077087,0.0,1089.75,114029.07
2017-09-15,2017-09-15,Invoice payment - Wilkins Ltd,REF16313233,0.0,882.9,114911.97
2017-09-15,2017-09-15,Invoice payment - Smith and Sons,REF95992200,0.0,739.37,115651.34
2017-09-15,2017-09-15,"Payment from Davis, Coleman and Rice",REF53578922,0.0,323.82,115975.16
2017-09-15,2017-09-15,Invoice payment - Benton-Mcdonald,REF22775156,0.0,1334.49,117309.65
2017-09-15,2017-09-15,Service payment - Green-Reed,REF69504308,0.0,748.01,118057.66
2017-09-15,2017-09-15,Project payment - Miller-Ruiz,REF68227773,0.0,610.57,118668.23
2017-09-16,2017-09-16,Business travel,REF97847485,737.17,0.0,117931.06
2017-09-18,2017-09-18,Accounting expense,REF34200381,244.58,0.0,117686.48
2017-09-21,2017-09-21,Accounting expense,REF40228863,114.06,0.0,117572.42
2017-09-21,2017-09-21,Marketing expenses,REF81068869,310.55,0.0,117261.87
2017-09-21,2017-09-21,Professional software license,REF20581016,216.56,0.0,117045.31
2017-09-22,2017-09-22,Marketing expenses,REF22467372,488.14,0.0,116557.17
2017-09-22,2017-09-22,Coworking space rental,REF97766034,182.26,0.0,116374.91
2017-09-22,2017-09-22,Business meal,REF86853529,309.9,0.0,116065.01
2017-09-24,2017-09-24,Marketing expenses,REF65486148,347.81,0.0,115717.2
2017-09-25,2017-09-25,Marketing expenses,REF71197797,427.35,0.0,115289.85
2017-09-30,2017-09-30,Business meal,REF58497124,410.35,0.0,114879.5
2017-09-30,2017-09-30,Business travel,REF86298559,438.22,0.0,114441.28
2017-10-02,2017-10-02,Business travel,REF27220316,686.83,0.0,113754.45
2017-10-07,2017-10-07,Business meal,REF75320742,282.19,0.0,113472.26
2017-10-13,2017-10-13,Business meal,REF82586363,251.01,0.0,113221.25
2017-10-13,2017-10-13,Accounting expense,REF93115831,245.35,0.0,112975.9
2017-10-14,2017-10-14,Accounting expense,REF90418547,310.91,0.0,112664.99
2017-10-15,2017-10-15,"Payment from Davis, Coleman and Rice",REF29544953,0.0,415.98,113080.97
2017-10-15,2017-10-15,Business insurance premium,REF41975671,161.71,0.0,112919.26
2017-10-15,2017-10-15,"Service payment - Meyers, Thompson and Cobb",REF25389808,0.0,675.56,113594.82
2017-10-15,2017-10-15,"Service payment - Parsons, Hamilton and Roberts",REF55866761,0.0,800.32,114395.14
2017-10-15,2017-10-15,Project payment - Green-Reed,REF94624387,0.0,890.19,115285.33
2017-10-15,2017-10-15,Project payment - Miller-Ruiz,REF24714227,0.0,868.43,116153.76
2017-10-15,2017-10-15,Payment from Benton-Mcdonald,REF75516951,0.0,1165.3,117319.06
2017-10-16,2017-10-16,Business travel,REF76890631,373.81,0.0,116945.25
2017-10-21,2017-10-21,Professional software license,REF20152371,247.8,0.0,116697.45
2017-10-24,2017-10-24,Business travel,REF20850059,485.13,0.0,116212.32
2017-10-25,2017-10-25,Accounting expense,REF81212304,326.01,0.0,115886.31
2017-11-01,2017-11-01,Training/conference,REF65356472,239.91,0.0,115646.4
2017-11-02,2017-11-02,Business travel,REF60502623,671.03,0.0,114975.37
2017-11-02,2017-11-02,Business meal,REF16968446,217.68,0.0,114757.69
2017-11-03,2017-11-03,Marketing expenses,REF37514011,464.77,0.0,114292.92
2017-11-04,2017-11-04,Coworking space rental,REF15522342,110.6,0.0,114182.32
2017-11-06,2017-11-06,Business travel,REF35161657,475.98,0.0,113706.34
2017-11-09,2017-11-09,Accounting expense,REF21613115,219.17,0.0,113487.17
2017-11-15,2017-11-15,Training/conference,REF62273646,240.26,0.0,113246.91
2017-11-15,2017-11-15,"Payment from Meyers, Thompson and Cobb",REF90532971,0.0,577.65,113824.56
2017-11-15,2017-11-15,Payment from Benton-Mcdonald,REF14793234,0.0,690.42,114514.98
2017-11-15,2017-11-15,"Service payment - Parsons, Hamilton and Roberts",REF90460668,0.0,1089.61,115604.59
2017-11-15,2017-11-15,"Service payment - Davis, Coleman and Rice",REF35732433,0.0,365.8,115970.39
2017-11-15,2017-11-15,Payment from Wilkins Ltd,REF46600928,0.0,754.99,116725.38
2017-11-15,2017-11-15,Payment from Smith and Sons,REF45414528,0.0,899.12,117624.5
2017-11-15,2017-11-15,Business insurance premium,REF34263960,149.39,0.0,117475.11
2017-11-15,2017-11-15,Project payment - Green-Reed,REF66035054,0.0,777.83,118252.94
2017-11-15,2017-11-15,Project payment - Miller-Ruiz,REF92784058,0.0,765.73,119018.67
2017-11-16,2017-11-16,Business travel,REF86580967,434.44,0.0,118584.23
2017-11-19,2017-11-19,Marketing expenses,REF82067232,314.27,0.0,118269.96
2017-11-19,2017-11-19,Accounting expense,REF27329999,278.78,0.0,117991.18
2017-11-20,2017-11-20,Training/conference,REF88929724,226.44,0.0,117764.74
2017-11-21,2017-11-21,Professional software license,REF70482044,217.24,0.0,117547.5
2017-11-23,2017-11-23,Business travel,REF85724460,535.98,0.0,117011.52
2017-11-24,2017-11-24,Business travel,REF92043414,469.66,0.0,116541.86
2017-11-30,2017-11-30,Business meal,REF55657465,397.32,0.0,116144.54
2017-12-01,2017-12-01,Accounting expense,REF90661598,204.13,0.0,115940.41
2017-12-08,2017-12-08,Business travel,REF37698191,551.73,0.0,115388.68
2017-12-14,2017-12-14,Business meal,REF39746122,223.07,0.0,115165.61
2017-12-15,2017-12-15,"Service payment - Parsons, Hamilton and Roberts",REF58252767,0.0,897.62,116063.23
2017-12-15,2017-12-15,Project payment - Benton-Mcdonald,REF34517024,0.0,736.03,116799.26
2017-12-15,2017-12-15,Project payment - Green-Reed,REF34762513,0.0,702.22,117501.48
2017-12-15,2017-12-15,"Payment from Meyers, Thompson and Cobb",REF86159279,0.0,496.6,117998.08
2017-12-15,2017-12-15,Business insurance premium,REF75375816,125.8,0.0,117872.28
2017-12-15,2017-12-15,Project payment - Smith and Sons,REF65607701,0.0,682.59,118554.87
2017-12-15,2017-12-15,Payment from Wilkins Ltd,REF21638134,0.0,799.59,119354.46
2017-12-15,2017-12-15,Project payment - Miller-Ruiz,REF46207566,0.0,625.86,119980.32
2017-12-21,2017-12-21,Professional software license,REF37585737,176.97,0.0,119803.35
2017-12-24,2017-12-24,Training/conference,REF49541014,97.81,0.0,119705.54
2017-12-27,2017-12-27,Training/conference,REF97881022,210.95,0.0,119494.59
2018-01-05,2018-01-05,Accounting expense,REF55306379,331.76,0.0,119162.83
2018-01-10,2018-01-10,Equipment purchase,REF26746370,187.81,0.0,118975.02
2018-01-12,2018-01-12,Equipment purchase,REF30281407,196.93,0.0,118778.09
2018-01-15,2018-01-15,Business insurance premium,REF70161104,158.51,0.0,118619.58
2018-01-15,2018-01-15,"Project payment - Meyers, Thompson and Cobb",REF43917692,0.0,445.75,119065.33
2018-01-15,2018-01-15,Project payment - Wilkins Ltd,REF64536545,0.0,705.75,119771.08
2018-01-15,2018-01-15,Payment from Miller-Ruiz,REF65794724,0.0,756.65,120527.73
2018-01-15,2018-01-15,Service payment - Benton-Mcdonald,REF12144540,0.0,697.71,121225.44
2018-01-15,2018-01-15,Project payment - Smith and Sons,REF34004171,0.0,1057.75,122283.19
2018-01-15,2018-01-15,"Payment from Davis, Coleman and Rice",REF93911090,0.0,529.77,122812.96
2018-01-15,2018-01-15,Invoice payment - Green-Reed,REF88208623,0.0,972.95,123785.91
2018-01-21,2018-01-21,Professional software license,REF67889028,210.56,0.0,123575.35
2018-01-26,2018-01-26,Training/conference,REF15915723,240.05,0.0,123335.3
2018-01-28,2018-01-28,Marketing expenses,REF57618723,524.4,0.0,122810.9
2018-02-05,2018-02-05,Business meal,REF56245205,387.56,0.0,122423.34
2018-02-13,2018-02-13,Coworking space rental,REF18630667,309.15,0.0,122114.19
2018-02-15,2018-02-15,Marketing expenses,REF69839784,169.47,0.0,121944.72
2018-02-15,2018-02-15,Business insurance premium,REF97455576,155.71,0.0,121789.01
2018-02-15,2018-02-15,"Service payment - Parsons, Hamilton and Roberts",REF87929658,0.0,1185.61,122974.62
2018-02-15,2018-02-15,Project payment - Wilkins Ltd,REF72385952,0.0,846.11,123820.73
2018-02-15,2018-02-15,Project payment - Green-Reed,REF15159303,0.0,604.75,124425.48
2018-02-15,2018-02-15,"Project payment - Davis, Coleman and Rice",REF94726751,0.0,351.45,124776.93
2018-02-15,2018-02-15,Service payment - Miller-Ruiz,REF78085472,0.0,723.46,125500.39
2018-02-15,2018-02-15,Payment from Smith and Sons,REF60892243,0.0,848.16,126348.55
2018-02-15,2018-02-15,Service payment - Benton-Mcdonald,REF37237193,0.0,716.52,127065.07
2018-02-15,2018-02-15,"Project payment - Meyers, Thompson and Cobb",REF49677256,0.0,769.05,127834.12
2018-02-21,2018-02-21,Accounting expense,REF24832075,182.86,0.0,127651.26
2018-02-21,2018-02-21,Professional software license,REF64715758,248.52,0.0,127402.74
2018-03-06,2018-03-06,Equipment purchase,REF34745955,200.94,0.0,127201.8
2018-03-06,2018-03-06,Marketing expenses,REF45888799,288.92,0.0,126912.88
2018-03-13,2018-03-13,Equipment purchase,REF10131628,92.82,0.0,126820.06
2018-03-13,2018-03-13,Marketing expenses,REF46744267,372.52,0.0,126447.54
2018-03-15,2018-03-15,Business insurance premium,REF55129003,150.99,0.0,126296.55
2018-03-15,2018-03-15,"Project payment - Meyers, Thompson and Cobb",REF89268133,0.0,531.47,126828.02
2018-03-15,2018-03-15,Invoice payment - Smith and Sons,REF52508411,0.0,689.55,127517.57
2018-03-15,2018-03-15,Invoice payment - Wilkins Ltd,REF94096815,0.0,622.1,128139.67
2018-03-15,2018-03-15,"Payment from Parsons, Hamilton and Roberts",REF76533122,0.0,935.93,129075.6
2018-03-15,2018-03-15,Payment from Miller-Ruiz,REF56385744,0.0,706.18,129781.78
2018-03-15,2018-03-15,Invoice payment - Benton-Mcdonald,REF79518622,0.0,811.27,130593.05
2018-03-15,2018-03-15,Service payment - Green-Reed,REF35998951,0.0,648.53,131241.58
2018-03-16,2018-03-16,Equipment purchase,REF32225283,158.26,0.0,131083.32
2018-03-20,2018-03-20,Business travel,REF40130417,424.38,0.0,130658.94
2018-03-21,2018-03-21,Professional software license,REF68912531,268.57,0.0,130390.37
2018-03-25,2018-03-25,Marketing expenses,REF87596788,380.39,0.0,130009.98
2018-03-29,2018-03-29,Equipment purchase,REF28847431,146.51,0.0,129863.47
2018-04-01,2018-04-01,Coworking space rental,REF46323626,350.53,0.0,129512.94
2018-04-07,2018-04-07,Business travel,REF15394062,443.56,0.0,129069.38
2018-04-11,2018-04-11,Marketing expenses,REF17012718,214.75,0.0,128854.63
2018-04-12,2018-04-12,Marketing expenses,REF29384669,158.03,0.0,128696.6
2018-04-13,2018-04-13,Equipment purchase,REF68945488,146.74,0.0,128549.86
2018-04-15,2018-04-15,Training/conference,REF65049833,176.14,0.0,128373.72
2018-04-15,2018-04-15,"Project payment - Davis, Coleman and Rice",REF35682384,0.0,412.82,128786.54
2018-04-15,2018-04-15,"Service payment - Meyers, Thompson and Cobb",REF53209196,0.0,604.57,129391.11
2018-04-15,2018-04-15,Invoice payment - Benton-Mcdonald,REF67583611,0.0,952.22,130343.33
2018-04-15,2018-04-15,Project payment - Miller-Ruiz,REF89933926,0.0,650.67,130994.0
2018-04-15,2018-04-15,Business travel,REF28494964,240.82,0.0,130753.18
2018-04-15,2018-04-15,Service payment - Smith and Sons,REF75054086,0.0,773.1,131526.28
2018-04-15,2018-04-15,"Invoice payment - Parsons, Hamilton and Roberts",REF58701648,0.0,968.57,132494.85
2018-04-15,2018-04-15,Project payment - Wilkins Ltd,REF54425639,0.0,819.36,133314.21
2018-04-15,2018-04-15,Project payment - Green-Reed,REF77253596,0.0,907.82,134222.03
2018-04-15,2018-04-15,Business insurance premium,REF83166002,132.98,0.0,134089.05
2018-04-16,2018-04-16,Training/conference,REF20498828,166.05,0.0,133923.0
2018-04-20,2018-04-20,Business meal,REF49809352,259.01,0.0,133663.99
2018-04-21,2018-04-21,Professional software license,REF72160633,210.29,0.0,133453.7
2018-04-22,2018-04-22,Coworking space rental,REF26051961,288.39,0.0,133165.31
2018-04-29,2018-04-29,Business meal,REF97316260,241.41,0.0,132923.9
2018-05-04,2018-05-04,Accounting expense,REF35770307,199.28,0.0,132724.62
2018-05-06,2018-05-06,Business meal,REF29586176,162.41,0.0,132562.21
2018-05-11,2018-05-11,Business travel,REF33639732,364.45,0.0,132197.76
2018-05-15,2018-05-15,Project payment - Benton-Mcdonald,REF55936290,0.0,793.08,132990.84
2018-05-15,2018-05-15,Invoice payment - Smith and Sons,REF94725805,0.0,724.62,133715.46
2018-05-15,2018-05-15,Payment from Green-Reed,REF77071203,0.0,603.52,134318.98
2018-05-15,2018-05-15,"Project payment - Meyers, Thompson and Cobb",REF14056990,0.0,397.92,134716.9
2018-05-15,2018-05-15,Service payment - Wilkins Ltd,REF55289268,0.0,861.51,135578.41
2018-05-15,2018-05-15,"Service payment - Davis, Coleman and Rice",REF93671482,0.0,358.87,135937.28
2018-05-15,2018-05-15,Project payment - Miller-Ruiz,REF39023690,0.0,516.5,136453.78
2018-05-15,2018-05-15,"Project payment - Parsons, Hamilton and Roberts",REF78948227,0.0,898.49,137352.27
2018-05-15,2018-05-15,Business insurance premium,REF90441795,133.92,0.0,137218.35
2018-05-17,2018-05-17,Training/conference,REF46095675,234.74,0.0,136983.61
2018-05-21,2018-05-21,Professional software license,REF43613919,171.36,0.0,136812.25
2018-05-22,2018-05-22,Training/conference,REF90990824,180.51,0.0,136631.74
2018-05-26,2018-05-26,Accounting expense,REF25177194,200.75,0.0,136430.99
2018-05-27,2018-05-27,Equipment purchase,REF64094351,161.56,0.0,136269.43
2018-05-29,2018-05-29,Coworking space rental,REF31780514,71.33,0.0,136198.1
2018-05-30,2018-05-30,Coworking space rental,REF64819892,339.7,0.0,135858.4
2018-05-31,2018-05-31,Business meal,REF11585149,300.44,0.0,135557.96
2018-06-12,2018-06-12,Business meal,REF66738494,164.53,0.0,135393.43
2018-06-15,2018-06-15,Business insurance premium,REF69166131,114.16,0.0,135279.27
2018-06-15,2018-06-15,"Service payment - Parsons, Hamilton and Roberts",REF19516516,0.0,516.29,135795.56
2018-06-15,2018-06-15,Payment from Smith and Sons,REF17787054,0.0,628.98,136424.54
2018-06-15,2018-06-15,Invoice payment - Benton-Mcdonald,REF55452514,0.0,572.34,136996.88
2018-06-15,2018-06-15,Service payment - Green-Reed,REF76505718,0.0,689.94,137686.82
2018-06-15,2018-06-15,"Service payment - Davis, Coleman and Rice",REF14016543,0.0,331.93,138018.75
2018-06-15,2018-06-15,Payment from Miller-Ruiz,REF33326141,0.0,532.6,138551.35
2018-06-21,2018-06-21,Professional software license,REF53683568,162.63,0.0,138388.72
2018-06-22,2018-06-22,Business meal,REF33021071,190.75,0.0,138197.97
2018-07-01,2018-07-01,Business travel,REF65324701,398.39,0.0,137799.58
2018-07-05,2018-07-05,Business meal,REF15980091,117.08,0.0,137682.5
2018-07-11,2018-07-11,Business travel,REF50260796,238.16,0.0,137444.34
2018-07-11,2018-07-11,Coworking space rental,REF90082500,316.98,0.0,137127.36
2018-07-12,2018-07-12,Accounting expense,REF60277195,174.94,0.0,136952.42
2018-07-13,2018-07-13,Business meal,REF54410038,176.09,0.0,136776.33
2018-07-15,2018-07-15,Business insurance premium,REF55957955,92.99,0.0,136683.34
2018-07-15,2018-07-15,Equipment purchase,REF79588098,67.62,0.0,136615.72
2018-07-15,2018-07-15,Service payment - Miller-Ruiz,REF44055908,0.0,466.28,137082.0
2018-07-15,2018-07-15,Service payment - Wilkins Ltd,REF56411142,0.0,457.79,137539.79
2018-07-15,2018-07-15,Payment from Benton-Mcdonald,REF12880428,0.0,660.29,138200.08
2018-07-15,2018-07-15,Invoice payment - Green-Reed,REF14109606,0.0,548.93,138749.01
2018-07-15,2018-07-15,"Invoice payment - Parsons, Hamilton and Roberts",REF87350790,0.0,583.47,139332.48
2018-07-15,2018-07-15,Service payment - Smith and Sons,REF46288442,0.0,657.66,139990.14
2018-07-21,2018-07-21,Professional software license,REF45873892,134.01,0.0,139856.13
2018-07-23,2018-07-23,Accounting expense,REF15299803,65.25,0.0,139790.88
2018-07-25,2018-07-25,Business meal,REF33199564,149.72,0.0,139641.16
2018-07-26,2018-07-26,Business travel,REF26015259,88.54,0.0,139552.62
2018-07-30,2018-07-30,Equipment purchase,REF37844848,103.06,0.0,139449.56
2018-08-02,2018-08-02,Coworking space rental,REF39846362,169.72,0.0,139279.84
2018-08-13,2018-08-13,Training/conference,REF82457650,97.2,0.0,139182.64
2018-08-15,2018-08-15,Business insurance premium,REF99756611,114.23,0.0,139068.41
2018-08-15,2018-08-15,"Payment from Meyers, Thompson and Cobb",REF13472144,0.0,436.59,139505.0
2018-08-15,2018-08-15,Service payment - Benton-Mcdonald,REF39283928,0.0,868.0,140373.0
2018-08-15,2018-08-15,"Service payment - Davis, Coleman and Rice",REF65514626,0.0,288.32,140661.32
2018-08-15,2018-08-15,Service payment - Wilkins Ltd,REF57200450,0.0,700.11,141361.43
2018-08-15,2018-08-15,Payment from Smith and Sons,REF64395743,0.0,493.36,141854.79
2018-08-15,2018-08-15,Invoice payment - Green-Reed,REF28656969,0.0,571.62,142426.41
2018-08-15,2018-08-15,Project payment - Miller-Ruiz,REF13365163,0.0,676.59,143103.0
2018-08-21,2018-08-21,Professional software license,REF49604049,159.3,0.0,142943.7
2018-08-21,2018-08-21,Accounting expense,REF57260313,215.13,0.0,142728.57
2018-08-22,2018-08-22,Equipment purchase,REF82265349,37.56,0.0,142691.01
2018-08-28,2018-08-28,Business travel,REF81942065,177.43,0.0,142513.58
2018-09-01,2018-09-01,Business travel,REF18829188,677.9,0.0,141835.68
2018-09-07,2018-09-07,Training/conference,REF16829709,276.41,0.0,141559.27
2018-09-08,2018-09-08,Marketing expenses,REF60947845,529.44,0.0,141029.83
2018-09-09,2018-09-09,Marketing expenses,REF80968087,404.89,0.0,140624.94
2018-09-15,2018-09-15,"Project payment - Davis, Coleman and Rice",REF12644899,0.0,434.15,141059.09
2018-09-15,2018-09-15,Invoice payment - Smith and Sons,REF90976359,0.0,743.61,141802.7
2018-09-15,2018-09-15,"Invoice payment - Parsons, Hamilton and Roberts",REF16307386,0.0,877.54,142680.24
2018-09-15,2018-09-15,Business insurance premium,REF62800696,152.93,0.0,142527.31
2018-09-15,2018-09-15,Service payment - Green-Reed,REF29202156,0.0,650.76,143178.07
2018-09-15,2018-09-15,Payment from Benton-Mcdonald,REF30539773,0.0,993.17,144171.24
2018-09-15,2018-09-15,"Payment from Meyers, Thompson and Cobb",REF86831614,0.0,557.47,144728.71
2018-09-15,2018-09-15,Invoice payment - Wilkins Ltd,REF23249740,0.0,918.08,145646.79
2018-09-21,2018-09-21,Professional software license,REF60819947,252.17,0.0,145394.62
2018-09-23,2018-09-23,Business meal,REF70130790,389.43,0.0,145005.19
2018-09-23,2018-09-23,Marketing expenses,REF90938741,130.84,0.0,144874.35
2018-09-25,2018-09-25,Accounting expense,REF77279315,209.44,0.0,144664.91
2018-09-26,2018-09-26,Business travel,REF12753103,599.52,0.0,144065.39
2018-09-29,2018-09-29,Business travel,REF84071397,470.74,0.0,143594.65
2018-10-07,2018-10-07,Business meal,REF43320114,376.68,0.0,143217.97
2018-10-12,2018-10-12,Business travel,REF53430000,361.98,0.0,142855.99
2018-10-15,2018-10-15,Payment from Green-Reed,REF40694477,0.0,971.35,143827.34
2018-10-15,2018-10-15,Business meal,REF61853874,223.73,0.0,143603.61
2018-10-15,2018-10-15,"Invoice payment - Meyers, Thompson and Cobb",REF50301931,0.0,676.83,144280.44
2018-10-15,2018-10-15,Business insurance premium,REF58915791,172.43,0.0,144108.01
2018-10-15,2018-10-15,Service payment - Wilkins Ltd,REF28902309,0.0,864.02,144972.03
2018-10-15,2018-10-15,Project payment - Smith and Sons,REF90067553,0.0,860.94,145832.97
2018-10-15,2018-10-15,"Service payment - Parsons, Hamilton and Roberts",REF64415017,0.0,902.64,146735.61
2018-10-15,2018-10-15,"Payment from Davis, Coleman and Rice",REF31562025,0.0,412.37,147147.98
2018-10-15,2018-10-15,Payment from Miller-Ruiz,REF22763925,0.0,571.95,147719.93
2018-10-17,2018-10-17,Training/conference,REF58039338,182.41,0.0,147537.52
2018-10-19,2018-10-19,Coworking space rental,REF18358488,108.11,0.0,147429.41
2018-10-21,2018-10-21,Professional software license,REF67485240,260.01,0.0,147169.4
2018-10-26,2018-10-26,Equipment purchase,REF20816562,202.45,0.0,146966.95
2018-11-05,2018-11-05,Marketing expenses,REF99376243,309.12,0.0,146657.83
2018-11-07,2018-11-07,Business travel,REF88613538,520.8,0.0,146137.03
2018-11-11,2018-11-11,Training/conference,REF52678108,298.39,0.0,145838.64
2018-11-12,2018-11-12,Business travel,REF82643187,568.96,0.0,145269.68
2018-11-15,2018-11-15,"Service payment - Meyers, Thompson and Cobb",REF24685752,0.0,610.41,145880.09
2018-11-15,2018-11-15,"Payment from Davis, Coleman and Rice",REF60370837,0.0,389.51,146269.6
2018-11-15,2018-11-15,"Invoice payment - Parsons, Hamilton and Roberts",REF67400671,0.0,1164.3,147433.9
2018-11-15,2018-11-15,Invoice payment - Wilkins Ltd,REF88707902,0.0,1038.71,148472.61
2018-11-15,2018-11-15,Service payment - Benton-Mcdonald,REF62305964,0.0,778.55,149251.16
2018-11-15,2018-11-15,Project payment - Smith and Sons,REF26760479,0.0,817.17,150068.33
2018-11-15,2018-11-15,Payment from Miller-Ruiz,REF72749193,0.0,811.02,150879.35
2018-11-15,2018-11-15,Business insurance premium,REF18832864,160.78,0.0,150718.57
2018-11-15,2018-11-15,Project payment - Green-Reed,REF81692707,0.0,678.78,151397.35
2018-11-17,2018-11-17,Business travel,REF95879251,379.03,0.0,151018.32
2018-11-21,2018-11-21,Professional software license,REF33996839,227.28,0.0,150791.04
2018-11-26,2018-11-26,Equipment purchase,REF39782645,154.34,0.0,150636.7
2018-11-30,2018-11-30,Training/conference,REF75012702,142.87,0.0,150493.83
2018-12-01,2018-12-01,Marketing expenses,REF52824567,382.84,0.0,150110.99
2018-12-04,2018-12-04,Accounting expense,REF69369570,106.62,0.0,150004.37
2018-12-12,2018-12-12,Business travel,REF87654746,312.11,0.0,149692.26
2018-12-15,2018-12-15,Invoice payment - Miller-Ruiz,REF19241562,0.0,600.87,150293.13
2018-12-15,2018-12-15,"Project payment - Meyers, Thompson and Cobb",REF84111053,0.0,511.02,150804.15
2018-12-15,2018-12-15,Service payment - Green-Reed,REF80025199,0.0,732.42,151536.57
2018-12-15,2018-12-15,Project payment - Benton-Mcdonald,REF32657393,0.0,652.23,152188.8
2018-12-15,2018-12-15,"Service payment - Davis, Coleman and Rice",REF51909390,0.0,300.92,152489.72
2018-12-15,2018-12-15,Payment from Smith and Sons,REF86879679,0.0,827.51,153317.23
2018-12-15,2018-12-15,"Service payment - Parsons, Hamilton and Roberts",REF18555722,0.0,799.51,154116.74
2018-12-15,2018-12-15,Business insurance premium,REF82066962,112.78,0.0,154003.96
2018-12-15,2018-12-15,Project payment - Wilkins Ltd,REF59714585,0.0,637.79,154641.75
2018-12-21,2018-12-21,Professional software license,REF37438591,185.29,0.0,154456.46
2018-12-22,2018-12-22,Marketing expenses,REF28739535,249.16,0.0,154207.3
2018-12-25,2018-12-25,Business travel,REF81956442,215.46,0.0,153991.84
2019-01-06,2019-01-06,Marketing expenses,REF92318938,369.76,0.0,153622.08
2019-01-12,2019-01-12,Accounting expense,REF25143747,187.04,0.0,153435.04
2019-01-15,2019-01-15,"Project payment - Parsons, Hamilton and Roberts",REF62791266,0.0,725.78,154160.82
2019-01-15,2019-01-15,Invoice payment - Wilkins Ltd,REF70029304,0.0,1030.86,155191.68
2019-01-15,2019-01-15,"Invoice payment - Meyers, Thompson and Cobb",REF86842000,0.0,552.96,155744.64
2019-01-15,2019-01-15,Project payment - Green-Reed,REF50509891,0.0,810.8,156555.44
2019-01-15,2019-01-15,Payment from Benton-Mcdonald,REF31335684,0.0,1044.11,157599.55
2019-01-15,2019-01-15,Service payment - Miller-Ruiz,REF38873750,0.0,978.13,158577.68
2019-01-15,2019-01-15,Payment from Smith and Sons,REF35325905,0.0,851.44,159429.12
2019-01-15,2019-01-15,"Service payment - Davis, Coleman and Rice",REF63402421,0.0,463.71,159892.83
2019-01-15,2019-01-15,Business insurance premium,REF43361470,157.63,0.0,159735.2
2019-01-21,2019-01-21,Equipment purchase,REF26575119,209.14,0.0,159526.06
2019-01-21,2019-01-21,Professional software license,REF44774359,216.11,0.0,159309.95
2019-01-30,2019-01-30,Business meal,REF26508536,356.14,0.0,158953.81
2019-02-01,2019-02-01,Training/conference,REF95894951,219.42,0.0,158734.39
2019-02-02,2019-02-02,Business meal,REF32456169,255.22,0.0,158479.17
2019-02-06,2019-02-06,Business meal,REF85515254,335.54,0.0,158143.63
2019-02-07,2019-02-07,Equipment purchase,REF35855865,166.06,0.0,157977.57
2019-02-12,2019-02-12,Marketing expenses,REF91519840,129.28,0.0,157848.29
2019-02-12,2019-02-12,Business meal,REF42829953,312.9,0.0,157535.39
2019-02-15,2019-02-15,"Invoice payment - Davis, Coleman and Rice",REF56105737,0.0,419.86,157955.25
2019-02-15,2019-02-15,Invoice payment - Wilkins Ltd,REF70902661,0.0,1142.79,159098.04
2019-02-15,2019-02-15,Project payment - Smith and Sons,REF96864335,0.0,844.72,159942.76
2019-02-15,2019-02-15,Service payment - Green-Reed,REF72418511,0.0,753.76,160696.52
2019-02-15,2019-02-15,Project payment - Miller-Ruiz,REF45539819,0.0,663.47,161359.99
2019-02-15,2019-02-15,Marketing expenses,REF96965411,542.28,0.0,160817.71
2019-02-15,2019-02-15,"Payment from Parsons, Hamilton and Roberts",REF31845939,0.0,1186.66,162004.37
2019-02-15,2019-02-15,Business insurance premium,REF20904193,146.38,0.0,161857.99
2019-02-15,2019-02-15,Invoice payment - Benton-Mcdonald,REF65466539,0.0,866.24,162724.23
2019-02-15,2019-02-15,"Invoice payment - Meyers, Thompson and Cobb",REF11043431,0.0,480.72,163204.95
2019-02-17,2019-02-17,Coworking space rental,REF80930844,349.13,0.0,162855.82
2019-02-19,2019-02-19,Marketing expenses,REF93716208,266.49,0.0,162589.33
2019-02-21,2019-02-21,Professional software license,REF65062752,179.66,0.0,162409.67
2019-02-21,2019-02-21,Coworking space rental,REF39611133,370.21,0.0,162039.46
2019-02-24,2019-02-24,Business meal,REF14254445,170.69,0.0,161868.77
2019-02-25,2019-02-25,Business meal,REF26392927,218.13,0.0,161650.64
2019-03-02,2019-03-02,Training/conference,REF10125583,58.12,0.0,161592.52
2019-03-03,2019-03-03,Business meal,REF44214761,397.33,0.0,161195.19
2019-03-04,2019-03-04,Business meal,REF52519676,151.25,0.0,161043.94
2019-03-09,2019-03-09,Business travel,REF11722376,438.81,0.0,160605.13
2019-03-11,2019-03-11,Business meal,REF24935672,339.08,0.0,160266.05
2019-03-15,2019-03-15,Project payment - Miller-Ruiz,REF67049856,0.0,694.18,160960.23
2019-03-15,2019-03-15,Project payment - Smith and Sons,REF10035572,0.0,522.34,161482.57
2019-03-15,2019-03-15,Service payment - Green-Reed,REF64977007,0.0,777.95,162260.52
2019-03-15,2019-03-15,"Invoice payment - Meyers, Thompson and Cobb",REF36653760,0.0,411.4,162671.92
2019-03-15,2019-03-15,Project payment - Benton-Mcdonald,REF33000220,0.0,791.76,163463.68
2019-03-15,2019-03-15,"Invoice payment - Parsons, Hamilton and Roberts",REF11761949,0.0,865.06,164328.74
2019-03-15,2019-03-15,"Invoice payment - Davis, Coleman and Rice",REF31360720,0.0,317.61,164646.35
2019-03-15,2019-03-15,Business insurance premium,REF26717825,130.38,0.0,164515.97
2019-03-16,2019-03-16,Business meal,REF76930760,292.7,0.0,164223.27
2019-03-19,2019-03-19,Business meal,REF33833210,254.4,0.0,163968.87
2019-03-21,2019-03-21,Business travel,REF97952567,236.68,0.0,163732.19
2019-03-21,2019-03-21,Professional software license,REF69843978,235.6,0.0,163496.59
2019-03-22,2019-03-22,Marketing expenses,REF64954122,329.8,0.0,163166.79
2019-03-26,2019-03-26,Accounting expense,REF78163978,225.63,0.0,162941.16
2019-03-30,2019-03-30,Marketing expenses,REF82474708,365.96,0.0,162575.2
2019-03-30,2019-03-30,Business meal,REF50408240,332.98,0.0,162242.22
2019-04-04,2019-04-04,Coworking space rental,REF69138590,248.62,0.0,161993.6
2019-04-07,2019-04-07,Business meal,REF65903056,151.83,0.0,161841.77
2019-04-13,2019-04-13,Coworking space rental,REF58538691,293.72,0.0,161548.05
2019-04-15,2019-04-15,Invoice payment - Smith and Sons,REF57191582,0.0,749.96,162298.01
2019-04-15,2019-04-15,"Invoice payment - Parsons, Hamilton and Roberts",REF38543449,0.0,936.48,163234.49
2019-04-15,2019-04-15,"Invoice payment - Meyers, Thompson and Cobb",REF71965797,0.0,380.51,163615.0
2019-04-15,2019-04-15,Project payment - Green-Reed,REF14143992,0.0,811.79,164426.79
2019-04-15,2019-04-15,Invoice payment - Miller-Ruiz,REF74112398,0.0,738.45,165165.24
2019-04-15,2019-04-15,Project payment - Benton-Mcdonald,REF39931276,0.0,866.82,166032.06
2019-04-15,2019-04-15,"Invoice payment - Davis, Coleman and Rice",REF79257948,0.0,368.38,166400.44
2019-04-15,2019-04-15,Invoice payment - Wilkins Ltd,REF76339674,0.0,753.18,167153.62
2019-04-15,2019-04-15,Business insurance premium,REF64273915,144.62,0.0,167009.0
2019-04-16,2019-04-16,Marketing expenses,REF91549280,199.8,0.0,166809.2
2019-04-21,2019-04-21,Business meal,REF67259571,202.81,0.0,166606.39
2019-04-21,2019-04-21,Professional software license,REF24360707,213.31,0.0,166393.08
2019-04-25,2019-04-25,Accounting expense,REF80950975,321.57,0.0,166071.51
2019-05-01,2019-05-01,Business travel,REF45843509,386.33,0.0,165685.18
2019-05-02,2019-05-02,Equipment purchase,REF30297981,111.3,0.0,165573.88
2019-05-02,2019-05-02,Business meal,REF48700939,317.26,0.0,165256.62
2019-05-04,2019-05-04,Business travel,REF48897953,533.73,0.0,164722.89
2019-05-09,2019-05-09,Training/conference,REF41069407,252.42,0.0,164470.47
2019-05-11,2019-05-11,Training/conference,REF30032892,323.84,0.0,164146.63
2019-05-12,2019-05-12,Training/conference,REF37947396,160.6,0.0,163986.03
2019-05-15,2019-05-15,Payment from Wilkins Ltd,REF85111909,0.0,784.63,164770.66
2019-05-15,2019-05-15,Payment from Smith and Sons,REF26583787,0.0,619.86,165390.52
2019-05-15,2019-05-15,Payment from Benton-Mcdonald,REF15855342,0.0,742.35,166132.87
2019-05-15,2019-05-15,"Service payment - Davis, Coleman and Rice",REF91414145,0.0,232.7,166365.57
2019-05-15,2019-05-15,Business insurance premium,REF94283047,128.91,0.0,166236.66
2019-05-15,2019-05-15,Service payment - Green-Reed,REF44080166,0.0,775.2,167011.86
2019-05-15,2019-05-15,"Payment from Meyers, Thompson and Cobb",REF77790208,0.0,393.08,167404.94
2019-05-15,2019-05-15,"Payment from Parsons, Hamilton and Roberts",REF39587792,0.0,581.91,167986.85
2019-05-15,2019-05-15,Invoice payment - Miller-Ruiz,REF46057660,0.0,638.04,168624.89
2019-05-17,2019-05-17,Equipment purchase,REF96090747,150.04,0.0,168474.85
2019-05-21,2019-05-21,Professional software license,REF65999766,155.38,0.0,168319.47
2019-05-24,2019-05-24,Business travel,REF31424318,251.29,0.0,168068.18
2019-06-05,2019-06-05,Training/conference,REF45028890,118.62,0.0,167949.56
2019-06-08,2019-06-08,Training/conference,REF95191417,165.43,0.0,167784.13
2019-06-10,2019-06-10,Equipment purchase,REF70115638,89.97,0.0,167694.16
2019-06-10,2019-06-10,Training/conference,REF93332173,230.58,0.0,167463.58
2019-06-10,2019-06-10,Business meal,REF54891473,148.18,0.0,167315.4
2019-06-14,2019-06-14,Business meal,REF30567658,213.81,0.0,167101.59
2019-06-14,2019-06-14,Accounting expense,REF39688019,154.73,0.0,166946.86
2019-06-15,2019-06-15,Service payment - Miller-Ruiz,REF36797732,0.0,526.4,167473.26
2019-06-15,2019-06-15,"Invoice payment - Parsons, Hamilton and Roberts",REF85679611,0.0,747.74,168221.0
2019-06-15,2019-06-15,Service payment - Smith and Sons,REF59301626,0.0,789.91,169010.91
2019-06-15,2019-06-15,Service payment - Green-Reed,REF20053993,0.0,578.6,169589.51
2019-06-15,2019-06-15,"Project payment - Meyers, Thompson and Cobb",REF39278868,0.0,293.93,169883.44
2019-06-15,2019-06-15,Invoice payment - Wilkins Ltd,REF31731519,0.0,589.76,170473.2
2019-06-15,2019-06-15,Business insurance premium,REF33678863,118.21,0.0,170354.99
2019-06-15,2019-06-15,Payment from Benton-Mcdonald,REF34885852,0.0,790.14,171145.13
2019-06-16,2019-06-16,Business meal,REF94317452,146.92,0.0,170998.21
2019-06-19,2019-06-19,Training/conference,REF92796639,253.26,0.0,170744.95
2019-06-20,2019-06-20,Training/conference,REF26156593,178.19,0.0,170566.76
2019-06-20,2019-06-20,Business meal,REF24310752,216.71,0.0,170350.05
2019-06-21,2019-06-21,Business travel,REF79915601,365.13,0.0,169984.92
2019-06-21,2019-06-21,Professional software license,REF35544058,148.85,0.0,169836.07
2019-06-22,2019-06-22,Business meal,REF66877102,296.37,0.0,169539.7
2019-06-23,2019-06-23,Coworking space rental,REF90076452,257.93,0.0,169281.77
2019-06-26,2019-06-26,Training/conference,REF65401093,178.43,0.0,169103.34
2019-07-03,2019-07-03,Business travel,REF46324425,143.7,0.0,168959.64
2019-07-03,2019-07-03,Business meal,REF66952058,183.78,0.0,168775.86
2019-07-06,2019-07-06,Business meal,REF35156758,190.86,0.0,168585.0
2019-07-12,2019-07-12,Equipment purchase,REF67465172,82.82,0.0,168502.18
2019-07-13,2019-07-13,Accounting expense,REF86220415,139.7,0.0,168362.48
2019-07-14,2019-07-14,Business meal,REF93942767,169.7,0.0,168192.78
2019-07-15,2019-07-15,Project payment - Smith and Sons,REF16428369,0.0,599.35,168792.13
2019-07-15,2019-07-15,Payment from Benton-Mcdonald,REF12391784,0.0,685.92,169478.05
2019-07-15,2019-07-15,"Payment from Davis, Coleman and Rice",REF97039406,0.0,266.99,169745.04
2019-07-15,2019-07-15,Business insurance premium,REF51528320,88.67,0.0,169656.37
2019-07-15,2019-07-15,Payment from Green-Reed,REF70923310,0.0,475.3,170131.67
2019-07-15,2019-07-15,Service payment - Miller-Ruiz,REF32500955,0.0,528.57,170660.24
2019-07-18,2019-07-18,Marketing expenses,REF72794130,254.29,0.0,170405.95
2019-07-19,2019-07-19,Business meal,REF44174577,145.88,0.0,170260.07
2019-07-20,2019-07-20,Training/conference,REF25580088,158.98,0.0,170101.09
2019-07-21,2019-07-21,Professional software license,REF66483869,105.59,0.0,169995.5
2019-07-22,2019-07-22,Coworking space rental,REF68192034,159.2,0.0,169836.3
2019-07-23,2019-07-23,Marketing expenses,REF13278152,303.12,0.0,169533.18
2019-07-24,2019-07-24,Coworking space rental,REF94660536,230.46,0.0,169302.72
2019-08-15,2019-08-15,Invoice payment - Smith and Sons,REF91205629,0.0,689.28,169992.0
2019-08-15,2019-08-15,Payment from Wilkins Ltd,REF20951024,0.0,561.97,170553.97
2019-08-15,2019-08-15,Project payment - Benton-Mcdonald,REF99502139,0.0,620.68,171174.65
2019-08-15,2019-08-15,Payment from Miller-Ruiz,REF63345201,0.0,423.71,171598.36
2019-08-15,2019-08-15,"Project payment - Meyers, Thompson and Cobb",REF88491119,0.0,345.83,171944.19
2019-08-15,2019-08-15,Business insurance premium,REF70400150,107.94,0.0,171836.25
2019-08-15,2019-08-15,Invoice payment - Green-Reed,REF29329668,0.0,519.84,172356.09
2019-08-18,2019-08-18,Business meal,REF62226651,274.66,0.0,172081.43
2019-08-20,2019-08-20,Coworking space rental,REF68722737,261.6,0.0,171819.83
2019-08-20,2019-08-20,Equipment purchase,REF25637086,171.57,0.0,171648.26
2019-08-21,2019-08-21,Professional software license,REF99603273,145.07,0.0,171503.19
2019-08-27,2019-08-27,Coworking space rental,REF92839993,61.59,0.0,171441.6
2019-09-01,2019-09-01,Training/conference,REF82145629,234.2,0.0,171207.4
2019-09-15,2019-09-15,Business insurance premium,REF68810199,146.6,0.0,171060.8
2019-09-15,2019-09-15,Invoice payment - Green-Reed,REF58714433,0.0,702.93,171763.73
2019-09-15,2019-09-15,"Payment from Meyers, Thompson and Cobb",REF24043785,0.0,510.53,172274.26
2019-09-15,2019-09-15,Invoice payment - Benton-Mcdonald,REF57102955,0.0,1295.27,173569.53
2019-09-15,2019-09-15,Project payment - Smith and Sons,REF65083925,0.0,647.9,174217.43
2019-09-15,2019-09-15,"Invoice payment - Parsons, Hamilton and Roberts",REF52550935,0.0,865.03,175082.46
2019-09-15,2019-09-15,Service payment - Wilkins Ltd,REF71357314,0.0,898.68,175981.14
2019-09-15,2019-09-15,Service payment - Miller-Ruiz,REF44197258,0.0,864.08,176845.22
2019-09-21,2019-09-21,Professional software license,REF23781607,211.52,0.0,176633.7
2019-09-22,2019-09-22,Business meal,REF19940474,306.47,0.0,176327.23
2019-09-26,2019-09-26,Business meal,REF33871714,336.59,0.0,175990.64
2019-09-30,2019-09-30,Business travel,REF84860565,269.85,0.0,175720.79
2019-10-09,2019-10-09,Business meal,REF21144839,423.37,0.0,175297.42
2019-10-11,2019-10-11,Marketing expenses,REF43028983,342.98,0.0,174954.44
2019-10-12,2019-10-12,Equipment purchase,REF70736440,140.26,0.0,174814.18
2019-10-15,2019-10-15,"Project payment - Parsons, Hamilton and Roberts",REF41308873,0.0,1055.09,175869.27
2019-10-15,2019-10-15,"Project payment - Davis, Coleman and Rice",REF10399279,0.0,334.93,176204.2
2019-10-15,2019-10-15,"Payment from Meyers, Thompson and Cobb",REF10130175,0.0,627.87,176832.07
2019-10-15,2019-10-15,Service payment - Green-Reed,REF30527484,0.0,854.34,177686.41
2019-10-15,2019-10-15,Project payment - Smith and Sons,REF81599701,0.0,947.52,178633.93
2019-10-15,2019-10-15,Invoice payment - Benton-Mcdonald,REF61520661,0.0,931.25,179565.18
2019-10-15,2019-10-15,Service payment - Miller-Ruiz,REF76913392,0.0,816.56,180381.74
2019-10-15,2019-10-15,Invoice payment - Wilkins Ltd,REF48271105,0.0,700.42,181082.16
2019-10-15,2019-10-15,Business insurance premium,REF50137821,158.37,0.0,180923.79
2019-10-18,2019-10-18,Marketing expenses,REF48575440,351.53,0.0,180572.26
2019-10-19,2019-10-19,Business meal,REF65068408,317.67,0.0,180254.59
2019-10-21,2019-10-21,Professional software license,REF59346571,243.57,0.0,180011.02
2019-10-23,2019-10-23,Training/conference,REF24346801,354.3,0.0,179656.72
2019-10-27,2019-10-27,Equipment purchase,REF99199498,123.64,0.0,179533.08
2019-10-28,2019-10-28,Accounting expense,REF38488564,304.55,0.0,179228.53
2019-10-30,2019-10-30,Equipment purchase,REF57283999,245.61,0.0,178982.92
2019-11-05,2019-11-05,Marketing expenses,REF68503611,341.76,0.0,178641.16
2019-11-08,2019-11-08,Equipment purchase,REF93335076,204.28,0.0,178436.88
2019-11-10,2019-11-10,Marketing expenses,REF83809834,236.89,0.0,178199.99
2019-11-13,2019-11-13,Marketing expenses,REF80670162,328.7,0.0,177871.29
2019-11-14,2019-11-14,Equipment purchase,REF85397940,53.94,0.0,177817.35
2019-11-15,2019-11-15,Project payment - Wilkins Ltd,REF33338707,0.0,880.19,178697.54
2019-11-15,2019-11-15,"Service payment - Parsons, Hamilton and Roberts",REF94205647,0.0,1074.94,179772.48
2019-11-15,2019-11-15,Project payment - Miller-Ruiz,REF17715069,0.0,809.33,180581.81
2019-11-15,2019-11-15,Project payment - Green-Reed,REF42769619,0.0,711.06,181292.87
2019-11-15,2019-11-15,Service payment - Benton-Mcdonald,REF14547382,0.0,1105.94,182398.81
2019-11-15,2019-11-15,Business insurance premium,REF99816734,157.73,0.0,182241.08
2019-11-15,2019-11-15,Service payment - Smith and Sons,REF55719449,0.0,1101.46,183342.54
2019-11-21,2019-11-21,Professional software license,REF35508195,233.02,0.0,183109.52
2019-11-22,2019-11-22,Business travel,REF59447796,268.32,0.0,182841.2
2019-11-23,2019-11-23,Training/conference,REF69978241,306.19,0.0,182535.01
2019-11-23,2019-11-23,Coworking space rental,REF17161507,334.37,0.0,182200.64
2019-11-24,2019-11-24,Business meal,REF79830328,289.76,0.0,181910.88
2019-11-26,2019-11-26,Training/conference,REF88629141,143.29,0.0,181767.59
2019-11-29,2019-11-29,Coworking space rental,REF16118218,338.61,0.0,181428.98
2019-12-04,2019-12-04,Marketing expenses,REF88559014,255.18,0.0,181173.8
2019-12-04,2019-12-04,Equipment purchase,REF71934536,97.79,0.0,181076.01
2019-12-05,2019-12-05,Training/conference,REF73367359,159.68,0.0,180916.33
2019-12-06,2019-12-06,Business meal,REF51124778,121.53,0.0,180794.8
2019-12-09,2019-12-09,Business travel,REF38835028,441.33,0.0,180353.47
2019-12-12,2019-12-12,Equipment purchase,REF92225731,113.36,0.0,180240.11
2019-12-13,2019-12-13,Training/conference,REF47143820,181.25,0.0,180058.86
2019-12-13,2019-12-13,Marketing expenses,REF44065468,228.41,0.0,179830.45
2019-12-15,2019-12-15,Project payment - Wilkins Ltd,REF79980238,0.0,682.14,180512.59
2019-12-15,2019-12-15,Business insurance premium,REF53549172,126.87,0.0,180385.72
2019-12-15,2019-12-15,"Invoice payment - Parsons, Hamilton and Roberts",REF93166596,0.0,619.9,181005.62
2019-12-15,2019-12-15,Invoice payment - Benton-Mcdonald,REF61258262,0.0,795.69,181801.31
2019-12-15,2019-12-15,Invoice payment - Smith and Sons,REF48518016,0.0,710.78,182512.09
2019-12-15,2019-12-15,"Invoice payment - Davis, Coleman and Rice",REF52366687,0.0,378.35,182890.44
2019-12-15,2019-12-15,Project payment - Miller-Ruiz,REF72021397,0.0,665.28,183555.72
2019-12-16,2019-12-16,Equipment purchase,REF11582415,167.56,0.0,183388.16
2019-12-21,2019-12-21,Professional software license,REF96570920,188.23,0.0,183199.93
2019-12-27,2019-12-27,Business travel,REF48510180,384.53,0.0,182815.4
2019-12-30,2019-12-30,Marketing expenses,REF56477083,361.46,0.0,182453.94
2020-01-02,2020-01-02,Training/conference,REF29840156,302.88,0.0,182151.06
2020-01-03,2020-01-03,Business meal,REF99959231,327.99,0.0,181823.07
2020-01-07,2020-01-07,Accounting expense,REF27065024,134.43,0.0,181688.64
2020-01-15,2020-01-15,Invoice payment - Smith and Sons,REF41724640,0.0,1002.78,182691.42
2020-01-15,2020-01-15,Payment from Benton-Mcdonald,REF52112272,0.0,822.19,183513.61
2020-01-15,2020-01-15,Payment from Green-Reed,REF74167463,0.0,909.4,184423.01
2020-01-15,2020-01-15,Invoice payment - Wilkins Ltd,REF29570482,0.0,1013.26,185436.27
2020-01-15,2020-01-15,"Service payment - Davis, Coleman and Rice",REF69437368,0.0,544.5,185980.77
2020-01-15,2020-01-15,"Project payment - Parsons, Hamilton and Roberts",REF18116714,0.0,1307.4,187288.17
2020-01-15,2020-01-15,"Invoice payment - Meyers, Thompson and Cobb",REF69884927,0.0,529.51,187817.68
2020-01-15,2020-01-15,Payment from Miller-Ruiz,REF10881188,0.0,763.69,188581.37
2020-01-15,2020-01-15,Business insurance premium,REF32165673,169.18,0.0,188412.19
2020-01-19,2020-01-19,Business meal,REF84536707,198.86,0.0,188213.33
2020-01-21,2020-01-21,Professional software license,REF17651503,207.9,0.0,188005.43
2020-01-23,2020-01-23,Accounting expense,REF63459326,227.31,0.0,187778.12
2020-01-24,2020-01-24,Training/conference,REF23696590,241.74,0.0,187536.38
2020-01-27,2020-01-27,Accounting expense,REF93971437,186.26,0.0,187350.12
2020-01-27,2020-01-27,Coworking space rental,REF49573460,409.68,0.0,186940.44
2020-02-05,2020-02-05,Business travel,REF99231048,466.79,0.0,186473.65
2020-02-07,2020-02-07,Equipment purchase,REF75456323,192.27,0.0,186281.38
2020-02-09,2020-02-09,Business meal,REF83146738,330.76,0.0,185950.62
2020-02-10,2020-02-10,Business travel,REF38918225,597.17,0.0,185353.45
2020-02-13,2020-02-13,Marketing expenses,REF83887369,479.24,0.0,184874.21
2020-02-14,2020-02-14,Equipment purchase,REF19011291,193.57,0.0,184680.64
2020-02-15,2020-02-15,"Invoice payment - Davis, Coleman and Rice",REF99157889,0.0,362.74,185043.38
2020-02-15,2020-02-15,Payment from Miller-Ruiz,REF32009099,0.0,597.94,185641.32
2020-02-15,2020-02-15,"Project payment - Parsons, Hamilton and Roberts",REF40255109,0.0,1105.61,186746.93
2020-02-15,2020-02-15,Service payment - Benton-Mcdonald,REF74301760,0.0,983.82,187730.75
2020-02-15,2020-02-15,Business insurance premium,REF25156352,160.41,0.0,187570.34
2020-02-15,2020-02-15,Service payment - Smith and Sons,REF64186559,0.0,614.18,188184.52
2020-02-15,2020-02-15,Service payment - Green-Reed,REF59705206,0.0,774.07,188958.59
2020-02-15,2020-02-15,Invoice payment - Wilkins Ltd,REF97318559,0.0,807.88,189766.47
2020-02-21,2020-02-21,Professional software license,REF12844135,268.16,0.0,189498.31
2020-02-22,2020-02-22,Business travel,REF86897057,605.46,0.0,188892.85
2020-02-24,2020-02-24,Coworking space rental,REF33477534,239.95,0.0,188652.9
2020-02-24,2020-02-24,Equipment purchase,REF11260015,130.55,0.0,188522.35
2020-02-25,2020-02-25,Accounting expense,REF24342516,209.3,0.0,188313.05
2020-02-26,2020-02-26,Training/conference,REF99806878,333.28,0.0,187979.77
2020-03-08,2020-03-08,Business meal,REF40687764,373.39,0.0,187606.38
2020-03-10,2020-03-10,Business travel,REF13945853,199.5,0.0,187406.88
2020-03-10,2020-03-10,Marketing expenses,REF91807293,297.89,0.0,187108.99
2020-03-15,2020-03-15,Business meal,REF63284056,125.69,0.0,186983.3
2020-03-15,2020-03-15,Payment from Benton-Mcdonald,REF84911528,0.0,979.52,187962.82
2020-03-15,2020-03-15,"Project payment - Parsons, Hamilton and Roberts",REF45153501,0.0,788.7,188751.52
2020-03-15,2020-03-15,Invoice payment - Smith and Sons,REF45578968,0.0,817.81,189569.33
2020-03-15,2020-03-15,"Payment from Meyers, Thompson and Cobb",REF99129803,0.0,349.65,189918.98
2020-03-15,2020-03-15,"Payment from Davis, Coleman and Rice",REF51481740,0.0,359.71,190278.69
2020-03-15,2020-03-15,Invoice payment - Wilkins Ltd,REF26388848,0.0,888.35,191167.04
2020-03-15,2020-03-15,Service payment - Miller-Ruiz,REF24994451,0.0,765.69,191932.73
2020-03-15,2020-03-15,Business insurance premium,REF35526042,145.11,0.0,191787.62
2020-03-16,2020-03-16,Business meal,REF37969219,232.93,0.0,191554.69
2020-03-20,2020-03-20,Coworking space rental,REF24709630,181.43,0.0,191373.26
2020-03-21,2020-03-21,Professional software license,REF19351068,219.33,0.0,191153.93
2020-03-28,2020-03-28,Business meal,REF46240150,358.71,0.0,190795.22
2020-03-30,2020-03-30,Coworking space rental,REF50538004,263.39,0.0,190531.83
2020-04-01,2020-04-01,Business travel,REF81103689,359.7,0.0,190172.13
2020-04-06,2020-04-06,Coworking space rental,REF85411676,241.1,0.0,189931.03
2020-04-09,2020-04-09,Equipment purchase,REF24513604,180.26,0.0,189750.77
2020-04-10,2020-04-10,Equipment purchase,REF52156786,68.57,0.0,189682.2
2020-04-15,2020-04-15,Accounting expense,REF68425773,193.84,0.0,189488.36
2020-04-15,2020-04-15,Service payment - Miller-Ruiz,REF59669996,0.0,481.12,189969.48
2020-04-15,2020-04-15,Service payment - Wilkins Ltd,REF20424137,0.0,951.66,190921.14
2020-04-15,2020-04-15,Service payment - Smith and Sons,REF36605093,0.0,644.72,191565.86
2020-04-15,2020-04-15,"Invoice payment - Parsons, Hamilton and Roberts",REF37169091,0.0,945.51,192511.37
2020-04-15,2020-04-15,Project payment - Green-Reed,REF39013507,0.0,720.95,193232.32
2020-04-15,2020-04-15,Invoice payment - Benton-Mcdonald,REF79666937,0.0,931.89,194164.21
2020-04-15,2020-04-15,"Payment from Davis, Coleman and Rice",REF22199733,0.0,324.44,194488.65
2020-04-15,2020-04-15,"Service payment - Meyers, Thompson and Cobb",REF12307571,0.0,569.21,195057.86
2020-04-15,2020-04-15,Business insurance premium,REF35596904,153.48,0.0,194904.38
2020-04-16,2020-04-16,Accounting expense,REF26601205,223.03,0.0,194681.35
2020-04-17,2020-04-17,Coworking space rental,REF76716114,217.02,0.0,194464.33
2020-04-21,2020-04-21,Professional software license,REF29823197,183.08,0.0,194281.25
2020-04-23,2020-04-23,Business travel,REF86416899,416.4,0.0,193864.85
2020-04-24,2020-04-24,Accounting expense,REF90867927,150.42,0.0,193714.43
2020-05-01,2020-05-01,Business meal,REF25591631,247.57,0.0,193466.86
2020-05-02,2020-05-02,Accounting expense,REF11384888,211.14,0.0,193255.72
2020-05-14,2020-05-14,Business meal,REF14998423,222.26,0.0,193033.46
2020-05-15,2020-05-15,"Invoice payment - Parsons, Hamilton and Roberts",REF10289321,0.0,844.43,193877.89
2020-05-15,2020-05-15,Payment from Smith and Sons,REF15078097,0.0,666.38,194544.27
2020-05-15,2020-05-15,Invoice payment - Wilkins Ltd,REF12188980,0.0,694.18,195238.45
2020-05-15,2020-05-15,Service payment - Green-Reed,REF81508300,0.0,726.63,195965.08
2020-05-15,2020-05-15,Business insurance premium,REF34355496,131.7,0.0,195833.38
2020-05-15,2020-05-15,"Payment from Meyers, Thompson and Cobb",REF99430149,0.0,519.65,196353.03
2020-05-15,2020-05-15,"Invoice payment - Davis, Coleman and Rice",REF32825928,0.0,322.04,196675.07
2020-05-15,2020-05-15,Invoice payment - Benton-Mcdonald,REF76049468,0.0,933.17,197608.24
2020-05-18,2020-05-18,Coworking space rental,REF43662422,201.81,0.0,197406.43
2020-05-21,2020-05-21,Professional software license,REF47333678,169.56,0.0,197236.87
2020-05-21,2020-05-21,Training/conference,REF14459340,142.12,0.0,197094.75
2020-05-22,2020-05-22,Equipment purchase,REF68782464,123.4,0.0,196971.35
2020-05-28,2020-05-28,Marketing expenses,REF82060299,276.7,0.0,196694.65
2020-05-29,2020-05-29,Business meal,REF20132578,184.01,0.0,196510.64
2020-05-31,2020-05-31,Business travel,REF33555299,344.79,0.0,196165.85
2020-06-05,2020-06-05,Equipment purchase,REF59137124,65.41,0.0,196100.44
2020-06-08,2020-06-08,Accounting expense,REF94804733,105.94,0.0,195994.5
2020-06-14,2020-06-14,Business meal,REF88820694,312.24,0.0,195682.26
2020-06-15,2020-06-15,Project payment - Smith and Sons,REF78272773,0.0,509.41,196191.67
2020-06-15,2020-06-15,Project payment - Green-Reed,REF71771846,0.0,509.0,196700.67
2020-06-15,2020-06-15,"Invoice payment - Meyers, Thompson and Cobb",REF33545197,0.0,447.65,197148.32
2020-06-15,2020-06-15,Service payment - Benton-Mcdonald,REF30614738,0.0,680.48,197828.8
2020-06-15,2020-06-15,"Project payment - Parsons, Hamilton and Roberts",REF91760049,0.0,737.67,198566.47
2020-06-15,2020-06-15,Invoice payment - Wilkins Ltd,REF73066721,0.0,614.41,199180.88
2020-06-15,2020-06-15,"Service payment - Davis, Coleman and Rice",REF51991303,0.0,249.43,199430.31
2020-06-15,2020-06-15,Service payment - Miller-Ruiz,REF31035046,0.0,459.65,199889.96
2020-06-15,2020-06-15,Business insurance premium,REF61010977,114.68,0.0,199775.28
2020-06-21,2020-06-21,Professional software license,REF45146759,136.92,0.0,199638.36
2020-06-26,2020-06-26,Accounting expense,REF77310992,193.76,0.0,199444.6
2020-06-26,2020-06-26,Business travel,REF69696786,397.39,0.0,199047.21
2020-06-27,2020-06-27,Training/conference,REF60017717,118.76,0.0,198928.45
2020-06-29,2020-06-29,Business meal,REF40448621,227.93,0.0,198700.52
2020-07-04,2020-07-04,Business travel,REF80579771,148.51,0.0,198552.01
2020-07-15,2020-07-15,Invoice payment - Miller-Ruiz,REF42503566,0.0,481.06,199033.07
2020-07-15,2020-07-15,Invoice payment - Benton-Mcdonald,REF45532114,0.0,606.38,199639.45
2020-07-15,2020-07-15,Payment from Wilkins Ltd,REF93510084,0.0,502.81,200142.26
2020-07-15,2020-07-15,"Project payment - Parsons, Hamilton and Roberts",REF84669351,0.0,661.38,200803.64
2020-07-15,2020-07-15,Project payment - Green-Reed,REF11500413,0.0,470.52,201274.16
2020-07-15,2020-07-15,"Invoice payment - Davis, Coleman and Rice",REF61317889,0.0,230.37,201504.53
2020-07-15,2020-07-15,Service payment - Smith and Sons,REF88960993,0.0,498.16,202002.69
2020-07-15,2020-07-15,"Invoice payment - Meyers, Thompson and Cobb",REF61701708,0.0,319.02,202321.71
2020-07-15,2020-07-15,Accounting expense,REF77444855,203.08,0.0,202118.63
2020-07-15,2020-07-15,Business insurance premium,REF37865569,99.65,0.0,202018.98
2020-07-16,2020-07-16,Business meal,REF30218087,170.83,0.0,201848.15
2020-07-21,2020-07-21,Professional software license,REF61408514,110.87,0.0,201737.28
2020-07-22,2020-07-22,Business travel,REF74925661,367.03,0.0,201370.25
2020-07-23,2020-07-23,Training/conference,REF73468525,14.86,0.0,201355.39
2020-08-02,2020-08-02,Equipment purchase,REF39353143,125.57,0.0,201229.82
2020-08-03,2020-08-03,Business meal,REF69299890,137.64,0.0,201092.18
2020-08-03,2020-08-03,Accounting expense,REF69209312,180.6,0.0,200911.58
2020-08-06,2020-08-06,Business meal,REF11173803,136.23,0.0,200775.35
2020-08-08,2020-08-08,Business meal,REF89066910,208.72,0.0,200566.63
2020-08-10,2020-08-10,Accounting expense,REF48864667,215.84,0.0,200350.79
2020-08-13,2020-08-13,Coworking space rental,REF84824938,276.74,0.0,200074.05
2020-08-15,2020-08-15,Project payment - Benton-Mcdonald,REF57608946,0.0,808.56,200882.61
2020-08-15,2020-08-15,Payment from Wilkins Ltd,REF54723114,0.0,576.28,201458.89
2020-08-15,2020-08-15,"Project payment - Parsons, Hamilton and Roberts",REF29050840,0.0,714.97,202173.86
2020-08-15,2020-08-15,Service payment - Smith and Sons,REF34825580,0.0,593.7,202767.56
2020-08-15,2020-08-15,Project payment - Miller-Ruiz,REF44447066,0.0,521.03,203288.59
2020-08-15,2020-08-15,"Payment from Davis, Coleman and Rice",REF41300866,0.0,276.53,203565.12
2020-08-15,2020-08-15,Payment from Green-Reed,REF25742983,0.0,514.86,204079.98
2020-08-15,2020-08-15,Business insurance premium,REF66203862,110.58,0.0,203969.4
2020-08-18,2020-08-18,Marketing expenses,REF51130057,265.67,0.0,203703.73
2020-08-19,2020-08-19,Coworking space rental,REF84720603,34.15,0.0,203669.58
2020-08-20,2020-08-20,Training/conference,REF96896139,123.48,0.0,203546.1
2020-08-21,2020-08-21,Professional software license,REF95563152,154.64,0.0,203391.46
2020-08-23,2020-08-23,Accounting expense,REF95991370,134.02,0.0,203257.44
2020-09-02,2020-09-02,Accounting expense,REF63280435,207.22,0.0,203050.22
2020-09-04,2020-09-04,Business meal,REF84995717,239.21,0.0,202811.01
2020-09-05,2020-09-05,Equipment purchase,REF13403453,144.0,0.0,202667.01
2020-09-05,2020-09-05,Business travel,REF42555807,433.95,0.0,202233.06
2020-09-15,2020-09-15,"Project payment - Parsons, Hamilton and Roberts",REF30155962,0.0,1008.71,203241.77
2020-09-15,2020-09-15,Invoice payment - Wilkins Ltd,REF81609817,0.0,880.95,204122.72
2020-09-15,2020-09-15,"Project payment - Meyers, Thompson and Cobb",REF58920457,0.0,535.18,204657.9
2020-09-15,2020-09-15,Payment from Green-Reed,REF21811865,0.0,871.03,205528.93
2020-09-15,2020-09-15,"Payment from Davis, Coleman and Rice",REF51236187,0.0,388.54,205917.47
2020-09-15,2020-09-15,Invoice payment - Benton-Mcdonald,REF57800738,0.0,884.79,206802.26
2020-09-15,2020-09-15,Business insurance premium,REF51976991,141.56,0.0,206660.7
2020-09-15,2020-09-15,Service payment - Smith and Sons,REF94436812,0.0,841.23,207501.93
2020-09-15,2020-09-15,Business meal,REF81678711,245.08,0.0,207256.85
2020-09-18,2020-09-18,Marketing expenses,REF23420670,358.31,0.0,206898.54
2020-09-20,2020-09-20,Business meal,REF49206375,305.0,0.0,206593.54
2020-09-21,2020-09-21,Professional software license,REF84484949,230.59,0.0,206362.95
2020-09-25,2020-09-25,Accounting expense,REF22881594,242.15,0.0,206120.8
2020-09-27,2020-09-27,Business travel,REF52006051,522.77,0.0,205598.03
2020-09-30,2020-09-30,Business meal,REF11279480,290.85,0.0,205307.18
2020-10-15,2020-10-15,"Service payment - Davis, Coleman and Rice",REF87869555,0.0,541.52,205848.7
2020-10-15,2020-10-15,Service payment - Green-Reed,REF54238161,0.0,746.04,206594.74
2020-10-15,2020-10-15,Service payment - Benton-Mcdonald,REF10197522,0.0,1124.63,207719.37
2020-10-15,2020-10-15,Project payment - Wilkins Ltd,REF72603249,0.0,1173.88,208893.25
2020-10-15,2020-10-15,"Project payment - Meyers, Thompson and Cobb",REF49127579,0.0,515.45,209408.7
2020-10-15,2020-10-15,Business insurance premium,REF64536670,179.08,0.0,209229.62
2020-10-15,2020-10-15,Invoice payment - Miller-Ruiz,REF23141752,0.0,933.13,210162.75
2020-10-15,2020-10-15,Invoice payment - Smith and Sons,REF26823495,0.0,801.89,210964.64
2020-10-15,2020-10-15,"Payment from Parsons, Hamilton and Roberts",REF74705265,0.0,992.1,211956.74
2020-10-17,2020-10-17,Business travel,REF69662208,459.98,0.0,211496.76
2020-10-18,2020-10-18,Marketing expenses,REF54637314,460.31,0.0,211036.45
2020-10-21,2020-10-21,Professional software license,REF94618183,205.68,0.0,210830.77
2020-11-01,2020-11-01,Coworking space rental,REF91739679,246.37,0.0,210584.4
2020-11-09,2020-11-09,Marketing expenses,REF26924520,422.99,0.0,210161.41
2020-11-11,2020-11-11,Accounting expense,REF37380359,293.92,0.0,209867.49
2020-11-15,2020-11-15,Business insurance premium,REF96351239,160.0,0.0,209707.49
2020-11-15,2020-11-15,Training/conference,REF24647994,141.39,0.0,209566.1
2020-11-15,2020-11-15,Project payment - Wilkins Ltd,REF23050714,0.0,1035.87,210601.97
2020-11-15,2020-11-15,Service payment - Miller-Ruiz,REF50350721,0.0,708.41,211310.38
2020-11-15,2020-11-15,Payment from Benton-Mcdonald,REF58674038,0.0,962.67,212273.05
2020-11-15,2020-11-15,Project payment - Smith and Sons,REF69695484,0.0,848.58,213121.63
2020-11-15,2020-11-15,Service payment - Green-Reed,REF79204564,0.0,755.15,213876.78
2020-11-15,2020-11-15,"Project payment - Davis, Coleman and Rice",REF93568446,0.0,474.32,214351.1
2020-11-15,2020-11-15,"Invoice payment - Parsons, Hamilton and Roberts",REF69375451,0.0,1015.39,215366.49
2020-11-20,2020-11-20,Business travel,REF55326804,294.25,0.0,215072.24
2020-11-21,2020-11-21,Professional software license,REF77969182,231.89,0.0,214840.35
2020-11-25,2020-11-25,Marketing expenses,REF23662890,362.85,0.0,214477.5
2020-11-28,2020-11-28,Coworking space rental,REF42845089,169.3,0.0,214308.2
2020-11-30,2020-11-30,Accounting expense,REF54092434,113.95,0.0,214194.25
2020-12-01,2020-12-01,Marketing expenses,REF74824386,410.4,0.0,213783.85
2020-12-15,2020-12-15,Business insurance premium,REF38830041,120.53,0.0,213663.32
2020-12-15,2020-12-15,"Project payment - Davis, Coleman and Rice",REF74824439,0.0,375.0,214038.32
2020-12-15,2020-12-15,"Invoice payment - Meyers, Thompson and Cobb",REF14950025,0.0,409.11,214447.43
2020-12-15,2020-12-15,Project payment - Benton-Mcdonald,REF81488470,0.0,728.01,215175.44
2020-12-15,2020-12-15,Service payment - Smith and Sons,REF13892438,0.0,674.4,215849.84
2020-12-15,2020-12-15,Project payment - Miller-Ruiz,REF41352240,0.0,614.46,216464.3
2020-12-15,2020-12-15,"Payment from Parsons, Hamilton and Roberts",REF73541058,0.0,1026.43,217490.73
2020-12-15,2020-12-15,Project payment - Wilkins Ltd,REF58616900,0.0,661.3,218152.03
2020-12-15,2020-12-15,Invoice payment - Green-Reed,REF15307888,0.0,741.48,218893.51
2020-12-18,2020-12-18,Accounting expense,REF11825325,227.75,0.0,218665.76
2020-12-20,2020-12-20,Marketing expenses,REF96148906,271.6,0.0,218394.16
2020-12-21,2020-12-21,Coworking space rental,REF92230790,263.32,0.0,218130.84
2020-12-21,2020-12-21,Professional software license,REF93414079,202.02,0.0,217928.82
2020-12-26,2020-12-26,Business meal,REF27409129,265.36,0.0,217663.46
2020-12-27,2020-12-27,Business travel,REF37311695,337.21,0.0,217326.25
2020-12-29,2020-12-29,Business travel,REF43904181,348.12,0.0,216978.13
2021-01-02,2021-01-02,Business meal,REF26389085,329.34,0.0,216648.79
2021-01-15,2021-01-15,"Service payment - Meyers, Thompson and Cobb",REF88481637,0.0,659.56,217308.35
2021-01-15,2021-01-15,Payment from Smith and Sons,REF68282007,0.0,896.06,218204.41
2021-01-15,2021-01-15,"Invoice payment - Parsons, Hamilton and Roberts",REF21029464,0.0,951.99,219156.4
2021-01-15,2021-01-15,Invoice payment - Benton-Mcdonald,REF99823890,0.0,1091.31,220247.71
2021-01-15,2021-01-15,Invoice payment - Wilkins Ltd,REF53159232,0.0,814.11,221061.82
2021-01-15,2021-01-15,Service payment - Miller-Ruiz,REF53231108,0.0,573.94,221635.76
2021-01-15,2021-01-15,Project payment - Green-Reed,REF66584089,0.0,934.72,222570.48
2021-01-15,2021-01-15,Business insurance premium,REF60490465,170.51,0.0,222399.97
2021-01-20,2021-01-20,Business travel,REF38774038,461.92,0.0,221938.05
2021-01-21,2021-01-21,Professional software license,REF47033728,237.63,0.0,221700.42
2021-01-21,2021-01-21,Accounting expense,REF91537636,268.17,0.0,221432.25
2021-01-29,2021-01-29,Business meal,REF55426247,428.95,0.0,221003.3
2021-01-31,2021-01-31,Business meal,REF73864427,305.97,0.0,220697.33
2021-02-03,2021-02-03,Training/conference,REF98832055,223.22,0.0,220474.11
2021-02-04,2021-02-04,Accounting expense,REF74856013,236.46,0.0,220237.65
2021-02-05,2021-02-05,Coworking space rental,REF65976317,461.37,0.0,219776.28
2021-02-06,2021-02-06,Training/conference,REF25366571,316.22,0.0,219460.06
2021-02-15,2021-02-15,"Invoice payment - Parsons, Hamilton and Roberts",REF77175741,0.0,971.79,220431.85
2021-02-15,2021-02-15,Business insurance premium,REF11893882,148.61,0.0,220283.24
2021-02-15,2021-02-15,Business meal,REF54893850,173.86,0.0,220109.38
2021-02-15,2021-02-15,Service payment - Wilkins Ltd,REF74425983,0.0,1098.99,221208.37
2021-02-15,2021-02-15,"Project payment - Davis, Coleman and Rice",REF27074226,0.0,439.41,221647.78
2021-02-15,2021-02-15,Service payment - Green-Reed,REF14561076,0.0,651.74,222299.52
2021-02-15,2021-02-15,Project payment - Miller-Ruiz,REF80314486,0.0,631.34,222930.86
2021-02-15,2021-02-15,Service payment - Benton-Mcdonald,REF25868561,0.0,936.25,223867.11
2021-02-15,2021-02-15,Service payment - Smith and Sons,REF82884500,0.0,947.68,224814.79
2021-02-15,2021-02-15,"Project payment - Meyers, Thompson and Cobb",REF70822298,0.0,692.84,225507.63
2021-02-17,2021-02-17,Equipment purchase,REF26824804,157.66,0.0,225349.97
2021-02-18,2021-02-18,Business meal,REF50130933,150.35,0.0,225199.62
2021-02-19,2021-02-19,Marketing expenses,REF83525654,178.09,0.0,225021.53
2021-02-20,2021-02-20,Business travel,REF11999232,335.04,0.0,224686.49
2021-02-21,2021-02-21,Professional software license,REF50011589,248.74,0.0,224437.75
2021-02-22,2021-02-22,Accounting expense,REF84232546,212.68,0.0,224225.07
2021-02-25,2021-02-25,Business meal,REF18447130,374.27,0.0,223850.8
2021-03-01,2021-03-01,Business travel,REF52543459,430.61,0.0,223420.19
2021-03-01,2021-03-01,Equipment purchase,REF85116598,230.42,0.0,223189.77
2021-03-03,2021-03-03,Business travel,REF77324727,160.66,0.0,223029.11
2021-03-09,2021-03-09,Coworking space rental,REF70494432,343.45,0.0,222685.66
2021-03-15,2021-03-15,Service payment - Miller-Ruiz,REF59433783,0.0,530.45,223216.11
2021-03-15,2021-03-15,"Payment from Meyers, Thompson and Cobb",REF20219497,0.0,416.56,223632.67
2021-03-15,2021-03-15,Payment from Green-Reed,REF74200826,0.0,932.63,224565.3
2021-03-15,2021-03-15,Project payment - Smith and Sons,REF59600899,0.0,773.54,225338.84
2021-03-15,2021-03-15,Payment from Benton-Mcdonald,REF79608780,0.0,732.21,226071.05
2021-03-15,2021-03-15,"Project payment - Davis, Coleman and Rice",REF70677226,0.0,376.66,226447.71
2021-03-15,2021-03-15,Business insurance premium,REF59765195,135.69,0.0,226312.02
2021-03-19,2021-03-19,Business meal,REF18428845,273.93,0.0,226038.09
2021-03-21,2021-03-21,Professional software license,REF36900930,212.11,0.0,225825.98
2021-03-24,2021-03-24,Training/conference,REF59734695,171.96,0.0,225654.02
2021-03-25,2021-03-25,Business meal,REF23572228,372.92,0.0,225281.1
2021-04-03,2021-04-03,Coworking space rental,REF84038004,250.37,0.0,225030.73
2021-04-10,2021-04-10,Business travel,REF36032616,333.7,0.0,224697.03
2021-04-15,2021-04-15,Project payment - Benton-Mcdonald,REF83114437,0.0,849.71,225546.74
2021-04-15,2021-04-15,Service payment - Miller-Ruiz,REF86825031,0.0,556.71,226103.45
2021-04-15,2021-04-15,Business insurance premium,REF22467783,136.62,0.0,225966.83
2021-04-15,2021-04-15,"Invoice payment - Parsons, Hamilton and Roberts",REF60259820,0.0,915.2,226882.03
2021-04-15,2021-04-15,Service payment - Smith and Sons,REF23371021,0.0,549.58,227431.61
2021-04-15,2021-04-15,"Project payment - Davis, Coleman and Rice",REF41249745,0.0,321.25,227752.86
2021-04-15,2021-04-15,"Service payment - Meyers, Thompson and Cobb",REF18991862,0.0,587.35,228340.21
2021-04-19,2021-04-19,Business meal,REF78036636,264.62,0.0,228075.59
2021-04-21,2021-04-21,Professional software license,REF67989806,240.19,0.0,227835.4
2021-05-02,2021-05-02,Equipment purchase,REF48550137,80.08,0.0,227755.32
2021-05-12,2021-05-12,Coworking space rental,REF78434904,229.36,0.0,227525.96
2021-05-15,2021-05-15,Invoice payment - Wilkins Ltd,REF49766466,0.0,639.66,228165.62
2021-05-15,2021-05-15,"Project payment - Davis, Coleman and Rice",REF75111556,0.0,302.88,228468.5
2021-05-15,2021-05-15,Service payment - Benton-Mcdonald,REF83995273,0.0,755.57,229224.07
2021-05-15,2021-05-15,Payment from Miller-Ruiz,REF82564555,0.0,446.56,229670.63
2021-05-15,2021-05-15,"Invoice payment - Meyers, Thompson and Cobb",REF75958987,0.0,563.86,230234.49
2021-05-15,2021-05-15,Business insurance premium,REF18220965,124.52,0.0,230109.97
2021-05-15,2021-05-15,"Service payment - Parsons, Hamilton and Roberts",REF40856929,0.0,654.05,230764.02
2021-05-15,2021-05-15,Payment from Green-Reed,REF76111622,0.0,494.4,231258.42
2021-05-15,2021-05-15,Project payment - Smith and Sons,REF36460797,0.0,657.77,231916.19
2021-05-16,2021-05-16,Business meal,REF17861418,203.85,0.0,231712.34
2021-05-16,2021-05-16,Marketing expenses,REF76306731,224.72,0.0,231487.62
2021-05-21,2021-05-21,Accounting expense,REF20188983,173.39,0.0,231314.23
2021-05-21,2021-05-21,Professional software license,REF24125484,201.27,0.0,231112.96
2021-06-01,2021-06-01,Business travel,REF12151403,289.85,0.0,230823.11
2021-06-02,2021-06-02,Marketing expenses,REF99332564,162.48,0.0,230660.63
2021-06-02,2021-06-02,Business travel,REF52041659,276.58,0.0,230384.05
2021-06-02,2021-06-02,Equipment purchase,REF25984357,125.15,0.0,230258.9
2021-06-05,2021-06-05,Business travel,REF20808178,384.24,0.0,229874.66
2021-06-08,2021-06-08,Accounting expense,REF77366145,177.34,0.0,229697.32
2021-06-10,2021-06-10,Training/conference,REF62621233,157.05,0.0,229540.27
2021-06-13,2021-06-13,Training/conference,REF90016647,191.39,0.0,229348.88
2021-06-15,2021-06-15,Business insurance premium,REF58500296,115.03,0.0,229233.85
2021-06-15,2021-06-15,Payment from Wilkins Ltd,REF37103575,0.0,653.48,229887.33
2021-06-15,2021-06-15,"Project payment - Meyers, Thompson and Cobb",REF97954216,0.0,401.2,230288.53
2021-06-15,2021-06-15,"Invoice payment - Parsons, Hamilton and Roberts",REF87828358,0.0,780.86,231069.39
2021-06-15,2021-06-15,Invoice payment - Smith and Sons,REF23302045,0.0,573.94,231643.33
2021-06-15,2021-06-15,Payment from Miller-Ruiz,REF47797158,0.0,592.87,232236.2
2021-06-15,2021-06-15,Service payment - Green-Reed,REF79009280,0.0,577.96,232814.16
2021-06-15,2021-06-15,"Service payment - Davis, Coleman and Rice",REF27734865,0.0,288.64,233102.8
2021-06-15,2021-06-15,Invoice payment - Benton-Mcdonald,REF36850288,0.0,561.27,233664.07
2021-06-16,2021-06-16,Business meal,REF20285944,186.27,0.0,233477.8
2021-06-16,2021-06-16,Marketing expenses,REF49873971,175.62,0.0,233302.18
2021-06-21,2021-06-21,Professional software license,REF24713535,182.37,0.0,233119.81
2021-06-26,2021-06-26,Equipment purchase,REF51973923,119.06,0.0,233000.75
2021-06-27,2021-06-27,Marketing expenses,REF65332360,107.63,0.0,232893.12
2021-06-29,2021-06-29,Training/conference,REF41839173,196.8,0.0,232696.32
2021-07-07,2021-07-07,Marketing expenses,REF81180245,162.34,0.0,232533.98
2021-07-11,2021-07-11,Business meal,REF12034954,110.17,0.0,232423.81
2021-07-15,2021-07-15,Business insurance premium,REF29498283,90.52,0.0,232333.29
2021-07-15,2021-07-15,Project payment - Green-Reed,REF24382398,0.0,422.2,232755.49
2021-07-15,2021-07-15,Invoice payment - Benton-Mcdonald,REF65736629,0.0,601.22,233356.71
2021-07-15,2021-07-15,"Project payment - Davis, Coleman and Rice",REF19098228,0.0,276.86,233633.57
2021-07-15,2021-07-15,Project payment - Wilkins Ltd,REF56976843,0.0,608.52,234242.09
2021-07-15,2021-07-15,Payment from Miller-Ruiz,REF73755006,0.0,347.05,234589.14
2021-07-15,2021-07-15,"Service payment - Meyers, Thompson and Cobb",REF26740843,0.0,384.27,234973.41
2021-07-15,2021-07-15,Project payment - Smith and Sons,REF94997584,0.0,549.39,235522.8
2021-07-15,2021-07-15,"Payment from Parsons, Hamilton and Roberts",REF13427836,0.0,694.95,236217.75
2021-07-21,2021-07-21,Professional software license,REF67590913,147.2,0.0,236070.55
2021-07-23,2021-07-23,Equipment purchase,REF57858159,52.11,0.0,236018.44
2021-07-28,2021-07-28,Business travel,REF11834550,186.27,0.0,235832.17
2021-08-07,2021-08-07,Accounting expense,REF25757232,135.46,0.0,235696.71
2021-08-15,2021-08-15,Business insurance premium,REF47129568,111.68,0.0,235585.03
2021-08-15,2021-08-15,Service payment - Green-Reed,REF93394611,0.0,609.42,236194.45
2021-08-15,2021-08-15,"Invoice payment - Parsons, Hamilton and Roberts",REF11489857,0.0,720.55,236915.0
2021-08-15,2021-08-15,"Service payment - Meyers, Thompson and Cobb",REF95647716,0.0,360.8,237275.8
2021-08-15,2021-08-15,"Payment from Davis, Coleman and Rice",REF24644444,0.0,205.85,237481.65
2021-08-15,2021-08-15,Payment from Wilkins Ltd,REF37848243,0.0,753.51,238235.16
2021-08-15,2021-08-15,Payment from Benton-Mcdonald,REF46285718,0.0,737.82,238972.98
2021-08-15,2021-08-15,Service payment - Smith and Sons,REF33682275,0.0,579.28,239552.26
2021-08-15,2021-08-15,Invoice payment - Miller-Ruiz,REF39447131,0.0,490.95,240043.21
2021-08-21,2021-08-21,Professional software license,REF10909886,162.56,0.0,239880.65
2021-08-26,2021-08-26,Marketing expenses,REF80809359,160.7,0.0,239719.95
2021-08-27,2021-08-27,Coworking space rental,REF64207332,167.38,0.0,239552.57
2021-08-28,2021-08-28,Training/conference,REF97114441,250.78,0.0,239301.79
2021-08-30,2021-08-30,Training/conference,REF69209899,108.87,0.0,239192.92
2021-09-03,2021-09-03,Training/conference,REF46303666,267.77,0.0,238925.15
2021-09-05,2021-09-05,Business travel,REF62079337,443.91,0.0,238481.24
2021-09-05,2021-09-05,Business meal,REF43847947,402.44,0.0,238078.8
2021-09-10,2021-09-10,Marketing expenses,REF61412555,39.27,0.0,238039.53
2021-09-11,2021-09-11,Business meal,REF89770006,170.72,0.0,237868.81
2021-09-15,2021-09-15,Invoice payment - Miller-Ruiz,REF20845701,0.0,568.43,238437.24
2021-09-15,2021-09-15,"Service payment - Meyers, Thompson and Cobb",REF26733554,0.0,497.43,238934.67
2021-09-15,2021-09-15,"Invoice payment - Parsons, Hamilton and Roberts",REF95944470,0.0,1098.31,240032.98
2021-09-15,2021-09-15,Payment from Benton-Mcdonald,REF39665484,0.0,1019.1,241052.08
2021-09-15,2021-09-15,Service payment - Wilkins Ltd,REF39467282,0.0,834.68,241886.76
2021-09-15,2021-09-15,Payment from Green-Reed,REF54990319,0.0,732.74,242619.5
2021-09-15,2021-09-15,Invoice payment - Smith and Sons,REF92905763,0.0,1007.21,243626.71
2021-09-15,2021-09-15,Business insurance premium,REF52913236,153.35,0.0,243473.36
2021-09-19,2021-09-19,Marketing expenses,REF99958120,187.21,0.0,243286.15
2021-09-21,2021-09-21,Professional software license,REF22148919,236.47,0.0,243049.68
2021-09-23,2021-09-23,Accounting expense,REF79392376,225.56,0.0,242824.12
2021-09-23,2021-09-23,Business meal,REF90243285,254.42,0.0,242569.7
2021-09-25,2021-09-25,Marketing expenses,REF75456452,197.91,0.0,242371.79
2021-10-01,2021-10-01,Business meal,REF12044693,334.6,0.0,242037.19
2021-10-05,2021-10-05,Accounting expense,REF46788836,285.21,0.0,241751.98
2021-10-05,2021-10-05,Equipment purchase,REF41537164,161.49,0.0,241590.49
2021-10-13,2021-10-13,Accounting expense,REF98736251,275.03,0.0,241315.46
2021-10-15,2021-10-15,Accounting expense,REF79842650,119.9,0.0,241195.56
2021-10-15,2021-10-15,Business insurance premium,REF32623618,173.03,0.0,241022.53
2021-10-15,2021-10-15,Payment from Wilkins Ltd,REF26431467,0.0,798.42,241820.95
2021-10-15,2021-10-15,"Invoice payment - Davis, Coleman and Rice",REF64090544,0.0,421.26,242242.21
2021-10-15,2021-10-15,Project payment - Smith and Sons,REF15350633,0.0,766.52,243008.73
2021-10-15,2021-10-15,Project payment - Benton-Mcdonald,REF78071278,0.0,814.51,243823.24
2021-10-15,2021-10-15,Project payment - Green-Reed,REF30651031,0.0,861.47,244684.71
2021-10-15,2021-10-15,Business meal,REF28680783,297.32,0.0,244387.39
2021-10-15,2021-10-15,Payment from Miller-Ruiz,REF41655051,0.0,774.79,245162.18
2021-10-15,2021-10-15,"Payment from Parsons, Hamilton and Roberts",REF97520320,0.0,855.86,246018.04
2021-10-17,2021-10-17,Coworking space rental,REF42758446,322.49,0.0,245695.55
2021-10-21,2021-10-21,Professional software license,REF25121162,226.75,0.0,245468.8
2021-10-25,2021-10-25,Business travel,REF86075946,590.17,0.0,244878.63
2021-10-28,2021-10-28,Business travel,REF52575960,313.15,0.0,244565.48
2021-11-02,2021-11-02,Coworking space rental,REF60968842,381.06,0.0,244184.42
2021-11-04,2021-11-04,Training/conference,REF61817798,186.17,0.0,243998.25
2021-11-05,2021-11-05,Marketing expenses,REF24325468,309.49,0.0,243688.76
2021-11-14,2021-11-14,Accounting expense,REF80858000,195.88,0.0,243492.88
2021-11-15,2021-11-15,"Payment from Meyers, Thompson and Cobb",REF42674485,0.0,636.66,244129.54
2021-11-15,2021-11-15,Project payment - Wilkins Ltd,REF46535164,0.0,908.2,245037.74
2021-11-15,2021-11-15,"Invoice payment - Parsons, Hamilton and Roberts",REF92509010,0.0,1237.24,246274.98
2021-11-15,2021-11-15,"Payment from Davis, Coleman and Rice",REF90083003,0.0,315.98,246590.96
2021-11-15,2021-11-15,Service payment - Green-Reed,REF43787071,0.0,951.47,247542.43
2021-11-15,2021-11-15,Business insurance premium,REF53767437,137.66,0.0,247404.77
2021-11-15,2021-11-15,Service payment - Miller-Ruiz,REF20013461,0.0,525.92,247930.69
2021-11-15,2021-11-15,Project payment - Smith and Sons,REF96385599,0.0,647.89,248578.58
2021-11-16,2021-11-16,Coworking space rental,REF66328709,182.9,0.0,248395.68
2021-11-19,2021-11-19,Business travel,REF40509586,478.55,0.0,247917.13
2021-11-20,2021-11-20,Business travel,REF47167629,694.02,0.0,247223.11
2021-11-21,2021-11-21,Professional software license,REF39765150,264.98,0.0,246958.13
2021-11-23,2021-11-23,Equipment purchase,REF50615528,147.96,0.0,246810.17
2021-11-26,2021-11-26,Accounting expense,REF34948692,153.6,0.0,246656.57
2021-11-30,2021-11-30,Business travel,REF35047862,426.52,0.0,246230.05
2021-12-02,2021-12-02,Business travel,REF40286727,346.02,0.0,245884.03
2021-12-04,2021-12-04,Business meal,REF39593710,177.27,0.0,245706.76
2021-12-06,2021-12-06,Equipment purchase,REF82059601,181.52,0.0,245525.24
2021-12-06,2021-12-06,Business travel,REF62781163,457.92,0.0,245067.32
2021-12-08,2021-12-08,Coworking space rental,REF10622152,187.0,0.0,244880.32
2021-12-10,2021-12-10,Marketing expenses,REF70789767,220.48,0.0,244659.84
2021-12-11,2021-12-11,Marketing expenses,REF57195295,232.98,0.0,244426.86
2021-12-15,2021-12-15,"Invoice payment - Davis, Coleman and Rice",REF35682726,0.0,281.73,244708.59
2021-12-15,2021-12-15,Invoice payment - Green-Reed,REF19729747,0.0,612.81,245321.4
2021-12-15,2021-12-15,Business insurance premium,REF90146174,119.84,0.0,245201.56
2021-12-15,2021-12-15,Project payment - Wilkins Ltd,REF81802618,0.0,764.42,245965.98
2021-12-15,2021-12-15,Payment from Miller-Ruiz,REF25392591,0.0,527.46,246493.44
2021-12-15,2021-12-15,Project payment - Smith and Sons,REF14670544,0.0,655.13,247148.57
2021-12-15,2021-12-15,"Service payment - Meyers, Thompson and Cobb",REF91825824,0.0,564.11,247712.68
2021-12-17,2021-12-17,Business meal,REF30284597,265.72,0.0,247446.96
2021-12-21,2021-12-21,Professional software license,REF83351063,193.84,0.0,247253.12
2021-12-22,2021-12-22,Marketing expenses,REF11652012,324.37,0.0,246928.75
2021-12-25,2021-12-25,Accounting expense,REF18492405,183.76,0.0,246744.99
2021-12-31,2021-12-31,Accounting expense,REF82018407,164.6,0.0,246580.39
2022-01-01,2022-01-01,Equipment purchase,REF92430260,257.65,0.0,246322.74
2022-01-06,2022-01-06,Business meal,REF29245674,410.63,0.0,245912.11
2022-01-11,2022-01-11,Marketing expenses,REF54651803,362.0,0.0,245550.11
2022-01-12,2022-01-12,Business meal,REF23440512,380.28,0.0,245169.83
2022-01-14,2022-01-14,Business travel,REF61166020,363.54,0.0,244806.29
2022-01-15,2022-01-15,Project payment - Miller-Ruiz,REF52346751,0.0,904.52,245710.81
2022-01-15,2022-01-15,"Service payment - Davis, Coleman and Rice",REF32019369,0.0,466.37,246177.18
2022-01-15,2022-01-15,Invoice payment - Green-Reed,REF70331222,0.0,885.99,247063.17
2022-01-15,2022-01-15,Payment from Smith and Sons,REF93300261,0.0,866.72,247929.89
2022-01-15,2022-01-15,"Payment from Parsons, Hamilton and Roberts",REF50693700,0.0,1165.51,249095.4
2022-01-15,2022-01-15,"Payment from Meyers, Thompson and Cobb",REF15529876,0.0,615.84,249711.24
2022-01-15,2022-01-15,Business insurance premium,REF41917918,166.06,0.0,249545.18
2022-01-15,2022-01-15,Payment from Wilkins Ltd,REF85780065,0.0,894.2,250439.38
2022-01-19,2022-01-19,Business travel,REF17313343,271.59,0.0,250167.79
2022-01-20,2022-01-20,Marketing expenses,REF77967711,425.87,0.0,249741.92
2022-01-21,2022-01-21,Professional software license,REF22922061,239.99,0.0,249501.93
2022-01-21,2022-01-21,Coworking space rental,REF24734594,488.47,0.0,249013.46
2022-01-23,2022-01-23,Business meal,REF59407719,195.98,0.0,248817.48
2022-01-28,2022-01-28,Coworking space rental,REF89741402,346.55,0.0,248470.93
2022-01-28,2022-01-28,Marketing expenses,REF83264970,254.51,0.0,248216.42
2022-01-30,2022-01-30,Marketing expenses,REF25740106,399.32,0.0,247817.1
2022-02-01,2022-02-01,Accounting expense,REF96872432,264.5,0.0,247552.6
2022-02-03,2022-02-03,Accounting expense,REF16692947,91.1,0.0,247461.5
2022-02-06,2022-02-06,Business meal,REF74636673,269.94,0.0,247191.56
2022-02-12,2022-02-12,Training/conference,REF92723119,308.56,0.0,246883.0
2022-02-15,2022-02-15,Payment from Wilkins Ltd,REF10715827,0.0,786.88,247669.88
2022-02-15,2022-02-15,"Invoice payment - Meyers, Thompson and Cobb",REF50801775,0.0,467.06,248136.94
2022-02-15,2022-02-15,Payment from Smith and Sons,REF80181103,0.0,735.73,248872.67
2022-02-15,2022-02-15,"Payment from Parsons, Hamilton and Roberts",REF75203112,0.0,943.83,249816.5
2022-02-15,2022-02-15,Service payment - Green-Reed,REF29026008,0.0,865.3,250681.8
2022-02-15,2022-02-15,Training/conference,REF99288047,167.17,0.0,250514.63
2022-02-15,2022-02-15,Service payment - Miller-Ruiz,REF20901458,0.0,863.44,251378.07
2022-02-15,2022-02-15,Payment from Benton-Mcdonald,REF30580056,0.0,1037.67,252415.74
2022-02-15,2022-02-15,"Project payment - Davis, Coleman and Rice",REF16298219,0.0,384.33,252800.07
2022-02-15,2022-02-15,Business insurance premium,REF19928994,152.51,0.0,252647.56
2022-02-21,2022-02-21,Professional software license,REF88652065,219.51,0.0,252428.05
2022-02-22,2022-02-22,Business meal,REF75961496,301.01,0.0,252127.04
2022-02-25,2022-02-25,Accounting expense,REF83280521,174.56,0.0,251952.48
2022-03-03,2022-03-03,Business travel,REF35560213,276.19,0.0,251676.29
2022-03-06,2022-03-06,Business meal,REF36169300,259.62,0.0,251416.67
2022-03-15,2022-03-15,Business insurance premium,REF60105606,152.1,0.0,251264.57
2022-03-15,2022-03-15,"Invoice payment - Davis, Coleman and Rice",REF40900804,0.0,338.11,251602.68
2022-03-15,2022-03-15,Service payment - Smith and Sons,REF29359474,0.0,915.22,252517.9
2022-03-15,2022-03-15,"Payment from Parsons, Hamilton and Roberts",REF83221639,0.0,951.37,253469.27
2022-03-15,2022-03-15,Project payment - Green-Reed,REF49493047,0.0,779.32,254248.59
2022-03-15,2022-03-15,Payment from Wilkins Ltd,REF56537164,0.0,1054.15,255302.74
2022-03-15,2022-03-15,Project payment - Miller-Ruiz,REF46352089,0.0,543.48,255846.22
2022-03-15,2022-03-15,Payment from Benton-Mcdonald,REF77674344,0.0,858.77,256704.99
2022-03-18,2022-03-18,Equipment purchase,REF79685605,202.46,0.0,256502.53
2022-03-18,2022-03-18,Business meal,REF49242171,262.31,0.0,256240.22
2022-03-21,2022-03-21,Professional software license,REF43163768,188.45,0.0,256051.77
2022-03-25,2022-03-25,Training/conference,REF63144431,145.05,0.0,255906.72
2022-03-26,2022-03-26,Marketing expenses,REF93592681,219.42,0.0,255687.3
2022-03-28,2022-03-28,Marketing expenses,REF18289036,477.51,0.0,255209.79
2022-04-02,2022-04-02,Coworking space rental,REF30592206,224.34,0.0,254985.45
2022-04-03,2022-04-03,Accounting expense,REF19885183,194.05,0.0,254791.4
2022-04-09,2022-04-09,Marketing expenses,REF20158024,336.98,0.0,254454.42
2022-04-15,2022-04-15,"Project payment - Davis, Coleman and Rice",REF99515431,0.0,383.42,254837.84
2022-04-15,2022-04-15,Project payment - Green-Reed,REF79101409,0.0,709.31,255547.15
2022-04-15,2022-04-15,Invoice payment - Benton-Mcdonald,REF52509590,0.0,533.92,256081.07
2022-04-15,2022-04-15,Marketing expenses,REF64819685,395.06,0.0,255686.01
2022-04-15,2022-04-15,Service payment - Miller-Ruiz,REF14707844,0.0,698.17,256384.18
2022-04-15,2022-04-15,Business insurance premium,REF53633899,130.69,0.0,256253.49
2022-04-15,2022-04-15,Coworking space rental,REF68231650,368.92,0.0,255884.57
2022-04-15,2022-04-15,"Service payment - Parsons, Hamilton and Roberts",REF47296178,0.0,880.82,256765.39
2022-04-15,2022-04-15,Payment from Wilkins Ltd,REF50509479,0.0,797.46,257562.85
2022-04-18,2022-04-18,Training/conference,REF32219803,202.74,0.0,257360.11
2022-04-21,2022-04-21,Accounting expense,REF57046215,187.52,0.0,257172.59
2022-04-21,2022-04-21,Professional software license,REF67586181,198.19,0.0,256974.4
2022-04-26,2022-04-26,Equipment purchase,REF72348866,149.39,0.0,256825.01
2022-05-01,2022-05-01,Equipment purchase,REF11137953,178.59,0.0,256646.42
2022-05-04,2022-05-04,Marketing expenses,REF53547879,250.55,0.0,256395.87
2022-05-09,2022-05-09,Business meal,REF16650970,167.06,0.0,256228.81
2022-05-13,2022-05-13,Accounting expense,REF72306028,201.22,0.0,256027.59
2022-05-15,2022-05-15,"Payment from Davis, Coleman and Rice",REF70221214,0.0,261.85,256289.44
2022-05-15,2022-05-15,"Project payment - Meyers, Thompson and Cobb",REF27852781,0.0,448.5,256737.94
2022-05-15,2022-05-15,Business insurance premium,REF57098270,115.74,0.0,256622.2
2022-05-15,2022-05-15,"Payment from Parsons, Hamilton and Roberts",REF16405117,0.0,770.58,257392.78
2022-05-15,2022-05-15,Project payment - Green-Reed,REF70574664,0.0,552.19,257944.97
2022-05-15,2022-05-15,Payment from Wilkins Ltd,REF64821758,0.0,599.98,258544.95
2022-05-15,2022-05-15,Payment from Benton-Mcdonald,REF43123502,0.0,824.79,259369.74
2022-05-15,2022-05-15,Service payment - Miller-Ruiz,REF42573744,0.0,479.65,259849.39
2022-05-18,2022-05-18,Training/conference,REF40506154,175.09,0.0,259674.3
2022-05-21,2022-05-21,Professional software license,REF70906932,164.71,0.0,259509.59
2022-05-24,2022-05-24,Business meal,REF47227933,133.08,0.0,259376.51
2022-05-28,2022-05-28,Business travel,REF73711835,353.28,0.0,259023.23
2022-06-05,2022-06-05,Accounting expense,REF66374328,163.58,0.0,258859.65
2022-06-08,2022-06-08,Marketing expenses,REF90601411,332.73,0.0,258526.92
2022-06-10,2022-06-10,Business meal,REF85925419,168.11,0.0,258358.81
2022-06-15,2022-06-15,Business meal,REF16620731,294.23,0.0,258064.58
2022-06-15,2022-06-15,Invoice payment - Benton-Mcdonald,REF26965502,0.0,843.79,258908.37
2022-06-15,2022-06-15,Business travel,REF94319785,383.05,0.0,258525.32
2022-06-15,2022-06-15,"Payment from Davis, Coleman and Rice",REF48029391,0.0,274.36,258799.68
2022-06-15,2022-06-15,Service payment - Wilkins Ltd,REF52702715,0.0,643.33,259443.01
2022-06-15,2022-06-15,"Service payment - Parsons, Hamilton and Roberts",REF94827358,0.0,691.65,260134.66
2022-06-15,2022-06-15,Service payment - Miller-Ruiz,REF45995913,0.0,547.72,260682.38
2022-06-15,2022-06-15,"Invoice payment - Meyers, Thompson and Cobb",REF37331027,0.0,326.65,261009.03
2022-06-15,2022-06-15,Payment from Smith and Sons,REF20231958,0.0,599.84,261608.87
2022-06-15,2022-06-15,Service payment - Green-Reed,REF71407847,0.0,519.59,262128.46
2022-06-15,2022-06-15,Business insurance premium,REF93790469,109.17,0.0,262019.29
2022-06-20,2022-06-20,Training/conference,REF55815789,146.27,0.0,261873.02
2022-06-21,2022-06-21,Professional software license,REF35465208,157.24,0.0,261715.78
2022-06-23,2022-06-23,Accounting expense,REF50991685,171.22,0.0,261544.56
2022-06-24,2022-06-24,Coworking space rental,REF11684608,157.14,0.0,261387.42
2022-06-27,2022-06-27,Equipment purchase,REF22896172,104.2,0.0,261283.22
2022-06-28,2022-06-28,Equipment purchase,REF51345493,154.28,0.0,261128.94
2022-06-30,2022-06-30,Marketing expenses,REF73980946,211.77,0.0,260917.17
2022-07-06,2022-07-06,Equipment purchase,REF51478389,128.66,0.0,260788.51
2022-07-06,2022-07-06,Business meal,REF84237578,197.44,0.0,260591.07
2022-07-11,2022-07-11,Coworking space rental,REF68211060,65.19,0.0,260525.88
2022-07-12,2022-07-12,Marketing expenses,REF81554810,336.85,0.0,260189.03
2022-07-12,2022-07-12,Business meal,REF79249053,167.07,0.0,260021.96
2022-07-13,2022-07-13,Training/conference,REF57434944,107.38,0.0,259914.58
2022-07-15,2022-07-15,Invoice payment - Benton-Mcdonald,REF90356991,0.0,570.07,260484.65
2022-07-15,2022-07-15,Payment from Miller-Ruiz,REF58426488,0.0,337.45,260822.1
2022-07-15,2022-07-15,"Service payment - Parsons, Hamilton and Roberts",REF60192188,0.0,618.43,261440.53
2022-07-15,2022-07-15,Service payment - Smith and Sons,REF20259525,0.0,426.74,261867.27
2022-07-15,2022-07-15,"Service payment - Meyers, Thompson and Cobb",REF68905032,0.0,429.6,262296.87
2022-07-15,2022-07-15,Payment from Wilkins Ltd,REF44685706,0.0,662.02,262958.89
2022-07-15,2022-07-15,"Payment from Davis, Coleman and Rice",REF77520964,0.0,248.45,263207.34
2022-07-15,2022-07-15,Business insurance premium,REF84391825,88.66,0.0,263118.68
2022-07-16,2022-07-16,Business travel,REF54981453,324.46,0.0,262794.22
2022-07-20,2022-07-20,Accounting expense,REF78802252,190.84,0.0,262603.38
2022-07-21,2022-07-21,Professional software license,REF24104495,157.1,0.0,262446.28
2022-07-21,2022-07-21,Business meal,REF98407792,159.26,0.0,262287.02
2022-07-23,2022-07-23,Business meal,REF66645459,122.13,0.0,262164.89
2022-07-25,2022-07-25,Business meal,REF35191437,191.98,0.0,261972.91
2022-07-27,2022-07-27,Marketing expenses,REF65202890,183.19,0.0,261789.72
2022-08-15,2022-08-15,Business travel,REF55010850,234.37,0.0,261555.35
2022-08-15,2022-08-15,Business insurance premium,REF28189953,106.23,0.0,261449.12
2022-08-15,2022-08-15,Invoice payment - Green-Reed,REF67925730,0.0,616.82,262065.94
2022-08-15,2022-08-15,Invoice payment - Wilkins Ltd,REF60019973,0.0,711.81,262777.75
2022-08-15,2022-08-15,"Invoice payment - Meyers, Thompson and Cobb",REF79719354,0.0,393.89,263171.64
2022-08-15,2022-08-15,"Payment from Parsons, Hamilton and Roberts",REF64591764,0.0,840.97,264012.61
2022-08-15,2022-08-15,Project payment - Miller-Ruiz,REF86882943,0.0,497.39,264510.0
2022-08-15,2022-08-15,Payment from Smith and Sons,REF79501694,0.0,672.98,265182.98
2022-08-15,2022-08-15,"Payment from Davis, Coleman and Rice",REF49759885,0.0,272.78,265455.76
2022-08-21,2022-08-21,Business meal,REF42899627,158.64,0.0,265297.12
2022-08-21,2022-08-21,Professional software license,REF61847200,190.02,0.0,265107.1
2022-08-22,2022-08-22,Marketing expenses,REF63169873,185.64,0.0,264921.46
2022-08-25,2022-08-25,Coworking space rental,REF48143811,250.34,0.0,264671.12
2022-08-31,2022-08-31,Marketing expenses,REF36179266,284.87,0.0,264386.25
2022-09-06,2022-09-06,Business travel,REF61825639,531.28,0.0,263854.97
2022-09-09,2022-09-09,Business travel,REF34764756,309.24,0.0,263545.73
2022-09-15,2022-09-15,Business insurance premium,REF72366091,151.19,0.0,263394.54
2022-09-15,2022-09-15,Invoice payment - Green-Reed,REF51355240,0.0,714.52,264109.06
2022-09-15,2022-09-15,Invoice payment - Wilkins Ltd,REF38360875,0.0,701.08,264810.14
2022-09-15,2022-09-15,Payment from Miller-Ruiz,REF46483314,0.0,656.4,265466.54
2022-09-15,2022-09-15,Payment from Benton-Mcdonald,REF61391883,0.0,771.48,266238.02
2022-09-15,2022-09-15,"Payment from Davis, Coleman and Rice",REF53221012,0.0,393.89,266631.91
2022-09-15,2022-09-15,"Service payment - Parsons, Hamilton and Roberts",REF64115400,0.0,1061.45,267693.36
2022-09-15,2022-09-15,"Payment from Meyers, Thompson and Cobb",REF58056125,0.0,523.34,268216.7
2022-09-15,2022-09-15,Service payment - Smith and Sons,REF22017472,0.0,566.6,268783.3
2022-09-21,2022-09-21,Professional software license,REF47793529,199.59,0.0,268583.71
2022-09-23,2022-09-23,Training/conference,REF28021832,189.48,0.0,268394.23
2022-09-24,2022-09-24,Marketing expenses,REF98087654,373.94,0.0,268020.29
2022-09-25,2022-09-25,Business travel,REF26558105,574.82,0.0,267445.47
2022-10-03,2022-10-03,Business travel,REF52665228,353.93,0.0,267091.54
2022-10-05,2022-10-05,Training/conference,REF37304048,110.57,0.0,266980.97
2022-10-09,2022-10-09,Training/conference,REF73785613,188.19,0.0,266792.78
2022-10-13,2022-10-13,Business travel,REF57772869,502.5,0.0,266290.28
2022-10-15,2022-10-15,Business insurance premium,REF96547510,162.03,0.0,266128.25
2022-10-15,2022-10-15,"Invoice payment - Meyers, Thompson and Cobb",REF73412492,0.0,462.38,266590.63
2022-10-15,2022-10-15,"Invoice payment - Davis, Coleman and Rice",REF31500774,0.0,484.4,267075.03
2022-10-15,2022-10-15,Service payment - Green-Reed,REF72349592,0.0,811.93,267886.96
2022-10-15,2022-10-15,Project payment - Benton-Mcdonald,REF32270769,0.0,1031.92,268918.88
2022-10-15,2022-10-15,Invoice payment - Miller-Ruiz,REF74867781,0.0,728.02,269646.9
2022-10-15,2022-10-15,"Invoice payment - Parsons, Hamilton and Roberts",REF75346560,0.0,830.74,270477.64
2022-10-15,2022-10-15,Service payment - Wilkins Ltd,REF19321842,0.0,910.41,271388.05
2022-10-19,2022-10-19,Business meal,REF44862606,130.02,0.0,271258.03
2022-10-20,2022-10-20,Coworking space rental,REF63720289,415.72,0.0,270842.31
2022-10-21,2022-10-21,Professional software license,REF68795941,275.02,0.0,270567.29
2022-10-23,2022-10-23,Accounting expense,REF90765456,210.74,0.0,270356.55
2022-10-27,2022-10-27,Training/conference,REF70087675,225.39,0.0,270131.16
2022-10-30,2022-10-30,Business travel,REF35483222,384.78,0.0,269746.38
2022-11-02,2022-11-02,Coworking space rental,REF76604744,380.57,0.0,269365.81
2022-11-06,2022-11-06,Training/conference,REF55916950,154.09,0.0,269211.72
2022-11-07,2022-11-07,Coworking space rental,REF80110214,261.3,0.0,268950.42
2022-11-11,2022-11-11,Training/conference,REF12036917,258.86,0.0,268691.56
2022-11-14,2022-11-14,Accounting expense,REF10324278,313.27,0.0,268378.29
2022-11-15,2022-11-15,Service payment - Green-Reed,REF10734844,0.0,677.64,269055.93
2022-11-15,2022-11-15,Payment from Wilkins Ltd,REF20352247,0.0,728.42,269784.35
2022-11-15,2022-11-15,"Service payment - Davis, Coleman and Rice",REF28560176,0.0,411.78,270196.13
2022-11-15,2022-11-15,Service payment - Miller-Ruiz,REF74550896,0.0,787.63,270983.76
2022-11-15,2022-11-15,"Project payment - Meyers, Thompson and Cobb",REF63999635,0.0,538.41,271522.17
2022-11-15,2022-11-15,"Payment from Parsons, Hamilton and Roberts",REF11912161,0.0,1155.79,272677.96
2022-11-15,2022-11-15,Invoice payment - Smith and Sons,REF12738960,0.0,922.86,273600.82
2022-11-15,2022-11-15,Invoice payment - Benton-Mcdonald,REF99554900,0.0,914.65,274515.47
2022-11-15,2022-11-15,Business insurance premium,REF37360387,162.49,0.0,274352.98
2022-11-19,2022-11-19,Business meal,REF72281675,403.77,0.0,273949.21
2022-11-21,2022-11-21,Professional software license,REF61268891,240.29,0.0,273708.92
2022-11-22,2022-11-22,Accounting expense,REF17949877,329.57,0.0,273379.35
2022-11-23,2022-11-23,Equipment purchase,REF14387130,204.67,0.0,273174.68
2022-11-26,2022-11-26,Accounting expense,REF72431838,157.37,0.0,273017.31
2022-12-04,2022-12-04,Business travel,REF44694895,430.71,0.0,272586.6
2022-12-05,2022-12-05,Marketing expenses,REF57496383,213.57,0.0,272373.03
2022-12-07,2022-12-07,Coworking space rental,REF58259397,262.18,0.0,272110.85
2022-12-12,2022-12-12,Training/conference,REF61281475,148.58,0.0,271962.27
2022-12-13,2022-12-13,Business travel,REF72705200,294.95,0.0,271667.32
2022-12-15,2022-12-15,"Invoice payment - Parsons, Hamilton and Roberts",REF15032160,0.0,978.94,272646.26
2022-12-15,2022-12-15,Business insurance premium,REF38395935,129.66,0.0,272516.6
2022-12-15,2022-12-15,"Project payment - Meyers, Thompson and Cobb",REF52884499,0.0,478.94,272995.54
2022-12-15,2022-12-15,Project payment - Miller-Ruiz,REF86333842,0.0,393.8,273389.34
2022-12-15,2022-12-15,Invoice payment - Benton-Mcdonald,REF24134429,0.0,631.02,274020.36
2022-12-15,2022-12-15,Payment from Wilkins Ltd,REF12732789,0.0,896.08,274916.44
2022-12-15,2022-12-15,"Service payment - Davis, Coleman and Rice",REF18992073,0.0,361.73,275278.17
2022-12-16,2022-12-16,Training/conference,REF92294293,109.09,0.0,275169.08
2022-12-21,2022-12-21,Accounting expense,REF75686245,134.35,0.0,275034.73
2022-12-21,2022-12-21,Professional software license,REF58146906,200.47,0.0,274834.26
2022-12-22,2022-12-22,Accounting expense,REF12648945,206.26,0.0,274628.0
2022-12-26,2022-12-26,Equipment purchase,REF43316538,153.65,0.0,274474.35
2023-01-05,2023-01-05,Business travel,REF44959792,523.8,0.0,273950.55
2023-01-11,2023-01-11,Business meal,REF59142219,345.62,0.0,273604.93
2023-01-12,2023-01-12,Marketing expenses,REF59940204,291.62,0.0,273313.31
2023-01-15,2023-01-15,Payment from Wilkins Ltd,REF47405817,0.0,716.32,274029.63
2023-01-15,2023-01-15,Business insurance premium,REF37179360,161.65,0.0,273867.98
2023-01-15,2023-01-15,Payment from Smith and Sons,REF38910643,0.0,1005.39,274873.37
2023-01-15,2023-01-15,"Payment from Davis, Coleman and Rice",REF60143904,0.0,483.99,275357.36
2023-01-15,2023-01-15,Service payment - Green-Reed,REF10284065,0.0,735.75,276093.11
2023-01-15,2023-01-15,Invoice payment - Benton-Mcdonald,REF52434820,0.0,1418.03,277511.14
2023-01-15,2023-01-15,Project payment - Miller-Ruiz,REF46607900,0.0,857.61,278368.75
2023-01-15,2023-01-15,"Invoice payment - Parsons, Hamilton and Roberts",REF42483176,0.0,1266.66,279635.41
2023-01-18,2023-01-18,Coworking space rental,REF60448503,265.34,0.0,279370.07
2023-01-21,2023-01-21,Professional software license,REF85624936,252.32,0.0,279117.75
2023-01-28,2023-01-28,Coworking space rental,REF15780384,309.28,0.0,278808.47
2023-01-29,2023-01-29,Training/conference,REF86277664,284.15,0.0,278524.32
2023-02-01,2023-02-01,Coworking space rental,REF47654368,276.09,0.0,278248.23
2023-02-02,2023-02-02,Marketing expenses,REF83940395,353.36,0.0,277894.87
2023-02-03,2023-02-03,Equipment purchase,REF79987568,227.53,0.0,277667.34
2023-02-03,2023-02-03,Coworking space rental,REF31190661,365.47,0.0,277301.87
2023-02-06,2023-02-06,Marketing expenses,REF59787344,414.79,0.0,276887.08
2023-02-07,2023-02-07,Coworking space rental,REF42847277,264.21,0.0,276622.87
2023-02-08,2023-02-08,Training/conference,REF47698437,292.71,0.0,276330.16
2023-02-15,2023-02-15,Business insurance premium,REF60423359,153.67,0.0,276176.49
2023-02-15,2023-02-15,Payment from Green-Reed,REF36540508,0.0,721.84,276898.33
2023-02-15,2023-02-15,"Invoice payment - Parsons, Hamilton and Roberts",REF28564001,0.0,744.26,277642.59
2023-02-15,2023-02-15,Payment from Benton-Mcdonald,REF61605325,0.0,766.42,278409.01
2023-02-15,2023-02-15,"Service payment - Davis, Coleman and Rice",REF69523754,0.0,366.41,278775.42
2023-02-15,2023-02-15,Invoice payment - Miller-Ruiz,REF42451236,0.0,805.3,279580.72
2023-02-15,2023-02-15,Payment from Smith and Sons,REF91795425,0.0,958.57,280539.29
2023-02-15,2023-02-15,Payment from Wilkins Ltd,REF37424378,0.0,750.15,281289.44
2023-02-16,2023-02-16,Business meal,REF30531608,244.28,0.0,281045.16
2023-02-20,2023-02-20,Business meal,REF22774676,130.01,0.0,280915.15
2023-02-21,2023-02-21,Professional software license,REF57045423,234.03,0.0,280681.12
2023-02-23,2023-02-23,Equipment purchase,REF32411414,132.88,0.0,280548.24
2023-02-27,2023-02-27,Training/conference,REF76568890,237.58,0.0,280310.66
2023-03-05,2023-03-05,Coworking space rental,REF62747580,132.89,0.0,280177.77
2023-03-13,2023-03-13,Equipment purchase,REF54234926,153.81,0.0,280023.96
2023-03-13,2023-03-13,Marketing expenses,REF96921143,299.62,0.0,279724.34
2023-03-15,2023-03-15,Invoice payment - Benton-Mcdonald,REF81637734,0.0,826.23,280550.57
2023-03-15,2023-03-15,"Payment from Meyers, Thompson and Cobb",REF54618893,0.0,537.76,281088.33
2023-03-15,2023-03-15,Payment from Wilkins Ltd,REF64900677,0.0,704.99,281793.32
2023-03-15,2023-03-15,Business insurance premium,REF69509964,138.17,0.0,281655.15
2023-03-15,2023-03-15,Project payment - Green-Reed,REF69488333,0.0,590.41,282245.56
2023-03-15,2023-03-15,"Project payment - Parsons, Hamilton and Roberts",REF16615766,0.0,1011.92,283257.48
2023-03-15,2023-03-15,Invoice payment - Miller-Ruiz,REF95018676,0.0,639.35,283896.83
2023-03-15,2023-03-15,Project payment - Smith and Sons,REF99671294,0.0,833.96,284730.79
2023-03-15,2023-03-15,"Payment from Davis, Coleman and Rice",REF13125036,0.0,261.27,284992.06
2023-03-18,2023-03-18,Marketing expenses,REF92803341,242.25,0.0,284749.81
2023-03-20,2023-03-20,Business meal,REF30348895,317.54,0.0,284432.27
2023-03-21,2023-03-21,Professional software license,REF65313086,179.58,0.0,284252.69
2023-03-21,2023-03-21,Training/conference,REF78128248,211.8,0.0,284040.89
2023-04-01,2023-04-01,Business meal,REF17104810,182.32,0.0,283858.57
2023-04-06,2023-04-06,Business travel,REF31669042,418.43,0.0,283440.14
2023-04-08,2023-04-08,Business travel,REF12435911,296.2,0.0,283143.94
2023-04-09,2023-04-09,Marketing expenses,REF53864544,376.08,0.0,282767.86
2023-04-15,2023-04-15,Business insurance premium,REF90097582,144.96,0.0,282622.9
2023-04-15,2023-04-15,Project payment - Miller-Ruiz,REF10834122,0.0,552.06,283174.96
2023-04-15,2023-04-15,"Invoice payment - Parsons, Hamilton and Roberts",REF84877052,0.0,780.45,283955.41
2023-04-15,2023-04-15,"Service payment - Davis, Coleman and Rice",REF23005760,0.0,314.44,284269.85
2023-04-15,2023-04-15,Service payment - Wilkins Ltd,REF64817418,0.0,949.2,285219.05
2023-04-15,2023-04-15,Invoice payment - Green-Reed,REF41979249,0.0,825.37,286044.42
2023-04-15,2023-04-15,Project payment - Smith and Sons,REF41425005,0.0,700.13,286744.55
2023-04-15,2023-04-15,"Invoice payment - Meyers, Thompson and Cobb",REF61977140,0.0,549.17,287293.72
2023-04-15,2023-04-15,Payment from Benton-Mcdonald,REF25535043,0.0,1052.89,288346.61
2023-04-21,2023-04-21,Professional software license,REF20666130,193.67,0.0,288152.94
2023-04-28,2023-04-28,Business travel,REF33996074,595.66,0.0,287557.28
2023-05-01,2023-05-01,Equipment purchase,REF19755428,141.0,0.0,287416.28
2023-05-03,2023-05-03,Marketing expenses,REF90093421,208.29,0.0,287207.99
2023-05-04,2023-05-04,Business travel,REF99545841,415.14,0.0,286792.85
2023-05-12,2023-05-12,Accounting expense,REF74831015,211.97,0.0,286580.88
2023-05-15,2023-05-15,Payment from Benton-Mcdonald,REF45571883,0.0,831.12,287412.0
2023-05-15,2023-05-15,"Invoice payment - Davis, Coleman and Rice",REF35909750,0.0,392.65,287804.65
2023-05-15,2023-05-15,Payment from Wilkins Ltd,REF84517740,0.0,684.75,288489.4
2023-05-15,2023-05-15,"Project payment - Meyers, Thompson and Cobb",REF77785818,0.0,375.52,288864.92
2023-05-15,2023-05-15,Project payment - Miller-Ruiz,REF32605561,0.0,565.29,289430.21
2023-05-15,2023-05-15,Project payment - Smith and Sons,REF52303090,0.0,550.36,289980.57
2023-05-15,2023-05-15,Service payment - Green-Reed,REF53562646,0.0,699.4,290679.97
2023-05-15,2023-05-15,"Project payment - Parsons, Hamilton and Roberts",REF20970031,0.0,754.64,291434.61
2023-05-15,2023-05-15,Business insurance premium,REF98255373,129.13,0.0,291305.48
2023-05-16,2023-05-16,Marketing expenses,REF22749504,161.24,0.0,291144.24
2023-05-21,2023-05-21,Professional software license,REF19791996,200.44,0.0,290943.8
2023-05-21,2023-05-21,Accounting expense,REF88050008,160.73,0.0,290783.07
2023-05-22,2023-05-22,Accounting expense,REF94361044,189.3,0.0,290593.77
2023-05-24,2023-05-24,Business meal,REF23580387,357.62,0.0,290236.15
2023-05-25,2023-05-25,Business travel,REF74074728,232.27,0.0,290003.88
2023-05-25,2023-05-25,Accounting expense,REF84270914,142.46,0.0,289861.42
2023-06-02,2023-06-02,Accounting expense,REF17630817,148.12,0.0,289713.3
2023-06-07,2023-06-07,Training/conference,REF26525120,163.22,0.0,289550.08
2023-06-10,2023-06-10,Business meal,REF42062414,114.37,0.0,289435.71
2023-06-12,2023-06-12,Accounting expense,REF54855092,213.34,0.0,289222.37
2023-06-15,2023-06-15,Business insurance premium,REF72072011,116.7,0.0,289105.67
2023-06-15,2023-06-15,"Payment from Meyers, Thompson and Cobb",REF21586189,0.0,367.82,289473.49
2023-06-15,2023-06-15,Service payment - Wilkins Ltd,REF57790090,0.0,641.92,290115.41
2023-06-15,2023-06-15,Payment from Green-Reed,REF45958743,0.0,427.16,290542.57
2023-06-15,2023-06-15,Invoice payment - Miller-Ruiz,REF26466719,0.0,469.72,291012.29
2023-06-15,2023-06-15,Payment from Benton-Mcdonald,REF91351380,0.0,764.31,291776.6
2023-06-15,2023-06-15,"Project payment - Davis, Coleman and Rice",REF38372531,0.0,322.31,292098.91
2023-06-15,2023-06-15,Payment from Smith and Sons,REF45523861,0.0,505.42,292604.33
2023-06-17,2023-06-17,Business meal,REF15811387,247.16,0.0,292357.17
2023-06-18,2023-06-18,Equipment purchase,REF34283462,130.81,0.0,292226.36
2023-06-21,2023-06-21,Professional software license,REF59358188,160.38,0.0,292065.98
2023-06-21,2023-06-21,Training/conference,REF83631041,138.88,0.0,291927.1
2023-06-22,2023-06-22,Business meal,REF63212291,209.43,0.0,291717.67
2023-06-25,2023-06-25,Marketing expenses,REF33870506,232.8,0.0,291484.87
2023-06-26,2023-06-26,Equipment purchase,REF40068568,177.5,0.0,291307.37
2023-06-26,2023-06-26,Accounting expense,REF64867051,97.7,0.0,291209.67
2023-07-01,2023-07-01,Business travel,REF67225582,342.41,0.0,290867.26
2023-07-05,2023-07-05,Accounting expense,REF93502919,124.17,0.0,290743.09
2023-07-08,2023-07-08,Training/conference,REF70603207,212.83,0.0,290530.26
2023-07-11,2023-07-11,Business travel,REF63389034,353.49,0.0,290176.77
2023-07-12,2023-07-12,Business meal,REF85367619,212.65,0.0,289964.12
2023-07-14,2023-07-14,Business travel,REF75205071,284.08,0.0,289680.04
2023-07-15,2023-07-15,Business insurance premium,REF59885158,106.91,0.0,289573.13
2023-07-15,2023-07-15,"Invoice payment - Meyers, Thompson and Cobb",REF81557884,0.0,246.72,289819.85
2023-07-15,2023-07-15,Payment from Smith and Sons,REF22297181,0.0,491.25,290311.1
2023-07-15,2023-07-15,"Service payment - Parsons, Hamilton and Roberts",REF54264099,0.0,688.17,290999.27
2023-07-15,2023-07-15,Invoice payment - Miller-Ruiz,REF34211306,0.0,412.34,291411.61
2023-07-15,2023-07-15,Service payment - Green-Reed,REF13343637,0.0,483.06,291894.67
2023-07-15,2023-07-15,Service payment - Wilkins Ltd,REF52402216,0.0,525.68,292420.35
2023-07-15,2023-07-15,"Service payment - Davis, Coleman and Rice",REF71263278,0.0,216.78,292637.13
2023-07-21,2023-07-21,Professional software license,REF32571834,133.54,0.0,292503.59
2023-07-22,2023-07-22,Marketing expenses,REF40823821,313.09,0.0,292190.5
2023-07-28,2023-07-28,Marketing expenses,REF44031469,322.83,0.0,291867.67
2023-08-04,2023-08-04,Business meal,REF38409086,180.91,0.0,291686.76
2023-08-08,2023-08-08,Accounting expense,REF12185019,183.45,0.0,291503.31
2023-08-11,2023-08-11,Business travel,REF46179884,317.63,0.0,291185.68
2023-08-12,2023-08-12,Business travel,REF81771814,291.09,0.0,290894.59
2023-08-13,2023-08-13,Coworking space rental,REF91239510,200.96,0.0,290693.63
2023-08-14,2023-08-14,Business meal,REF79632037,197.79,0.0,290495.84
2023-08-15,2023-08-15,Project payment - Green-Reed,REF59906623,0.0,526.26,291022.1
2023-08-15,2023-08-15,"Payment from Meyers, Thompson and Cobb",REF28169399,0.0,398.71,291420.81
2023-08-15,2023-08-15,Business insurance premium,REF71511951,105.26,0.0,291315.55
2023-08-15,2023-08-15,Service payment - Miller-Ruiz,REF18618511,0.0,669.81,291985.36
2023-08-15,2023-08-15,"Project payment - Parsons, Hamilton and Roberts",REF47204032,0.0,857.82,292843.18
2023-08-15,2023-08-15,"Invoice payment - Davis, Coleman and Rice",REF85565290,0.0,321.75,293164.93
2023-08-15,2023-08-15,Invoice payment - Wilkins Ltd,REF79085640,0.0,460.25,293625.18
2023-08-15,2023-08-15,Project payment - Benton-Mcdonald,REF78364612,0.0,827.14,294452.32
2023-08-15,2023-08-15,Invoice payment - Smith and Sons,REF89027310,0.0,582.98,295035.3
2023-08-20,2023-08-20,Business meal,REF48072533,220.57,0.0,294814.73
2023-08-21,2023-08-21,Professional software license,REF85314586,127.38,0.0,294687.35
2023-08-25,2023-08-25,Accounting expense,REF40128312,167.08,0.0,294520.27
2023-08-25,2023-08-25,Coworking space rental,REF64546599,248.07,0.0,294272.2
2023-08-27,2023-08-27,Marketing expenses,REF34803546,306.78,0.0,293965.42
2023-08-31,2023-08-31,Business meal,REF45746767,285.61,0.0,293679.81
2023-08-31,2023-08-31,Marketing expenses,REF82742003,271.38,0.0,293408.43
2023-09-04,2023-09-04,Business travel,REF32271440,440.88,0.0,292967.55
2023-09-06,2023-09-06,Coworking space rental,REF80419450,403.34,0.0,292564.21
2023-09-06,2023-09-06,Business meal,REF19901793,102.0,0.0,292462.21
2023-09-08,2023-09-08,Coworking space rental,REF74916290,277.64,0.0,292184.57
2023-09-15,2023-09-15,"Invoice payment - Meyers, Thompson and Cobb",REF75384315,0.0,570.12,292754.69
2023-09-15,2023-09-15,Payment from Smith and Sons,REF42429935,0.0,826.62,293581.31
2023-09-15,2023-09-15,Business insurance premium,REF32782995,155.62,0.0,293425.69
2023-09-15,2023-09-15,"Project payment - Parsons, Hamilton and Roberts",REF76441238,0.0,750.02,294175.71
2023-09-15,2023-09-15,Service payment - Miller-Ruiz,REF37487311,0.0,767.29,294943.0
2023-09-15,2023-09-15,Payment from Benton-Mcdonald,REF83518385,0.0,1073.63,296016.63
2023-09-15,2023-09-15,Payment from Green-Reed,REF88491580,0.0,671.74,296688.37
2023-09-15,2023-09-15,"Service payment - Davis, Coleman and Rice",REF36233945,0.0,370.67,297059.04
2023-09-15,2023-09-15,Service payment - Wilkins Ltd,REF69324289,0.0,827.66,297886.7
2023-09-18,2023-09-18,Business meal,REF36709965,190.97,0.0,297695.73
2023-09-21,2023-09-21,Professional software license,REF84820538,200.23,0.0,297495.5
2023-09-21,2023-09-21,Accounting expense,REF46410711,207.48,0.0,297288.02
2023-09-24,2023-09-24,Training/conference,REF51554919,249.03,0.0,297038.99
2023-09-28,2023-09-28,Training/conference,REF27894323,199.26,0.0,296839.73
2023-10-01,2023-10-01,Business meal,REF58482481,194.27,0.0,296645.46
2023-10-02,2023-10-02,Equipment purchase,REF43599320,150.24,0.0,296495.22
2023-10-05,2023-10-05,Business travel,REF63613700,259.11,0.0,296236.11
2023-10-08,2023-10-08,Training/conference,REF86404331,314.47,0.0,295921.64
2023-10-10,2023-10-10,Marketing expenses,REF73814799,649.13,0.0,295272.51
2023-10-12,2023-10-12,Accounting expense,REF72795441,133.46,0.0,295139.05
2023-10-15,2023-10-15,Project payment - Miller-Ruiz,REF14978649,0.0,900.18,296039.23
2023-10-15,2023-10-15,Business insurance premium,REF14992056,166.42,0.0,295872.81
2023-10-15,2023-10-15,Payment from Wilkins Ltd,REF30581713,0.0,958.56,296831.37
2023-10-15,2023-10-15,"Invoice payment - Meyers, Thompson and Cobb",REF65632343,0.0,714.06,297545.43
2023-10-15,2023-10-15,Invoice payment - Benton-Mcdonald,REF53636369,0.0,902.64,298448.07
2023-10-15,2023-10-15,"Service payment - Parsons, Hamilton and Roberts",REF68480938,0.0,1174.16,299622.23
2023-10-15,2023-10-15,Invoice payment - Green-Reed,REF37932827,0.0,820.6,300442.83
2023-10-15,2023-10-15,Project payment - Smith and Sons,REF33924581,0.0,1104.65,301547.48
2023-10-15,2023-10-15,"Payment from Davis, Coleman and Rice",REF89146891,0.0,378.34,301925.82
2023-10-21,2023-10-21,Professional software license,REF68948698,221.03,0.0,301704.79
2023-10-24,2023-10-24,Coworking space rental,REF91597587,393.96,0.0,301310.83
2023-10-29,2023-10-29,Equipment purchase,REF68457518,209.62,0.0,301101.21
2023-10-30,2023-10-30,Coworking space rental,REF97487554,498.63,0.0,300602.58
2023-11-06,2023-11-06,Equipment purchase,REF97880191,186.08,0.0,300416.5
2023-11-10,2023-11-10,Accounting expense,REF59532362,261.83,0.0,300154.67
2023-11-11,2023-11-11,Business travel,REF81128987,192.87,0.0,299961.8
2023-11-12,2023-11-12,Business meal,REF57271696,248.49,0.0,299713.31
2023-11-15,2023-11-15,Project payment - Benton-Mcdonald,REF55000276,0.0,793.96,300507.27
2023-11-15,2023-11-15,"Project payment - Meyers, Thompson and Cobb",REF70728635,0.0,380.98,300888.25
2023-11-15,2023-11-15,Project payment - Smith and Sons,REF92898987,0.0,553.03,301441.28
2023-11-15,2023-11-15,"Invoice payment - Parsons, Hamilton and Roberts",REF53702602,0.0,759.89,302201.17
2023-11-15,2023-11-15,Invoice payment - Wilkins Ltd,REF43375680,0.0,653.59,302854.76
2023-11-15,2023-11-15,"Project payment - Davis, Coleman and Rice",REF56953684,0.0,301.62,303156.38
2023-11-15,2023-11-15,Project payment - Miller-Ruiz,REF72996497,0.0,692.89,303849.27
2023-11-15,2023-11-15,Service payment - Green-Reed,REF34143950,0.0,733.82,304583.09
2023-11-15,2023-11-15,Business insurance premium,REF73493349,160.94,0.0,304422.15
2023-11-16,2023-11-16,Training/conference,REF16303634,226.69,0.0,304195.46
2023-11-21,2023-11-21,Business meal,REF40584783,405.83,0.0,303789.63
2023-11-21,2023-11-21,Business travel,REF54988577,568.51,0.0,303221.12
2023-11-21,2023-11-21,Professional software license,REF60584244,210.51,0.0,303010.61
2023-11-23,2023-11-23,Business meal,REF31447701,296.71,0.0,302713.9
2023-11-29,2023-11-29,Marketing expenses,REF32045411,247.65,0.0,302466.25
2023-12-11,2023-12-11,Business meal,REF45679867,253.16,0.0,302213.09
2023-12-13,2023-12-13,Coworking space rental,REF64449587,375.93,0.0,301837.16
2023-12-15,2023-12-15,"Invoice payment - Davis, Coleman and Rice",REF22630953,0.0,330.03,302167.19
2023-12-15,2023-12-15,"Service payment - Parsons, Hamilton and Roberts",REF67972461,0.0,880.15,303047.34
2023-12-15,2023-12-15,"Payment from Meyers, Thompson and Cobb",REF30075848,0.0,460.65,303507.99
2023-12-15,2023-12-15,Invoice payment - Smith and Sons,REF87497173,0.0,576.18,304084.17
2023-12-15,2023-12-15,Payment from Benton-Mcdonald,REF13979906,0.0,1010.03,305094.2
2023-12-15,2023-12-15,Service payment - Wilkins Ltd,REF82388115,0.0,878.36,305972.56
2023-12-15,2023-12-15,Business insurance premium,REF18421838,119.23,0.0,305853.33
2023-12-15,2023-12-15,Payment from Miller-Ruiz,REF74263898,0.0,562.39,306415.72
2023-12-16,2023-12-16,Equipment purchase,REF69937752,214.54,0.0,306201.18
2023-12-21,2023-12-21,Professional software license,REF25037488,166.22,0.0,306034.96
2023-12-21,2023-12-21,Business travel,REF86353964,158.92,0.0,305876.04
2023-12-25,2023-12-25,Coworking space rental,REF60881974,283.01,0.0,305593.03
2023-12-27,2023-12-27,Business travel,REF84150576,368.55,0.0,305224.48
2023-12-28,2023-12-28,Business travel,REF45980916,364.72,0.0,304859.76
2023-12-28,2023-12-28,Equipment purchase,REF83045695,157.32,0.0,304702.44
2024-01-07,2024-01-07,Business meal,REF50249347,427.69,0.0,304274.75
2024-01-09,2024-01-09,Equipment purchase,REF63145468,278.09,0.0,303996.66
2024-01-11,2024-01-11,Marketing expenses,REF80253097,311.17,0.0,303685.49
2024-01-14,2024-01-14,Equipment purchase,REF97539383,203.06,0.0,303482.43
2024-01-15,2024-01-15,Invoice payment - Green-Reed,REF80326370,0.0,919.45,304401.88
2024-01-15,2024-01-15,Payment from Smith and Sons,REF50265840,0.0,1022.95,305424.83
2024-01-15,2024-01-15,Project payment - Miller-Ruiz,REF34979787,0.0,860.41,306285.24
2024-01-15,2024-01-15,"Project payment - Meyers, Thompson and Cobb",REF80629533,0.0,597.44,306882.68
2024-01-15,2024-01-15,"Service payment - Parsons, Hamilton and Roberts",REF35317083,0.0,955.19,307837.87
2024-01-15,2024-01-15,Business insurance premium,REF45191318,154.9,0.0,307682.97
2024-01-21,2024-01-21,Professional software license,REF94321338,243.45,0.0,307439.52
2024-01-22,2024-01-22,Training/conference,REF94847719,125.94,0.0,307313.58
2024-01-24,2024-01-24,Training/conference,REF40753816,278.44,0.0,307035.14
2024-01-24,2024-01-24,Business travel,REF68353722,411.46,0.0,306623.68
2024-01-25,2024-01-25,Business meal,REF89489271,296.34,0.0,306327.34
2024-01-29,2024-01-29,Business travel,REF90022754,410.57,0.0,305916.77
2024-02-02,2024-02-02,Business meal,REF70646479,297.45,0.0,305619.32
2024-02-14,2024-02-14,Marketing expenses,REF29924712,400.88,0.0,305218.44
2024-02-15,2024-02-15,Project payment - Smith and Sons,REF12092851,0.0,722.83,305941.27
2024-02-15,2024-02-15,"Payment from Parsons, Hamilton and Roberts",REF71184935,0.0,993.85,306935.12
2024-02-15,2024-02-15,"Project payment - Davis, Coleman and Rice",REF28381648,0.0,325.37,307260.49
2024-02-15,2024-02-15,Payment from Green-Reed,REF52273304,0.0,825.59,308086.08
2024-02-15,2024-02-15,"Payment from Meyers, Thompson and Cobb",REF52786204,0.0,379.54,308465.62
2024-02-15,2024-02-15,Business insurance premium,REF52589752,162.5,0.0,308303.12
2024-02-15,2024-02-15,Payment from Wilkins Ltd,REF64923489,0.0,902.59,309205.71
2024-02-15,2024-02-15,Project payment - Benton-Mcdonald,REF88353098,0.0,904.32,310110.03
2024-02-17,2024-02-17,Marketing expenses,REF90407065,300.19,0.0,309809.84
2024-02-19,2024-02-19,Accounting expense,REF93584985,335.26,0.0,309474.58
2024-02-21,2024-02-21,Professional software license,REF16289736,272.74,0.0,309201.84
2024-02-23,2024-02-23,Business travel,REF95575295,610.6,0.0,308591.24
2024-02-26,2024-02-26,Accounting expense,REF89168376,329.41,0.0,308261.83
2024-03-02,2024-03-02,Coworking space rental,REF42636401,284.62,0.0,307977.21
2024-03-11,2024-03-11,Marketing expenses,REF51965572,122.44,0.0,307854.77
2024-03-12,2024-03-12,Business meal,REF73101594,369.71,0.0,307485.06
2024-03-15,2024-03-15,Service payment - Miller-Ruiz,REF83907802,0.0,519.3,308004.36
2024-03-15,2024-03-15,Invoice payment - Smith and Sons,REF42634298,0.0,795.43,308799.79
2024-03-15,2024-03-15,Business insurance premium,REF42043325,134.32,0.0,308665.47
2024-03-15,2024-03-15,"Invoice payment - Davis, Coleman and Rice",REF22377402,0.0,382.6,309048.07
2024-03-15,2024-03-15,"Project payment - Meyers, Thompson and Cobb",REF83969709,0.0,492.0,309540.07
2024-03-15,2024-03-15,Marketing expenses,REF59872634,316.25,0.0,309223.82
2024-03-15,2024-03-15,Service payment - Green-Reed,REF18592605,0.0,647.8,309871.62
2024-03-15,2024-03-15,Service payment - Benton-Mcdonald,REF97650909,0.0,941.92,310813.54
2024-03-15,2024-03-15,Payment from Wilkins Ltd,REF52015195,0.0,780.12,311593.66
2024-03-15,2024-03-15,"Project payment - Parsons, Hamilton and Roberts",REF93926392,0.0,1053.24,312646.9
2024-03-17,2024-03-17,Business travel,REF46106390,354.0,0.0,312292.9
2024-03-18,2024-03-18,Coworking space rental,REF61697461,198.09,0.0,312094.81
2024-03-19,2024-03-19,Marketing expenses,REF13571190,414.23,0.0,311680.58
2024-03-21,2024-03-21,Professional software license,REF16463917,216.61,0.0,311463.97
2024-03-22,2024-03-22,Training/conference,REF20667432,267.16,0.0,311196.81
2024-03-25,2024-03-25,Business meal,REF19526645,198.89,0.0,310997.92
2024-03-26,2024-03-26,Business travel,REF43781285,513.0,0.0,310484.92
2024-03-27,2024-03-27,Accounting expense,REF94858430,200.23,0.0,310284.69
2024-03-29,2024-03-29,Training/conference,REF89132051,267.93,0.0,310016.76
2024-03-30,2024-03-30,Marketing expenses,REF20357897,285.33,0.0,309731.43
2024-03-31,2024-03-31,Equipment purchase,REF83156571,212.81,0.0,309518.62
2024-04-11,2024-04-11,Training/conference,REF82248863,171.09,0.0,309347.53
2024-04-13,2024-04-13,Business meal,REF30262933,310.44,0.0,309037.09
2024-04-13,2024-04-13,Equipment purchase,REF16940530,115.06,0.0,308922.03
2024-04-15,2024-04-15,Invoice payment - Smith and Sons,REF50100411,0.0,566.49,309488.52
2024-04-15,2024-04-15,Business insurance premium,REF19934431,134.56,0.0,309353.96
2024-04-15,2024-04-15,Service payment - Green-Reed,REF69311206,0.0,604.44,309958.4
2024-04-15,2024-04-15,"Invoice payment - Davis, Coleman and Rice",REF24513884,0.0,351.25,310309.65
2024-04-15,2024-04-15,Project payment - Wilkins Ltd,REF69337186,0.0,808.24,311117.89
2024-04-15,2024-04-15,Service payment - Miller-Ruiz,REF14536550,0.0,566.11,311684.0
2024-04-15,2024-04-15,"Project payment - Parsons, Hamilton and Roberts",REF69577387,0.0,926.26,312610.26
2024-04-18,2024-04-18,Training/conference,REF73290642,244.62,0.0,312365.64
2024-04-19,2024-04-19,Coworking space rental,REF63834255,310.47,0.0,312055.17
2024-04-20,2024-04-20,Business travel,REF59506630,212.87,0.0,311842.3
2024-04-21,2024-04-21,Professional software license,REF99836897,232.69,0.0,311609.61
2024-04-25,2024-04-25,Coworking space rental,REF20742610,289.5,0.0,311320.11
2024-05-07,2024-05-07,Business travel,REF60499735,211.35,0.0,311108.76
2024-05-15,2024-05-15,Project payment - Benton-Mcdonald,REF72141649,0.0,879.08,311987.84
2024-05-15,2024-05-15,Business insurance premium,REF69243927,134.07,0.0,311853.77
2024-05-15,2024-05-15,"Service payment - Meyers, Thompson and Cobb",REF93629071,0.0,521.33,312375.1
2024-05-15,2024-05-15,"Service payment - Davis, Coleman and Rice",REF13699269,0.0,283.87,312658.97
2024-05-15,2024-05-15,Invoice payment - Green-Reed,REF59718685,0.0,581.92,313240.89
2024-05-15,2024-05-15,Project payment - Wilkins Ltd,REF76486927,0.0,840.97,314081.86
2024-05-15,2024-05-15,Project payment - Miller-Ruiz,REF95824054,0.0,793.33,314875.19
2024-05-15,2024-05-15,"Service payment - Parsons, Hamilton and Roberts",REF21156107,0.0,854.18,315729.37
2024-05-15,2024-05-15,Project payment - Smith and Sons,REF22979397,0.0,708.17,316437.54
2024-05-21,2024-05-21,Professional software license,REF10594906,178.32,0.0,316259.22
2024-05-23,2024-05-23,Equipment purchase,REF15207062,179.38,0.0,316079.84
2024-05-27,2024-05-27,Coworking space rental,REF51673355,341.24,0.0,315738.6
2024-06-06,2024-06-06,Business travel,REF89073049,61.99,0.0,315676.61
2024-06-08,2024-06-08,Business meal,REF21616283,70.37,0.0,315606.24
2024-06-11,2024-06-11,Business meal,REF37759899,187.33,0.0,315418.91
2024-06-12,2024-06-12,Training/conference,REF13603693,95.98,0.0,315322.93
2024-06-13,2024-06-13,Equipment purchase,REF65920634,126.53,0.0,315196.4
2024-06-15,2024-06-15,"Project payment - Meyers, Thompson and Cobb",REF90989498,0.0,419.97,315616.37
2024-06-15,2024-06-15,Invoice payment - Miller-Ruiz,REF15262646,0.0,612.21,316228.58
2024-06-15,2024-06-15,Service payment - Benton-Mcdonald,REF50829257,0.0,641.51,316870.09
2024-06-15,2024-06-15,Payment from Wilkins Ltd,REF41409088,0.0,562.64,317432.73
2024-06-15,2024-06-15,Project payment - Green-Reed,REF77297366,0.0,650.96,318083.69
2024-06-15,2024-06-15,Payment from Smith and Sons,REF72610039,0.0,577.6,318661.29
2024-06-15,2024-06-15,"Project payment - Parsons, Hamilton and Roberts",REF78564348,0.0,739.08,319400.37
2024-06-15,2024-06-15,"Service payment - Davis, Coleman and Rice",REF27497104,0.0,258.45,319658.82
2024-06-15,2024-06-15,Business insurance premium,REF36651816,112.12,0.0,319546.7
2024-06-17,2024-06-17,Coworking space rental,REF35915172,170.22,0.0,319376.48
2024-06-17,2024-06-17,Business meal,REF72176204,205.97,0.0,319170.51
2024-06-21,2024-06-21,Professional software license,REF77237247,158.73,0.0,319011.78
2024-06-22,2024-06-22,Equipment purchase,REF12438413,141.09,0.0,318870.69
2024-06-23,2024-06-23,Coworking space rental,REF31803350,141.02,0.0,318729.67
2024-06-23,2024-06-23,Equipment purchase,REF83103760,163.57,0.0,318566.1
2024-06-26,2024-06-26,Coworking space rental,REF34045342,223.06,0.0,318343.04
2024-06-27,2024-06-27,Coworking space rental,REF39307047,248.02,0.0,318095.02
2024-07-11,2024-07-11,Equipment purchase,REF61568528,152.84,0.0,317942.18
2024-07-13,2024-07-13,Coworking space rental,REF15960270,173.81,0.0,317768.37
2024-07-15,2024-07-15,Business insurance premium,REF67919979,100.37,0.0,317668.0
2024-07-15,2024-07-15,Invoice payment - Smith and Sons,REF70618963,0.0,537.15,318205.15
2024-07-15,2024-07-15,"Project payment - Meyers, Thompson and Cobb",REF26129029,0.0,361.85,318567.0
2024-07-15,2024-07-15,Marketing expenses,REF17163932,259.97,0.0,318307.03
2024-07-15,2024-07-15,"Payment from Davis, Coleman and Rice",REF85332090,0.0,260.19,318567.22
2024-07-15,2024-07-15,Payment from Miller-Ruiz,REF93854843,0.0,440.33,319007.55
2024-07-15,2024-07-15,Invoice payment - Green-Reed,REF16355931,0.0,446.04,319453.59
2024-07-15,2024-07-15,Payment from Wilkins Ltd,REF70338411,0.0,560.5,320014.09
2024-07-15,2024-07-15,"Invoice payment - Parsons, Hamilton and Roberts",REF85655316,0.0,664.21,320678.3
2024-07-15,2024-07-15,Service payment - Benton-Mcdonald,REF58520317,0.0,548.65,321226.95
2024-07-16,2024-07-16,Accounting expense,REF66349035,79.67,0.0,321147.28
2024-07-18,2024-07-18,Business meal,REF54740875,190.6,0.0,320956.68
2024-07-20,2024-07-20,Equipment purchase,REF36064249,116.1,0.0,320840.58
2024-07-21,2024-07-21,Professional software license,REF93460170,143.31,0.0,320697.27
2024-08-01,2024-08-01,Training/conference,REF41405107,201.03,0.0,320496.24
2024-08-03,2024-08-03,Business travel,REF48110279,237.55,0.0,320258.69
2024-08-09,2024-08-09,Marketing expenses,REF32911821,167.38,0.0,320091.31
2024-08-13,2024-08-13,Equipment purchase,REF93899542,111.42,0.0,319979.89
2024-08-14,2024-08-14,Marketing expenses,REF43895348,333.22,0.0,319646.67
2024-08-15,2024-08-15,"Invoice payment - Davis, Coleman and Rice",REF43582073,0.0,249.64,319896.31
2024-08-15,2024-08-15,Marketing expenses,REF70079991,318.56,0.0,319577.75
2024-08-15,2024-08-15,Service payment - Miller-Ruiz,REF58929759,0.0,443.13,320020.88
2024-08-15,2024-08-15,Payment from Wilkins Ltd,REF93781876,0.0,658.86,320679.74
2024-08-15,2024-08-15,"Service payment - Meyers, Thompson and Cobb",REF96680540,0.0,336.76,321016.5
2024-08-15,2024-08-15,Business insurance premium,REF70537463,105.8,0.0,320910.7
2024-08-15,2024-08-15,"Invoice payment - Parsons, Hamilton and Roberts",REF71460289,0.0,537.17,321447.87
2024-08-15,2024-08-15,Service payment - Benton-Mcdonald,REF66735675,0.0,681.05,322128.92
2024-08-15,2024-08-15,Invoice payment - Smith and Sons,REF34771134,0.0,562.24,322691.16
2014-08-21,2014-08-21,Professional software license,REF73100856,158.61,0.0,5068.24
2014-08-26,2014-08-26,Equipment purchase,REF84204486,63.71,0.0,5004.53
2014-08-26,2014-08-26,Coworking space rental,REF34249574,141.16,0.0,4863.37
2014-08-29,2014-08-29,Business travel,REF98972798,316.76,0.0,4546.61
2014-09-07,2014-09-07,Business meal,REF69748146,248.29,0.0,4298.32
2014-09-13,2014-09-13,Marketing expenses,REF74842808,138.13,0.0,4160.19
2014-09-15,2014-09-15,Invoice payment - Wheeler PLC,REF90053136,0.0,835.27,4995.46
2014-09-15,2014-09-15,"Service payment - Gould, Moran and Thomas",REF21655818,0.0,1006.21,6001.67
2014-09-15,2014-09-15,Business insurance premium,REF34142862,156.56,0.0,5845.11
2014-09-15,2014-09-15,Payment from Thompson-Baker,REF47021712,0.0,954.15,6799.26
2014-09-15,2014-09-15,Payment from Griffin-Ortega,REF73490239,0.0,299.64,7098.9
2014-09-15,2014-09-15,Payment from Tran Inc,REF84845230,0.0,886.53,7985.43
2014-09-15,2014-09-15,Service payment - Hayes-Mclean,REF59193883,0.0,633.0,8618.43
2014-09-15,2014-09-15,Service payment - Keller-Stewart,REF41501898,0.0,667.84,9286.27
2014-09-15,2014-09-15,"Payment from Andrews, Stanton and Hines",REF27126520,0.0,551.65,9837.92
2014-09-21,2014-09-21,Training/conference,REF22739668,315.76,0.0,9522.16
2014-09-21,2014-09-21,Professional software license,REF59034852,217.93,0.0,9304.23
2014-09-27,2014-09-27,Training/conference,REF39763279,138.99,0.0,9165.24
2014-09-28,2014-09-28,Equipment purchase,REF61775893,169.15,0.0,8996.09
2014-09-29,2014-09-29,Marketing expenses,REF23688219,356.56,0.0,8639.53
2014-09-30,2014-09-30,Training/conference,REF50975516,278.44,0.0,8361.09
2014-10-01,2014-10-01,Business meal,REF52447037,439.24,0.0,7921.85
2014-10-04,2014-10-04,Accounting expense,REF26127075,264.96,0.0,7656.89
2014-10-15,2014-10-15,Marketing expenses,REF58113405,322.71,0.0,7334.18
2014-10-15,2014-10-15,"Invoice payment - Gould, Moran and Thomas",REF76762947,0.0,1296.91,8631.09
2014-10-15,2014-10-15,Project payment - Wheeler PLC,REF52726137,0.0,849.14,9480.23
2014-10-15,2014-10-15,Payment from Thompson-Baker,REF26702277,0.0,828.42,10308.65
2014-10-15,2014-10-15,Project payment - Griffin-Ortega,REF73892804,0.0,487.58,10796.23
2014-10-15,2014-10-15,Project payment - Hayes-Mclean,REF36489480,0.0,785.63,11581.86
2014-10-15,2014-10-15,Service payment - Tran Inc,REF55233209,0.0,801.58,12383.44
2014-10-15,2014-10-15,"Invoice payment - Andrews, Stanton and Hines",REF88335482,0.0,531.76,12915.2
2014-10-15,2014-10-15,Business insurance premium,REF84093589,158.38,0.0,12756.82
2014-10-17,2014-10-17,Coworking space rental,REF27211459,314.92,0.0,12441.9
2014-10-21,2014-10-21,Professional software license,REF50140289,255.14,0.0,12186.76
2014-10-24,2014-10-24,Business travel,REF97183520,339.22,0.0,11847.54
2014-10-24,2014-10-24,Training/conference,REF14606662,100.58,0.0,11746.96
2014-10-27,2014-10-27,Equipment purchase,REF44796457,145.06,0.0,11601.9
2014-11-09,2014-11-09,Equipment purchase,REF51979673,134.73,0.0,11467.17
2014-11-12,2014-11-12,Business meal,REF92002028,191.37,0.0,11275.8
2014-11-15,2014-11-15,Business insurance premium,REF74511699,166.06,0.0,11109.74
2014-11-15,2014-11-15,Payment from Thompson-Baker,REF76592083,0.0,827.33,11937.07
2014-11-15,2014-11-15,"Invoice payment - Gould, Moran and Thomas",REF11561093,0.0,1118.63,13055.7
2014-11-15,2014-11-15,Payment from Hayes-Mclean,REF82715067,0.0,571.94,13627.64
2014-11-15,2014-11-15,Payment from Keller-Stewart,REF67091534,0.0,751.29,14378.93
2014-11-15,2014-11-15,Invoice payment - Wheeler PLC,REF88027235,0.0,690.07,15069.0
2014-11-15,2014-11-15,Service payment - Tran Inc,REF23756621,0.0,654.76,15723.76
2014-11-15,2014-11-15,"Invoice payment - Andrews, Stanton and Hines",REF21866529,0.0,534.91,16258.67
2014-11-16,2014-11-16,Equipment purchase,REF55956732,169.96,0.0,16088.71
2014-11-17,2014-11-17,Equipment purchase,REF67440809,177.86,0.0,15910.85
2014-11-18,2014-11-18,Training/conference,REF98570136,130.29,0.0,15780.56
2014-11-21,2014-11-21,Professional software license,REF66748011,197.36,0.0,15583.2
2014-11-23,2014-11-23,Business meal,REF24360363,187.8,0.0,15395.4
2014-11-29,2014-11-29,Equipment purchase,REF34111725,147.7,0.0,15247.7
2014-11-30,2014-11-30,Equipment purchase,REF48156402,227.55,0.0,15020.15
2014-12-01,2014-12-01,Training/conference,REF85358032,253.85,0.0,14766.3
2014-12-01,2014-12-01,Equipment purchase,REF43380947,183.53,0.0,14582.77
2014-12-10,2014-12-10,Coworking space rental,REF72313239,246.13,0.0,14336.64
2014-12-10,2014-12-10,Training/conference,REF21418452,185.81,0.0,14150.83
2014-12-13,2014-12-13,Business travel,REF52782028,448.79,0.0,13702.04
2014-12-15,2014-12-15,Service payment - Griffin-Ortega,REF45796433,0.0,298.51,14000.55
2014-12-15,2014-12-15,Service payment - Hayes-Mclean,REF15924100,0.0,549.54,14550.09
2014-12-15,2014-12-15,Payment from Wheeler PLC,REF64177465,0.0,595.09,15145.18
2014-12-15,2014-12-15,Business insurance premium,REF89981793,117.97,0.0,15027.21
2014-12-15,2014-12-15,Project payment - Thompson-Baker,REF58977182,0.0,637.23,15664.44
2014-12-15,2014-12-15,"Payment from Andrews, Stanton and Hines",REF98928508,0.0,453.65,16118.09
2014-12-15,2014-12-15,"Service payment - Gould, Moran and Thomas",REF54428231,0.0,849.81,16967.9
2014-12-15,2014-12-15,Invoice payment - Keller-Stewart,REF69800779,0.0,450.1,17418.0
2014-12-16,2014-12-16,Business travel,REF97393823,514.65,0.0,16903.35
2014-12-21,2014-12-21,Professional software license,REF11485805,212.85,0.0,16690.5
2014-12-26,2014-12-26,Marketing expenses,REF77881553,164.81,0.0,16525.69
2015-01-10,2015-01-10,Business meal,REF73980011,179.48,0.0,16346.21
2015-01-10,2015-01-10,Coworking space rental,REF53030852,426.8,0.0,15919.41
2015-01-15,2015-01-15,Business insurance premium,REF56701142,152.18,0.0,15767.23
2015-01-15,2015-01-15,Service payment - Keller-Stewart,REF58573313,0.0,550.39,16317.62
2015-01-15,2015-01-15,"Invoice payment - Gould, Moran and Thomas",REF95878084,0.0,1101.07,17418.69
2015-01-15,2015-01-15,Project payment - Griffin-Ortega,REF55182588,0.0,337.02,17755.71
2015-01-15,2015-01-15,Invoice payment - Hayes-Mclean,REF79751007,0.0,747.32,18503.03
2015-01-15,2015-01-15,Payment from Thompson-Baker,REF98311308,0.0,1019.47,19522.5
2015-01-15,2015-01-15,Service payment - Tran Inc,REF24736664,0.0,706.41,20228.91
2015-01-15,2015-01-15,Invoice payment - Wheeler PLC,REF13549304,0.0,745.96,20974.87
2015-01-17,2015-01-17,Accounting expense,REF50988040,238.64,0.0,20736.23
2015-01-21,2015-01-21,Training/conference,REF41950760,236.56,0.0,20499.67
2015-01-21,2015-01-21,Professional software license,REF81755004,247.74,0.0,20251.93
2015-01-26,2015-01-26,Coworking space rental,REF60468447,267.55,0.0,19984.38
2015-01-29,2015-01-29,Business meal,REF65496317,278.05,0.0,19706.33
2015-01-31,2015-01-31,Equipment purchase,REF81963006,183.66,0.0,19522.67
2015-02-03,2015-02-03,Training/conference,REF76729208,111.77,0.0,19410.9
2015-02-07,2015-02-07,Business meal,REF54468271,207.39,0.0,19203.51
2015-02-07,2015-02-07,Coworking space rental,REF92471079,207.95,0.0,18995.56
2015-02-10,2015-02-10,Business meal,REF54346227,328.32,0.0,18667.24
2015-02-10,2015-02-10,Marketing expenses,REF37314478,406.05,0.0,18261.19
2015-02-11,2015-02-11,Accounting expense,REF27864510,213.23,0.0,18047.96
2015-02-12,2015-02-12,Business travel,REF84340761,398.65,0.0,17649.31
2015-02-15,2015-02-15,Business insurance premium,REF16260286,160.24,0.0,17489.07
2015-02-15,2015-02-15,Project payment - Hayes-Mclean,REF47767641,0.0,872.7,18361.77
2015-02-15,2015-02-15,Payment from Wheeler PLC,REF93792994,0.0,834.2,19195.97
2015-02-15,2015-02-15,"Invoice payment - Gould, Moran and Thomas",REF66091431,0.0,1016.65,20212.62
2015-02-15,2015-02-15,Payment from Griffin-Ortega,REF95225026,0.0,291.12,20503.74
2015-02-15,2015-02-15,Project payment - Thompson-Baker,REF28699004,0.0,975.45,21479.19
2015-02-15,2015-02-15,Payment from Tran Inc,REF74235761,0.0,660.42,22139.61
2015-02-15,2015-02-15,Service payment - Keller-Stewart,REF90238107,0.0,470.72,22610.33
2015-02-15,2015-02-15,"Invoice payment - Andrews, Stanton and Hines",REF48007003,0.0,479.81,23090.14
2015-02-20,2015-02-20,Business travel,REF73324402,303.15,0.0,22786.99
2015-02-20,2015-02-20,Business meal,REF36177641,329.95,0.0,22457.04
2015-02-21,2015-02-21,Professional software license,REF16288377,226.45,0.0,22230.59
2015-02-22,2015-02-22,Accounting expense,REF98770416,229.85,0.0,22000.74
2015-02-25,2015-02-25,Coworking space rental,REF43410850,340.99,0.0,21659.75
2015-02-27,2015-02-27,Business travel,REF49731068,335.82,0.0,21323.93
2015-03-04,2015-03-04,Marketing expenses,REF28424690,325.81,0.0,20998.12
2015-03-08,2015-03-08,Coworking space rental,REF38611614,134.36,0.0,20863.76
2015-03-08,2015-03-08,Training/conference,REF54417289,184.71,0.0,20679.05
2015-03-15,2015-03-15,Service payment - Thompson-Baker,REF99521781,0.0,831.22,21510.27
2015-03-15,2015-03-15,Business insurance premium,REF98740830,147.99,0.0,21362.28
2015-03-15,2015-03-15,Service payment - Wheeler PLC,REF94273772,0.0,619.25,21981.53
2015-03-15,2015-03-15,"Service payment - Gould, Moran and Thomas",REF72317210,0.0,838.44,22819.97
2015-03-15,2015-03-15,Project payment - Keller-Stewart,REF96124712,0.0,570.39,23390.36
2015-03-15,2015-03-15,"Project payment - Andrews, Stanton and Hines",REF94922541,0.0,449.3,23839.66
2015-03-15,2015-03-15,Service payment - Tran Inc,REF55966874,0.0,678.58,24518.24
2015-03-15,2015-03-15,Service payment - Hayes-Mclean,REF61596344,0.0,602.92,25121.16
2015-03-15,2015-03-15,Payment from Griffin-Ortega,REF31679624,0.0,242.29,25363.45
2015-03-21,2015-03-21,Professional software license,REF97003414,208.75,0.0,25154.7
2015-03-21,2015-03-21,Coworking space rental,REF60735854,296.93,0.0,24857.77
2015-03-22,2015-03-22,Business meal,REF82966476,333.72,0.0,24524.05
2015-03-28,2015-03-28,Business meal,REF41248152,286.86,0.0,24237.19
2015-04-04,2015-04-04,Equipment purchase,REF19935677,116.67,0.0,24120.52
2015-04-05,2015-04-05,Equipment purchase,REF58583622,116.68,0.0,24003.84
2015-04-06,2015-04-06,Business travel,REF52195312,277.88,0.0,23725.96
2015-04-09,2015-04-09,Business meal,REF96867523,349.82,0.0,23376.14
2015-04-15,2015-04-15,Project payment - Griffin-Ortega,REF78751098,0.0,336.36,23712.5
2015-04-15,2015-04-15,Payment from Tran Inc,REF70659856,0.0,707.69,24420.19
2015-04-15,2015-04-15,Invoice payment - Wheeler PLC,REF76980676,0.0,809.71,25229.9
2015-04-15,2015-04-15,Invoice payment - Thompson-Baker,REF13263677,0.0,630.22,25860.12
2015-04-15,2015-04-15,"Project payment - Andrews, Stanton and Hines",REF72353009,0.0,520.55,26380.67
2015-04-15,2015-04-15,Service payment - Hayes-Mclean,REF45030380,0.0,553.29,26933.96
2015-04-15,2015-04-15,Service payment - Keller-Stewart,REF77301340,0.0,567.74,27501.7
2015-04-15,2015-04-15,Business insurance premium,REF44881599,139.45,0.0,27362.25
2015-04-21,2015-04-21,Professional software license,REF55878910,238.98,0.0,27123.27
2015-04-24,2015-04-24,Accounting expense,REF41022478,265.44,0.0,26857.83
2015-05-09,2015-05-09,Business meal,REF39117315,278.13,0.0,26579.7
2015-05-12,2015-05-12,Equipment purchase,REF48587545,120.26,0.0,26459.44
2015-05-14,2015-05-14,Equipment purchase,REF93153678,162.49,0.0,26296.95
2015-05-15,2015-05-15,Business insurance premium,REF35744396,124.39,0.0,26172.56
2015-05-15,2015-05-15,"Invoice payment - Andrews, Stanton and Hines",REF80001063,0.0,420.14,26592.7
2015-05-15,2015-05-15,Payment from Wheeler PLC,REF97311709,0.0,689.33,27282.03
2015-05-15,2015-05-15,Project payment - Hayes-Mclean,REF90407605,0.0,537.1,27819.13
2015-05-15,2015-05-15,Service payment - Thompson-Baker,REF61906220,0.0,595.33,28414.46
2015-05-15,2015-05-15,Payment from Tran Inc,REF54807140,0.0,595.77,29010.23
2015-05-15,2015-05-15,Payment from Keller-Stewart,REF32096922,0.0,468.31,29478.54
2015-05-15,2015-05-15,Payment from Griffin-Ortega,REF14546517,0.0,271.24,29749.78
2015-05-15,2015-05-15,"Project payment - Gould, Moran and Thomas",REF49740677,0.0,1132.29,30882.07
2015-05-18,2015-05-18,Business travel,REF92089727,444.14,0.0,30437.93
2015-05-19,2015-05-19,Marketing expenses,REF71334400,228.82,0.0,30209.11
2015-05-21,2015-05-21,Professional software license,REF35811625,178.48,0.0,30030.63
2015-05-22,2015-05-22,Business travel,REF27283594,216.74,0.0,29813.89
2015-05-24,2015-05-24,Business travel,REF60776363,436.72,0.0,29377.17
2015-05-30,2015-05-30,Business meal,REF65813929,244.97,0.0,29132.2
2015-05-31,2015-05-31,Business meal,REF15202345,250.83,0.0,28881.37
2015-06-10,2015-06-10,Marketing expenses,REF91281608,201.07,0.0,28680.3
2015-06-12,2015-06-12,Business meal,REF51020522,165.97,0.0,28514.33
2015-06-15,2015-06-15,Business insurance premium,REF86551461,102.72,0.0,28411.61
2015-06-15,2015-06-15,Payment from Tran Inc,REF81166847,0.0,503.99,28915.6
2015-06-15,2015-06-15,Project payment - Griffin-Ortega,REF43256811,0.0,192.39,29107.99
2015-06-15,2015-06-15,"Invoice payment - Andrews, Stanton and Hines",REF89816188,0.0,307.59,29415.58
2015-06-15,2015-06-15,"Invoice payment - Gould, Moran and Thomas",REF88544569,0.0,663.61,30079.19
2015-06-15,2015-06-15,Invoice payment - Keller-Stewart,REF67229889,0.0,524.34,30603.53
2015-06-15,2015-06-15,Project payment - Hayes-Mclean,REF92014456,0.0,548.13,31151.66
2015-06-15,2015-06-15,Payment from Thompson-Baker,REF97191965,0.0,497.1,31648.76
2015-06-15,2015-06-15,Service payment - Wheeler PLC,REF20679932,0.0,602.62,32251.38
2015-06-19,2015-06-19,Marketing expenses,REF59505731,259.83,0.0,31991.55
2015-06-20,2015-06-20,Equipment purchase,REF73016112,140.1,0.0,31851.45
2015-06-20,2015-06-20,Training/conference,REF16950062,127.69,0.0,31723.76
2015-06-21,2015-06-21,Professional software license,REF61324237,147.51,0.0,31576.25
2015-06-22,2015-06-22,Business meal,REF30736130,88.37,0.0,31487.88
2015-06-23,2015-06-23,Business travel,REF28796173,432.31,0.0,31055.57
2015-06-25,2015-06-25,Business meal,REF79701825,186.83,0.0,30868.74
2015-06-27,2015-06-27,Coworking space rental,REF47011931,260.55,0.0,30608.19
2015-06-29,2015-06-29,Training/conference,REF11679042,157.51,0.0,30450.68
2015-07-02,2015-07-02,Business meal,REF72018734,125.36,0.0,30325.32
2015-07-05,2015-07-05,Coworking space rental,REF18225551,256.62,0.0,30068.7
2015-07-15,2015-07-15,Project payment - Tran Inc,REF82734540,0.0,507.7,30576.4
2015-07-15,2015-07-15,Service payment - Wheeler PLC,REF63725042,0.0,669.02,31245.42
2015-07-15,2015-07-15,Project payment - Keller-Stewart,REF96859002,0.0,404.82,31650.24
2015-07-15,2015-07-15,Business insurance premium,REF98404769,100.09,0.0,31550.15
2015-07-15,2015-07-15,Payment from Hayes-Mclean,REF69265838,0.0,485.36,32035.51
2015-07-15,2015-07-15,Payment from Thompson-Baker,REF25315510,0.0,516.73,32552.24
2015-07-15,2015-07-15,"Service payment - Gould, Moran and Thomas",REF51086968,0.0,501.0,33053.24
2015-07-17,2015-07-17,Equipment purchase,REF37310116,73.71,0.0,32979.53
2015-07-21,2015-07-21,Accounting expense,REF25176849,130.28,0.0,32849.25
2015-07-21,2015-07-21,Professional software license,REF22905793,169.63,0.0,32679.62
2015-07-24,2015-07-24,Training/conference,REF73227864,47.38,0.0,32632.24
2015-07-27,2015-07-27,Equipment purchase,REF28900216,85.71,0.0,32546.53
2015-08-05,2015-08-05,Coworking space rental,REF16369407,100.78,0.0,32445.75
2015-08-06,2015-08-06,Coworking space rental,REF24413397,337.42,0.0,32108.33
2015-08-06,2015-08-06,Accounting expense,REF46806735,216.84,0.0,31891.49
2015-08-06,2015-08-06,Business travel,REF47714288,325.41,0.0,31566.08
2015-08-09,2015-08-09,Business meal,REF76515507,221.61,0.0,31344.47
2015-08-10,2015-08-10,Equipment purchase,REF93008364,86.49,0.0,31257.98
2015-08-13,2015-08-13,Business travel,REF70189274,231.09,0.0,31026.89
2015-08-14,2015-08-14,Training/conference,REF35881664,239.83,0.0,30787.06
2015-08-15,2015-08-15,Invoice payment - Thompson-Baker,REF37688177,0.0,815.92,31602.98
2015-08-15,2015-08-15,Business insurance premium,REF41308336,117.93,0.0,31485.05
2015-08-15,2015-08-15,Project payment - Keller-Stewart,REF50442017,0.0,415.53,31900.58
2015-08-15,2015-08-15,Project payment - Hayes-Mclean,REF59402493,0.0,523.85,32424.43
2015-08-15,2015-08-15,"Invoice payment - Andrews, Stanton and Hines",REF62202537,0.0,474.95,32899.38
2015-08-15,2015-08-15,Payment from Tran Inc,REF90499273,0.0,670.57,33569.95
2015-08-21,2015-08-21,Equipment purchase,REF37295445,120.09,0.0,33449.86
2015-08-21,2015-08-21,Professional software license,REF72225791,146.86,0.0,33303.0
2015-08-29,2015-08-29,Training/conference,REF56679033,100.38,0.0,33202.62
2015-08-30,2015-08-30,Equipment purchase,REF47830519,132.42,0.0,33070.2
2015-09-01,2015-09-01,Business travel,REF42918873,232.79,0.0,32837.41
2015-09-06,2015-09-06,Coworking space rental,REF76846155,295.19,0.0,32542.22
2015-09-07,2015-09-07,Accounting expense,REF59142997,190.32,0.0,32351.9
2015-09-11,2015-09-11,Accounting expense,REF99803261,338.32,0.0,32013.58
2015-09-12,2015-09-12,Training/conference,REF36390242,356.98,0.0,31656.6
2015-09-15,2015-09-15,"Service payment - Andrews, Stanton and Hines",REF55375573,0.0,588.43,32245.03
2015-09-15,2015-09-15,Invoice payment - Hayes-Mclean,REF96463351,0.0,663.93,32908.96
2015-09-15,2015-09-15,Payment from Keller-Stewart,REF38448597,0.0,641.11,33550.07
2015-09-15,2015-09-15,Invoice payment - Griffin-Ortega,REF54176928,0.0,318.23,33868.3
2015-09-15,2015-09-15,Business insurance premium,REF72794991,153.62,0.0,33714.68
2015-09-15,2015-09-15,Service payment - Wheeler PLC,REF98662019,0.0,781.47,34496.15
2015-09-15,2015-09-15,Payment from Tran Inc,REF87521484,0.0,622.37,35118.52
2015-09-15,2015-09-15,Service payment - Thompson-Baker,REF67328438,0.0,1100.05,36218.57
2015-09-15,2015-09-15,"Invoice payment - Gould, Moran and Thomas",REF48510287,0.0,904.29,37122.86
2015-09-16,2015-09-16,Business travel,REF18137174,624.91,0.0,36497.95
2015-09-18,2015-09-18,Accounting expense,REF56707473,313.68,0.0,36184.27
2015-09-18,2015-09-18,Equipment purchase,REF21798366,190.86,0.0,35993.41
2015-09-19,2015-09-19,Business meal,REF17772612,221.83,0.0,35771.58
2015-09-21,2015-09-21,Professional software license,REF89945488,232.53,0.0,35539.05
2015-09-23,2015-09-23,Training/conference,REF85105113,241.41,0.0,35297.64
2015-10-01,2015-10-01,Coworking space rental,REF22514715,487.88,0.0,34809.76
2015-10-02,2015-10-02,Business meal,REF32615739,310.88,0.0,34498.88
2015-10-09,2015-10-09,Business travel,REF64567240,372.67,0.0,34126.21
2015-10-09,2015-10-09,Business meal,REF68761554,236.55,0.0,33889.66
2015-10-14,2015-10-14,Training/conference,REF27783206,308.65,0.0,33581.01
2015-10-15,2015-10-15,Service payment - Wheeler PLC,REF69568483,0.0,761.2,34342.21
2015-10-15,2015-10-15,Service payment - Thompson-Baker,REF42657533,0.0,660.57,35002.78
2015-10-15,2015-10-15,Service payment - Griffin-Ortega,REF64340023,0.0,314.91,35317.69
2015-10-15,2015-10-15,Payment from Hayes-Mclean,REF36782381,0.0,746.36,36064.05
2015-10-15,2015-10-15,Project payment - Tran Inc,REF87447866,0.0,815.62,36879.67
2015-10-15,2015-10-15,"Payment from Andrews, Stanton and Hines",REF22383083,0.0,519.28,37398.95
2015-10-15,2015-10-15,Payment from Keller-Stewart,REF63783387,0.0,858.07,38257.02
2015-10-15,2015-10-15,"Payment from Gould, Moran and Thomas",REF43405402,0.0,1071.46,39328.48
2015-10-15,2015-10-15,Business insurance premium,REF78180550,176.96,0.0,39151.52
2015-10-16,2015-10-16,Coworking space rental,REF21338563,405.08,0.0,38746.44
2015-10-21,2015-10-21,Professional software license,REF85070153,261.32,0.0,38485.12
2015-10-26,2015-10-26,Business meal,REF41198774,126.83,0.0,38358.29
2015-11-02,2015-11-02,Marketing expenses,REF97004521,541.24,0.0,37817.05
2015-11-06,2015-11-06,Business meal,REF58410121,283.41,0.0,37533.64
2015-11-09,2015-11-09,Training/conference,REF30012434,216.88,0.0,37316.76
2015-11-14,2015-11-14,Training/conference,REF16055471,355.79,0.0,36960.97
2015-11-15,2015-11-15,Business insurance premium,REF32744191,148.52,0.0,36812.45
2015-11-15,2015-11-15,Project payment - Wheeler PLC,REF13353254,0.0,881.87,37694.32
2015-11-15,2015-11-15,Invoice payment - Hayes-Mclean,REF55047085,0.0,740.72,38435.04
2015-11-15,2015-11-15,Payment from Keller-Stewart,REF56016798,0.0,613.04,39048.08
2015-11-15,2015-11-15,"Payment from Gould, Moran and Thomas",REF70962826,0.0,840.26,39888.34
2015-11-15,2015-11-15,"Service payment - Andrews, Stanton and Hines",REF59918217,0.0,457.71,40346.05
2015-11-15,2015-11-15,Service payment - Thompson-Baker,REF83913337,0.0,845.89,41191.94
2015-11-15,2015-11-15,Service payment - Griffin-Ortega,REF64411656,0.0,220.96,41412.9
2015-11-15,2015-11-15,Service payment - Tran Inc,REF26804468,0.0,704.22,42117.12
2015-11-17,2015-11-17,Business meal,REF53887279,317.31,0.0,41799.81
2015-11-21,2015-11-21,Professional software license,REF95954370,206.66,0.0,41593.15
2015-11-23,2015-11-23,Marketing expenses,REF16246971,351.97,0.0,41241.18
2015-11-25,2015-11-25,Business travel,REF14125822,202.56,0.0,41038.62
2015-11-25,2015-11-25,Training/conference,REF59968411,247.38,0.0,40791.24
2015-11-27,2015-11-27,Coworking space rental,REF36930726,476.16,0.0,40315.08
2015-11-30,2015-11-30,Business meal,REF83399981,256.26,0.0,40058.82
2015-12-02,2015-12-02,Business travel,REF63569397,380.59,0.0,39678.23
2015-12-11,2015-12-11,Coworking space rental,REF52066673,343.72,0.0,39334.51
2015-12-12,2015-12-12,Accounting expense,REF87710628,258.7,0.0,39075.81
2015-12-15,2015-12-15,Business insurance premium,REF48658588,120.42,0.0,38955.39
2015-12-15,2015-12-15,"Invoice payment - Gould, Moran and Thomas",REF68056408,0.0,746.65,39702.04
2015-12-15,2015-12-15,Invoice payment - Tran Inc,REF41480683,0.0,644.13,40346.17
2015-12-15,2015-12-15,"Invoice payment - Andrews, Stanton and Hines",REF62600985,0.0,375.0,40721.17
2015-12-15,2015-12-15,Service payment - Griffin-Ortega,REF30865495,0.0,353.62,41074.79
2015-12-15,2015-12-15,Service payment - Keller-Stewart,REF14035085,0.0,588.97,41663.76
2015-12-15,2015-12-15,Invoice payment - Wheeler PLC,REF26347519,0.0,655.31,42319.07
2015-12-15,2015-12-15,Invoice payment - Thompson-Baker,REF81919593,0.0,864.22,43183.29
2015-12-15,2015-12-15,Project payment - Hayes-Mclean,REF13828896,0.0,508.27,43691.56
2015-12-17,2015-12-17,Business travel,REF53961244,210.26,0.0,43481.3
2015-12-20,2015-12-20,Business travel,REF89870712,232.4,0.0,43248.9
2015-12-21,2015-12-21,Professional software license,REF89857417,167.71,0.0,43081.19
2016-01-09,2016-01-09,Business travel,REF32830496,209.9,0.0,42871.29
2016-01-15,2016-01-15,Invoice payment - Hayes-Mclean,REF63423550,0.0,760.26,43631.55
2016-01-15,2016-01-15,Service payment - Griffin-Ortega,REF38683378,0.0,352.07,43983.62
2016-01-15,2016-01-15,Project payment - Thompson-Baker,REF66274404,0.0,995.08,44978.7
2016-01-15,2016-01-15,Project payment - Wheeler PLC,REF70482995,0.0,754.08,45732.78
2016-01-15,2016-01-15,Business insurance premium,REF14128304,168.91,0.0,45563.87
2016-01-15,2016-01-15,Payment from Keller-Stewart,REF87460121,0.0,646.05,46209.92
2016-01-15,2016-01-15,Service payment - Tran Inc,REF70037420,0.0,862.95,47072.87
2016-01-21,2016-01-21,Professional software license,REF78767845,254.33,0.0,46818.54
2016-01-28,2016-01-28,Business travel,REF27679127,229.17,0.0,46589.37
2016-01-31,2016-01-31,Marketing expenses,REF89300750,474.65,0.0,46114.72
2016-02-06,2016-02-06,Business travel,REF33622170,194.29,0.0,45920.43
2016-02-09,2016-02-09,Accounting expense,REF58480399,283.52,0.0,45636.91
2016-02-09,2016-02-09,Equipment purchase,REF54585702,174.41,0.0,45462.5
2016-02-14,2016-02-14,Business travel,REF50816250,427.65,0.0,45034.85
2016-02-15,2016-02-15,Invoice payment - Wheeler PLC,REF88247352,0.0,802.85,45837.7
2016-02-15,2016-02-15,Payment from Thompson-Baker,REF76909755,0.0,747.11,46584.81
2016-02-15,2016-02-15,Invoice payment - Tran Inc,REF15391678,0.0,831.57,47416.38
2016-02-15,2016-02-15,Payment from Griffin-Ortega,REF68037612,0.0,305.52,47721.9
2016-02-15,2016-02-15,"Payment from Gould, Moran and Thomas",REF96385633,0.0,947.31,48669.21
2016-02-15,2016-02-15,Business insurance premium,REF75125039,160.78,0.0,48508.43
2016-02-15,2016-02-15,"Payment from Andrews, Stanton and Hines",REF97521516,0.0,608.72,49117.15
2016-02-15,2016-02-15,Project payment - Hayes-Mclean,REF51050744,0.0,909.81,50026.96
2016-02-15,2016-02-15,Invoice payment - Keller-Stewart,REF58085452,0.0,635.64,50662.6
2016-02-21,2016-02-21,Professional software license,REF76347141,204.87,0.0,50457.73
2016-02-25,2016-02-25,Business travel,REF42488243,384.22,0.0,50073.51
2016-02-26,2016-02-26,Accounting expense,REF63718920,275.1,0.0,49798.41
2016-03-04,2016-03-04,Training/conference,REF85783224,143.43,0.0,49654.98
2016-03-04,2016-03-04,Business travel,REF98063058,91.19,0.0,49563.79
2016-03-09,2016-03-09,Business travel,REF76816024,396.59,0.0,49167.2
2016-03-11,2016-03-11,Equipment purchase,REF76287547,141.82,0.0,49025.38
2016-03-11,2016-03-11,Training/conference,REF27786674,322.34,0.0,48703.04
2016-03-11,2016-03-11,Accounting expense,REF18397469,236.68,0.0,48466.36
2016-03-14,2016-03-14,Marketing expenses,REF41617021,402.25,0.0,48064.11
2016-03-15,2016-03-15,Business insurance premium,REF47824174,132.74,0.0,47931.37
2016-03-15,2016-03-15,Service payment - Griffin-Ortega,REF22895565,0.0,279.66,48211.03
2016-03-15,2016-03-15,"Payment from Gould, Moran and Thomas",REF39616550,0.0,944.98,49156.01
2016-03-15,2016-03-15,"Project payment - Andrews, Stanton and Hines",REF74632658,0.0,549.94,49705.95
2016-03-15,2016-03-15,Payment from Hayes-Mclean,REF81572386,0.0,886.19,50592.14
2016-03-15,2016-03-15,Payment from Wheeler PLC,REF82592472,0.0,549.71,51141.85
2016-03-15,2016-03-15,Service payment - Keller-Stewart,REF85454263,0.0,659.31,51801.16
2016-03-15,2016-03-15,Project payment - Thompson-Baker,REF29905802,0.0,1046.72,52847.88
2016-03-15,2016-03-15,Service payment - Tran Inc,REF74160259,0.0,646.09,53493.97
2016-03-17,2016-03-17,Accounting expense,REF99195719,223.77,0.0,53270.2
2016-03-20,2016-03-20,Business travel,REF87396939,513.11,0.0,52757.09
2016-03-21,2016-03-21,Professional software license,REF53867074,192.89,0.0,52564.2
2016-03-27,2016-03-27,Accounting expense,REF32545848,224.59,0.0,52339.61
2016-03-29,2016-03-29,Accounting expense,REF22718412,63.08,0.0,52276.53
2016-03-30,2016-03-30,Marketing expenses,REF11494932,304.89,0.0,51971.64
2016-03-30,2016-03-30,Business travel,REF77065183,320.3,0.0,51651.34
2016-04-08,2016-04-08,Training/conference,REF91455319,218.86,0.0,51432.48
2016-04-10,2016-04-10,Accounting expense,REF37461628,221.6,0.0,51210.88
2016-04-14,2016-04-14,Coworking space rental,REF88992310,366.24,0.0,50844.64
2016-04-15,2016-04-15,Invoice payment - Griffin-Ortega,REF54292403,0.0,277.27,51121.91
2016-04-15,2016-04-15,Service payment - Keller-Stewart,REF48612513,0.0,521.94,51643.85
2016-04-15,2016-04-15,"Project payment - Andrews, Stanton and Hines",REF59559153,0.0,519.14,52162.99
2016-04-15,2016-04-15,"Payment from Gould, Moran and Thomas",REF66777140,0.0,971.7,53134.69
2016-04-15,2016-04-15,Payment from Hayes-Mclean,REF24567055,0.0,641.36,53776.05
2016-04-15,2016-04-15,Invoice payment - Thompson-Baker,REF60322512,0.0,827.91,54603.96
2016-04-15,2016-04-15,Project payment - Wheeler PLC,REF97829673,0.0,782.77,55386.73
2016-04-15,2016-04-15,Project payment - Tran Inc,REF32930433,0.0,541.89,55928.62
2016-04-15,2016-04-15,Business insurance premium,REF70720847,132.56,0.0,55796.06
2016-04-19,2016-04-19,Training/conference,REF41162454,187.52,0.0,55608.54
2016-04-21,2016-04-21,Professional software license,REF74699723,198.79,0.0,55409.75
2016-04-22,2016-04-22,Marketing expenses,REF18927547,376.01,0.0,55033.74
2016-05-09,2016-05-09,Equipment purchase,REF28300908,90.99,0.0,54942.75
2016-05-15,2016-05-15,Business meal,REF16635291,229.65,0.0,54713.1
2016-05-15,2016-05-15,"Service payment - Gould, Moran and Thomas",REF21970934,0.0,525.28,55238.38
2016-05-15,2016-05-15,Payment from Keller-Stewart,REF58568489,0.0,456.01,55694.39
2016-05-15,2016-05-15,Payment from Hayes-Mclean,REF76485745,0.0,679.27,56373.66
2016-05-15,2016-05-15,Business insurance premium,REF50316284,115.83,0.0,56257.83
2016-05-15,2016-05-15,"Project payment - Andrews, Stanton and Hines",REF11945966,0.0,550.83,56808.66
2016-05-15,2016-05-15,Project payment - Wheeler PLC,REF73301711,0.0,617.77,57426.43
2016-05-15,2016-05-15,Invoice payment - Thompson-Baker,REF42359096,0.0,859.62,58286.05
2016-05-17,2016-05-17,Equipment purchase,REF69038833,150.03,0.0,58136.02
2016-05-17,2016-05-17,Business meal,REF34994581,109.41,0.0,58026.61
2016-05-18,2016-05-18,Marketing expenses,REF57304861,179.6,0.0,57847.01
2016-05-21,2016-05-21,Professional software license,REF68632653,168.67,0.0,57678.34
2016-05-23,2016-05-23,Business meal,REF84968828,207.36,0.0,57470.98
2016-05-29,2016-05-29,Coworking space rental,REF39261041,138.24,0.0,57332.74
2016-05-29,2016-05-29,Training/conference,REF28716608,146.93,0.0,57185.81
2016-06-02,2016-06-02,Coworking space rental,REF22926450,133.04,0.0,57052.77
2016-06-04,2016-06-04,Accounting expense,REF36370067,166.18,0.0,56886.59
2016-06-14,2016-06-14,Business meal,REF61625078,281.56,0.0,56605.03
2016-06-15,2016-06-15,Coworking space rental,REF30702860,178.93,0.0,56426.1
2016-06-15,2016-06-15,Invoice payment - Thompson-Baker,REF60536751,0.0,605.27,57031.37
2016-06-15,2016-06-15,"Service payment - Gould, Moran and Thomas",REF36484258,0.0,665.91,57697.28
2016-06-15,2016-06-15,Payment from Hayes-Mclean,REF80704540,0.0,557.35,58254.63
2016-06-15,2016-06-15,Business insurance premium,REF50595844,107.33,0.0,58147.3
2016-06-15,2016-06-15,"Invoice payment - Andrews, Stanton and Hines",REF63222513,0.0,387.38,58534.68
2016-06-15,2016-06-15,Payment from Wheeler PLC,REF23541462,0.0,567.78,59102.46
2016-06-15,2016-06-15,Project payment - Tran Inc,REF45281274,0.0,549.6,59652.06
2016-06-15,2016-06-15,Invoice payment - Griffin-Ortega,REF59648521,0.0,174.57,59826.63
2016-06-15,2016-06-15,Service payment - Keller-Stewart,REF16767011,0.0,407.65,60234.28
2016-06-16,2016-06-16,Accounting expense,REF80471931,246.06,0.0,59988.22
2016-06-21,2016-06-21,Professional software license,REF85169746,178.31,0.0,59809.91
2016-06-22,2016-06-22,Business meal,REF79739874,214.85,0.0,59595.06
2016-06-23,2016-06-23,Marketing expenses,REF29523917,184.29,0.0,59410.77
2016-06-26,2016-06-26,Business meal,REF85801175,285.24,0.0,59125.53
2016-07-04,2016-07-04,Training/conference,REF56343729,126.16,0.0,58999.37
2016-07-04,2016-07-04,Business travel,REF10415127,128.51,0.0,58870.86
2016-07-05,2016-07-05,Accounting expense,REF34040549,91.11,0.0,58779.75
2016-07-15,2016-07-15,Project payment - Keller-Stewart,REF84715046,0.0,462.47,59242.22
2016-07-15,2016-07-15,"Payment from Andrews, Stanton and Hines",REF39828274,0.0,383.04,59625.26
2016-07-15,2016-07-15,Payment from Griffin-Ortega,REF50814115,0.0,159.6,59784.86
2016-07-15,2016-07-15,Business insurance premium,REF77300165,97.79,0.0,59687.07
2016-07-15,2016-07-15,Project payment - Tran Inc,REF26512129,0.0,544.89,60231.96
2016-07-15,2016-07-15,Service payment - Hayes-Mclean,REF88666652,0.0,414.6,60646.56
2016-07-15,2016-07-15,"Payment from Gould, Moran and Thomas",REF83801995,0.0,632.48,61279.04
2016-07-15,2016-07-15,Invoice payment - Thompson-Baker,REF40481817,0.0,418.8,61697.84
2016-07-15,2016-07-15,Project payment - Wheeler PLC,REF69948615,0.0,625.61,62323.45
2016-07-21,2016-07-21,Marketing expenses,REF34208052,217.79,0.0,62105.66
2016-07-21,2016-07-21,Coworking space rental,REF65286355,233.96,0.0,61871.7
2016-07-21,2016-07-21,Professional software license,REF94295967,154.96,0.0,61716.74
2016-07-25,2016-07-25,Accounting expense,REF95129486,147.54,0.0,61569.2
2016-08-01,2016-08-01,Business travel,REF24670577,305.86,0.0,61263.34
2016-08-04,2016-08-04,Business meal,REF90222003,199.27,0.0,61064.07
2016-08-08,2016-08-08,Business travel,REF27053359,329.27,0.0,60734.8
2016-08-10,2016-08-10,Business meal,REF59201732,131.69,0.0,60603.11
2016-08-12,2016-08-12,Marketing expenses,REF89577502,131.31,0.0,60471.8
2016-08-14,2016-08-14,Coworking space rental,REF97086696,206.7,0.0,60265.1
2016-08-14,2016-08-14,Business travel,REF32587400,442.95,0.0,59822.15
2016-08-15,2016-08-15,Business insurance premium,REF32101498,113.76,0.0,59708.39
2016-08-15,2016-08-15,Project payment - Thompson-Baker,REF68436438,0.0,647.46,60355.85
2016-08-15,2016-08-15,Invoice payment - Wheeler PLC,REF90548358,0.0,532.03,60887.88
2016-08-15,2016-08-15,"Invoice payment - Gould, Moran and Thomas",REF11593938,0.0,862.32,61750.2
2016-08-15,2016-08-15,Service payment - Griffin-Ortega,REF49458297,0.0,261.78,62011.98
2016-08-15,2016-08-15,Service payment - Keller-Stewart,REF87987405,0.0,517.48,62529.46
2016-08-15,2016-08-15,Project payment - Tran Inc,REF20897146,0.0,469.75,62999.21
2016-08-15,2016-08-15,Service payment - Hayes-Mclean,REF13056525,0.0,459.13,63458.34
2016-08-15,2016-08-15,"Project payment - Andrews, Stanton and Hines",REF57217820,0.0,566.99,64025.33
2016-08-18,2016-08-18,Coworking space rental,REF21915199,239.25,0.0,63786.08
2016-08-21,2016-08-21,Coworking space rental,REF95641627,238.98,0.0,63547.1
2016-08-21,2016-08-21,Professional software license,REF20993753,181.89,0.0,63365.21
2016-08-22,2016-08-22,Business travel,REF69763637,216.66,0.0,63148.55
2016-08-25,2016-08-25,Marketing expenses,REF12280235,147.61,0.0,63000.94
2016-08-26,2016-08-26,Marketing expenses,REF32501122,234.19,0.0,62766.75
2016-08-30,2016-08-30,Business travel,REF58577026,275.8,0.0,62490.95
2016-09-04,2016-09-04,Accounting expense,REF59626236,288.93,0.0,62202.02
2016-09-08,2016-09-08,Accounting expense,REF82969667,306.49,0.0,61895.53
2016-09-14,2016-09-14,Business meal,REF92399848,377.71,0.0,61517.82
2016-09-15,2016-09-15,Service payment - Tran Inc,REF42740044,0.0,769.47,62287.29
2016-09-15,2016-09-15,Business insurance premium,REF27351783,155.88,0.0,62131.41
2016-09-15,2016-09-15,"Service payment - Gould, Moran and Thomas",REF53176186,0.0,1236.39,63367.8
2016-09-15,2016-09-15,Payment from Griffin-Ortega,REF77242538,0.0,412.86,63780.66
2016-09-15,2016-09-15,Payment from Thompson-Baker,REF20584964,0.0,807.95,64588.61
2016-09-15,2016-09-15,"Service payment - Andrews, Stanton and Hines",REF10140482,0.0,564.67,65153.28
2016-09-15,2016-09-15,Invoice payment - Wheeler PLC,REF74575409,0.0,644.87,65798.15
2016-09-16,2016-09-16,Business travel,REF22811935,428.64,0.0,65369.51
2016-09-18,2016-09-18,Accounting expense,REF18691408,226.48,0.0,65143.03
2016-09-21,2016-09-21,Professional software license,REF33298639,233.64,0.0,64909.39
2016-09-21,2016-09-21,Equipment purchase,REF33892940,98.75,0.0,64810.64
2016-09-26,2016-09-26,Marketing expenses,REF25551421,386.19,0.0,64424.45
2016-10-02,2016-10-02,Training/conference,REF93007234,362.88,0.0,64061.57
2016-10-04,2016-10-04,Business travel,REF38885810,506.19,0.0,63555.38
2016-10-06,2016-10-06,Equipment purchase,REF38683163,227.24,0.0,63328.14
2016-10-07,2016-10-07,Accounting expense,REF47208884,210.55,0.0,63117.59
2016-10-11,2016-10-11,Business meal,REF76831157,341.68,0.0,62775.91
2016-10-15,2016-10-15,Payment from Wheeler PLC,REF67404735,0.0,722.93,63498.84
2016-10-15,2016-10-15,Service payment - Thompson-Baker,REF47603280,0.0,1250.79,64749.63
2016-10-15,2016-10-15,Payment from Tran Inc,REF44395214,0.0,1070.01,65819.64
2016-10-15,2016-10-15,"Project payment - Gould, Moran and Thomas",REF15174837,0.0,925.88,66745.52
2016-10-15,2016-10-15,Business insurance premium,REF76026960,175.66,0.0,66569.86
2016-10-15,2016-10-15,Project payment - Hayes-Mclean,REF78770654,0.0,952.29,67522.15
2016-10-15,2016-10-15,"Invoice payment - Andrews, Stanton and Hines",REF72523392,0.0,683.74,68205.89
2016-10-15,2016-10-15,Payment from Griffin-Ortega,REF60337001,0.0,325.07,68530.96
2016-10-16,2016-10-16,Coworking space rental,REF51826465,294.14,0.0,68236.82
2016-10-20,2016-10-20,Business meal,REF97190996,329.58,0.0,67907.24
2016-10-21,2016-10-21,Professional software license,REF42560987,251.2,0.0,67656.04
2016-10-25,2016-10-25,Accounting expense,REF28479905,144.26,0.0,67511.78
2016-11-01,2016-11-01,Training/conference,REF16980034,198.58,0.0,67313.2
2016-11-08,2016-11-08,Accounting expense,REF69376054,244.39,0.0,67068.81
2016-11-09,2016-11-09,Accounting expense,REF99741316,262.51,0.0,66806.3
2016-11-13,2016-11-13,Business travel,REF45877420,420.26,0.0,66386.04
2016-11-15,2016-11-15,Service payment - Thompson-Baker,REF53315560,0.0,975.06,67361.1
2016-11-15,2016-11-15,Business insurance premium,REF94970371,157.11,0.0,67203.99
2016-11-15,2016-11-15,Project payment - Wheeler PLC,REF51619932,0.0,705.45,67909.44
2016-11-15,2016-11-15,Invoice payment - Keller-Stewart,REF88303953,0.0,506.96,68416.4
2016-11-15,2016-11-15,"Payment from Gould, Moran and Thomas",REF31815125,0.0,1002.42,69418.82
2016-11-15,2016-11-15,Payment from Griffin-Ortega,REF43747367,0.0,223.46,69642.28
2016-11-15,2016-11-15,"Project payment - Andrews, Stanton and Hines",REF84931858,0.0,610.28,70252.56
2016-11-15,2016-11-15,Project payment - Tran Inc,REF94228908,0.0,629.9,70882.46
2016-11-15,2016-11-15,Invoice payment - Hayes-Mclean,REF84756905,0.0,476.71,71359.17
2016-11-17,2016-11-17,Equipment purchase,REF51611808,119.71,0.0,71239.46
2016-11-21,2016-11-21,Professional software license,REF97154896,221.95,0.0,71017.51
2016-11-21,2016-11-21,Business travel,REF17209925,533.23,0.0,70484.28
2016-11-23,2016-11-23,Accounting expense,REF61404476,325.42,0.0,70158.86
2016-11-25,2016-11-25,Marketing expenses,REF98734050,185.24,0.0,69973.62
2016-11-27,2016-11-27,Marketing expenses,REF61640657,500.69,0.0,69472.93
2016-11-29,2016-11-29,Marketing expenses,REF26784489,379.45,0.0,69093.48
2016-11-30,2016-11-30,Business travel,REF73058401,425.25,0.0,68668.23
2016-12-06,2016-12-06,Equipment purchase,REF43421785,126.27,0.0,68541.96
2016-12-08,2016-12-08,Coworking space rental,REF30934970,250.26,0.0,68291.7
2016-12-15,2016-12-15,Project payment - Thompson-Baker,REF75865406,0.0,790.4,69082.1
2016-12-15,2016-12-15,"Service payment - Andrews, Stanton and Hines",REF83657013,0.0,507.3,69589.4
2016-12-15,2016-12-15,Invoice payment - Keller-Stewart,REF24489349,0.0,436.47,70025.87
2016-12-15,2016-12-15,Payment from Griffin-Ortega,REF33469454,0.0,214.5,70240.37
2016-12-15,2016-12-15,Payment from Tran Inc,REF48115924,0.0,531.46,70771.83
2016-12-15,2016-12-15,Payment from Wheeler PLC,REF55788474,0.0,551.31,71323.14
2016-12-15,2016-12-15,"Service payment - Gould, Moran and Thomas",REF48004255,0.0,776.13,72099.27
2016-12-15,2016-12-15,Business insurance premium,REF82998670,134.17,0.0,71965.1
2016-12-15,2016-12-15,Payment from Hayes-Mclean,REF88318785,0.0,751.82,72716.92
2016-12-18,2016-12-18,Business travel,REF83721244,231.8,0.0,72485.12
2016-12-21,2016-12-21,Professional software license,REF24499566,210.7,0.0,72274.42
2016-12-24,2016-12-24,Business meal,REF92669126,248.88,0.0,72025.54
2016-12-25,2016-12-25,Marketing expenses,REF30126771,416.38,0.0,71609.16
2016-12-29,2016-12-29,Business meal,REF17329773,378.02,0.0,71231.14
2016-12-29,2016-12-29,Training/conference,REF44630943,94.39,0.0,71136.75
2016-12-29,2016-12-29,Business travel,REF63851623,407.34,0.0,70729.41
2017-01-01,2017-01-01,Coworking space rental,REF12094110,352.96,0.0,70376.45
2017-01-06,2017-01-06,Business meal,REF86043383,140.01,0.0,70236.44
2017-01-07,2017-01-07,Coworking space rental,REF21110884,315.92,0.0,69920.52
2017-01-09,2017-01-09,Equipment purchase,REF35172820,154.83,0.0,69765.69
2017-01-11,2017-01-11,Coworking space rental,REF31496307,303.65,0.0,69462.04
2017-01-11,2017-01-11,Training/conference,REF23256740,180.29,0.0,69281.75
2017-01-15,2017-01-15,Business insurance premium,REF27653734,185.47,0.0,69096.28
2017-01-15,2017-01-15,Invoice payment - Thompson-Baker,REF79067210,0.0,1165.2,70261.48
2017-01-15,2017-01-15,Project payment - Wheeler PLC,REF84240324,0.0,681.11,70942.59
2017-01-15,2017-01-15,Invoice payment - Tran Inc,REF81123621,0.0,815.65,71758.24
2017-01-15,2017-01-15,Service payment - Keller-Stewart,REF72065329,0.0,927.2,72685.44
2017-01-15,2017-01-15,"Project payment - Gould, Moran and Thomas",REF97016194,0.0,1212.4,73897.84
2017-01-15,2017-01-15,"Service payment - Andrews, Stanton and Hines",REF30666156,0.0,685.78,74583.62
2017-01-15,2017-01-15,Project payment - Griffin-Ortega,REF24392068,0.0,340.64,74924.26
2017-01-20,2017-01-20,Coworking space rental,REF37090873,458.89,0.0,74465.37
2017-01-21,2017-01-21,Business meal,REF68784293,458.32,0.0,74007.05
2017-01-21,2017-01-21,Professional software license,REF29375409,207.28,0.0,73799.77
2017-01-22,2017-01-22,Coworking space rental,REF83709975,170.39,0.0,73629.38
2017-01-24,2017-01-24,Marketing expenses,REF97551105,443.71,0.0,73185.67
2017-01-28,2017-01-28,Accounting expense,REF98109162,212.89,0.0,72972.78
2017-02-03,2017-02-03,Business meal,REF37812790,394.2,0.0,72578.58
2017-02-15,2017-02-15,Business insurance premium,REF56059817,153.69,0.0,72424.89
2017-02-15,2017-02-15,Project payment - Hayes-Mclean,REF98579449,0.0,821.27,73246.16
2017-02-15,2017-02-15,Service payment - Thompson-Baker,REF48495604,0.0,1090.87,74337.03
2017-02-15,2017-02-15,Invoice payment - Griffin-Ortega,REF19898135,0.0,256.29,74593.32
2017-02-15,2017-02-15,Project payment - Wheeler PLC,REF89310447,0.0,531.71,75125.03
2017-02-15,2017-02-15,"Service payment - Andrews, Stanton and Hines",REF81820269,0.0,447.54,75572.57
2017-02-15,2017-02-15,"Invoice payment - Gould, Moran and Thomas",REF44082468,0.0,827.93,76400.5
2017-02-15,2017-02-15,Project payment - Keller-Stewart,REF94432654,0.0,641.34,77041.84
2017-02-18,2017-02-18,Marketing expenses,REF50348905,286.21,0.0,76755.63
2017-02-19,2017-02-19,Business meal,REF42314091,314.33,0.0,76441.3
2017-02-21,2017-02-21,Training/conference,REF50949516,15.2,0.0,76426.1
2017-02-21,2017-02-21,Professional software license,REF41240218,229.37,0.0,76196.73
2017-03-01,2017-03-01,Business travel,REF51308250,482.61,0.0,75714.12
2017-03-03,2017-03-03,Equipment purchase,REF48853084,178.83,0.0,75535.29
2017-03-06,2017-03-06,Training/conference,REF84218234,328.64,0.0,75206.65
2017-03-11,2017-03-11,Business travel,REF85475015,356.56,0.0,74850.09
2017-03-13,2017-03-13,Marketing expenses,REF44466220,354.76,0.0,74495.33
2017-03-15,2017-03-15,Invoice payment - Wheeler PLC,REF62262247,0.0,632.28,75127.61
2017-03-15,2017-03-15,Project payment - Griffin-Ortega,REF32206374,0.0,278.84,75406.45
2017-03-15,2017-03-15,"Project payment - Gould, Moran and Thomas",REF63655843,0.0,1070.99,76477.44
2017-03-15,2017-03-15,Marketing expenses,REF34767476,320.22,0.0,76157.22
2017-03-15,2017-03-15,Project payment - Hayes-Mclean,REF14653533,0.0,670.26,76827.48
2017-03-15,2017-03-15,Invoice payment - Tran Inc,REF85176247,0.0,785.41,77612.89
2017-03-15,2017-03-15,Payment from Keller-Stewart,REF75463437,0.0,520.75,78133.64
2017-03-15,2017-03-15,Business insurance premium,REF81833117,143.12,0.0,77990.52
2017-03-21,2017-03-21,Professional software license,REF85009484,227.18,0.0,77763.34
2017-03-22,2017-03-22,Business meal,REF31936570,243.57,0.0,77519.77
2017-03-31,2017-03-31,Coworking space rental,REF21988730,203.26,0.0,77316.51
2017-04-03,2017-04-03,Business travel,REF79801127,336.07,0.0,76980.44
2017-04-07,2017-04-07,Coworking space rental,REF46503640,145.5,0.0,76834.94
2017-04-08,2017-04-08,Business meal,REF12393558,362.69,0.0,76472.25
2017-04-14,2017-04-14,Training/conference,REF10078437,227.6,0.0,76244.65
2017-04-15,2017-04-15,Project payment - Wheeler PLC,REF78519835,0.0,813.94,77058.59
2017-04-15,2017-04-15,"Invoice payment - Gould, Moran and Thomas",REF62780698,0.0,734.94,77793.53
2017-04-15,2017-04-15,Project payment - Tran Inc,REF68425936,0.0,812.95,78606.48
2017-04-15,2017-04-15,Invoice payment - Hayes-Mclean,REF58243087,0.0,741.16,79347.64
2017-04-15,2017-04-15,Project payment - Griffin-Ortega,REF20211166,0.0,252.82,79600.46
2017-04-15,2017-04-15,"Project payment - Andrews, Stanton and Hines",REF98595381,0.0,522.99,80123.45
2017-04-15,2017-04-15,Project payment - Keller-Stewart,REF13465791,0.0,562.76,80686.21
2017-04-15,2017-04-15,Business insurance premium,REF16437961,152.2,0.0,80534.01
2017-04-20,2017-04-20,Business travel,REF65354593,526.23,0.0,80007.78
2017-04-21,2017-04-21,Professional software license,REF68957751,217.03,0.0,79790.75
2017-04-21,2017-04-21,Equipment purchase,REF52375073,167.89,0.0,79622.86
2017-04-22,2017-04-22,Coworking space rental,REF15554463,184.61,0.0,79438.25
2017-05-01,2017-05-01,Business travel,REF65293323,337.53,0.0,79100.72
2017-05-07,2017-05-07,Business meal,REF41611929,213.4,0.0,78887.32
2017-05-13,2017-05-13,Accounting expense,REF58001091,238.83,0.0,78648.49
2017-05-14,2017-05-14,Training/conference,REF33079604,300.63,0.0,78347.86
2017-05-15,2017-05-15,Business insurance premium,REF55893766,126.3,0.0,78221.56
2017-05-15,2017-05-15,Invoice payment - Wheeler PLC,REF68271790,0.0,495.75,78717.31
2017-05-15,2017-05-15,Service payment - Hayes-Mclean,REF84656471,0.0,496.22,79213.53
2017-05-15,2017-05-15,Project payment - Tran Inc,REF24503914,0.0,635.06,79848.59
2017-05-15,2017-05-15,"Project payment - Andrews, Stanton and Hines",REF84317659,0.0,478.88,80327.47
2017-05-15,2017-05-15,Invoice payment - Keller-Stewart,REF62092530,0.0,394.6,80722.07
2017-05-15,2017-05-15,Payment from Thompson-Baker,REF16139054,0.0,712.91,81434.98
2017-05-15,2017-05-15,"Payment from Gould, Moran and Thomas",REF95692666,0.0,1037.06,82472.04
2017-05-15,2017-05-15,Service payment - Griffin-Ortega,REF59939028,0.0,248.52,82720.56
2017-05-20,2017-05-20,Business travel,REF94529699,199.33,0.0,82521.23
2017-05-21,2017-05-21,Professional software license,REF71394803,197.83,0.0,82323.4
2017-05-21,2017-05-21,Business meal,REF82694602,181.61,0.0,82141.79
2017-05-24,2017-05-24,Training/conference,REF49144990,163.27,0.0,81978.52
2017-05-30,2017-05-30,Accounting expense,REF84898839,220.18,0.0,81758.34
2017-06-12,2017-06-12,Business travel,REF19409602,262.55,0.0,81495.79
2017-06-13,2017-06-13,Business meal,REF34862755,83.49,0.0,81412.3
2017-06-15,2017-06-15,Business insurance premium,REF59613113,111.63,0.0,81300.67
2017-06-15,2017-06-15,"Invoice payment - Gould, Moran and Thomas",REF64459540,0.0,840.88,82141.55
2017-06-15,2017-06-15,Invoice payment - Thompson-Baker,REF39059108,0.0,653.27,82794.82
2017-06-15,2017-06-15,"Project payment - Andrews, Stanton and Hines",REF63480747,0.0,498.01,83292.83
2017-06-15,2017-06-15,Project payment - Griffin-Ortega,REF77869843,0.0,216.6,83509.43
2017-06-15,2017-06-15,Service payment - Keller-Stewart,REF13568175,0.0,342.81,83852.24
2017-06-15,2017-06-15,Service payment - Tran Inc,REF49395242,0.0,609.2,84461.44
2017-06-20,2017-06-20,Training/conference,REF40404605,177.92,0.0,84283.52
2017-06-21,2017-06-21,Professional software license,REF51333214,152.95,0.0,84130.57
2017-06-22,2017-06-22,Coworking space rental,REF52554775,276.67,0.0,83853.9
2017-06-28,2017-06-28,Training/conference,REF50129667,77.69,0.0,83776.21
2017-07-09,2017-07-09,Equipment purchase,REF28136499,170.24,0.0,83605.97
2017-07-14,2017-07-14,Accounting expense,REF45770765,155.45,0.0,83450.52
2017-07-15,2017-07-15,Invoice payment - Keller-Stewart,REF36450936,0.0,395.03,83845.55
2017-07-15,2017-07-15,Service payment - Thompson-Baker,REF92610908,0.0,415.97,84261.52
2017-07-15,2017-07-15,Payment from Wheeler PLC,REF99076293,0.0,308.15,84569.67
2017-07-15,2017-07-15,Project payment - Tran Inc,REF80930718,0.0,495.28,85064.95
2017-07-15,2017-07-15,"Invoice payment - Andrews, Stanton and Hines",REF32738617,0.0,369.51,85434.46
2017-07-15,2017-07-15,Business insurance premium,REF54191825,96.82,0.0,85337.64
2017-07-15,2017-07-15,"Project payment - Gould, Moran and Thomas",REF56516991,0.0,799.1,86136.74
2017-07-15,2017-07-15,Invoice payment - Griffin-Ortega,REF80566442,0.0,179.38,86316.12
2017-07-17,2017-07-17,Marketing expenses,REF40474408,163.33,0.0,86152.79
2017-07-21,2017-07-21,Professional software license,REF88959196,136.83,0.0,86015.96
2017-07-23,2017-07-23,Training/conference,REF23228825,50.65,0.0,85965.31
2017-07-24,2017-07-24,Coworking space rental,REF36492295,345.15,0.0,85620.16
2017-07-29,2017-07-29,Business meal,REF45540639,115.9,0.0,85504.26
2017-07-31,2017-07-31,Business meal,REF33150470,241.87,0.0,85262.39
2017-08-03,2017-08-03,Business meal,REF54099365,227.83,0.0,85034.56
2017-08-04,2017-08-04,Business meal,REF82400635,157.37,0.0,84877.19
2017-08-09,2017-08-09,Training/conference,REF71665543,89.9,0.0,84787.29
2017-08-11,2017-08-11,Accounting expense,REF30883565,147.94,0.0,84639.35
2017-08-15,2017-08-15,Service payment - Wheeler PLC,REF49613684,0.0,582.36,85221.71
2017-08-15,2017-08-15,Service payment - Tran Inc,REF86857511,0.0,601.86,85823.57
2017-08-15,2017-08-15,Service payment - Griffin-Ortega,REF24202491,0.0,179.62,86003.19
2017-08-15,2017-08-15,Business insurance premium,REF58699217,115.38,0.0,85887.81
2017-08-15,2017-08-15,Service payment - Keller-Stewart,REF10264114,0.0,459.65,86347.46
2017-08-15,2017-08-15,Invoice payment - Thompson-Baker,REF89071074,0.0,575.83,86923.29
2017-08-15,2017-08-15,"Project payment - Gould, Moran and Thomas",REF35100490,0.0,786.81,87710.1
2017-08-15,2017-08-15,"Invoice payment - Andrews, Stanton and Hines",REF42171340,0.0,494.33,88204.43
2017-08-15,2017-08-15,Project payment - Hayes-Mclean,REF32633360,0.0,662.84,88867.27
2017-08-19,2017-08-19,Accounting expense,REF28475627,121.9,0.0,88745.37
2017-08-21,2017-08-21,Professional software license,REF79001606,187.16,0.0,88558.21
2017-08-21,2017-08-21,Coworking space rental,REF11506712,149.05,0.0,88409.16
2017-08-25,2017-08-25,Coworking space rental,REF35479080,363.01,0.0,88046.15
2017-08-25,2017-08-25,Marketing expenses,REF31775568,222.3,0.0,87823.85
2017-08-26,2017-08-26,Accounting expense,REF16177972,110.51,0.0,87713.34
2017-08-30,2017-08-30,Marketing expenses,REF36420485,294.04,0.0,87419.3
2017-09-01,2017-09-01,Accounting expense,REF91399449,260.69,0.0,87158.61
2017-09-03,2017-09-03,Training/conference,REF60919120,245.38,0.0,86913.23
2017-09-04,2017-09-04,Training/conference,REF97548192,186.02,0.0,86727.21
2017-09-07,2017-09-07,Business travel,REF17469081,577.11,0.0,86150.1
2017-09-10,2017-09-10,Business meal,REF38337214,444.88,0.0,85705.22
2017-09-11,2017-09-11,Accounting expense,REF93850402,257.0,0.0,85448.22
2017-09-15,2017-09-15,"Payment from Andrews, Stanton and Hines",REF56763677,0.0,537.28,85985.5
2017-09-15,2017-09-15,"Project payment - Gould, Moran and Thomas",REF74352174,0.0,1174.55,87160.05
2017-09-15,2017-09-15,Invoice payment - Griffin-Ortega,REF74947950,0.0,297.34,87457.39
2017-09-15,2017-09-15,Service payment - Hayes-Mclean,REF94170069,0.0,854.44,88311.83
2017-09-15,2017-09-15,Invoice payment - Thompson-Baker,REF83270257,0.0,1060.27,89372.1
2017-09-15,2017-09-15,Business insurance premium,REF68134675,161.16,0.0,89210.94
2017-09-15,2017-09-15,Project payment - Tran Inc,REF39968520,0.0,951.15,90162.09
2017-09-15,2017-09-15,Payment from Wheeler PLC,REF44537550,0.0,825.58,90987.67
2017-09-17,2017-09-17,Coworking space rental,REF50168782,358.89,0.0,90628.78
2017-09-18,2017-09-18,Coworking space rental,REF51535845,267.09,0.0,90361.69
2017-09-21,2017-09-21,Professional software license,REF20189584,225.98,0.0,90135.71
2017-09-29,2017-09-29,Business meal,REF49232590,254.44,0.0,89881.27
2017-10-04,2017-10-04,Coworking space rental,REF68460131,140.09,0.0,89741.18
2017-10-15,2017-10-15,Payment from Keller-Stewart,REF46890111,0.0,355.9,90097.08
2017-10-15,2017-10-15,Payment from Hayes-Mclean,REF77874853,0.0,978.12,91075.2
2017-10-15,2017-10-15,Invoice payment - Thompson-Baker,REF61452685,0.0,1083.72,92158.92
2017-10-15,2017-10-15,Project payment - Griffin-Ortega,REF59541877,0.0,312.74,92471.66
2017-10-15,2017-10-15,Invoice payment - Tran Inc,REF86130933,0.0,674.77,93146.43
2017-10-15,2017-10-15,"Payment from Gould, Moran and Thomas",REF56174909,0.0,1107.25,94253.68
2017-10-15,2017-10-15,Business insurance premium,REF87994454,147.35,0.0,94106.33
2017-10-19,2017-10-19,Coworking space rental,REF35043441,412.25,0.0,93694.08
2017-10-21,2017-10-21,Professional software license,REF23684953,288.47,0.0,93405.61
2017-10-30,2017-10-30,Marketing expenses,REF41618204,425.09,0.0,92980.52
2017-11-03,2017-11-03,Accounting expense,REF82611587,225.58,0.0,92754.94
2017-11-07,2017-11-07,Business travel,REF35792683,419.99,0.0,92334.95
2017-11-15,2017-11-15,Project payment - Hayes-Mclean,REF98554033,0.0,683.47,93018.42
2017-11-15,2017-11-15,Invoice payment - Wheeler PLC,REF41692250,0.0,929.73,93948.15
2017-11-15,2017-11-15,Project payment - Tran Inc,REF62344875,0.0,746.86,94695.01
2017-11-15,2017-11-15,Project payment - Griffin-Ortega,REF82107556,0.0,252.61,94947.62
2017-11-15,2017-11-15,Business insurance premium,REF57658473,154.37,0.0,94793.25
2017-11-15,2017-11-15,"Project payment - Andrews, Stanton and Hines",REF41969794,0.0,465.26,95258.51
2017-11-15,2017-11-15,Service payment - Keller-Stewart,REF35883793,0.0,696.1,95954.61
2017-11-15,2017-11-15,Payment from Thompson-Baker,REF80860145,0.0,1165.0,97119.61
2017-11-20,2017-11-20,Marketing expenses,REF37316982,451.36,0.0,96668.25
2017-11-21,2017-11-21,Professional software license,REF25080331,218.06,0.0,96450.19
2017-11-23,2017-11-23,Business travel,REF38158521,471.57,0.0,95978.62
2017-12-02,2017-12-02,Coworking space rental,REF31436953,295.5,0.0,95683.12
2017-12-14,2017-12-14,Business meal,REF57311514,131.93,0.0,95551.19
2017-12-15,2017-12-15,Business insurance premium,REF15856510,129.08,0.0,95422.11
2017-12-15,2017-12-15,Project payment - Tran Inc,REF92569647,0.0,548.69,95970.8
2017-12-15,2017-12-15,"Project payment - Gould, Moran and Thomas",REF88672802,0.0,761.06,96731.86
2017-12-15,2017-12-15,Service payment - Hayes-Mclean,REF93044612,0.0,544.04,97275.9
2017-12-15,2017-12-15,Payment from Griffin-Ortega,REF11172842,0.0,286.64,97562.54
2017-12-15,2017-12-15,"Project payment - Andrews, Stanton and Hines",REF10624242,0.0,559.63,98122.17
2017-12-15,2017-12-15,Service payment - Wheeler PLC,REF50295363,0.0,627.75,98749.92
2017-12-15,2017-12-15,Project payment - Thompson-Baker,REF88466486,0.0,665.3,99415.22
2017-12-15,2017-12-15,Project payment - Keller-Stewart,REF39856126,0.0,451.14,99866.36
2017-12-17,2017-12-17,Coworking space rental,REF59573328,310.19,0.0,99556.17
2017-12-19,2017-12-19,Business meal,REF38184893,296.12,0.0,99260.05
2017-12-21,2017-12-21,Marketing expenses,REF23527385,251.54,0.0,99008.51
2017-12-21,2017-12-21,Coworking space rental,REF83173185,267.9,0.0,98740.61
2017-12-21,2017-12-21,Professional software license,REF18894031,187.24,0.0,98553.37
2017-12-25,2017-12-25,Accounting expense,REF95659593,140.28,0.0,98413.09
2017-12-25,2017-12-25,Business meal,REF53452803,230.7,0.0,98182.39
2017-12-27,2017-12-27,Training/conference,REF77059622,170.81,0.0,98011.58
2018-01-01,2018-01-01,Equipment purchase,REF62503319,115.46,0.0,97896.12
2018-01-06,2018-01-06,Training/conference,REF31161707,253.35,0.0,97642.77
2018-01-07,2018-01-07,Marketing expenses,REF46933402,400.08,0.0,97242.69
2018-01-15,2018-01-15,Training/conference,REF24331068,268.59,0.0,96974.1
2018-01-15,2018-01-15,Project payment - Thompson-Baker,REF50786609,0.0,1048.85,98022.95
2018-01-15,2018-01-15,Service payment - Hayes-Mclean,REF17403105,0.0,1035.78,99058.73
2018-01-15,2018-01-15,Invoice payment - Wheeler PLC,REF18538091,0.0,788.88,99847.61
2018-01-15,2018-01-15,Payment from Keller-Stewart,REF22311295,0.0,666.83,100514.44
2018-01-15,2018-01-15,"Service payment - Gould, Moran and Thomas",REF58724241,0.0,1242.61,101757.05
2018-01-15,2018-01-15,"Service payment - Andrews, Stanton and Hines",REF25250950,0.0,514.08,102271.13
2018-01-15,2018-01-15,Project payment - Griffin-Ortega,REF22168723,0.0,376.38,102647.51
2018-01-15,2018-01-15,Payment from Tran Inc,REF40989704,0.0,751.83,103399.34
2018-01-15,2018-01-15,Business insurance premium,REF16757138,167.32,0.0,103232.02
2018-01-17,2018-01-17,Business meal,REF20186646,183.15,0.0,103048.87
2018-01-19,2018-01-19,Training/conference,REF84964809,372.43,0.0,102676.44
2018-01-21,2018-01-21,Professional software license,REF31796832,223.78,0.0,102452.66
2018-01-29,2018-01-29,Business meal,REF26003012,304.95,0.0,102147.71
2018-02-02,2018-02-02,Accounting expense,REF59921248,125.36,0.0,102022.35
2018-02-10,2018-02-10,Training/conference,REF11813608,242.99,0.0,101779.36
2018-02-15,2018-02-15,Business insurance premium,REF44712211,152.22,0.0,101627.14
2018-02-15,2018-02-15,Project payment - Hayes-Mclean,REF92349192,0.0,948.62,102575.76
2018-02-15,2018-02-15,Invoice payment - Thompson-Baker,REF29370351,0.0,768.7,103344.46
2018-02-15,2018-02-15,Service payment - Griffin-Ortega,REF15922533,0.0,285.13,103629.59
2018-02-15,2018-02-15,Project payment - Keller-Stewart,REF20841062,0.0,572.07,104201.66
2018-02-15,2018-02-15,Payment from Tran Inc,REF43249424,0.0,727.08,104928.74
2018-02-15,2018-02-15,"Project payment - Andrews, Stanton and Hines",REF28204251,0.0,674.92,105603.66
2018-02-15,2018-02-15,Invoice payment - Wheeler PLC,REF52826804,0.0,976.27,106579.93
2018-02-16,2018-02-16,Equipment purchase,REF91600539,74.86,0.0,106505.07
2018-02-21,2018-02-21,Professional software license,REF32877489,233.2,0.0,106271.87
2018-02-26,2018-02-26,Accounting expense,REF64211251,223.82,0.0,106048.05
2018-02-27,2018-02-27,Marketing expenses,REF75143322,294.08,0.0,105753.97
2018-02-28,2018-02-28,Coworking space rental,REF30345275,309.12,0.0,105444.85
2018-03-07,2018-03-07,Business meal,REF24507579,384.51,0.0,105060.34
2018-03-07,2018-03-07,Accounting expense,REF97847076,243.78,0.0,104816.56
2018-03-07,2018-03-07,Training/conference,REF91346251,208.24,0.0,104608.32
2018-03-08,2018-03-08,Accounting expense,REF77279411,207.61,0.0,104400.71
2018-03-10,2018-03-10,Business meal,REF38534893,219.79,0.0,104180.92
2018-03-15,2018-03-15,Invoice payment - Thompson-Baker,REF39818231,0.0,896.63,105077.55
2018-03-15,2018-03-15,Payment from Keller-Stewart,REF30685108,0.0,522.95,105600.5
2018-03-15,2018-03-15,Payment from Wheeler PLC,REF55236029,0.0,699.22,106299.72
2018-03-15,2018-03-15,Service payment - Tran Inc,REF99081666,0.0,692.89,106992.61
2018-03-15,2018-03-15,Service payment - Hayes-Mclean,REF82325659,0.0,711.11,107703.72
2018-03-15,2018-03-15,"Payment from Andrews, Stanton and Hines",REF18021853,0.0,610.15,108313.87
2018-03-15,2018-03-15,"Payment from Gould, Moran and Thomas",REF32604800,0.0,1037.88,109351.75
2018-03-15,2018-03-15,Business insurance premium,REF95522878,140.55,0.0,109211.2
2018-03-20,2018-03-20,Business meal,REF10580367,287.5,0.0,108923.7
2018-03-21,2018-03-21,Business travel,REF30290640,422.76,0.0,108500.94
2018-03-21,2018-03-21,Professional software license,REF52674166,194.9,0.0,108306.04
2018-03-25,2018-03-25,Marketing expenses,REF25664658,141.75,0.0,108164.29
2018-03-29,2018-03-29,Business travel,REF65176344,469.39,0.0,107694.9
2018-03-31,2018-03-31,Marketing expenses,REF25603329,223.31,0.0,107471.59
2018-04-05,2018-04-05,Training/conference,REF88496702,192.35,0.0,107279.24
2018-04-08,2018-04-08,Business meal,REF75418484,322.89,0.0,106956.35
2018-04-10,2018-04-10,Training/conference,REF99742620,174.38,0.0,106781.97
2018-04-12,2018-04-12,Business meal,REF78226306,306.54,0.0,106475.43
2018-04-15,2018-04-15,"Payment from Andrews, Stanton and Hines",REF26453052,0.0,434.32,106909.75
2018-04-15,2018-04-15,"Payment from Gould, Moran and Thomas",REF52246496,0.0,837.53,107747.28
2018-04-15,2018-04-15,Invoice payment - Thompson-Baker,REF75830400,0.0,737.2,108484.48
2018-04-15,2018-04-15,Project payment - Wheeler PLC,REF18952836,0.0,444.18,108928.66
2018-04-15,2018-04-15,Project payment - Griffin-Ortega,REF71076346,0.0,333.89,109262.55
2018-04-15,2018-04-15,Invoice payment - Keller-Stewart,REF18771154,0.0,478.06,109740.61
2018-04-15,2018-04-15,Payment from Hayes-Mclean,REF63356778,0.0,491.46,110232.07
2018-04-15,2018-04-15,Service payment - Tran Inc,REF12603618,0.0,631.59,110863.66
2018-04-15,2018-04-15,Business insurance premium,REF93501661,131.58,0.0,110732.08
2018-04-17,2018-04-17,Equipment purchase,REF52416957,154.06,0.0,110578.02
2018-04-21,2018-04-21,Professional software license,REF90218117,171.12,0.0,110406.9
2018-04-21,2018-04-21,Business meal,REF60111120,268.59,0.0,110138.31
2018-04-23,2018-04-23,Coworking space rental,REF77224812,280.29,0.0,109858.02
2018-04-24,2018-04-24,Equipment purchase,REF74201770,193.88,0.0,109664.14
2018-05-03,2018-05-03,Business meal,REF42541036,277.39,0.0,109386.75
2018-05-09,2018-05-09,Business travel,REF54179468,287.99,0.0,109098.76
2018-05-13,2018-05-13,Marketing expenses,REF76287933,264.63,0.0,108834.13
2018-05-15,2018-05-15,Business insurance premium,REF66198282,120.23,0.0,108713.9
2018-05-15,2018-05-15,Invoice payment - Thompson-Baker,REF41395585,0.0,701.16,109415.06
2018-05-15,2018-05-15,Invoice payment - Hayes-Mclean,REF55678267,0.0,543.18,109958.24
2018-05-15,2018-05-15,Invoice payment - Keller-Stewart,REF47539670,0.0,483.16,110441.4
2018-05-15,2018-05-15,Payment from Tran Inc,REF84290046,0.0,738.77,111180.17
2018-05-15,2018-05-15,"Project payment - Andrews, Stanton and Hines",REF28172354,0.0,484.62,111664.79
2018-05-15,2018-05-15,Project payment - Griffin-Ortega,REF73262732,0.0,278.24,111943.03
2018-05-15,2018-05-15,"Payment from Gould, Moran and Thomas",REF68780871,0.0,546.15,112489.18
2018-05-15,2018-05-15,Business travel,REF91676771,536.16,0.0,111953.02
2018-05-17,2018-05-17,Business meal,REF33189809,135.93,0.0,111817.09
2018-05-18,2018-05-18,Training/conference,REF13976448,215.45,0.0,111601.64
2018-05-21,2018-05-21,Professional software license,REF23603228,168.73,0.0,111432.91
2018-05-27,2018-05-27,Marketing expenses,REF95748907,367.8,0.0,111065.11
2018-05-27,2018-05-27,Coworking space rental,REF69780537,306.28,0.0,110758.83
2018-05-28,2018-05-28,Marketing expenses,REF12660749,292.01,0.0,110466.82
2018-05-29,2018-05-29,Marketing expenses,REF49361645,320.52,0.0,110146.3
2018-06-02,2018-06-02,Business meal,REF87636780,169.45,0.0,109976.85
2018-06-04,2018-06-04,Business meal,REF48314627,196.28,0.0,109780.57
2018-06-08,2018-06-08,Business meal,REF89372176,246.16,0.0,109534.41
2018-06-09,2018-06-09,Accounting expense,REF94075461,85.01,0.0,109449.4
2018-06-10,2018-06-10,Training/conference,REF97880894,230.38,0.0,109219.02
2018-06-11,2018-06-11,Accounting expense,REF63410535,151.97,0.0,109067.05
2018-06-14,2018-06-14,Equipment purchase,REF35525336,103.73,0.0,108963.32
2018-06-15,2018-06-15,Project payment - Keller-Stewart,REF61843774,0.0,348.7,109312.02
2018-06-15,2018-06-15,Project payment - Hayes-Mclean,REF75223403,0.0,562.9,109874.92
2018-06-15,2018-06-15,Business insurance premium,REF18306471,113.15,0.0,109761.77
2018-06-15,2018-06-15,Payment from Tran Inc,REF75719481,0.0,784.99,110546.76
2018-06-15,2018-06-15,Invoice payment - Griffin-Ortega,REF79000277,0.0,232.37,110779.13
2018-06-15,2018-06-15,Invoice payment - Thompson-Baker,REF34218363,0.0,717.12,111496.25
2018-06-15,2018-06-15,Service payment - Wheeler PLC,REF22323539,0.0,556.05,112052.3
2018-06-15,2018-06-15,"Service payment - Gould, Moran and Thomas",REF40821228,0.0,541.08,112593.38
2018-06-15,2018-06-15,"Service payment - Andrews, Stanton and Hines",REF62970321,0.0,485.26,113078.64
2018-06-19,2018-06-19,Accounting expense,REF51058027,145.85,0.0,112932.79
2018-06-21,2018-06-21,Professional software license,REF22762279,151.73,0.0,112781.06
2018-06-22,2018-06-22,Marketing expenses,REF56837009,259.63,0.0,112521.43
2018-06-22,2018-06-22,Business travel,REF73701240,362.37,0.0,112159.06
2018-06-28,2018-06-28,Marketing expenses,REF82927756,305.95,0.0,111853.11
2018-06-29,2018-06-29,Training/conference,REF69697639,101.25,0.0,111751.86
2018-07-06,2018-07-06,Equipment purchase,REF93501447,95.14,0.0,111656.72
2018-07-08,2018-07-08,Business meal,REF49653525,118.02,0.0,111538.7
2018-07-09,2018-07-09,Business meal,REF23049347,118.77,0.0,111419.93
2018-07-10,2018-07-10,Coworking space rental,REF63661166,235.63,0.0,111184.3
2018-07-11,2018-07-11,Marketing expenses,REF20751083,255.59,0.0,110928.71
2018-07-11,2018-07-11,Accounting expense,REF95013309,174.08,0.0,110754.63
2018-07-13,2018-07-13,Business travel,REF13137413,455.51,0.0,110299.12
2018-07-14,2018-07-14,Business travel,REF70017765,158.29,0.0,110140.83
2018-07-15,2018-07-15,"Invoice payment - Gould, Moran and Thomas",REF13400307,0.0,591.85,110732.68
2018-07-15,2018-07-15,Invoice payment - Thompson-Baker,REF40791452,0.0,667.94,111400.62
2018-07-15,2018-07-15,Business insurance premium,REF93405514,93.1,0.0,111307.52
2018-07-15,2018-07-15,Project payment - Hayes-Mclean,REF14591910,0.0,451.01,111758.53
2018-07-15,2018-07-15,Business travel,REF26552919,118.45,0.0,111640.08
2018-07-15,2018-07-15,Project payment - Wheeler PLC,REF24530734,0.0,548.83,112188.91
2018-07-19,2018-07-19,Equipment purchase,REF16741381,116.65,0.0,112072.26
2018-07-20,2018-07-20,Accounting expense,REF66734931,170.87,0.0,111901.39
2018-07-21,2018-07-21,Professional software license,REF93858523,153.69,0.0,111747.7
2018-07-26,2018-07-26,Marketing expenses,REF30652106,194.57,0.0,111553.13
2018-07-28,2018-07-28,Business travel,REF21849104,252.36,0.0,111300.77
2018-08-03,2018-08-03,Accounting expense,REF49790732,109.32,0.0,111191.45
2018-08-07,2018-08-07,Business meal,REF43482528,249.07,0.0,110942.38
2018-08-11,2018-08-11,Business meal,REF93803956,200.2,0.0,110742.18
2018-08-12,2018-08-12,Equipment purchase,REF98777553,143.59,0.0,110598.59
2018-08-13,2018-08-13,Marketing expenses,REF17209678,112.68,0.0,110485.91
2018-08-15,2018-08-15,Invoice payment - Wheeler PLC,REF61075905,0.0,679.55,111165.46
2018-08-15,2018-08-15,Business travel,REF37450990,440.63,0.0,110724.83
2018-08-15,2018-08-15,Service payment - Thompson-Baker,REF83422562,0.0,611.97,111336.8
2018-08-15,2018-08-15,"Project payment - Andrews, Stanton and Hines",REF55987360,0.0,338.59,111675.39
2018-08-15,2018-08-15,Business insurance premium,REF60073330,116.46,0.0,111558.93
2018-08-15,2018-08-15,Project payment - Griffin-Ortega,REF71465896,0.0,245.05,111803.98
2018-08-15,2018-08-15,"Invoice payment - Gould, Moran and Thomas",REF88285507,0.0,884.9,112688.88
2018-08-15,2018-08-15,Service payment - Tran Inc,REF27967694,0.0,445.55,113134.43
2018-08-15,2018-08-15,Service payment - Keller-Stewart,REF73800967,0.0,479.84,113614.27
2018-08-15,2018-08-15,Project payment - Hayes-Mclean,REF68570632,0.0,427.21,114041.48
2018-08-20,2018-08-20,Marketing expenses,REF74582077,191.27,0.0,113850.21
2018-08-21,2018-08-21,Professional software license,REF46839445,172.13,0.0,113678.08
2018-08-22,2018-08-22,Equipment purchase,REF28066214,131.04,0.0,113547.04
2018-08-26,2018-08-26,Marketing expenses,REF34957395,282.27,0.0,113264.77
2018-08-28,2018-08-28,Marketing expenses,REF37233937,165.08,0.0,113099.69
2018-08-29,2018-08-29,Business meal,REF58094728,179.69,0.0,112920.0
2018-09-01,2018-09-01,Marketing expenses,REF61636528,273.31,0.0,112646.69
2018-09-04,2018-09-04,Business travel,REF91739582,333.49,0.0,112313.2
2018-09-04,2018-09-04,Training/conference,REF38082181,193.95,0.0,112119.25
2018-09-15,2018-09-15,Project payment - Wheeler PLC,REF28103799,0.0,735.43,112854.68
2018-09-15,2018-09-15,Business insurance premium,REF81975549,166.26,0.0,112688.42
2018-09-15,2018-09-15,Payment from Griffin-Ortega,REF34491761,0.0,324.14,113012.56
2018-09-15,2018-09-15,Invoice payment - Thompson-Baker,REF41857630,0.0,622.32,113634.88
2018-09-15,2018-09-15,"Payment from Gould, Moran and Thomas",REF69794796,0.0,643.95,114278.83
2018-09-15,2018-09-15,"Service payment - Andrews, Stanton and Hines",REF56550911,0.0,399.27,114678.1
2018-09-15,2018-09-15,Service payment - Tran Inc,REF44694596,0.0,781.05,115459.15
2018-09-17,2018-09-17,Training/conference,REF98046998,312.32,0.0,115146.83
2018-09-20,2018-09-20,Business meal,REF68450428,189.25,0.0,114957.58
2018-09-20,2018-09-20,Business travel,REF27409688,379.27,0.0,114578.31
2018-09-21,2018-09-21,Business travel,REF47448012,622.26,0.0,113956.05
2018-09-21,2018-09-21,Professional software license,REF59938722,226.19,0.0,113729.86
2018-09-28,2018-09-28,Business travel,REF69186149,612.38,0.0,113117.48
2018-10-01,2018-10-01,Business travel,REF24502085,375.46,0.0,112742.02
2018-10-05,2018-10-05,Business meal,REF49937894,175.81,0.0,112566.21
2018-10-12,2018-10-12,Coworking space rental,REF61383949,344.84,0.0,112221.37
2018-10-15,2018-10-15,Project payment - Tran Inc,REF68734072,0.0,786.78,113008.15
2018-10-15,2018-10-15,"Project payment - Andrews, Stanton and Hines",REF31250536,0.0,565.92,113574.07
2018-10-15,2018-10-15,"Service payment - Gould, Moran and Thomas",REF74468130,0.0,984.8,114558.87
2018-10-15,2018-10-15,Service payment - Wheeler PLC,REF37614466,0.0,1067.35,115626.22
2018-10-15,2018-10-15,Payment from Thompson-Baker,REF55869585,0.0,1196.72,116822.94
2018-10-15,2018-10-15,Invoice payment - Keller-Stewart,REF62410659,0.0,650.12,117473.06
2018-10-15,2018-10-15,Business insurance premium,REF93712748,161.26,0.0,117311.8
2018-10-15,2018-10-15,Service payment - Hayes-Mclean,REF18410668,0.0,710.31,118022.11
2018-10-15,2018-10-15,Project payment - Griffin-Ortega,REF66654101,0.0,243.48,118265.59
2018-10-18,2018-10-18,Training/conference,REF13197457,396.5,0.0,117869.09
2018-10-18,2018-10-18,Coworking space rental,REF85663574,435.92,0.0,117433.17
2018-10-20,2018-10-20,Coworking space rental,REF47478242,247.26,0.0,117185.91
2018-10-21,2018-10-21,Professional software license,REF85610067,210.18,0.0,116975.73
2018-10-25,2018-10-25,Coworking space rental,REF61445056,219.86,0.0,116755.87
2018-10-28,2018-10-28,Accounting expense,REF33913739,364.03,0.0,116391.84
2018-10-31,2018-10-31,Coworking space rental,REF99103748,8.17,0.0,116383.67
2018-11-02,2018-11-02,Equipment purchase,REF13521541,190.29,0.0,116193.38
2018-11-03,2018-11-03,Marketing expenses,REF83884224,315.32,0.0,115878.06
2018-11-07,2018-11-07,Equipment purchase,REF48822375,203.38,0.0,115674.68
2018-11-15,2018-11-15,"Service payment - Gould, Moran and Thomas",REF87173034,0.0,1150.99,116825.67
2018-11-15,2018-11-15,Service payment - Tran Inc,REF80601709,0.0,655.63,117481.3
2018-11-15,2018-11-15,"Service payment - Andrews, Stanton and Hines",REF64528401,0.0,599.62,118080.92
2018-11-15,2018-11-15,Invoice payment - Keller-Stewart,REF94349389,0.0,605.76,118686.68
2018-11-15,2018-11-15,Service payment - Wheeler PLC,REF83047439,0.0,842.6,119529.28
2018-11-15,2018-11-15,Project payment - Thompson-Baker,REF51765984,0.0,843.7,120372.98
2018-11-15,2018-11-15,Invoice payment - Griffin-Ortega,REF60782399,0.0,238.45,120611.43
2018-11-15,2018-11-15,Business insurance premium,REF86095146,166.94,0.0,120444.49
2018-11-19,2018-11-19,Business travel,REF19580026,664.3,0.0,119780.19
2018-11-21,2018-11-21,Professional software license,REF35681110,194.27,0.0,119585.92
2018-11-26,2018-11-26,Business meal,REF81029784,361.81,0.0,119224.11
2018-11-27,2018-11-27,Coworking space rental,REF20846195,396.13,0.0,118827.98
2018-12-04,2018-12-04,Business meal,REF35187006,214.51,0.0,118613.47
2018-12-13,2018-12-13,Marketing expenses,REF81098734,294.64,0.0,118318.83
2018-12-14,2018-12-14,Accounting expense,REF21136062,155.32,0.0,118163.51
2018-12-15,2018-12-15,Payment from Keller-Stewart,REF38485940,0.0,462.91,118626.42
2018-12-15,2018-12-15,Invoice payment - Tran Inc,REF81011437,0.0,514.66,119141.08
2018-12-15,2018-12-15,Business insurance premium,REF54831696,121.09,0.0,119019.99
2018-12-15,2018-12-15,Payment from Thompson-Baker,REF49453198,0.0,687.01,119707.0
2018-12-15,2018-12-15,Service payment - Griffin-Ortega,REF97265943,0.0,246.12,119953.12
2018-12-15,2018-12-15,Service payment - Hayes-Mclean,REF24336119,0.0,569.38,120522.5
2018-12-15,2018-12-15,Invoice payment - Wheeler PLC,REF56745051,0.0,564.71,121087.21
2018-12-15,2018-12-15,"Project payment - Andrews, Stanton and Hines",REF99664712,0.0,549.49,121636.7
2018-12-15,2018-12-15,"Invoice payment - Gould, Moran and Thomas",REF91818923,0.0,780.68,122417.38
2018-12-17,2018-12-17,Marketing expenses,REF97623283,375.93,0.0,122041.45
2018-12-21,2018-12-21,Professional software license,REF72116898,174.63,0.0,121866.82
2018-12-26,2018-12-26,Accounting expense,REF17198559,173.82,0.0,121693.0
2018-12-26,2018-12-26,Equipment purchase,REF80978505,107.51,0.0,121585.49
2018-12-30,2018-12-30,Training/conference,REF37193961,267.46,0.0,121318.03
2019-01-06,2019-01-06,Coworking space rental,REF29080123,51.95,0.0,121266.08
2019-01-10,2019-01-10,Equipment purchase,REF93653276,172.5,0.0,121093.58
2019-01-15,2019-01-15,Business insurance premium,REF43516877,170.42,0.0,120923.16
2019-01-15,2019-01-15,"Invoice payment - Andrews, Stanton and Hines",REF91852688,0.0,672.42,121595.58
2019-01-15,2019-01-15,Service payment - Hayes-Mclean,REF95580824,0.0,910.98,122506.56
2019-01-15,2019-01-15,"Service payment - Gould, Moran and Thomas",REF35349494,0.0,1152.49,123659.05
2019-01-15,2019-01-15,Invoice payment - Griffin-Ortega,REF85298627,0.0,368.49,124027.54
2019-01-15,2019-01-15,Project payment - Tran Inc,REF73020843,0.0,763.62,124791.16
2019-01-15,2019-01-15,Service payment - Thompson-Baker,REF24658036,0.0,1031.13,125822.29
2019-01-15,2019-01-15,Payment from Keller-Stewart,REF70504447,0.0,661.92,126484.21
2019-01-15,2019-01-15,Payment from Wheeler PLC,REF47355002,0.0,942.23,127426.44
2019-01-21,2019-01-21,Professional software license,REF43658048,269.19,0.0,127157.25
2019-01-22,2019-01-22,Coworking space rental,REF15556221,113.82,0.0,127043.43
2019-01-26,2019-01-26,Marketing expenses,REF79486727,345.86,0.0,126697.57
2019-01-30,2019-01-30,Accounting expense,REF19025214,74.84,0.0,126622.73
2019-02-02,2019-02-02,Marketing expenses,REF54605380,335.91,0.0,126286.82
2019-02-05,2019-02-05,Business meal,REF47380122,309.44,0.0,125977.38
2019-02-11,2019-02-11,Business travel,REF18966048,495.39,0.0,125481.99
2019-02-11,2019-02-11,Equipment purchase,REF53078135,202.77,0.0,125279.22
2019-02-15,2019-02-15,Payment from Thompson-Baker,REF57920599,0.0,922.77,126201.99
2019-02-15,2019-02-15,Invoice payment - Wheeler PLC,REF42015023,0.0,811.89,127013.88
2019-02-15,2019-02-15,"Project payment - Andrews, Stanton and Hines",REF41178162,0.0,582.25,127596.13
2019-02-15,2019-02-15,Invoice payment - Hayes-Mclean,REF63367370,0.0,519.72,128115.85
2019-02-15,2019-02-15,Business insurance premium,REF69966080,155.5,0.0,127960.35
2019-02-15,2019-02-15,Invoice payment - Tran Inc,REF43355212,0.0,861.6,128821.95
2019-02-15,2019-02-15,Service payment - Keller-Stewart,REF45076755,0.0,699.63,129521.58
2019-02-15,2019-02-15,Invoice payment - Griffin-Ortega,REF48105383,0.0,276.72,129798.3
2019-02-15,2019-02-15,"Invoice payment - Gould, Moran and Thomas",REF95615354,0.0,910.07,130708.37
2019-02-20,2019-02-20,Coworking space rental,REF80288096,174.51,0.0,130533.86
2019-02-21,2019-02-21,Professional software license,REF71039666,239.24,0.0,130294.62
2019-02-25,2019-02-25,Business meal,REF41049397,409.67,0.0,129884.95
2019-02-26,2019-02-26,Training/conference,REF54825403,158.32,0.0,129726.63
2019-02-28,2019-02-28,Equipment purchase,REF48293533,151.94,0.0,129574.69
2019-03-03,2019-03-03,Equipment purchase,REF77158897,134.27,0.0,129440.42
2019-03-03,2019-03-03,Coworking space rental,REF54809032,239.0,0.0,129201.42
2019-03-06,2019-03-06,Equipment purchase,REF85379515,119.29,0.0,129082.13
2019-03-09,2019-03-09,Business travel,REF99314600,605.87,0.0,128476.26
2019-03-13,2019-03-13,Business meal,REF20336036,224.01,0.0,128252.25
2019-03-15,2019-03-15,"Service payment - Andrews, Stanton and Hines",REF66404073,0.0,629.66,128881.91
2019-03-15,2019-03-15,Payment from Wheeler PLC,REF83761226,0.0,589.49,129471.4
2019-03-15,2019-03-15,Project payment - Hayes-Mclean,REF48155329,0.0,752.3,130223.7
2019-03-15,2019-03-15,Business insurance premium,REF63993679,135.98,0.0,130087.72
2019-03-15,2019-03-15,Service payment - Keller-Stewart,REF60819503,0.0,722.28,130810.0
2019-03-15,2019-03-15,Invoice payment - Tran Inc,REF18438046,0.0,811.43,131621.43
2019-03-15,2019-03-15,Invoice payment - Thompson-Baker,REF24468784,0.0,737.28,132358.71
2019-03-15,2019-03-15,Payment from Griffin-Ortega,REF27404201,0.0,224.19,132582.9
2019-03-17,2019-03-17,Business meal,REF67197193,299.65,0.0,132283.25
2019-03-21,2019-03-21,Professional software license,REF30568059,228.38,0.0,132054.87
2019-03-25,2019-03-25,Equipment purchase,REF46178107,121.08,0.0,131933.79
2019-03-29,2019-03-29,Equipment purchase,REF70633030,168.26,0.0,131765.53
2019-03-30,2019-03-30,Accounting expense,REF68998373,236.51,0.0,131529.02
2019-03-30,2019-03-30,Business travel,REF21911618,631.65,0.0,130897.37
2019-04-02,2019-04-02,Business travel,REF70275180,463.33,0.0,130434.04
2019-04-05,2019-04-05,Training/conference,REF45335729,151.84,0.0,130282.2
2019-04-07,2019-04-07,Equipment purchase,REF62614361,141.16,0.0,130141.04
2019-04-09,2019-04-09,Equipment purchase,REF94707175,182.65,0.0,129958.39
2019-04-11,2019-04-11,Equipment purchase,REF14498475,211.52,0.0,129746.87
2019-04-13,2019-04-13,Marketing expenses,REF78276297,332.96,0.0,129413.91
2019-04-15,2019-04-15,"Invoice payment - Andrews, Stanton and Hines",REF88818123,0.0,500.34,129914.25
2019-04-15,2019-04-15,Business insurance premium,REF19721336,125.34,0.0,129788.91
2019-04-15,2019-04-15,Service payment - Griffin-Ortega,REF32429084,0.0,220.73,130009.64
2019-04-15,2019-04-15,Project payment - Thompson-Baker,REF58851569,0.0,688.01,130697.65
2019-04-15,2019-04-15,Invoice payment - Hayes-Mclean,REF20458024,0.0,795.0,131492.65
2019-04-15,2019-04-15,Service payment - Tran Inc,REF97366011,0.0,553.35,132046.0
2019-04-15,2019-04-15,Service payment - Wheeler PLC,REF69161174,0.0,744.11,132790.11
2019-04-15,2019-04-15,Project payment - Keller-Stewart,REF59441317,0.0,647.34,133437.45
2019-04-20,2019-04-20,Business meal,REF59179122,153.19,0.0,133284.26
2019-04-21,2019-04-21,Professional software license,REF12612525,230.57,0.0,133053.69
2019-04-23,2019-04-23,Equipment purchase,REF72709870,165.92,0.0,132887.77
2019-04-25,2019-04-25,Business travel,REF33964816,213.53,0.0,132674.24
2019-04-26,2019-04-26,Business meal,REF14415738,311.38,0.0,132362.86
2019-04-26,2019-04-26,Training/conference,REF10479724,250.85,0.0,132112.01
2019-05-09,2019-05-09,Equipment purchase,REF42584216,158.23,0.0,131953.78
2019-05-15,2019-05-15,Payment from Thompson-Baker,REF68870116,0.0,758.44,132712.22
2019-05-15,2019-05-15,"Project payment - Gould, Moran and Thomas",REF98617460,0.0,736.53,133448.75
2019-05-15,2019-05-15,Project payment - Hayes-Mclean,REF19600942,0.0,640.75,134089.5
2019-05-15,2019-05-15,Business insurance premium,REF23176342,127.12,0.0,133962.38
2019-05-15,2019-05-15,"Invoice payment - Andrews, Stanton and Hines",REF85226389,0.0,380.77,134343.15
2019-05-15,2019-05-15,Project payment - Wheeler PLC,REF93894485,0.0,632.43,134975.58
2019-05-15,2019-05-15,Invoice payment - Keller-Stewart,REF15843311,0.0,379.54,135355.12
2019-05-15,2019-05-15,Project payment - Tran Inc,REF76560368,0.0,764.7,136119.82
2019-05-15,2019-05-15,Payment from Griffin-Ortega,REF89606832,0.0,203.0,136322.82
2019-05-16,2019-05-16,Business meal,REF85649532,178.07,0.0,136144.75
2019-05-19,2019-05-19,Business travel,REF94948704,339.99,0.0,135804.76
2019-05-21,2019-05-21,Professional software license,REF52549751,156.22,0.0,135648.54
2019-05-25,2019-05-25,Training/conference,REF66962553,244.32,0.0,135404.22
2019-05-25,2019-05-25,Accounting expense,REF90431701,168.41,0.0,135235.81
2019-05-27,2019-05-27,Accounting expense,REF20001112,153.28,0.0,135082.53
2019-06-02,2019-06-02,Marketing expenses,REF90499358,312.24,0.0,134770.29
2019-06-11,2019-06-11,Equipment purchase,REF27300572,104.05,0.0,134666.24
2019-06-12,2019-06-12,Accounting expense,REF40493277,206.18,0.0,134460.06
2019-06-15,2019-06-15,"Payment from Gould, Moran and Thomas",REF85716769,0.0,781.68,135241.74
2019-06-15,2019-06-15,Service payment - Thompson-Baker,REF58811879,0.0,671.53,135913.27
2019-06-15,2019-06-15,Payment from Hayes-Mclean,REF59148186,0.0,509.47,136422.74
2019-06-15,2019-06-15,Project payment - Wheeler PLC,REF43999898,0.0,464.32,136887.06
2019-06-15,2019-06-15,Project payment - Griffin-Ortega,REF60495596,0.0,204.33,137091.39
2019-06-15,2019-06-15,Service payment - Tran Inc,REF77201306,0.0,615.8,137707.19
2019-06-15,2019-06-15,Business insurance premium,REF86307446,112.62,0.0,137594.57
2019-06-15,2019-06-15,Service payment - Keller-Stewart,REF28953518,0.0,469.95,138064.52
2019-06-21,2019-06-21,Professional software license,REF96212392,126.05,0.0,137938.47
2019-06-21,2019-06-21,Accounting expense,REF74248789,107.53,0.0,137830.94
2019-06-25,2019-06-25,Accounting expense,REF30577006,178.82,0.0,137652.12
2019-06-25,2019-06-25,Coworking space rental,REF18371680,183.29,0.0,137468.83
2019-06-26,2019-06-26,Coworking space rental,REF66976631,165.49,0.0,137303.34
2019-06-28,2019-06-28,Equipment purchase,REF90037337,125.61,0.0,137177.73
2019-06-30,2019-06-30,Business meal,REF80460448,185.78,0.0,136991.95
2019-07-01,2019-07-01,Training/conference,REF27794053,149.89,0.0,136842.06
2019-07-04,2019-07-04,Business travel,REF46193162,497.15,0.0,136344.91
2019-07-05,2019-07-05,Business travel,REF87565622,363.19,0.0,135981.72
2019-07-15,2019-07-15,Invoice payment - Thompson-Baker,REF30009003,0.0,590.51,136572.23
2019-07-15,2019-07-15,Invoice payment - Griffin-Ortega,REF38205053,0.0,217.03,136789.26
2019-07-15,2019-07-15,"Project payment - Gould, Moran and Thomas",REF81577895,0.0,553.35,137342.61
2019-07-15,2019-07-15,"Project payment - Andrews, Stanton and Hines",REF83360406,0.0,306.97,137649.58
2019-07-15,2019-07-15,Invoice payment - Wheeler PLC,REF25299304,0.0,438.33,138087.91
2019-07-15,2019-07-15,Project payment - Tran Inc,REF90708464,0.0,462.38,138550.29
2019-07-15,2019-07-15,Project payment - Keller-Stewart,REF97123155,0.0,459.82,139010.11
2019-07-15,2019-07-15,Business insurance premium,REF51144548,89.58,0.0,138920.53
2019-07-16,2019-07-16,Business travel,REF40565897,278.88,0.0,138641.65
2019-07-16,2019-07-16,Equipment purchase,REF68182451,133.89,0.0,138507.76
2019-07-19,2019-07-19,Accounting expense,REF91851184,91.19,0.0,138416.57
2019-07-21,2019-07-21,Professional software license,REF29062813,133.43,0.0,138283.14
2019-07-22,2019-07-22,Business travel,REF34958024,218.67,0.0,138064.47
2019-07-31,2019-07-31,Coworking space rental,REF38404873,147.71,0.0,137916.76
2019-08-05,2019-08-05,Training/conference,REF10420408,221.49,0.0,137695.27
2019-08-06,2019-08-06,Business travel,REF46512197,300.73,0.0,137394.54
2019-08-07,2019-08-07,Coworking space rental,REF95798485,230.48,0.0,137164.06
2019-08-15,2019-08-15,Invoice payment - Hayes-Mclean,REF26745030,0.0,598.31,137762.37
2019-08-15,2019-08-15,"Service payment - Andrews, Stanton and Hines",REF65864087,0.0,514.79,138277.16
2019-08-15,2019-08-15,Service payment - Thompson-Baker,REF45487597,0.0,611.65,138888.81
2019-08-15,2019-08-15,Invoice payment - Wheeler PLC,REF42771546,0.0,554.56,139443.37
2019-08-15,2019-08-15,Invoice payment - Tran Inc,REF72821892,0.0,583.28,140026.65
2019-08-15,2019-08-15,"Project payment - Gould, Moran and Thomas",REF88747121,0.0,693.93,140720.58
2019-08-15,2019-08-15,Invoice payment - Keller-Stewart,REF93843490,0.0,385.28,141105.86
2019-08-15,2019-08-15,Business insurance premium,REF62099663,107.59,0.0,140998.27
2019-08-21,2019-08-21,Professional software license,REF56761685,175.98,0.0,140822.29
2019-08-24,2019-08-24,Coworking space rental,REF26239140,292.53,0.0,140529.76
2019-09-03,2019-09-03,Marketing expenses,REF20606376,427.94,0.0,140101.82
2019-09-05,2019-09-05,Business meal,REF44477642,319.61,0.0,139782.21
2019-09-07,2019-09-07,Equipment purchase,REF98277024,151.83,0.0,139630.38
2019-09-09,2019-09-09,Marketing expenses,REF47884247,387.9,0.0,139242.48
2019-09-15,2019-09-15,Business insurance premium,REF75843242,145.52,0.0,139096.96
2019-09-15,2019-09-15,Project payment - Wheeler PLC,REF15197319,0.0,697.92,139794.88
2019-09-15,2019-09-15,"Project payment - Andrews, Stanton and Hines",REF57969197,0.0,503.43,140298.31
2019-09-15,2019-09-15,Invoice payment - Griffin-Ortega,REF12678279,0.0,308.3,140606.61
2019-09-15,2019-09-15,Invoice payment - Thompson-Baker,REF55595617,0.0,950.92,141557.53
2019-09-15,2019-09-15,"Service payment - Gould, Moran and Thomas",REF11267787,0.0,1111.8,142669.33
2019-09-15,2019-09-15,Service payment - Hayes-Mclean,REF74853663,0.0,842.3,143511.63
2019-09-16,2019-09-16,Training/conference,REF90421109,222.35,0.0,143289.28
2019-09-19,2019-09-19,Business travel,REF50973855,583.78,0.0,142705.5
2019-09-19,2019-09-19,Accounting expense,REF55411841,236.08,0.0,142469.42
2019-09-21,2019-09-21,Marketing expenses,REF53075705,554.01,0.0,141915.41
2019-09-21,2019-09-21,Professional software license,REF73860063,193.11,0.0,141722.3
2019-09-21,2019-09-21,Business travel,REF18047289,510.04,0.0,141212.26
2019-09-23,2019-09-23,Accounting expense,REF53963773,139.71,0.0,141072.55
2019-09-27,2019-09-27,Marketing expenses,REF85280072,341.02,0.0,140731.53
2019-09-27,2019-09-27,Equipment purchase,REF24432654,184.44,0.0,140547.09
2019-09-28,2019-09-28,Marketing expenses,REF86320666,239.91,0.0,140307.18
2019-10-01,2019-10-01,Business meal,REF92811987,447.36,0.0,139859.82
2019-10-05,2019-10-05,Training/conference,REF29124683,163.45,0.0,139696.37
2019-10-15,2019-10-15,"Invoice payment - Andrews, Stanton and Hines",REF88393254,0.0,635.39,140331.76
2019-10-15,2019-10-15,Payment from Griffin-Ortega,REF85934261,0.0,275.38,140607.14
2019-10-15,2019-10-15,Payment from Tran Inc,REF81740727,0.0,685.36,141292.5
2019-10-15,2019-10-15,"Project payment - Gould, Moran and Thomas",REF60789557,0.0,1187.63,142480.13
2019-10-15,2019-10-15,Invoice payment - Hayes-Mclean,REF84694932,0.0,656.74,143136.87
2019-10-15,2019-10-15,Project payment - Keller-Stewart,REF16072164,0.0,554.07,143690.94
2019-10-15,2019-10-15,Project payment - Wheeler PLC,REF35697688,0.0,760.55,144451.49
2019-10-15,2019-10-15,Invoice payment - Thompson-Baker,REF32052805,0.0,941.7,145393.19
2019-10-15,2019-10-15,Business insurance premium,REF70908359,170.46,0.0,145222.73
2019-10-16,2019-10-16,Training/conference,REF68862494,124.45,0.0,145098.28
2019-10-18,2019-10-18,Accounting expense,REF77129868,263.81,0.0,144834.47
2019-10-21,2019-10-21,Professional software license,REF39286901,258.39,0.0,144576.08
2019-10-28,2019-10-28,Training/conference,REF17134548,180.32,0.0,144395.76
2019-10-30,2019-10-30,Business travel,REF83833108,484.49,0.0,143911.27
2019-11-07,2019-11-07,Marketing expenses,REF93050756,448.65,0.0,143462.62
2019-11-08,2019-11-08,Business travel,REF17916843,535.65,0.0,142926.97
2019-11-11,2019-11-11,Coworking space rental,REF27424571,268.27,0.0,142658.7
2019-11-12,2019-11-12,Business meal,REF28504853,186.71,0.0,142471.99
2019-11-15,2019-11-15,Project payment - Tran Inc,REF74187129,0.0,720.96,143192.95
2019-11-15,2019-11-15,Invoice payment - Griffin-Ortega,REF72192327,0.0,308.2,143501.15
2019-11-15,2019-11-15,Invoice payment - Wheeler PLC,REF53369985,0.0,624.86,144126.01
2019-11-15,2019-11-15,Project payment - Thompson-Baker,REF43845778,0.0,800.0,144926.01
2019-11-15,2019-11-15,"Invoice payment - Gould, Moran and Thomas",REF84707647,0.0,825.38,145751.39
2019-11-15,2019-11-15,Business insurance premium,REF87424083,158.7,0.0,145592.69
2019-11-17,2019-11-17,Marketing expenses,REF90151824,214.41,0.0,145378.28
2019-11-18,2019-11-18,Business meal,REF60031480,230.52,0.0,145147.76
2019-11-21,2019-11-21,Professional software license,REF21055882,226.96,0.0,144920.8
2019-11-22,2019-11-22,Accounting expense,REF17235910,89.51,0.0,144831.29
2019-11-24,2019-11-24,Coworking space rental,REF46886352,386.73,0.0,144444.56
2019-11-25,2019-11-25,Equipment purchase,REF75478532,130.94,0.0,144313.62
2019-11-25,2019-11-25,Business travel,REF64111638,316.13,0.0,143997.49
2019-11-28,2019-11-28,Accounting expense,REF95983349,175.01,0.0,143822.48
2019-11-28,2019-11-28,Business travel,REF86517292,362.89,0.0,143459.59
2019-12-03,2019-12-03,Coworking space rental,REF33460816,316.46,0.0,143143.13
2019-12-15,2019-12-15,Business insurance premium,REF77186824,123.5,0.0,143019.63
2019-12-15,2019-12-15,Project payment - Griffin-Ortega,REF19770201,0.0,292.48,143312.11
2019-12-15,2019-12-15,"Invoice payment - Andrews, Stanton and Hines",REF20939925,0.0,479.53,143791.64
2019-12-15,2019-12-15,Payment from Keller-Stewart,REF61157272,0.0,479.16,144270.8
2019-12-15,2019-12-15,Project payment - Thompson-Baker,REF69859190,0.0,804.82,145075.62
2019-12-15,2019-12-15,Invoice payment - Wheeler PLC,REF29107800,0.0,448.65,145524.27
2019-12-15,2019-12-15,Service payment - Tran Inc,REF72406095,0.0,405.57,145929.84
2019-12-15,2019-12-15,Project payment - Hayes-Mclean,REF65310038,0.0,721.79,146651.63
2019-12-16,2019-12-16,Accounting expense,REF60141936,240.52,0.0,146411.11
2019-12-18,2019-12-18,Business meal,REF94263922,290.66,0.0,146120.45
2019-12-20,2019-12-20,Business meal,REF95512013,278.56,0.0,145841.89
2019-12-21,2019-12-21,Accounting expense,REF14818705,262.45,0.0,145579.44
2019-12-21,2019-12-21,Professional software license,REF93017116,190.08,0.0,145389.36
2020-01-04,2020-01-04,Equipment purchase,REF43704617,204.18,0.0,145185.18
2020-01-04,2020-01-04,Marketing expenses,REF59417202,473.11,0.0,144712.07
2020-01-08,2020-01-08,Business meal,REF73064892,425.49,0.0,144286.58
2020-01-10,2020-01-10,Business meal,REF24904732,208.93,0.0,144077.65
2020-01-11,2020-01-11,Marketing expenses,REF74655922,321.86,0.0,143755.79
2020-01-15,2020-01-15,Business insurance premium,REF68267920,179.73,0.0,143576.06
2020-01-15,2020-01-15,Service payment - Griffin-Ortega,REF33002269,0.0,244.92,143820.98
2020-01-15,2020-01-15,Service payment - Thompson-Baker,REF46026637,0.0,959.44,144780.42
2020-01-15,2020-01-15,Payment from Tran Inc,REF15334162,0.0,790.05,145570.47
2020-01-15,2020-01-15,Payment from Hayes-Mclean,REF45977671,0.0,842.06,146412.53
2020-01-15,2020-01-15,"Service payment - Andrews, Stanton and Hines",REF88050444,0.0,604.79,147017.32
2020-01-15,2020-01-15,Project payment - Keller-Stewart,REF84300724,0.0,737.42,147754.74
2020-01-15,2020-01-15,Service payment - Wheeler PLC,REF81965237,0.0,777.05,148531.79
2020-01-15,2020-01-15,"Payment from Gould, Moran and Thomas",REF73294472,0.0,1095.11,149626.9
2020-01-16,2020-01-16,Business meal,REF77016217,226.09,0.0,149400.81
2020-01-21,2020-01-21,Professional software license,REF92260445,250.37,0.0,149150.44
2020-01-22,2020-01-22,Business meal,REF57772315,234.66,0.0,148915.78
2020-01-30,2020-01-30,Coworking space rental,REF39021448,283.11,0.0,148632.67
2020-02-03,2020-02-03,Marketing expenses,REF22379665,260.88,0.0,148371.79
2020-02-05,2020-02-05,Business travel,REF82961414,364.11,0.0,148007.68
2020-02-09,2020-02-09,Business travel,REF18007843,345.75,0.0,147661.93
2020-02-12,2020-02-12,Marketing expenses,REF19634497,318.81,0.0,147343.12
2020-02-15,2020-02-15,Invoice payment - Griffin-Ortega,REF26397414,0.0,371.96,147715.08
2020-02-15,2020-02-15,"Payment from Gould, Moran and Thomas",REF89300134,0.0,1059.01,148774.09
2020-02-15,2020-02-15,Service payment - Keller-Stewart,REF62287368,0.0,572.82,149346.91
2020-02-15,2020-02-15,Project payment - Wheeler PLC,REF32703733,0.0,867.5,150214.41
2020-02-15,2020-02-15,"Service payment - Andrews, Stanton and Hines",REF13783177,0.0,556.21,150770.62
2020-02-15,2020-02-15,Invoice payment - Tran Inc,REF82904255,0.0,534.61,151305.23
2020-02-15,2020-02-15,Invoice payment - Thompson-Baker,REF57856481,0.0,690.39,151995.62
2020-02-15,2020-02-15,Business insurance premium,REF87215400,146.68,0.0,151848.94
2020-02-15,2020-02-15,Service payment - Hayes-Mclean,REF98838117,0.0,735.55,152584.49
2020-02-16,2020-02-16,Equipment purchase,REF54631839,207.45,0.0,152377.04
2020-02-19,2020-02-19,Business meal,REF72025127,215.97,0.0,152161.07
2020-02-21,2020-02-21,Professional software license,REF54594496,212.8,0.0,151948.27
2020-02-25,2020-02-25,Business meal,REF76695527,351.42,0.0,151596.85
2020-02-25,2020-02-25,Business travel,REF46066794,348.08,0.0,151248.77
2020-02-28,2020-02-28,Business meal,REF53142146,365.86,0.0,150882.91
2020-02-29,2020-02-29,Coworking space rental,REF66729927,298.07,0.0,150584.84
2020-03-02,2020-03-02,Equipment purchase,REF20019290,160.89,0.0,150423.95
2020-03-03,2020-03-03,Marketing expenses,REF83929850,286.39,0.0,150137.56
2020-03-10,2020-03-10,Business travel,REF12676798,454.05,0.0,149683.51
2020-03-11,2020-03-11,Business meal,REF78582143,266.07,0.0,149417.44
2020-03-12,2020-03-12,Business meal,REF25908543,183.36,0.0,149234.08
2020-03-13,2020-03-13,Business travel,REF66857930,145.22,0.0,149088.86
2020-03-15,2020-03-15,Service payment - Thompson-Baker,REF14192825,0.0,1010.8,150099.66
2020-03-15,2020-03-15,Invoice payment - Wheeler PLC,REF70635317,0.0,656.64,150756.3
2020-03-15,2020-03-15,"Service payment - Andrews, Stanton and Hines",REF55505697,0.0,531.9,151288.2
2020-03-15,2020-03-15,Invoice payment - Keller-Stewart,REF27056034,0.0,637.44,151925.64
2020-03-15,2020-03-15,Invoice payment - Griffin-Ortega,REF47697651,0.0,310.55,152236.19
2020-03-15,2020-03-15,"Service payment - Gould, Moran and Thomas",REF97279457,0.0,825.78,153061.97
2020-03-15,2020-03-15,Invoice payment - Tran Inc,REF83397394,0.0,574.47,153636.44
2020-03-15,2020-03-15,Payment from Hayes-Mclean,REF41829307,0.0,604.07,154240.51
2020-03-15,2020-03-15,Business travel,REF29849803,418.84,0.0,153821.67
2020-03-15,2020-03-15,Business insurance premium,REF68787924,136.88,0.0,153684.79
2020-03-20,2020-03-20,Business travel,REF50680529,559.09,0.0,153125.7
2020-03-21,2020-03-21,Professional software license,REF40950100,209.71,0.0,152915.99
2020-03-24,2020-03-24,Marketing expenses,REF27027981,400.63,0.0,152515.36
2020-03-29,2020-03-29,Business travel,REF86454375,397.26,0.0,152118.1
2020-03-29,2020-03-29,Training/conference,REF62290958,176.42,0.0,151941.68
2020-04-04,2020-04-04,Business travel,REF32170778,307.51,0.0,151634.17
2020-04-09,2020-04-09,Accounting expense,REF39281605,215.03,0.0,151419.14
2020-04-11,2020-04-11,Equipment purchase,REF23238497,161.58,0.0,151257.56
2020-04-15,2020-04-15,Project payment - Wheeler PLC,REF35009235,0.0,650.34,151907.9
2020-04-15,2020-04-15,Service payment - Thompson-Baker,REF98452244,0.0,779.13,152687.03
2020-04-15,2020-04-15,"Payment from Gould, Moran and Thomas",REF21924185,0.0,1059.03,153746.06
2020-04-15,2020-04-15,Business insurance premium,REF18775358,135.7,0.0,153610.36
2020-04-15,2020-04-15,Payment from Hayes-Mclean,REF73936176,0.0,705.74,154316.1
2020-04-15,2020-04-15,Service payment - Keller-Stewart,REF43286141,0.0,583.07,154899.17
2020-04-15,2020-04-15,Invoice payment - Griffin-Ortega,REF96565919,0.0,331.04,155230.21
2020-04-16,2020-04-16,Business travel,REF53889176,557.34,0.0,154672.87
2020-04-20,2020-04-20,Business meal,REF63112200,176.05,0.0,154496.82
2020-04-21,2020-04-21,Professional software license,REF73943253,182.42,0.0,154314.4
2020-04-21,2020-04-21,Marketing expenses,REF22710178,247.96,0.0,154066.44
2020-04-23,2020-04-23,Training/conference,REF92596425,129.16,0.0,153937.28
2020-04-24,2020-04-24,Training/conference,REF79229695,180.95,0.0,153756.33
2020-04-29,2020-04-29,Marketing expenses,REF33813545,273.66,0.0,153482.67
2020-04-29,2020-04-29,Business meal,REF70210863,218.11,0.0,153264.56
2020-05-02,2020-05-02,Accounting expense,REF88514292,235.05,0.0,153029.51
2020-05-03,2020-05-03,Business meal,REF69169355,204.24,0.0,152825.27
2020-05-06,2020-05-06,Business meal,REF57592523,224.61,0.0,152600.66
2020-05-14,2020-05-14,Business travel,REF18328492,311.29,0.0,152289.37
2020-05-15,2020-05-15,Business insurance premium,REF43421223,116.07,0.0,152173.3
2020-05-15,2020-05-15,Project payment - Keller-Stewart,REF47645641,0.0,530.0,152703.3
2020-05-15,2020-05-15,Invoice payment - Griffin-Ortega,REF47623684,0.0,230.62,152933.92
2020-05-15,2020-05-15,Project payment - Thompson-Baker,REF39659150,0.0,708.23,153642.15
2020-05-15,2020-05-15,"Project payment - Gould, Moran and Thomas",REF16393813,0.0,701.67,154343.82
2020-05-15,2020-05-15,Project payment - Tran Inc,REF43128372,0.0,524.1,154867.92
2020-05-15,2020-05-15,Invoice payment - Wheeler PLC,REF30756417,0.0,665.38,155533.3
2020-05-15,2020-05-15,"Invoice payment - Andrews, Stanton and Hines",REF70414588,0.0,545.41,156078.71
2020-05-16,2020-05-16,Accounting expense,REF99101687,121.48,0.0,155957.23
2020-05-21,2020-05-21,Professional software license,REF78718367,176.21,0.0,155781.02
2020-05-21,2020-05-21,Equipment purchase,REF37246074,139.97,0.0,155641.05
2020-05-28,2020-05-28,Business meal,REF97574052,161.44,0.0,155479.61
2020-05-30,2020-05-30,Business meal,REF95572939,200.27,0.0,155279.34
2020-06-08,2020-06-08,Accounting expense,REF51939609,173.76,0.0,155105.58
2020-06-10,2020-06-10,Business meal,REF22822006,236.67,0.0,154868.91
2020-06-12,2020-06-12,Business travel,REF32747384,270.13,0.0,154598.78
2020-06-15,2020-06-15,Business insurance premium,REF44798007,116.89,0.0,154481.89
2020-06-15,2020-06-15,Service payment - Hayes-Mclean,REF71838710,0.0,663.9,155145.79
2020-06-15,2020-06-15,"Invoice payment - Gould, Moran and Thomas",REF12720163,0.0,736.17,155881.96
2020-06-15,2020-06-15,Payment from Wheeler PLC,REF92241504,0.0,528.57,156410.53
2020-06-15,2020-06-15,"Service payment - Andrews, Stanton and Hines",REF95368327,0.0,471.54,156882.07
2020-06-15,2020-06-15,Invoice payment - Thompson-Baker,REF34022104,0.0,727.3,157609.37
2020-06-15,2020-06-15,Project payment - Keller-Stewart,REF46704554,0.0,346.14,157955.51
2020-06-15,2020-06-15,Payment from Tran Inc,REF66912748,0.0,509.08,158464.59
2020-06-15,2020-06-15,Service payment - Griffin-Ortega,REF93007967,0.0,256.74,158721.33
2020-06-17,2020-06-17,Business meal,REF89039952,276.41,0.0,158444.92
2020-06-17,2020-06-17,Marketing expenses,REF97443695,291.15,0.0,158153.77
2020-06-20,2020-06-20,Marketing expenses,REF56670530,189.55,0.0,157964.22
2020-06-21,2020-06-21,Professional software license,REF41471807,160.9,0.0,157803.32
2020-06-22,2020-06-22,Business travel,REF79574482,371.41,0.0,157431.91
2020-06-23,2020-06-23,Coworking space rental,REF49287984,231.25,0.0,157200.66
2020-07-07,2020-07-07,Training/conference,REF25727944,201.87,0.0,156998.79
2020-07-08,2020-07-08,Equipment purchase,REF30441316,171.66,0.0,156827.13
2020-07-15,2020-07-15,Project payment - Wheeler PLC,REF70400813,0.0,527.1,157354.23
2020-07-15,2020-07-15,"Project payment - Gould, Moran and Thomas",REF76494927,0.0,633.33,157987.56
2020-07-15,2020-07-15,"Project payment - Andrews, Stanton and Hines",REF63786778,0.0,383.08,158370.64
2020-07-15,2020-07-15,Business insurance premium,REF71002106,99.85,0.0,158270.79
2020-07-15,2020-07-15,Payment from Keller-Stewart,REF98083593,0.0,347.81,158618.6
2020-07-15,2020-07-15,Project payment - Thompson-Baker,REF64660221,0.0,441.98,159060.58
2020-07-15,2020-07-15,Project payment - Hayes-Mclean,REF72325207,0.0,461.46,159522.04
2020-07-16,2020-07-16,Business meal,REF99171217,153.15,0.0,159368.89
2020-07-18,2020-07-18,Business meal,REF77087191,122.42,0.0,159246.47
2020-07-21,2020-07-21,Professional software license,REF96072608,151.11,0.0,159095.36
2020-07-25,2020-07-25,Training/conference,REF79923199,260.85,0.0,158834.51
2020-08-01,2020-08-01,Accounting expense,REF38534082,76.5,0.0,158758.01
2020-08-03,2020-08-03,Coworking space rental,REF63090693,262.42,0.0,158495.59
2020-08-11,2020-08-11,Business travel,REF63990941,366.51,0.0,158129.08
2020-08-13,2020-08-13,Business meal,REF26911017,329.13,0.0,157799.95
2020-08-15,2020-08-15,Invoice payment - Wheeler PLC,REF50038269,0.0,483.53,158283.48
2020-08-15,2020-08-15,Business insurance premium,REF14375035,110.2,0.0,158173.28
2020-08-15,2020-08-15,"Project payment - Andrews, Stanton and Hines",REF79591539,0.0,401.63,158574.91
2020-08-15,2020-08-15,Invoice payment - Griffin-Ortega,REF50326780,0.0,250.34,158825.25
2020-08-15,2020-08-15,Invoice payment - Keller-Stewart,REF14869175,0.0,424.84,159250.09
2020-08-15,2020-08-15,Payment from Hayes-Mclean,REF71772626,0.0,657.33,159907.42
2020-08-15,2020-08-15,Payment from Thompson-Baker,REF54754387,0.0,702.22,160609.64
2020-08-15,2020-08-15,"Service payment - Gould, Moran and Thomas",REF70764620,0.0,813.69,161423.33
2020-08-15,2020-08-15,Project payment - Tran Inc,REF61493104,0.0,472.48,161895.81
2020-08-18,2020-08-18,Training/conference,REF76565468,107.59,0.0,161788.22
2020-08-21,2020-08-21,Professional software license,REF15718782,180.79,0.0,161607.43
2020-08-24,2020-08-24,Accounting expense,REF70578613,245.55,0.0,161361.88
2020-08-25,2020-08-25,Business meal,REF99558832,126.31,0.0,161235.57
2020-08-29,2020-08-29,Business meal,REF28479680,189.29,0.0,161046.28
2020-09-05,2020-09-05,Business meal,REF13343494,199.01,0.0,160847.27
2020-09-05,2020-09-05,Business travel,REF83481023,607.2,0.0,160240.07
2020-09-10,2020-09-10,Training/conference,REF89089486,149.2,0.0,160090.87
2020-09-10,2020-09-10,Business meal,REF38327027,319.46,0.0,159771.41
2020-09-15,2020-09-15,Business insurance premium,REF32888153,139.68,0.0,159631.73
2020-09-15,2020-09-15,Equipment purchase,REF46598349,265.58,0.0,159366.15
2020-09-15,2020-09-15,Invoice payment - Wheeler PLC,REF67283476,0.0,602.15,159968.3
2020-09-15,2020-09-15,Invoice payment - Tran Inc,REF37721164,0.0,904.21,160872.51
2020-09-15,2020-09-15,"Project payment - Gould, Moran and Thomas",REF27632717,0.0,807.5,161680.01
2020-09-15,2020-09-15,Project payment - Keller-Stewart,REF38443512,0.0,296.39,161976.4
2020-09-15,2020-09-15,Service payment - Griffin-Ortega,REF30652111,0.0,308.71,162285.11
2020-09-15,2020-09-15,Project payment - Hayes-Mclean,REF70158885,0.0,661.31,162946.42
2020-09-15,2020-09-15,Invoice payment - Thompson-Baker,REF11028864,0.0,1012.51,163958.93
2020-09-15,2020-09-15,"Payment from Andrews, Stanton and Hines",REF91268722,0.0,641.9,164600.83
2020-09-19,2020-09-19,Equipment purchase,REF95691761,230.31,0.0,164370.52
2020-09-20,2020-09-20,Coworking space rental,REF82618235,308.48,0.0,164062.04
2020-09-20,2020-09-20,Business travel,REF90805870,62.38,0.0,163999.66
2020-09-21,2020-09-21,Professional software license,REF32713595,222.32,0.0,163777.34
2020-09-24,2020-09-24,Business travel,REF25065802,682.27,0.0,163095.07
2020-09-25,2020-09-25,Accounting expense,REF47165257,247.21,0.0,162847.86
2020-09-25,2020-09-25,Business travel,REF97456641,826.95,0.0,162020.91
2020-09-28,2020-09-28,Accounting expense,REF37442390,207.39,0.0,161813.52
2020-09-28,2020-09-28,Business travel,REF91523832,332.16,0.0,161481.36
2020-10-02,2020-10-02,Business travel,REF90306864,324.92,0.0,161156.44
2020-10-14,2020-10-14,Equipment purchase,REF49640101,121.67,0.0,161034.77
2020-10-15,2020-10-15,Service payment - Thompson-Baker,REF78884569,0.0,1005.56,162040.33
2020-10-15,2020-10-15,Service payment - Griffin-Ortega,REF45529535,0.0,359.83,162400.16
2020-10-15,2020-10-15,Business insurance premium,REF43354260,157.95,0.0,162242.21
2020-10-15,2020-10-15,"Payment from Gould, Moran and Thomas",REF28176947,0.0,866.51,163108.72
2020-10-15,2020-10-15,Payment from Hayes-Mclean,REF50268384,0.0,924.45,164033.17
2020-10-15,2020-10-15,"Invoice payment - Andrews, Stanton and Hines",REF34087868,0.0,527.05,164560.22
2020-10-15,2020-10-15,Project payment - Keller-Stewart,REF93581691,0.0,584.78,165145.0
2020-10-15,2020-10-15,Business meal,REF56299810,308.42,0.0,164836.58
2020-10-15,2020-10-15,Project payment - Wheeler PLC,REF79806991,0.0,717.4,165553.98
2020-10-15,2020-10-15,Service payment - Tran Inc,REF78977087,0.0,760.85,166314.83
2020-10-17,2020-10-17,Business travel,REF15032551,650.21,0.0,165664.62
2020-10-21,2020-10-21,Professional software license,REF32715260,211.54,0.0,165453.08
2020-10-21,2020-10-21,Coworking space rental,REF28414946,435.29,0.0,165017.79
2020-10-21,2020-10-21,Training/conference,REF35911169,180.29,0.0,164837.5
2020-10-22,2020-10-22,Accounting expense,REF57596925,226.25,0.0,164611.25
2020-11-10,2020-11-10,Business travel,REF61381714,257.32,0.0,164353.93
2020-11-15,2020-11-15,Service payment - Griffin-Ortega,REF99112087,0.0,302.3,164656.23
2020-11-15,2020-11-15,Project payment - Hayes-Mclean,REF36359286,0.0,655.89,165312.12
2020-11-15,2020-11-15,"Payment from Andrews, Stanton and Hines",REF60939794,0.0,555.48,165867.6
2020-11-15,2020-11-15,"Invoice payment - Gould, Moran and Thomas",REF92686677,0.0,1027.25,166894.85
2020-11-15,2020-11-15,Project payment - Keller-Stewart,REF47666622,0.0,715.6,167610.45
2020-11-15,2020-11-15,Project payment - Thompson-Baker,REF22972982,0.0,652.68,168263.13
2020-11-15,2020-11-15,Project payment - Wheeler PLC,REF78326227,0.0,793.29,169056.42
2020-11-15,2020-11-15,Service payment - Tran Inc,REF27947571,0.0,848.29,169904.71
2020-11-15,2020-11-15,Business insurance premium,REF37066809,153.78,0.0,169750.93
2020-11-17,2020-11-17,Business travel,REF40409346,311.21,0.0,169439.72
2020-11-21,2020-11-21,Professional software license,REF10666962,238.06,0.0,169201.66
2020-11-23,2020-11-23,Business travel,REF59186075,455.5,0.0,168746.16
2020-11-27,2020-11-27,Business travel,REF29862642,362.68,0.0,168383.48
2020-11-27,2020-11-27,Business meal,REF32642327,142.02,0.0,168241.46
2020-11-29,2020-11-29,Business meal,REF24719716,320.47,0.0,167920.99
2020-12-03,2020-12-03,Business travel,REF50851214,472.84,0.0,167448.15
2020-12-09,2020-12-09,Coworking space rental,REF26479422,282.16,0.0,167165.99
2020-12-11,2020-12-11,Business travel,REF95572535,544.29,0.0,166621.7
2020-12-12,2020-12-12,Business meal,REF27619146,238.37,0.0,166383.33
2020-12-15,2020-12-15,Project payment - Hayes-Mclean,REF50274085,0.0,784.22,167167.55
2020-12-15,2020-12-15,"Project payment - Gould, Moran and Thomas",REF99783553,0.0,850.52,168018.07
2020-12-15,2020-12-15,Invoice payment - Tran Inc,REF11677194,0.0,596.69,168614.76
2020-12-15,2020-12-15,"Project payment - Andrews, Stanton and Hines",REF29009977,0.0,468.26,169083.02
2020-12-15,2020-12-15,Payment from Wheeler PLC,REF11257176,0.0,660.35,169743.37
2020-12-15,2020-12-15,Invoice payment - Griffin-Ortega,REF39413799,0.0,261.22,170004.59
2020-12-15,2020-12-15,Payment from Thompson-Baker,REF24568790,0.0,769.84,170774.43
2020-12-15,2020-12-15,Equipment purchase,REF34918509,145.54,0.0,170628.89
2020-12-15,2020-12-15,Project payment - Keller-Stewart,REF30952779,0.0,415.2,171044.09
2020-12-15,2020-12-15,Business insurance premium,REF41691413,109.17,0.0,170934.92
2020-12-15,2020-12-15,Coworking space rental,REF59315403,266.43,0.0,170668.49
2020-12-16,2020-12-16,Equipment purchase,REF41685675,140.02,0.0,170528.47
2020-12-20,2020-12-20,Training/conference,REF64285772,82.01,0.0,170446.46
2020-12-21,2020-12-21,Professional software license,REF65001473,176.46,0.0,170270.0
2020-12-21,2020-12-21,Training/conference,REF43670467,271.15,0.0,169998.85
2020-12-25,2020-12-25,Business meal,REF35727569,272.13,0.0,169726.72
2020-12-25,2020-12-25,Business travel,REF48048615,300.63,0.0,169426.09
2020-12-27,2020-12-27,Business travel,REF99377921,483.37,0.0,168942.72
2020-12-27,2020-12-27,Equipment purchase,REF35843588,120.81,0.0,168821.91
2021-01-03,2021-01-03,Marketing expenses,REF50115808,570.75,0.0,168251.16
2021-01-07,2021-01-07,Business travel,REF26959058,538.94,0.0,167712.22
2021-01-09,2021-01-09,Coworking space rental,REF91647435,494.67,0.0,167217.55
2021-01-11,2021-01-11,Training/conference,REF48562478,248.96,0.0,166968.59
2021-01-15,2021-01-15,"Invoice payment - Andrews, Stanton and Hines",REF34671095,0.0,495.03,167463.62
2021-01-15,2021-01-15,Invoice payment - Thompson-Baker,REF20857807,0.0,1013.97,168477.59
2021-01-15,2021-01-15,Project payment - Hayes-Mclean,REF47348515,0.0,867.69,169345.28
2021-01-15,2021-01-15,Payment from Keller-Stewart,REF40918380,0.0,701.72,170047.0
2021-01-15,2021-01-15,Business insurance premium,REF67833801,165.46,0.0,169881.54
2021-01-15,2021-01-15,"Invoice payment - Gould, Moran and Thomas",REF87706230,0.0,1058.52,170940.06
2021-01-15,2021-01-15,Service payment - Wheeler PLC,REF17974332,0.0,644.22,171584.28
2021-01-15,2021-01-15,Service payment - Griffin-Ortega,REF87878612,0.0,330.47,171914.75
2021-01-15,2021-01-15,Project payment - Tran Inc,REF49364294,0.0,904.03,172818.78
2021-01-20,2021-01-20,Marketing expenses,REF40542085,272.33,0.0,172546.45
2021-01-21,2021-01-21,Business travel,REF98535194,758.46,0.0,171787.99
2021-01-21,2021-01-21,Professional software license,REF23183219,255.18,0.0,171532.81
2021-01-24,2021-01-24,Business travel,REF68884327,629.24,0.0,170903.57
2021-01-25,2021-01-25,Business meal,REF53964253,264.86,0.0,170638.71
2021-01-29,2021-01-29,Business travel,REF29722296,475.74,0.0,170162.97
2021-02-09,2021-02-09,Business travel,REF27721979,374.88,0.0,169788.09
2021-02-15,2021-02-15,Business insurance premium,REF93240890,152.25,0.0,169635.84
2021-02-15,2021-02-15,Invoice payment - Keller-Stewart,REF50740871,0.0,733.18,170369.02
2021-02-15,2021-02-15,Service payment - Wheeler PLC,REF14107687,0.0,803.93,171172.95
2021-02-15,2021-02-15,Payment from Tran Inc,REF17081863,0.0,584.93,171757.88
2021-02-15,2021-02-15,Invoice payment - Hayes-Mclean,REF28470131,0.0,774.4,172532.28
2021-02-15,2021-02-15,Payment from Griffin-Ortega,REF98428667,0.0,326.76,172859.04
2021-02-15,2021-02-15,"Project payment - Andrews, Stanton and Hines",REF32329405,0.0,629.71,173488.75
2021-02-15,2021-02-15,Service payment - Thompson-Baker,REF29956980,0.0,686.17,174174.92
2021-02-15,2021-02-15,"Service payment - Gould, Moran and Thomas",REF86322013,0.0,985.12,175160.04
2021-02-21,2021-02-21,Professional software license,REF63757983,213.38,0.0,174946.66
2021-02-26,2021-02-26,Business meal,REF17756998,131.09,0.0,174815.57
2021-02-27,2021-02-27,Equipment purchase,REF85412849,115.06,0.0,174700.51
2021-03-03,2021-03-03,Equipment purchase,REF36465667,143.63,0.0,174556.88
2021-03-05,2021-03-05,Business travel,REF61432918,398.35,0.0,174158.53
2021-03-05,2021-03-05,Coworking space rental,REF41088373,300.1,0.0,173858.43
2021-03-06,2021-03-06,Accounting expense,REF75410646,212.79,0.0,173645.64
2021-03-06,2021-03-06,Business meal,REF16518592,215.48,0.0,173430.16
2021-03-07,2021-03-07,Business travel,REF24045327,396.03,0.0,173034.13
2021-03-08,2021-03-08,Equipment purchase,REF98726403,83.72,0.0,172950.41
2021-03-09,2021-03-09,Coworking space rental,REF20098056,363.55,0.0,172586.86
2021-03-11,2021-03-11,Business meal,REF64310743,219.15,0.0,172367.71
2021-03-12,2021-03-12,Business meal,REF44753727,282.67,0.0,172085.04
2021-03-15,2021-03-15,Business insurance premium,REF73740659,142.63,0.0,171942.41
2021-03-15,2021-03-15,"Project payment - Gould, Moran and Thomas",REF48976062,0.0,678.28,172620.69
2021-03-15,2021-03-15,"Project payment - Andrews, Stanton and Hines",REF72354494,0.0,576.67,173197.36
2021-03-15,2021-03-15,Business travel,REF97671330,441.25,0.0,172756.11
2021-03-15,2021-03-15,Service payment - Tran Inc,REF58933179,0.0,720.89,173477.0
2021-03-15,2021-03-15,Invoice payment - Griffin-Ortega,REF45672117,0.0,353.76,173830.76
2021-03-15,2021-03-15,Service payment - Thompson-Baker,REF95461769,0.0,897.44,174728.2
2021-03-15,2021-03-15,Payment from Wheeler PLC,REF69594740,0.0,557.98,175286.18
2021-03-15,2021-03-15,Payment from Keller-Stewart,REF82074528,0.0,668.05,175954.23
2021-03-15,2021-03-15,Invoice payment - Hayes-Mclean,REF42001539,0.0,642.92,176597.15
2021-03-16,2021-03-16,Business meal,REF99729487,328.34,0.0,176268.81
2021-03-20,2021-03-20,Training/conference,REF40923368,232.06,0.0,176036.75
2021-03-21,2021-03-21,Professional software license,REF90348860,194.13,0.0,175842.62
2021-03-22,2021-03-22,Business meal,REF67683262,157.69,0.0,175684.93
2021-03-26,2021-03-26,Business travel,REF56583746,365.82,0.0,175319.11
2021-04-03,2021-04-03,Marketing expenses,REF81775567,255.05,0.0,175064.06
2021-04-05,2021-04-05,Coworking space rental,REF62286747,357.54,0.0,174706.52
2021-04-15,2021-04-15,Business insurance premium,REF70890252,152.14,0.0,174554.38
2021-04-15,2021-04-15,Business meal,REF98821354,259.69,0.0,174294.69
2021-04-15,2021-04-15,Payment from Tran Inc,REF45775032,0.0,833.51,175128.2
2021-04-15,2021-04-15,"Project payment - Andrews, Stanton and Hines",REF15893293,0.0,399.53,175527.73
2021-04-15,2021-04-15,Invoice payment - Griffin-Ortega,REF21158030,0.0,309.07,175836.8
2021-04-15,2021-04-15,Service payment - Thompson-Baker,REF68873431,0.0,901.73,176738.53
2021-04-15,2021-04-15,Service payment - Keller-Stewart,REF32578438,0.0,607.72,177346.25
2021-04-15,2021-04-15,Invoice payment - Wheeler PLC,REF41357082,0.0,698.92,178045.17
2021-04-15,2021-04-15,"Project payment - Gould, Moran and Thomas",REF98633325,0.0,1052.14,179097.31
2021-04-15,2021-04-15,Payment from Hayes-Mclean,REF33979630,0.0,756.28,179853.59
2021-04-20,2021-04-20,Business meal,REF95140188,181.98,0.0,179671.61
2021-04-21,2021-04-21,Professional software license,REF72961999,176.23,0.0,179495.38
2021-04-24,2021-04-24,Business meal,REF97541499,285.91,0.0,179209.47
2021-04-24,2021-04-24,Equipment purchase,REF83001146,175.19,0.0,179034.28
2021-05-02,2021-05-02,Business meal,REF39340529,187.71,0.0,178846.57
2021-05-05,2021-05-05,Training/conference,REF42553887,160.98,0.0,178685.59
2021-05-06,2021-05-06,Coworking space rental,REF10846350,328.37,0.0,178357.22
2021-05-07,2021-05-07,Training/conference,REF18888079,164.3,0.0,178192.92
2021-05-15,2021-05-15,"Payment from Gould, Moran and Thomas",REF78742044,0.0,893.8,179086.72
2021-05-15,2021-05-15,Invoice payment - Wheeler PLC,REF55457664,0.0,661.89,179748.61
2021-05-15,2021-05-15,Project payment - Hayes-Mclean,REF39025344,0.0,528.93,180277.54
2021-05-15,2021-05-15,Payment from Keller-Stewart,REF30014982,0.0,532.09,180809.63
2021-05-15,2021-05-15,Invoice payment - Tran Inc,REF60543439,0.0,485.65,181295.28
2021-05-15,2021-05-15,Business insurance premium,REF15485433,130.54,0.0,181164.74
2021-05-15,2021-05-15,"Payment from Andrews, Stanton and Hines",REF83346873,0.0,453.87,181618.61
2021-05-15,2021-05-15,Invoice payment - Thompson-Baker,REF33432030,0.0,787.91,182406.52
2021-05-17,2021-05-17,Marketing expenses,REF47330000,302.9,0.0,182103.62
2021-05-19,2021-05-19,Coworking space rental,REF36260577,316.4,0.0,181787.22
2021-05-21,2021-05-21,Professional software license,REF65922601,215.41,0.0,181571.81
2021-05-22,2021-05-22,Accounting expense,REF23737157,207.16,0.0,181364.65
2021-05-23,2021-05-23,Marketing expenses,REF92283603,49.56,0.0,181315.09
2021-05-27,2021-05-27,Accounting expense,REF14206283,84.98,0.0,181230.11
2021-05-29,2021-05-29,Coworking space rental,REF79861481,177.11,0.0,181053.0
2021-05-30,2021-05-30,Business meal,REF86639222,219.4,0.0,180833.6
2021-06-04,2021-06-04,Business travel,REF32064900,491.74,0.0,180341.86
2021-06-04,2021-06-04,Coworking space rental,REF50235841,132.49,0.0,180209.37
2021-06-06,2021-06-06,Business travel,REF21637405,395.79,0.0,179813.58
2021-06-06,2021-06-06,Marketing expenses,REF99880573,284.76,0.0,179528.82
2021-06-07,2021-06-07,Coworking space rental,REF25390866,203.57,0.0,179325.25
2021-06-15,2021-06-15,"Payment from Andrews, Stanton and Hines",REF99896087,0.0,439.19,179764.44
2021-06-15,2021-06-15,Business insurance premium,REF59081120,106.66,0.0,179657.78
2021-06-15,2021-06-15,Service payment - Hayes-Mclean,REF82414876,0.0,512.09,180169.87
2021-06-15,2021-06-15,Project payment - Thompson-Baker,REF19158356,0.0,459.26,180629.13
2021-06-15,2021-06-15,Payment from Wheeler PLC,REF18285368,0.0,621.85,181250.98
2021-06-15,2021-06-15,Payment from Griffin-Ortega,REF80145278,0.0,258.52,181509.5
2021-06-15,2021-06-15,"Project payment - Gould, Moran and Thomas",REF65420921,0.0,806.04,182315.54
2021-06-15,2021-06-15,Payment from Keller-Stewart,REF50412239,0.0,511.9,182827.44
2021-06-19,2021-06-19,Business meal,REF64069587,215.52,0.0,182611.92
2021-06-20,2021-06-20,Accounting expense,REF73171369,242.49,0.0,182369.43
2021-06-21,2021-06-21,Professional software license,REF68576254,162.81,0.0,182206.62
2021-07-07,2021-07-07,Business travel,REF90940395,291.39,0.0,181915.23
2021-07-10,2021-07-10,Business meal,REF53393184,176.69,0.0,181738.54
2021-07-14,2021-07-14,Business meal,REF13207146,137.78,0.0,181600.76
2021-07-15,2021-07-15,Invoice payment - Thompson-Baker,REF15270795,0.0,544.01,182144.77
2021-07-15,2021-07-15,Payment from Keller-Stewart,REF54812499,0.0,456.13,182600.9
2021-07-15,2021-07-15,Business insurance premium,REF60260674,97.75,0.0,182503.15
2021-07-15,2021-07-15,Service payment - Wheeler PLC,REF53796230,0.0,586.19,183089.34
2021-07-15,2021-07-15,Service payment - Griffin-Ortega,REF34327366,0.0,223.45,183312.79
2021-07-15,2021-07-15,"Payment from Andrews, Stanton and Hines",REF77577613,0.0,322.32,183635.11
2021-07-15,2021-07-15,"Project payment - Gould, Moran and Thomas",REF28881640,0.0,627.0,184262.11
2021-07-15,2021-07-15,Service payment - Tran Inc,REF46544310,0.0,537.78,184799.89
2021-07-15,2021-07-15,Payment from Hayes-Mclean,REF55519534,0.0,550.51,185350.4
2021-07-19,2021-07-19,Equipment purchase,REF43832643,155.73,0.0,185194.67
2021-07-21,2021-07-21,Coworking space rental,REF70546865,193.54,0.0,185001.13
2021-07-21,2021-07-21,Professional software license,REF76223041,140.06,0.0,184861.07
2021-07-21,2021-07-21,Accounting expense,REF63713315,99.92,0.0,184761.15
2021-07-26,2021-07-26,Marketing expenses,REF55307730,121.14,0.0,184640.01
2021-07-27,2021-07-27,Business travel,REF34433581,391.14,0.0,184248.87
2021-07-28,2021-07-28,Business meal,REF38833922,163.28,0.0,184085.59
2021-07-30,2021-07-30,Business travel,REF89708315,224.95,0.0,183860.64
2021-07-31,2021-07-31,Marketing expenses,REF61122036,199.5,0.0,183661.14
2021-08-05,2021-08-05,Business travel,REF99094140,426.62,0.0,183234.52
2021-08-08,2021-08-08,Business meal,REF39765653,267.24,0.0,182967.28
2021-08-14,2021-08-14,Coworking space rental,REF96163826,199.19,0.0,182768.09
2021-08-15,2021-08-15,Invoice payment - Tran Inc,REF19737409,0.0,526.22,183294.31
2021-08-15,2021-08-15,Business insurance premium,REF74948894,112.07,0.0,183182.24
2021-08-15,2021-08-15,"Payment from Andrews, Stanton and Hines",REF87165473,0.0,500.68,183682.92
2021-08-15,2021-08-15,Project payment - Thompson-Baker,REF33173495,0.0,653.13,184336.05
2021-08-15,2021-08-15,Payment from Griffin-Ortega,REF18949166,0.0,195.03,184531.08
2021-08-15,2021-08-15,Service payment - Wheeler PLC,REF40680655,0.0,454.03,184985.11
2021-08-15,2021-08-15,Service payment - Hayes-Mclean,REF31992303,0.0,439.14,185424.25
2021-08-15,2021-08-15,"Service payment - Gould, Moran and Thomas",REF91390919,0.0,736.21,186160.46
2021-08-15,2021-08-15,Service payment - Keller-Stewart,REF42924282,0.0,439.66,186600.12
2021-08-19,2021-08-19,Training/conference,REF12712662,207.86,0.0,186392.26
2021-08-21,2021-08-21,Business meal,REF41293551,244.24,0.0,186148.02
2021-08-21,2021-08-21,Professional software license,REF64984952,181.99,0.0,185966.03
2021-08-24,2021-08-24,Accounting expense,REF66224399,180.38,0.0,185785.65
2021-08-29,2021-08-29,Training/conference,REF58993260,200.99,0.0,185584.66
2021-09-04,2021-09-04,Accounting expense,REF64656449,197.02,0.0,185387.64
2021-09-05,2021-09-05,Business travel,REF60225255,430.75,0.0,184956.89
2021-09-09,2021-09-09,Business travel,REF62267720,497.13,0.0,184459.76
2021-09-10,2021-09-10,Equipment purchase,REF25432271,129.69,0.0,184330.07
2021-09-13,2021-09-13,Coworking space rental,REF23743247,354.57,0.0,183975.5
2021-09-15,2021-09-15,Payment from Keller-Stewart,REF60219739,0.0,495.27,184470.77
2021-09-15,2021-09-15,Service payment - Griffin-Ortega,REF80558334,0.0,255.79,184726.56
2021-09-15,2021-09-15,Business insurance premium,REF26861729,148.63,0.0,184577.93
2021-09-15,2021-09-15,Payment from Thompson-Baker,REF74019182,0.0,1108.57,185686.5
2021-09-15,2021-09-15,Payment from Hayes-Mclean,REF20528607,0.0,700.98,186387.48
2021-09-15,2021-09-15,"Project payment - Andrews, Stanton and Hines",REF60586641,0.0,558.73,186946.21
2021-09-15,2021-09-15,Payment from Tran Inc,REF72800653,0.0,687.04,187633.25
2021-09-15,2021-09-15,Invoice payment - Wheeler PLC,REF24219034,0.0,688.57,188321.82
2021-09-21,2021-09-21,Professional software license,REF26262222,189.1,0.0,188132.72
2021-09-23,2021-09-23,Business meal,REF42936149,271.8,0.0,187860.92
2021-09-28,2021-09-28,Business meal,REF79038817,402.91,0.0,187458.01
2021-10-04,2021-10-04,Business travel,REF37971102,581.86,0.0,186876.15
2021-10-06,2021-10-06,Marketing expenses,REF34011733,564.7,0.0,186311.45
2021-10-08,2021-10-08,Accounting expense,REF97758570,200.8,0.0,186110.65
2021-10-10,2021-10-10,Business travel,REF79531669,391.57,0.0,185719.08
2021-10-15,2021-10-15,Project payment - Wheeler PLC,REF46425089,0.0,729.65,186448.73
2021-10-15,2021-10-15,Payment from Tran Inc,REF21436388,0.0,776.53,187225.26
2021-10-15,2021-10-15,Payment from Hayes-Mclean,REF31471085,0.0,845.91,188071.17
2021-10-15,2021-10-15,Service payment - Griffin-Ortega,REF81586452,0.0,379.52,188450.69
2021-10-15,2021-10-15,Business insurance premium,REF63544464,154.66,0.0,188296.03
2021-10-15,2021-10-15,"Project payment - Andrews, Stanton and Hines",REF10694695,0.0,830.66,189126.69
2021-10-15,2021-10-15,Invoice payment - Thompson-Baker,REF13231303,0.0,995.13,190121.82
2021-10-15,2021-10-15,"Payment from Gould, Moran and Thomas",REF44790740,0.0,910.07,191031.89
2021-10-15,2021-10-15,Service payment - Keller-Stewart,REF97127607,0.0,542.38,191574.27
2021-10-16,2021-10-16,Coworking space rental,REF39845319,272.8,0.0,191301.47
2021-10-21,2021-10-21,Professional software license,REF73941118,234.53,0.0,191066.94
2021-10-23,2021-10-23,Business meal,REF48932059,304.04,0.0,190762.9
2021-10-25,2021-10-25,Accounting expense,REF39203921,162.07,0.0,190600.83
2021-10-26,2021-10-26,Business travel,REF61652285,660.98,0.0,189939.85
2021-10-29,2021-10-29,Equipment purchase,REF34701704,177.54,0.0,189762.31
2021-11-04,2021-11-04,Business meal,REF23615996,330.72,0.0,189431.59
2021-11-11,2021-11-11,Business meal,REF23127310,266.16,0.0,189165.43
2021-11-12,2021-11-12,Business meal,REF38257252,365.78,0.0,188799.65
2021-11-13,2021-11-13,Equipment purchase,REF64962111,212.5,0.0,188587.15
2021-11-13,2021-11-13,Accounting expense,REF27188957,139.81,0.0,188447.34
2021-11-14,2021-11-14,Accounting expense,REF21568960,106.11,0.0,188341.23
2021-11-15,2021-11-15,Invoice payment - Keller-Stewart,REF77948852,0.0,684.45,189025.68
2021-11-15,2021-11-15,Project payment - Griffin-Ortega,REF98488861,0.0,343.3,189368.98
2021-11-15,2021-11-15,"Project payment - Gould, Moran and Thomas",REF97455778,0.0,946.52,190315.5
2021-11-15,2021-11-15,"Invoice payment - Andrews, Stanton and Hines",REF40220470,0.0,511.24,190826.74
2021-11-15,2021-11-15,Service payment - Thompson-Baker,REF82050452,0.0,958.52,191785.26
2021-11-15,2021-11-15,Service payment - Hayes-Mclean,REF25160568,0.0,713.46,192498.72
2021-11-15,2021-11-15,Project payment - Tran Inc,REF23990600,0.0,806.22,193304.94
2021-11-15,2021-11-15,Project payment - Wheeler PLC,REF87693230,0.0,728.79,194033.73
2021-11-15,2021-11-15,Business insurance premium,REF44899650,144.45,0.0,193889.28
2021-11-17,2021-11-17,Coworking space rental,REF60852991,185.77,0.0,193703.51
2021-11-19,2021-11-19,Coworking space rental,REF50425381,295.0,0.0,193408.51
2021-11-21,2021-11-21,Professional software license,REF18657322,226.45,0.0,193182.06
2021-11-22,2021-11-22,Business meal,REF48956839,314.91,0.0,192867.15
2021-11-24,2021-11-24,Equipment purchase,REF30072071,183.12,0.0,192684.03
2021-11-28,2021-11-28,Business travel,REF52322930,395.9,0.0,192288.13
2021-12-05,2021-12-05,Equipment purchase,REF63148281,132.74,0.0,192155.39
2021-12-08,2021-12-08,Business travel,REF57150571,283.33,0.0,191872.06
2021-12-15,2021-12-15,Business insurance premium,REF61918810,136.22,0.0,191735.84
2021-12-15,2021-12-15,Invoice payment - Hayes-Mclean,REF70956574,0.0,684.02,192419.86
2021-12-15,2021-12-15,"Payment from Andrews, Stanton and Hines",REF45448349,0.0,547.29,192967.15
2021-12-15,2021-12-15,Business meal,REF68464855,312.96,0.0,192654.19
2021-12-15,2021-12-15,Service payment - Tran Inc,REF36486445,0.0,814.61,193468.8
2021-12-15,2021-12-15,"Project payment - Gould, Moran and Thomas",REF44933452,0.0,581.12,194049.92
2021-12-15,2021-12-15,Invoice payment - Griffin-Ortega,REF94163396,0.0,196.68,194246.6
2021-12-15,2021-12-15,Project payment - Wheeler PLC,REF88479610,0.0,620.98,194867.58
2021-12-17,2021-12-17,Training/conference,REF22009771,183.25,0.0,194684.33
2021-12-18,2021-12-18,Business travel,REF30549135,340.01,0.0,194344.32
2021-12-21,2021-12-21,Professional software license,REF63203519,172.81,0.0,194171.51
2021-12-21,2021-12-21,Marketing expenses,REF35100972,248.74,0.0,193922.77
2021-12-24,2021-12-24,Equipment purchase,REF73217608,132.55,0.0,193790.22
2021-12-29,2021-12-29,Coworking space rental,REF32363281,291.43,0.0,193498.79
2021-12-31,2021-12-31,Marketing expenses,REF30820817,299.73,0.0,193199.06
2022-01-01,2022-01-01,Equipment purchase,REF38435656,161.47,0.0,193037.59
2022-01-03,2022-01-03,Marketing expenses,REF33623243,208.32,0.0,192829.27
2022-01-07,2022-01-07,Equipment purchase,REF17873032,184.76,0.0,192644.51
2022-01-10,2022-01-10,Business meal,REF80491455,408.15,0.0,192236.36
2022-01-11,2022-01-11,Equipment purchase,REF62649454,172.95,0.0,192063.41
2022-01-11,2022-01-11,Business meal,REF69806663,276.7,0.0,191786.71
2022-01-11,2022-01-11,Accounting expense,REF50509794,126.49,0.0,191660.22
2022-01-14,2022-01-14,Coworking space rental,REF80324637,331.65,0.0,191328.57
2022-01-15,2022-01-15,"Payment from Gould, Moran and Thomas",REF13788093,0.0,996.15,192324.72
2022-01-15,2022-01-15,Project payment - Thompson-Baker,REF36159302,0.0,1009.18,193333.9
2022-01-15,2022-01-15,Payment from Keller-Stewart,REF96690865,0.0,776.98,194110.88
2022-01-15,2022-01-15,Equipment purchase,REF63604676,199.72,0.0,193911.16
2022-01-15,2022-01-15,"Payment from Andrews, Stanton and Hines",REF50841609,0.0,632.59,194543.75
2022-01-15,2022-01-15,Business insurance premium,REF82315778,161.39,0.0,194382.36
2022-01-15,2022-01-15,Project payment - Wheeler PLC,REF31112245,0.0,719.75,195102.11
2022-01-15,2022-01-15,Project payment - Griffin-Ortega,REF60926552,0.0,340.4,195442.51
2022-01-15,2022-01-15,Project payment - Hayes-Mclean,REF40952343,0.0,688.36,196130.87
2022-01-17,2022-01-17,Coworking space rental,REF83214523,177.59,0.0,195953.28
2022-01-21,2022-01-21,Professional software license,REF73396631,207.59,0.0,195745.69
2022-01-24,2022-01-24,Marketing expenses,REF59054217,349.73,0.0,195395.96
2022-01-24,2022-01-24,Business meal,REF86884083,281.98,0.0,195113.98
2022-01-25,2022-01-25,Marketing expenses,REF73401030,367.31,0.0,194746.67
2022-02-01,2022-02-01,Equipment purchase,REF88502094,212.81,0.0,194533.86
2022-02-06,2022-02-06,Accounting expense,REF22138916,165.1,0.0,194368.76
2022-02-07,2022-02-07,Marketing expenses,REF61406271,216.22,0.0,194152.54
2022-02-09,2022-02-09,Marketing expenses,REF47511476,377.47,0.0,193775.07
2022-02-15,2022-02-15,Business travel,REF45586043,353.32,0.0,193421.75
2022-02-15,2022-02-15,Coworking space rental,REF43325513,334.94,0.0,193086.81
2022-02-15,2022-02-15,Business insurance premium,REF94495159,149.89,0.0,192936.92
2022-02-15,2022-02-15,"Service payment - Andrews, Stanton and Hines",REF97402072,0.0,698.96,193635.88
2022-02-15,2022-02-15,Invoice payment - Wheeler PLC,REF76897551,0.0,740.65,194376.53
2022-02-15,2022-02-15,Invoice payment - Hayes-Mclean,REF40534507,0.0,816.95,195193.48
2022-02-15,2022-02-15,"Invoice payment - Gould, Moran and Thomas",REF59533459,0.0,1009.94,196203.42
2022-02-15,2022-02-15,Service payment - Tran Inc,REF94672467,0.0,583.17,196786.59
2022-02-15,2022-02-15,Service payment - Thompson-Baker,REF35442717,0.0,561.2,197347.79
2022-02-15,2022-02-15,Payment from Griffin-Ortega,REF86077448,0.0,353.5,197701.29
2022-02-15,2022-02-15,Invoice payment - Keller-Stewart,REF21222160,0.0,616.55,198317.84
2022-02-17,2022-02-17,Business travel,REF83866815,414.25,0.0,197903.59
2022-02-20,2022-02-20,Business travel,REF90171359,624.54,0.0,197279.05
2022-02-21,2022-02-21,Business travel,REF24579738,38.39,0.0,197240.66
2022-02-21,2022-02-21,Professional software license,REF17800346,249.53,0.0,196991.13
2022-02-28,2022-02-28,Business travel,REF72446471,238.01,0.0,196753.12
2022-03-05,2022-03-05,Business travel,REF51200904,487.12,0.0,196266.0
2022-03-06,2022-03-06,Business travel,REF90062940,440.74,0.0,195825.26
2022-03-09,2022-03-09,Accounting expense,REF55845456,182.48,0.0,195642.78
2022-03-15,2022-03-15,Coworking space rental,REF10772485,220.1,0.0,195422.68
2022-03-15,2022-03-15,Project payment - Wheeler PLC,REF44064540,0.0,846.74,196269.42
2022-03-15,2022-03-15,Payment from Tran Inc,REF46284292,0.0,665.01,196934.43
2022-03-15,2022-03-15,Payment from Griffin-Ortega,REF94790610,0.0,311.26,197245.69
2022-03-15,2022-03-15,Project payment - Keller-Stewart,REF46867397,0.0,530.55,197776.24
2022-03-15,2022-03-15,Invoice payment - Hayes-Mclean,REF16758241,0.0,644.27,198420.51
2022-03-15,2022-03-15,"Payment from Andrews, Stanton and Hines",REF99246300,0.0,433.32,198853.83
2022-03-15,2022-03-15,Invoice payment - Thompson-Baker,REF26778577,0.0,880.76,199734.59
2022-03-15,2022-03-15,Business insurance premium,REF45344823,136.89,0.0,199597.7
2022-03-19,2022-03-19,Accounting expense,REF98175749,208.69,0.0,199389.01
2022-03-21,2022-03-21,Professional software license,REF34827981,194.29,0.0,199194.72
2022-04-02,2022-04-02,Marketing expenses,REF62089022,323.35,0.0,198871.37
2022-04-03,2022-04-03,Marketing expenses,REF85370517,432.44,0.0,198438.93
2022-04-09,2022-04-09,Marketing expenses,REF33709703,358.9,0.0,198080.03
2022-04-15,2022-04-15,Project payment - Griffin-Ortega,REF80589735,0.0,216.97,198297.0
2022-04-15,2022-04-15,Payment from Thompson-Baker,REF85454242,0.0,757.93,199054.93
2022-04-15,2022-04-15,Invoice payment - Keller-Stewart,REF91936499,0.0,526.2,199581.13
2022-04-15,2022-04-15,Service payment - Hayes-Mclean,REF65743091,0.0,942.01,200523.14
2022-04-15,2022-04-15,Invoice payment - Tran Inc,REF92800624,0.0,751.38,201274.52
2022-04-15,2022-04-15,Payment from Wheeler PLC,REF46250106,0.0,878.72,202153.24
2022-04-15,2022-04-15,"Service payment - Andrews, Stanton and Hines",REF39510464,0.0,557.23,202710.47
2022-04-15,2022-04-15,"Payment from Gould, Moran and Thomas",REF12930613,0.0,866.75,203577.22
2022-04-15,2022-04-15,Business insurance premium,REF53256463,138.83,0.0,203438.39
2022-04-16,2022-04-16,Marketing expenses,REF85488748,292.51,0.0,203145.88
2022-04-20,2022-04-20,Coworking space rental,REF72091082,305.47,0.0,202840.41
2022-04-21,2022-04-21,Professional software license,REF20020051,250.62,0.0,202589.79
2022-04-23,2022-04-23,Equipment purchase,REF69401960,143.31,0.0,202446.48
2022-04-23,2022-04-23,Business travel,REF27057555,366.54,0.0,202079.94
2022-04-24,2022-04-24,Training/conference,REF10371354,327.14,0.0,201752.8
2022-04-26,2022-04-26,Training/conference,REF20492287,310.72,0.0,201442.08
2022-04-26,2022-04-26,Accounting expense,REF66757035,257.61,0.0,201184.47
2022-04-27,2022-04-27,Equipment purchase,REF70544202,104.05,0.0,201080.42
2022-04-28,2022-04-28,Equipment purchase,REF50921599,134.27,0.0,200946.15
2022-05-03,2022-05-03,Training/conference,REF67936571,163.25,0.0,200782.9
2022-05-14,2022-05-14,Equipment purchase,REF19838365,114.16,0.0,200668.74
2022-05-15,2022-05-15,"Project payment - Andrews, Stanton and Hines",REF49420501,0.0,395.45,201064.19
2022-05-15,2022-05-15,Project payment - Wheeler PLC,REF53885380,0.0,497.69,201561.88
2022-05-15,2022-05-15,Payment from Griffin-Ortega,REF79071309,0.0,247.84,201809.72
2022-05-15,2022-05-15,Project payment - Thompson-Baker,REF25980326,0.0,944.68,202754.4
2022-05-15,2022-05-15,Service payment - Tran Inc,REF95403989,0.0,500.08,203254.48
2022-05-15,2022-05-15,Invoice payment - Hayes-Mclean,REF34974263,0.0,735.34,203989.82
2022-05-15,2022-05-15,Payment from Keller-Stewart,REF95369937,0.0,462.31,204452.13
2022-05-15,2022-05-15,Business insurance premium,REF96274401,132.77,0.0,204319.36
2022-05-19,2022-05-19,Training/conference,REF16153419,61.04,0.0,204258.32
2022-05-19,2022-05-19,Marketing expenses,REF76744431,279.0,0.0,203979.32
2022-05-21,2022-05-21,Business meal,REF86575416,308.98,0.0,203670.34
2022-05-21,2022-05-21,Professional software license,REF56069393,164.22,0.0,203506.12
2022-05-21,2022-05-21,Business travel,REF80553028,306.59,0.0,203199.53
2022-05-22,2022-05-22,Coworking space rental,REF31952433,202.15,0.0,202997.38
2022-05-23,2022-05-23,Training/conference,REF50766782,205.69,0.0,202791.69
2022-05-24,2022-05-24,Equipment purchase,REF56683665,128.53,0.0,202663.16
2022-05-25,2022-05-25,Accounting expense,REF54980789,126.32,0.0,202536.84
2022-06-15,2022-06-15,Service payment - Griffin-Ortega,REF16185146,0.0,209.0,202745.84
2022-06-15,2022-06-15,Training/conference,REF70441316,250.12,0.0,202495.72
2022-06-15,2022-06-15,Business insurance premium,REF46776950,112.15,0.0,202383.57
2022-06-15,2022-06-15,Invoice payment - Wheeler PLC,REF10196676,0.0,708.29,203091.86
2022-06-15,2022-06-15,Invoice payment - Keller-Stewart,REF21607966,0.0,532.47,203624.33
2022-06-15,2022-06-15,Project payment - Tran Inc,REF56455706,0.0,463.24,204087.57
2022-06-15,2022-06-15,"Invoice payment - Andrews, Stanton and Hines",REF49717409,0.0,399.58,204487.15
2022-06-15,2022-06-15,Invoice payment - Thompson-Baker,REF40382892,0.0,746.12,205233.27
2022-06-15,2022-06-15,"Payment from Gould, Moran and Thomas",REF25445252,0.0,708.51,205941.78
2022-06-15,2022-06-15,Payment from Hayes-Mclean,REF81903112,0.0,482.93,206424.71
2022-06-17,2022-06-17,Training/conference,REF61016871,211.14,0.0,206213.57
2022-06-21,2022-06-21,Equipment purchase,REF37760050,94.23,0.0,206119.34
2022-06-21,2022-06-21,Professional software license,REF80102044,140.68,0.0,205978.66
2022-06-23,2022-06-23,Business travel,REF24632680,227.99,0.0,205750.67
2022-06-24,2022-06-24,Accounting expense,REF55213724,226.75,0.0,205523.92
2022-06-25,2022-06-25,Business meal,REF29752489,219.19,0.0,205304.73
2022-06-26,2022-06-26,Training/conference,REF90782096,108.19,0.0,205196.54
2022-07-04,2022-07-04,Business travel,REF71164627,243.94,0.0,204952.6
2022-07-15,2022-07-15,Project payment - Tran Inc,REF24188904,0.0,459.43,205412.03
2022-07-15,2022-07-15,"Project payment - Andrews, Stanton and Hines",REF96573337,0.0,394.13,205806.16
2022-07-15,2022-07-15,Payment from Griffin-Ortega,REF90111982,0.0,225.43,206031.59
2022-07-15,2022-07-15,Payment from Wheeler PLC,REF22271182,0.0,317.03,206348.62
2022-07-15,2022-07-15,"Service payment - Gould, Moran and Thomas",REF84788367,0.0,683.9,207032.52
2022-07-15,2022-07-15,Invoice payment - Hayes-Mclean,REF34367345,0.0,463.55,207496.07
2022-07-15,2022-07-15,Business insurance premium,REF33134030,95.49,0.0,207400.58
2022-07-15,2022-07-15,Service payment - Thompson-Baker,REF47618758,0.0,531.83,207932.41
2022-07-15,2022-07-15,Marketing expenses,REF83050745,206.81,0.0,207725.6
2022-07-15,2022-07-15,Invoice payment - Keller-Stewart,REF97480298,0.0,404.27,208129.87
2022-07-16,2022-07-16,Coworking space rental,REF53182988,268.37,0.0,207861.5
2022-07-21,2022-07-21,Professional software license,REF20660218,125.04,0.0,207736.46
2022-07-25,2022-07-25,Business meal,REF65275187,151.99,0.0,207584.47
2022-07-30,2022-07-30,Accounting expense,REF70005899,166.36,0.0,207418.11
2022-07-31,2022-07-31,Business meal,REF16169018,273.66,0.0,207144.45
2022-08-01,2022-08-01,Accounting expense,REF48841740,149.48,0.0,206994.97
2022-08-02,2022-08-02,Equipment purchase,REF25147988,97.22,0.0,206897.75
2022-08-03,2022-08-03,Coworking space rental,REF44697635,168.71,0.0,206729.04
2022-08-08,2022-08-08,Business meal,REF83856262,177.97,0.0,206551.07
2022-08-12,2022-08-12,Training/conference,REF12739203,121.28,0.0,206429.79
2022-08-13,2022-08-13,Business meal,REF76873018,198.13,0.0,206231.66
2022-08-15,2022-08-15,"Invoice payment - Andrews, Stanton and Hines",REF43460117,0.0,273.32,206504.98
2022-08-15,2022-08-15,Invoice payment - Tran Inc,REF46549227,0.0,539.75,207044.73
2022-08-15,2022-08-15,Service payment - Thompson-Baker,REF26078762,0.0,805.18,207849.91
2022-08-15,2022-08-15,Service payment - Hayes-Mclean,REF51946142,0.0,534.58,208384.49
2022-08-15,2022-08-15,Project payment - Wheeler PLC,REF14775957,0.0,691.58,209076.07
2022-08-15,2022-08-15,Service payment - Keller-Stewart,REF37043326,0.0,381.35,209457.42
2022-08-15,2022-08-15,"Invoice payment - Gould, Moran and Thomas",REF25735150,0.0,510.19,209967.61
2022-08-15,2022-08-15,Payment from Griffin-Ortega,REF54431691,0.0,187.68,210155.29
2022-08-15,2022-08-15,Business insurance premium,REF84760216,115.52,0.0,210039.77
2022-08-21,2022-08-21,Professional software license,REF29098667,193.46,0.0,209846.31
2022-08-25,2022-08-25,Training/conference,REF61165294,203.11,0.0,209643.2
2022-08-25,2022-08-25,Business meal,REF28123362,194.1,0.0,209449.1
2022-08-26,2022-08-26,Training/conference,REF97203163,94.03,0.0,209355.07
2022-08-26,2022-08-26,Accounting expense,REF22395634,194.34,0.0,209160.73
2022-08-27,2022-08-27,Accounting expense,REF60442279,164.82,0.0,208995.91
2022-09-04,2022-09-04,Training/conference,REF36129008,314.36,0.0,208681.55
2022-09-06,2022-09-06,Marketing expenses,REF29948421,535.47,0.0,208146.08
2022-09-08,2022-09-08,Equipment purchase,REF37730360,215.96,0.0,207930.12
2022-09-09,2022-09-09,Training/conference,REF19753845,159.18,0.0,207770.94
2022-09-15,2022-09-15,Payment from Thompson-Baker,REF11212187,0.0,1079.39,208850.33
2022-09-15,2022-09-15,Payment from Griffin-Ortega,REF81268685,0.0,303.27,209153.6
2022-09-15,2022-09-15,Project payment - Wheeler PLC,REF81532857,0.0,500.0,209653.6
2022-09-15,2022-09-15,Payment from Tran Inc,REF24855182,0.0,689.22,210342.82
2022-09-15,2022-09-15,"Project payment - Gould, Moran and Thomas",REF14183130,0.0,985.42,211328.24
2022-09-15,2022-09-15,Business insurance premium,REF80820479,148.94,0.0,211179.3
2022-09-15,2022-09-15,"Project payment - Andrews, Stanton and Hines",REF35352271,0.0,605.92,211785.22
2022-09-15,2022-09-15,Service payment - Keller-Stewart,REF58025745,0.0,745.95,212531.17
2022-09-16,2022-09-16,Business meal,REF34238909,188.54,0.0,212342.63
2022-09-17,2022-09-17,Business travel,REF48279943,346.0,0.0,211996.63
2022-09-21,2022-09-21,Professional software license,REF39564419,201.4,0.0,211795.23
2022-09-24,2022-09-24,Business travel,REF21528383,644.12,0.0,211151.11
2022-09-25,2022-09-25,Business travel,REF79436150,656.39,0.0,210494.72
2022-09-27,2022-09-27,Marketing expenses,REF67018670,358.19,0.0,210136.53
2022-09-29,2022-09-29,Accounting expense,REF59674570,156.08,0.0,209980.45
2022-10-01,2022-10-01,Business meal,REF23878640,307.59,0.0,209672.86
2022-10-02,2022-10-02,Equipment purchase,REF30966141,215.4,0.0,209457.46
2022-10-10,2022-10-10,Accounting expense,REF76526293,224.49,0.0,209232.97
2022-10-15,2022-10-15,Project payment - Griffin-Ortega,REF99747150,0.0,288.12,209521.09
2022-10-15,2022-10-15,Invoice payment - Keller-Stewart,REF60661724,0.0,841.92,210363.01
2022-10-15,2022-10-15,Payment from Wheeler PLC,REF62708290,0.0,743.73,211106.74
2022-10-15,2022-10-15,Equipment purchase,REF36126219,198.62,0.0,210908.12
2022-10-15,2022-10-15,"Invoice payment - Andrews, Stanton and Hines",REF36764441,0.0,461.42,211369.54
2022-10-15,2022-10-15,Business insurance premium,REF18793532,159.75,0.0,211209.79
2022-10-15,2022-10-15,Service payment - Tran Inc,REF25465199,0.0,608.89,211818.68
2022-10-15,2022-10-15,Service payment - Hayes-Mclean,REF45752625,0.0,716.9,212535.58
2022-10-15,2022-10-15,Invoice payment - Thompson-Baker,REF75524030,0.0,890.42,213426.0
2022-10-21,2022-10-21,Professional software license,REF87843313,208.73,0.0,213217.27
2022-10-24,2022-10-24,Accounting expense,REF68953282,262.97,0.0,212954.3
2022-11-02,2022-11-02,Business meal,REF14255927,270.0,0.0,212684.3
2022-11-15,2022-11-15,"Invoice payment - Andrews, Stanton and Hines",REF92578160,0.0,492.57,213176.87
2022-11-15,2022-11-15,Project payment - Thompson-Baker,REF11471933,0.0,812.41,213989.28
2022-11-15,2022-11-15,Invoice payment - Griffin-Ortega,REF34631317,0.0,360.42,214349.7
2022-11-15,2022-11-15,Service payment - Tran Inc,REF54094624,0.0,762.87,215112.57
2022-11-15,2022-11-15,Invoice payment - Hayes-Mclean,REF80639557,0.0,654.58,215767.15
2022-11-15,2022-11-15,Business insurance premium,REF30484487,155.39,0.0,215611.76
2022-11-15,2022-11-15,"Service payment - Gould, Moran and Thomas",REF67441186,0.0,837.11,216448.87
2022-11-15,2022-11-15,Project payment - Keller-Stewart,REF79200644,0.0,504.57,216953.44
2022-11-18,2022-11-18,Equipment purchase,REF48510528,150.9,0.0,216802.54
2022-11-21,2022-11-21,Equipment purchase,REF17163498,170.38,0.0,216632.16
2022-11-21,2022-11-21,Professional software license,REF81208722,226.55,0.0,216405.61
2022-11-30,2022-11-30,Business travel,REF50583654,370.85,0.0,216034.76
2022-12-02,2022-12-02,Business travel,REF86994758,361.52,0.0,215673.24
2022-12-04,2022-12-04,Equipment purchase,REF54746522,130.43,0.0,215542.81
2022-12-10,2022-12-10,Business meal,REF54469008,298.83,0.0,215243.98
2022-12-13,2022-12-13,Equipment purchase,REF97062960,93.49,0.0,215150.49
2022-12-15,2022-12-15,"Invoice payment - Gould, Moran and Thomas",REF33588663,0.0,789.33,215939.82
2022-12-15,2022-12-15,Payment from Tran Inc,REF39574220,0.0,638.72,216578.54
2022-12-15,2022-12-15,Invoice payment - Wheeler PLC,REF83324923,0.0,564.38,217142.92
2022-12-15,2022-12-15,Accounting expense,REF16793334,139.44,0.0,217003.48
2022-12-15,2022-12-15,Service payment - Hayes-Mclean,REF74266072,0.0,571.12,217574.6
2022-12-15,2022-12-15,Invoice payment - Griffin-Ortega,REF88020897,0.0,284.41,217859.01
2022-12-15,2022-12-15,Invoice payment - Thompson-Baker,REF73715927,0.0,696.12,218555.13
2022-12-15,2022-12-15,Business insurance premium,REF30285744,113.49,0.0,218441.64
2022-12-21,2022-12-21,Professional software license,REF23563471,180.71,0.0,218260.93
2022-12-25,2022-12-25,Accounting expense,REF71190530,220.87,0.0,218040.06
2022-12-30,2022-12-30,Accounting expense,REF54738231,148.81,0.0,217891.25
2023-01-11,2023-01-11,Coworking space rental,REF43097043,318.99,0.0,217572.26
2023-01-14,2023-01-14,Accounting expense,REF65315868,276.33,0.0,217295.93
2023-01-15,2023-01-15,"Project payment - Andrews, Stanton and Hines",REF34680524,0.0,580.08,217876.01
2023-01-15,2023-01-15,Project payment - Thompson-Baker,REF45086209,0.0,839.89,218715.9
2023-01-15,2023-01-15,Service payment - Tran Inc,REF20372045,0.0,737.22,219453.12
2023-01-15,2023-01-15,Service payment - Griffin-Ortega,REF65518271,0.0,341.88,219795.0
2023-01-15,2023-01-15,Business insurance premium,REF67686242,178.49,0.0,219616.51
2023-01-15,2023-01-15,"Project payment - Gould, Moran and Thomas",REF59679865,0.0,785.56,220402.07
2023-01-15,2023-01-15,Payment from Hayes-Mclean,REF74687019,0.0,915.74,221317.81
2023-01-15,2023-01-15,Payment from Keller-Stewart,REF40530928,0.0,668.08,221985.89
2023-01-15,2023-01-15,Service payment - Wheeler PLC,REF40908583,0.0,904.61,222890.5
2023-01-17,2023-01-17,Business meal,REF38796610,250.37,0.0,222640.13
2023-01-17,2023-01-17,Business travel,REF20650653,605.4,0.0,222034.73
2023-01-19,2023-01-19,Training/conference,REF98903393,315.65,0.0,221719.08
2023-01-21,2023-01-21,Professional software license,REF48990145,246.72,0.0,221472.36
2023-01-21,2023-01-21,Accounting expense,REF78361967,272.39,0.0,221199.97
2023-01-28,2023-01-28,Business travel,REF26460529,625.33,0.0,220574.64
2023-02-01,2023-02-01,Marketing expenses,REF72315051,235.5,0.0,220339.14
2023-02-05,2023-02-05,Accounting expense,REF64651834,430.4,0.0,219908.74
2023-02-07,2023-02-07,Equipment purchase,REF54197184,143.33,0.0,219765.41
2023-02-10,2023-02-10,Business travel,REF69931445,486.54,0.0,219278.87
2023-02-11,2023-02-11,Accounting expense,REF77513500,270.13,0.0,219008.74
2023-02-15,2023-02-15,Training/conference,REF19008533,151.15,0.0,218857.59
2023-02-15,2023-02-15,Business meal,REF61390439,398.48,0.0,218459.11
2023-02-15,2023-02-15,"Project payment - Andrews, Stanton and Hines",REF19972149,0.0,600.89,219060.0
2023-02-15,2023-02-15,Payment from Wheeler PLC,REF51442797,0.0,971.98,220031.98
2023-02-15,2023-02-15,"Invoice payment - Gould, Moran and Thomas",REF97850898,0.0,942.02,220974.0
2023-02-15,2023-02-15,Project payment - Griffin-Ortega,REF89233234,0.0,357.05,221331.05
2023-02-15,2023-02-15,Project payment - Tran Inc,REF98707084,0.0,651.42,221982.47
2023-02-15,2023-02-15,Project payment - Hayes-Mclean,REF53659273,0.0,847.67,222830.14
2023-02-15,2023-02-15,Invoice payment - Keller-Stewart,REF31832995,0.0,621.77,223451.91
2023-02-15,2023-02-15,Business insurance premium,REF29092452,136.62,0.0,223315.29
2023-02-21,2023-02-21,Professional software license,REF96850995,217.11,0.0,223098.18
2023-02-27,2023-02-27,Coworking space rental,REF69853127,329.5,0.0,222768.68
2023-02-27,2023-02-27,Business meal,REF18746747,361.62,0.0,222407.06
2023-03-05,2023-03-05,Marketing expenses,REF59288016,298.49,0.0,222108.57
2023-03-06,2023-03-06,Accounting expense,REF50021712,176.58,0.0,221931.99
2023-03-07,2023-03-07,Training/conference,REF60736172,152.84,0.0,221779.15
2023-03-12,2023-03-12,Equipment purchase,REF92760668,119.9,0.0,221659.25
2023-03-15,2023-03-15,Project payment - Tran Inc,REF43155575,0.0,681.66,222340.91
2023-03-15,2023-03-15,Payment from Keller-Stewart,REF96985607,0.0,564.15,222905.06
2023-03-15,2023-03-15,Invoice payment - Thompson-Baker,REF53979555,0.0,643.6,223548.66
2023-03-15,2023-03-15,Invoice payment - Wheeler PLC,REF95498627,0.0,839.33,224387.99
2023-03-15,2023-03-15,Business insurance premium,REF66398686,143.85,0.0,224244.14
2023-03-15,2023-03-15,Service payment - Hayes-Mclean,REF68279391,0.0,711.88,224956.02
2023-03-15,2023-03-15,"Invoice payment - Andrews, Stanton and Hines",REF44501425,0.0,384.36,225340.38
2023-03-21,2023-03-21,Professional software license,REF76264766,218.57,0.0,225121.81
2023-03-21,2023-03-21,Equipment purchase,REF95689658,70.02,0.0,225051.79
2023-03-23,2023-03-23,Equipment purchase,REF56014072,126.54,0.0,224925.25
2023-03-24,2023-03-24,Coworking space rental,REF52412898,227.34,0.0,224697.91
2023-03-28,2023-03-28,Business travel,REF49676311,499.07,0.0,224198.84
2023-03-30,2023-03-30,Business travel,REF80146950,124.2,0.0,224074.64
2023-04-03,2023-04-03,Business travel,REF33429665,439.97,0.0,223634.67
2023-04-06,2023-04-06,Marketing expenses,REF11565363,260.28,0.0,223374.39
2023-04-07,2023-04-07,Business travel,REF44446221,427.76,0.0,222946.63
2023-04-07,2023-04-07,Business meal,REF18522243,328.62,0.0,222618.01
2023-04-11,2023-04-11,Business meal,REF87313406,383.28,0.0,222234.73
2023-04-15,2023-04-15,Business insurance premium,REF83836565,151.8,0.0,222082.93
2023-04-15,2023-04-15,Payment from Thompson-Baker,REF86240544,0.0,675.37,222758.3
2023-04-15,2023-04-15,"Payment from Gould, Moran and Thomas",REF20511861,0.0,667.39,223425.69
2023-04-15,2023-04-15,Payment from Hayes-Mclean,REF79394612,0.0,706.6,224132.29
2023-04-15,2023-04-15,Project payment - Wheeler PLC,REF97907061,0.0,585.05,224717.34
2023-04-15,2023-04-15,Payment from Griffin-Ortega,REF97900514,0.0,260.81,224978.15
2023-04-15,2023-04-15,Project payment - Keller-Stewart,REF85536817,0.0,505.33,225483.48
2023-04-15,2023-04-15,"Invoice payment - Andrews, Stanton and Hines",REF29322165,0.0,630.59,226114.07
2023-04-15,2023-04-15,Project payment - Tran Inc,REF71296999,0.0,806.01,226920.08
2023-04-19,2023-04-19,Equipment purchase,REF71571021,227.53,0.0,226692.55
2023-04-21,2023-04-21,Professional software license,REF69298475,197.82,0.0,226494.73
2023-04-30,2023-04-30,Business travel,REF77376002,448.13,0.0,226046.6
2023-05-02,2023-05-02,Equipment purchase,REF95660038,130.66,0.0,225915.94
2023-05-09,2023-05-09,Business travel,REF77828201,603.33,0.0,225312.61
2023-05-14,2023-05-14,Business travel,REF87936214,411.6,0.0,224901.01
2023-05-15,2023-05-15,"Service payment - Gould, Moran and Thomas",REF26080392,0.0,611.28,225512.29
2023-05-15,2023-05-15,Business insurance premium,REF74398290,122.48,0.0,225389.81
2023-05-15,2023-05-15,Project payment - Tran Inc,REF14255472,0.0,572.18,225961.99
2023-05-15,2023-05-15,Invoice payment - Hayes-Mclean,REF76777990,0.0,575.41,226537.4
2023-05-15,2023-05-15,Project payment - Griffin-Ortega,REF48387583,0.0,220.98,226758.38
2023-05-15,2023-05-15,Service payment - Wheeler PLC,REF44916759,0.0,640.88,227399.26
2023-05-15,2023-05-15,Service payment - Thompson-Baker,REF73068763,0.0,779.08,228178.34
2023-05-15,2023-05-15,"Service payment - Andrews, Stanton and Hines",REF41745007,0.0,532.78,228711.12
2023-05-17,2023-05-17,Business travel,REF38293889,219.66,0.0,228491.46
2023-05-21,2023-05-21,Professional software license,REF95912214,161.33,0.0,228330.13
2023-05-23,2023-05-23,Coworking space rental,REF66699136,319.56,0.0,228010.57
2023-05-24,2023-05-24,Business travel,REF18872642,293.77,0.0,227716.8
2023-05-24,2023-05-24,Equipment purchase,REF22513870,120.82,0.0,227595.98
2023-05-27,2023-05-27,Business travel,REF26539273,417.12,0.0,227178.86
2023-05-27,2023-05-27,Equipment purchase,REF33682821,155.79,0.0,227023.07
2023-06-09,2023-06-09,Accounting expense,REF38446185,138.64,0.0,226884.43
2023-06-14,2023-06-14,Business meal,REF30920079,99.16,0.0,226785.27
2023-06-15,2023-06-15,Payment from Wheeler PLC,REF11196135,0.0,488.71,227273.98
2023-06-15,2023-06-15,Service payment - Keller-Stewart,REF82541186,0.0,445.58,227719.56
2023-06-15,2023-06-15,Invoice payment - Griffin-Ortega,REF38060202,0.0,243.36,227962.92
2023-06-15,2023-06-15,"Invoice payment - Andrews, Stanton and Hines",REF44794229,0.0,477.33,228440.25
2023-06-15,2023-06-15,Accounting expense,REF30249848,165.0,0.0,228275.25
2023-06-15,2023-06-15,Project payment - Tran Inc,REF92009354,0.0,536.5,228811.75
2023-06-15,2023-06-15,Payment from Hayes-Mclean,REF89041236,0.0,664.61,229476.36
2023-06-15,2023-06-15,Invoice payment - Thompson-Baker,REF61528174,0.0,769.5,230245.86
2023-06-15,2023-06-15,Business insurance premium,REF19896206,113.12,0.0,230132.74
2023-06-15,2023-06-15,"Service payment - Gould, Moran and Thomas",REF54231021,0.0,857.39,230990.13
2023-06-19,2023-06-19,Marketing expenses,REF70662636,119.28,0.0,230870.85
2023-06-20,2023-06-20,Accounting expense,REF19888145,234.44,0.0,230636.41
2023-06-21,2023-06-21,Professional software license,REF85886263,172.71,0.0,230463.7
2023-06-22,2023-06-22,Business meal,REF47209121,290.57,0.0,230173.13
2023-06-29,2023-06-29,Business travel,REF65707930,322.64,0.0,229850.49
2023-06-29,2023-06-29,Accounting expense,REF66544839,159.76,0.0,229690.73
2023-07-12,2023-07-12,Business travel,REF35093843,353.87,0.0,229336.86
2023-07-12,2023-07-12,Coworking space rental,REF72366517,331.67,0.0,229005.19
2023-07-13,2023-07-13,Business meal,REF31541589,217.34,0.0,228787.85
2023-07-15,2023-07-15,Payment from Wheeler PLC,REF44078572,0.0,547.78,229335.63
2023-07-15,2023-07-15,Invoice payment - Tran Inc,REF31422001,0.0,497.4,229833.03
2023-07-15,2023-07-15,Project payment - Thompson-Baker,REF67730895,0.0,694.8,230527.83
2023-07-15,2023-07-15,"Project payment - Gould, Moran and Thomas",REF50512288,0.0,669.28,231197.11
2023-07-15,2023-07-15,Business insurance premium,REF77232996,100.91,0.0,231096.2
2023-07-15,2023-07-15,Invoice payment - Hayes-Mclean,REF92236612,0.0,495.22,231591.42
2023-07-15,2023-07-15,Payment from Griffin-Ortega,REF47773262,0.0,200.89,231792.31
2023-07-15,2023-07-15,Service payment - Keller-Stewart,REF38359067,0.0,369.13,232161.44
2023-07-15,2023-07-15,"Service payment - Andrews, Stanton and Hines",REF62634548,0.0,347.14,232508.58
2023-07-16,2023-07-16,Business meal,REF46235122,242.93,0.0,232265.65
2023-07-21,2023-07-21,Professional software license,REF59646385,133.45,0.0,232132.2
2023-07-23,2023-07-23,Equipment purchase,REF84248232,125.22,0.0,232006.98
2023-07-26,2023-07-26,Marketing expenses,REF91440492,233.55,0.0,231773.43
2023-07-26,2023-07-26,Accounting expense,REF32014973,55.14,0.0,231718.29
2023-07-27,2023-07-27,Business meal,REF49635245,240.47,0.0,231477.82
2023-08-01,2023-08-01,Marketing expenses,REF97054287,377.0,0.0,231100.82
2023-08-07,2023-08-07,Equipment purchase,REF92817506,140.41,0.0,230960.41
2023-08-08,2023-08-08,Coworking space rental,REF78062377,382.86,0.0,230577.55
2023-08-12,2023-08-12,Marketing expenses,REF47900737,163.77,0.0,230413.78
2023-08-14,2023-08-14,Coworking space rental,REF79691211,284.08,0.0,230129.7
2023-08-15,2023-08-15,Invoice payment - Wheeler PLC,REF21698038,0.0,606.9,230736.6
2023-08-15,2023-08-15,"Invoice payment - Gould, Moran and Thomas",REF16385568,0.0,789.17,231525.77
2023-08-15,2023-08-15,Payment from Griffin-Ortega,REF55491865,0.0,208.47,231734.24
2023-08-15,2023-08-15,Service payment - Tran Inc,REF24618862,0.0,406.14,232140.38
2023-08-15,2023-08-15,Invoice payment - Thompson-Baker,REF61491239,0.0,801.49,232941.87
2023-08-15,2023-08-15,Business insurance premium,REF79130110,115.31,0.0,232826.56
2023-08-15,2023-08-15,Invoice payment - Keller-Stewart,REF89945376,0.0,491.37,233317.93
2023-08-15,2023-08-15,Invoice payment - Hayes-Mclean,REF91399775,0.0,569.85,233887.78
2023-08-15,2023-08-15,"Invoice payment - Andrews, Stanton and Hines",REF65448103,0.0,400.63,234288.41
2023-08-21,2023-08-21,Professional software license,REF74502134,151.08,0.0,234137.33
2023-09-01,2023-09-01,Accounting expense,REF52662045,89.22,0.0,234048.11
2023-09-04,2023-09-04,Business meal,REF17519683,343.57,0.0,233704.54
2023-09-14,2023-09-14,Coworking space rental,REF48855099,376.05,0.0,233328.49
2023-09-15,2023-09-15,Business insurance premium,REF71913150,151.97,0.0,233176.52
2023-09-15,2023-09-15,Payment from Griffin-Ortega,REF12763635,0.0,212.61,233389.13
2023-09-15,2023-09-15,Project payment - Hayes-Mclean,REF60103867,0.0,670.62,234059.75
2023-09-15,2023-09-15,Invoice payment - Thompson-Baker,REF62408585,0.0,1063.06,235122.81
2023-09-15,2023-09-15,Invoice payment - Keller-Stewart,REF28422873,0.0,742.51,235865.32
2023-09-15,2023-09-15,Invoice payment - Wheeler PLC,REF76392732,0.0,824.55,236689.87
2023-09-15,2023-09-15,"Project payment - Andrews, Stanton and Hines",REF82980715,0.0,412.96,237102.83
2023-09-15,2023-09-15,Payment from Tran Inc,REF37077125,0.0,724.59,237827.42
2023-09-15,2023-09-15,"Payment from Gould, Moran and Thomas",REF20553138,0.0,1119.98,238947.4
2023-09-16,2023-09-16,Business travel,REF49956710,601.67,0.0,238345.73
2023-09-17,2023-09-17,Accounting expense,REF98760348,245.03,0.0,238100.7
2023-09-19,2023-09-19,Business travel,REF67641849,751.82,0.0,237348.88
2023-09-21,2023-09-21,Professional software license,REF86533771,235.01,0.0,237113.87
2023-09-25,2023-09-25,Business meal,REF37245648,257.92,0.0,236855.95
2023-09-29,2023-09-29,Business travel,REF92708452,249.54,0.0,236606.41
2023-10-05,2023-10-05,Training/conference,REF76456021,234.79,0.0,236371.62
2023-10-10,2023-10-10,Business meal,REF89422369,369.1,0.0,236002.52
2023-10-10,2023-10-10,Business travel,REF63773924,724.88,0.0,235277.64
2023-10-11,2023-10-11,Business meal,REF43907906,236.88,0.0,235040.76
2023-10-11,2023-10-11,Business travel,REF92207432,388.93,0.0,234651.83
2023-10-15,2023-10-15,Project payment - Griffin-Ortega,REF72940400,0.0,310.79,234962.62
2023-10-15,2023-10-15,"Project payment - Gould, Moran and Thomas",REF75869020,0.0,904.57,235867.19
2023-10-15,2023-10-15,Service payment - Thompson-Baker,REF38625124,0.0,1038.98,236906.17
2023-10-15,2023-10-15,Invoice payment - Wheeler PLC,REF51441827,0.0,913.58,237819.75
2023-10-15,2023-10-15,Payment from Tran Inc,REF95860205,0.0,786.54,238606.29
2023-10-15,2023-10-15,Business insurance premium,REF99375959,175.08,0.0,238431.21
2023-10-15,2023-10-15,Project payment - Hayes-Mclean,REF51263579,0.0,731.83,239163.04
2023-10-15,2023-10-15,Project payment - Keller-Stewart,REF73110951,0.0,591.73,239754.77
2023-10-15,2023-10-15,"Payment from Andrews, Stanton and Hines",REF79677021,0.0,636.71,240391.48
2023-10-21,2023-10-21,Professional software license,REF47259794,214.65,0.0,240176.83
2023-11-01,2023-11-01,Business meal,REF80110659,397.15,0.0,239779.68
2023-11-10,2023-11-10,Equipment purchase,REF36505935,88.68,0.0,239691.0
2023-11-10,2023-11-10,Coworking space rental,REF39075360,238.91,0.0,239452.09
2023-11-14,2023-11-14,Equipment purchase,REF27081575,210.58,0.0,239241.51
2023-11-15,2023-11-15,"Payment from Andrews, Stanton and Hines",REF70291621,0.0,530.56,239772.07
2023-11-15,2023-11-15,Service payment - Tran Inc,REF33561746,0.0,674.75,240446.82
2023-11-15,2023-11-15,Invoice payment - Keller-Stewart,REF25058776,0.0,584.01,241030.83
2023-11-15,2023-11-15,Invoice payment - Hayes-Mclean,REF57446356,0.0,757.53,241788.36
2023-11-15,2023-11-15,Payment from Wheeler PLC,REF72546673,0.0,735.13,242523.49
2023-11-15,2023-11-15,"Payment from Gould, Moran and Thomas",REF53969026,0.0,784.04,243307.53
2023-11-15,2023-11-15,Business insurance premium,REF36295934,157.63,0.0,243149.9
2023-11-15,2023-11-15,Project payment - Griffin-Ortega,REF66768011,0.0,297.77,243447.67
2023-11-15,2023-11-15,Payment from Thompson-Baker,REF66688675,0.0,876.94,244324.61
2023-11-21,2023-11-21,Professional software license,REF78941172,225.85,0.0,244098.76
2023-11-27,2023-11-27,Marketing expenses,REF52971264,242.53,0.0,243856.23
2023-12-02,2023-12-02,Marketing expenses,REF81353556,271.82,0.0,243584.41
2023-12-07,2023-12-07,Marketing expenses,REF60820632,212.46,0.0,243371.95
2023-12-11,2023-12-11,Coworking space rental,REF66033704,154.07,0.0,243217.88
2023-12-12,2023-12-12,Business travel,REF97132302,176.37,0.0,243041.51
2023-12-15,2023-12-15,Business insurance premium,REF88382288,110.27,0.0,242931.24
2023-12-15,2023-12-15,Service payment - Keller-Stewart,REF98046416,0.0,411.72,243342.96
2023-12-15,2023-12-15,Service payment - Tran Inc,REF31764231,0.0,670.48,244013.44
2023-12-15,2023-12-15,Service payment - Hayes-Mclean,REF93344255,0.0,676.09,244689.53
2023-12-15,2023-12-15,Invoice payment - Griffin-Ortega,REF39021582,0.0,253.94,244943.47
2023-12-15,2023-12-15,"Project payment - Gould, Moran and Thomas",REF42366684,0.0,755.27,245698.74
2023-12-15,2023-12-15,Project payment - Thompson-Baker,REF66451914,0.0,629.67,246328.41
2023-12-15,2023-12-15,"Project payment - Andrews, Stanton and Hines",REF39134263,0.0,538.81,246867.22
2023-12-15,2023-12-15,Project payment - Wheeler PLC,REF93376733,0.0,599.29,247466.51
2023-12-21,2023-12-21,Professional software license,REF42992172,176.02,0.0,247290.49
2023-12-24,2023-12-24,Accounting expense,REF32726291,257.51,0.0,247032.98
2023-12-28,2023-12-28,Equipment purchase,REF64485708,121.4,0.0,246911.58
2024-01-02,2024-01-02,Training/conference,REF38967199,274.48,0.0,246637.1
2024-01-04,2024-01-04,Equipment purchase,REF70438915,202.98,0.0,246434.12
2024-01-07,2024-01-07,Business travel,REF60617729,552.35,0.0,245881.77
2024-01-10,2024-01-10,Business travel,REF53659323,208.73,0.0,245673.04
2024-01-15,2024-01-15,Service payment - Thompson-Baker,REF98320193,0.0,675.58,246348.62
2024-01-15,2024-01-15,Service payment - Wheeler PLC,REF62651639,0.0,1127.85,247476.47
2024-01-15,2024-01-15,"Project payment - Andrews, Stanton and Hines",REF10838068,0.0,708.61,248185.08
2024-01-15,2024-01-15,Invoice payment - Keller-Stewart,REF68512467,0.0,737.42,248922.5
2024-01-15,2024-01-15,"Invoice payment - Gould, Moran and Thomas",REF80932265,0.0,825.42,249747.92
2024-01-15,2024-01-15,Project payment - Tran Inc,REF63381495,0.0,851.2,250599.12
2024-01-15,2024-01-15,Business insurance premium,REF76344237,165.41,0.0,250433.71
2024-01-15,2024-01-15,Project payment - Griffin-Ortega,REF75960397,0.0,305.44,250739.15
2024-01-21,2024-01-21,Professional software license,REF98027644,275.75,0.0,250463.4
2024-01-21,2024-01-21,Equipment purchase,REF20929429,129.23,0.0,250334.17
2024-01-22,2024-01-22,Training/conference,REF92336620,196.67,0.0,250137.5
2024-01-28,2024-01-28,Training/conference,REF85894852,143.19,0.0,249994.31
2024-01-29,2024-01-29,Business travel,REF46750479,504.19,0.0,249490.12
2024-01-30,2024-01-30,Coworking space rental,REF65071676,415.73,0.0,249074.39
2024-02-03,2024-02-03,Business meal,REF75703165,274.18,0.0,248800.21
2024-02-05,2024-02-05,Accounting expense,REF53893042,202.21,0.0,248598.0
2024-02-07,2024-02-07,Training/conference,REF50244499,175.33,0.0,248422.67
2024-02-08,2024-02-08,Equipment purchase,REF22122239,73.2,0.0,248349.47
2024-02-09,2024-02-09,Accounting expense,REF32178504,284.01,0.0,248065.46
2024-02-11,2024-02-11,Equipment purchase,REF34072788,29.83,0.0,248035.63
2024-02-15,2024-02-15,Business insurance premium,REF71755627,154.23,0.0,247881.4
2024-02-15,2024-02-15,"Payment from Gould, Moran and Thomas",REF98531502,0.0,855.33,248736.73
2024-02-15,2024-02-15,Payment from Wheeler PLC,REF71262012,0.0,721.52,249458.25
2024-02-15,2024-02-15,Service payment - Thompson-Baker,REF67538075,0.0,856.12,250314.37
2024-02-15,2024-02-15,Invoice payment - Hayes-Mclean,REF22412305,0.0,674.29,250988.66
2024-02-15,2024-02-15,Payment from Griffin-Ortega,REF36515139,0.0,316.85,251305.51
2024-02-15,2024-02-15,Project payment - Tran Inc,REF85389982,0.0,788.47,252093.98
2024-02-15,2024-02-15,Invoice payment - Keller-Stewart,REF94450513,0.0,753.74,252847.72
2024-02-18,2024-02-18,Training/conference,REF87291490,137.7,0.0,252710.02
2024-02-21,2024-02-21,Training/conference,REF11333025,245.71,0.0,252464.31
2024-02-21,2024-02-21,Professional software license,REF68780510,239.75,0.0,252224.56
2024-02-26,2024-02-26,Business meal,REF79572608,317.32,0.0,251907.24
2024-03-01,2024-03-01,Business meal,REF10825798,134.09,0.0,251773.15
2024-03-02,2024-03-02,Coworking space rental,REF29956427,227.67,0.0,251545.48
2024-03-03,2024-03-03,Coworking space rental,REF76557046,243.05,0.0,251302.43
2024-03-05,2024-03-05,Business travel,REF48232193,532.67,0.0,250769.76
2024-03-05,2024-03-05,Coworking space rental,REF72974685,353.92,0.0,250415.84
2024-03-10,2024-03-10,Business meal,REF23786199,213.61,0.0,250202.23
2024-03-11,2024-03-11,Coworking space rental,REF35306607,209.83,0.0,249992.4
2024-03-15,2024-03-15,Business insurance premium,REF79572904,139.69,0.0,249852.71
2024-03-15,2024-03-15,Invoice payment - Keller-Stewart,REF90084046,0.0,615.6,250468.31
2024-03-15,2024-03-15,Invoice payment - Griffin-Ortega,REF73490897,0.0,324.23,250792.54
2024-03-15,2024-03-15,"Service payment - Andrews, Stanton and Hines",REF22174675,0.0,428.82,251221.36
2024-03-15,2024-03-15,Invoice payment - Hayes-Mclean,REF93755878,0.0,741.89,251963.25
2024-03-15,2024-03-15,Project payment - Thompson-Baker,REF18172404,0.0,809.05,252772.3
2024-03-15,2024-03-15,Payment from Wheeler PLC,REF70901044,0.0,582.69,253354.99
2024-03-15,2024-03-15,Payment from Tran Inc,REF66697198,0.0,822.44,254177.43
2024-03-15,2024-03-15,"Service payment - Gould, Moran and Thomas",REF22807719,0.0,737.74,254915.17
2024-03-16,2024-03-16,Marketing expenses,REF10642974,278.3,0.0,254636.87
2024-03-17,2024-03-17,Coworking space rental,REF77599931,592.38,0.0,254044.49
2024-03-20,2024-03-20,Training/conference,REF94062475,253.93,0.0,253790.56
2024-03-21,2024-03-21,Coworking space rental,REF48037893,352.96,0.0,253437.6
2024-03-21,2024-03-21,Professional software license,REF43163750,203.81,0.0,253233.79
2024-03-23,2024-03-23,Marketing expenses,REF42208939,269.15,0.0,252964.64
2024-03-24,2024-03-24,Coworking space rental,REF21165361,187.39,0.0,252777.25
2024-03-24,2024-03-24,Business travel,REF58376634,463.91,0.0,252313.34
2024-03-27,2024-03-27,Training/conference,REF39346602,213.5,0.0,252099.84
2024-04-01,2024-04-01,Equipment purchase,REF79697953,108.32,0.0,251991.52
2024-04-03,2024-04-03,Coworking space rental,REF49210312,271.86,0.0,251719.66
2024-04-06,2024-04-06,Training/conference,REF47601709,295.04,0.0,251424.62
2024-04-08,2024-04-08,Accounting expense,REF18770981,150.64,0.0,251273.98
2024-04-15,2024-04-15,Business insurance premium,REF35727879,160.15,0.0,251113.83
2024-04-15,2024-04-15,Invoice payment - Hayes-Mclean,REF95264727,0.0,687.13,251800.96
2024-04-15,2024-04-15,Project payment - Keller-Stewart,REF62824485,0.0,325.49,252126.45
2024-04-15,2024-04-15,"Invoice payment - Andrews, Stanton and Hines",REF73012241,0.0,457.59,252584.04
2024-04-15,2024-04-15,"Invoice payment - Gould, Moran and Thomas",REF50833328,0.0,946.12,253530.16
2024-04-15,2024-04-15,Payment from Tran Inc,REF26649056,0.0,583.78,254113.94
2024-04-15,2024-04-15,Project payment - Thompson-Baker,REF28991711,0.0,817.04,254930.98
2024-04-20,2024-04-20,Coworking space rental,REF88644103,229.82,0.0,254701.16
2024-04-21,2024-04-21,Professional software license,REF52052894,214.13,0.0,254487.03
2024-04-23,2024-04-23,Business travel,REF82484124,396.63,0.0,254090.4
2024-04-30,2024-04-30,Equipment purchase,REF38643609,206.52,0.0,253883.88
2024-05-02,2024-05-02,Business meal,REF76804822,199.75,0.0,253684.13
2024-05-05,2024-05-05,Coworking space rental,REF32474668,319.22,0.0,253364.91
2024-05-10,2024-05-10,Business meal,REF81868350,227.33,0.0,253137.58
2024-05-14,2024-05-14,Equipment purchase,REF70171197,99.52,0.0,253038.06
2024-05-15,2024-05-15,Invoice payment - Hayes-Mclean,REF72788719,0.0,517.59,253555.65
2024-05-15,2024-05-15,Business insurance premium,REF68086863,131.57,0.0,253424.08
2024-05-15,2024-05-15,Invoice payment - Wheeler PLC,REF59956854,0.0,645.94,254070.02
2024-05-15,2024-05-15,Project payment - Thompson-Baker,REF99826245,0.0,651.01,254721.03
2024-05-15,2024-05-15,Invoice payment - Keller-Stewart,REF38646629,0.0,605.57,255326.6
2024-05-15,2024-05-15,Payment from Griffin-Ortega,REF73531876,0.0,338.0,255664.6
2024-05-15,2024-05-15,"Payment from Andrews, Stanton and Hines",REF93890460,0.0,532.82,256197.42
2024-05-15,2024-05-15,Service payment - Tran Inc,REF97956091,0.0,566.48,256763.9
2024-05-16,2024-05-16,Business meal,REF15950595,113.16,0.0,256650.74
2024-05-21,2024-05-21,Professional software license,REF23664106,195.69,0.0,256455.05
2024-05-22,2024-05-22,Business travel,REF59977456,333.0,0.0,256122.05
2024-05-28,2024-05-28,Coworking space rental,REF85353721,317.91,0.0,255804.14
2024-05-31,2024-05-31,Equipment purchase,REF55435206,132.04,0.0,255672.1
2024-06-12,2024-06-12,Business travel,REF32218491,264.25,0.0,255407.85
2024-06-14,2024-06-14,Marketing expenses,REF68603190,247.68,0.0,255160.17
2024-06-15,2024-06-15,Project payment - Tran Inc,REF93924815,0.0,500.95,255661.12
2024-06-15,2024-06-15,Service payment - Griffin-Ortega,REF37713350,0.0,177.23,255838.35
2024-06-15,2024-06-15,Service payment - Keller-Stewart,REF32908993,0.0,490.86,256329.21
2024-06-15,2024-06-15,"Project payment - Gould, Moran and Thomas",REF53476580,0.0,647.57,256976.78
2024-06-15,2024-06-15,Project payment - Thompson-Baker,REF23801747,0.0,670.28,257647.06
2024-06-15,2024-06-15,Project payment - Hayes-Mclean,REF34123013,0.0,555.03,258202.09
2024-06-15,2024-06-15,"Service payment - Andrews, Stanton and Hines",REF68694074,0.0,340.06,258542.15
2024-06-15,2024-06-15,Business insurance premium,REF50035634,122.9,0.0,258419.25
2024-06-19,2024-06-19,Coworking space rental,REF19711493,215.61,0.0,258203.64
2024-06-20,2024-06-20,Business meal,REF35156499,241.73,0.0,257961.91
2024-06-21,2024-06-21,Professional software license,REF85189138,166.64,0.0,257795.27
2024-06-25,2024-06-25,Coworking space rental,REF26928910,247.4,0.0,257547.87
2024-07-09,2024-07-09,Training/conference,REF52320806,165.36,0.0,257382.51
2024-07-14,2024-07-14,Accounting expense,REF25460542,165.81,0.0,257216.7
2024-07-15,2024-07-15,Invoice payment - Keller-Stewart,REF82812834,0.0,341.71,257558.41
2024-07-15,2024-07-15,Payment from Tran Inc,REF77673057,0.0,469.52,258027.93
2024-07-15,2024-07-15,Business insurance premium,REF11111905,88.92,0.0,257939.01
2024-07-15,2024-07-15,Invoice payment - Thompson-Baker,REF20002738,0.0,582.87,258521.88
2024-07-15,2024-07-15,Payment from Hayes-Mclean,REF44281131,0.0,551.93,259073.81
2024-07-15,2024-07-15,"Service payment - Gould, Moran and Thomas",REF68778252,0.0,757.27,259831.08
2024-07-15,2024-07-15,Payment from Wheeler PLC,REF34727007,0.0,490.0,260321.08
2024-07-17,2024-07-17,Business travel,REF72186015,183.76,0.0,260137.32
2024-07-21,2024-07-21,Professional software license,REF28682826,141.0,0.0,259996.32
2024-07-23,2024-07-23,Business travel,REF52214166,359.66,0.0,259636.66
2024-07-28,2024-07-28,Equipment purchase,REF29610438,127.91,0.0,259508.75
2024-08-07,2024-08-07,Coworking space rental,REF74853599,196.14,0.0,259312.61
2024-08-09,2024-08-09,Coworking space rental,REF53493294,360.86,0.0,258951.75
2024-08-15,2024-08-15,Payment from Thompson-Baker,REF37196595,0.0,737.9,259689.65
2024-08-15,2024-08-15,Business insurance premium,REF89676635,105.86,0.0,259583.79
2024-08-15,2024-08-15,"Invoice payment - Andrews, Stanton and Hines",REF22439172,0.0,344.55,259928.34
2024-08-15,2024-08-15,Invoice payment - Hayes-Mclean,REF84186912,0.0,483.91,260412.25
2024-08-15,2024-08-15,Invoice payment - Keller-Stewart,REF58562930,0.0,374.71,260786.96
2024-08-15,2024-08-15,Service payment - Griffin-Ortega,REF17247476,0.0,206.83,260993.79
2024-08-15,2024-08-15,"Invoice payment - Gould, Moran and Thomas",REF72586852,0.0,558.33,261552.12
2024-08-15,2024-08-15,Service payment - Tran Inc,REF80944911,0.0,512.4,262064.52
2024-08-16,2024-08-16,Business meal,REF94926800,159.57,0.0,261904.95
2015-08-21,2015-08-21,Professional software license,REF41694024,161.86,0.0,6467.99
2015-08-30,2015-08-30,Accounting expense,REF95412930,165.94,0.0,6302.05
2015-09-05,2015-09-05,Business travel,REF97470391,436.84,0.0,5865.21
2015-09-06,2015-09-06,Business travel,REF21262510,240.73,0.0,5624.48
2015-09-15,2015-09-15,Project payment - Lucero-Pope,REF53737732,0.0,615.51,6239.99
2015-09-15,2015-09-15,Marketing expenses,REF63960223,485.97,0.0,5754.02
2015-09-15,2015-09-15,"Service payment - Hurley, Johnson and Bell",REF43271922,0.0,696.1,6450.12
2015-09-15,2015-09-15,Invoice payment - Wells Inc,REF48389675,0.0,400.06,6850.18
2015-09-15,2015-09-15,"Service payment - Horton, Adams and Smith",REF45486805,0.0,456.71,7306.89
2015-09-15,2015-09-15,"Invoice payment - Wilson, Murphy and Sanders",REF14438049,0.0,1220.33,8527.22
2015-09-15,2015-09-15,"Service payment - Howard, Cunningham and Murphy",REF54591959,0.0,453.56,8980.78
2015-09-15,2015-09-15,"Invoice payment - Hernandez, Jones and Adams",REF91186892,0.0,821.93,9802.71
2015-09-15,2015-09-15,"Payment from Hernandez, Sanders and Williams",REF72099877,0.0,552.21,10354.92
2015-09-15,2015-09-15,Business insurance premium,REF88105400,153.16,0.0,10201.76
2015-09-21,2015-09-21,Professional software license,REF23427035,264.35,0.0,9937.41
2015-10-08,2015-10-08,Marketing expenses,REF42873470,423.7,0.0,9513.71
2015-10-11,2015-10-11,Business meal,REF56850715,376.99,0.0,9136.72
2015-10-15,2015-10-15,Business insurance premium,REF45294463,174.14,0.0,8962.58
2015-10-15,2015-10-15,Business meal,REF40377034,196.34,0.0,8766.24
2015-10-15,2015-10-15,"Invoice payment - Howard, Cunningham and Murphy",REF65689960,0.0,567.21,9333.45
2015-10-15,2015-10-15,"Invoice payment - Hurley, Johnson and Bell",REF69554156,0.0,507.52,9840.97
2015-10-15,2015-10-15,"Invoice payment - Hernandez, Sanders and Williams",REF68369408,0.0,645.35,10486.32
2015-10-15,2015-10-15,"Invoice payment - Wilson, Murphy and Sanders",REF35243227,0.0,1307.19,11793.51
2015-10-15,2015-10-15,"Project payment - Hernandez, Jones and Adams",REF22870148,0.0,650.62,12444.13
2015-10-15,2015-10-15,Invoice payment - Lucero-Pope,REF31704762,0.0,767.96,13212.09
2015-10-15,2015-10-15,"Payment from Horton, Adams and Smith",REF35616964,0.0,424.23,13636.32
2015-10-15,2015-10-15,Service payment - Wells Inc,REF38863028,0.0,465.32,14101.64
2015-10-16,2015-10-16,Business travel,REF31299867,351.9,0.0,13749.74
2015-10-18,2015-10-18,Business travel,REF42267039,366.46,0.0,13383.28
2015-10-19,2015-10-19,Marketing expenses,REF29208301,499.11,0.0,12884.17
2015-10-21,2015-10-21,Professional software license,REF72455718,247.62,0.0,12636.55
2015-10-24,2015-10-24,Accounting expense,REF14354831,209.1,0.0,12427.45
2015-10-25,2015-10-25,Business meal,REF44968360,316.34,0.0,12111.11
2015-10-26,2015-10-26,Marketing expenses,REF88588616,452.21,0.0,11658.9
2015-11-01,2015-11-01,Coworking space rental,REF76317982,387.47,0.0,11271.43
2015-11-02,2015-11-02,Training/conference,REF17240373,82.77,0.0,11188.66
2015-11-02,2015-11-02,Accounting expense,REF72529306,175.27,0.0,11013.39
2015-11-12,2015-11-12,Business travel,REF50777532,536.34,0.0,10477.05
2015-11-12,2015-11-12,Equipment purchase,REF67331961,162.38,0.0,10314.67
2015-11-15,2015-11-15,Business insurance premium,REF65638151,154.69,0.0,10159.98
2015-11-15,2015-11-15,"Service payment - Horton, Adams and Smith",REF25030755,0.0,617.12,10777.1
2015-11-15,2015-11-15,Project payment - Lucero-Pope,REF98858886,0.0,653.04,11430.14
2015-11-15,2015-11-15,"Service payment - Wilson, Murphy and Sanders",REF12297335,0.0,934.53,12364.67
2015-11-15,2015-11-15,"Payment from Hernandez, Sanders and Williams",REF48744026,0.0,555.69,12920.36
2015-11-15,2015-11-15,"Invoice payment - Howard, Cunningham and Murphy",REF44973839,0.0,567.84,13488.2
2015-11-15,2015-11-15,"Service payment - Hernandez, Jones and Adams",REF54575480,0.0,569.64,14057.84
2015-11-15,2015-11-15,Payment from Wells Inc,REF97581942,0.0,356.92,14414.76
2015-11-19,2015-11-19,Training/conference,REF12200105,242.16,0.0,14172.6
2015-11-20,2015-11-20,Accounting expense,REF98857494,241.65,0.0,13930.95
2015-11-21,2015-11-21,Training/conference,REF34290463,109.7,0.0,13821.25
2015-11-21,2015-11-21,Marketing expenses,REF33210864,324.45,0.0,13496.8
2015-11-21,2015-11-21,Professional software license,REF25750772,220.96,0.0,13275.84
2015-12-03,2015-12-03,Business travel,REF73662171,284.62,0.0,12991.22
2015-12-09,2015-12-09,Accounting expense,REF12326453,139.75,0.0,12851.47
2015-12-11,2015-12-11,Equipment purchase,REF76229565,142.89,0.0,12708.58
2015-12-15,2015-12-15,Business insurance premium,REF35403837,114.59,0.0,12593.99
2015-12-15,2015-12-15,"Service payment - Hernandez, Sanders and Williams",REF46802009,0.0,612.7,13206.69
2015-12-15,2015-12-15,Project payment - Lucero-Pope,REF97155492,0.0,606.43,13813.12
2015-12-15,2015-12-15,Invoice payment - Wells Inc,REF15872746,0.0,356.52,14169.64
2015-12-15,2015-12-15,"Invoice payment - Hurley, Johnson and Bell",REF32356393,0.0,665.39,14835.03
2015-12-15,2015-12-15,"Invoice payment - Hernandez, Jones and Adams",REF88144149,0.0,601.42,15436.45
2015-12-15,2015-12-15,"Service payment - Wilson, Murphy and Sanders",REF21339392,0.0,948.34,16384.79
2015-12-15,2015-12-15,"Payment from Horton, Adams and Smith",REF69858845,0.0,307.24,16692.03
2015-12-15,2015-12-15,"Invoice payment - Howard, Cunningham and Murphy",REF69329052,0.0,454.05,17146.08
2015-12-18,2015-12-18,Equipment purchase,REF93190619,102.01,0.0,17044.07
2015-12-20,2015-12-20,Coworking space rental,REF65885448,241.73,0.0,16802.34
2015-12-21,2015-12-21,Professional software license,REF11195839,208.83,0.0,16593.51
2015-12-30,2015-12-30,Business travel,REF17745236,433.82,0.0,16159.69
2016-01-15,2016-01-15,Marketing expenses,REF97693725,336.85,0.0,15822.84
2016-01-15,2016-01-15,"Project payment - Howard, Cunningham and Murphy",REF25681430,0.0,621.45,16444.29
2016-01-15,2016-01-15,Invoice payment - Wells Inc,REF92824110,0.0,381.36,16825.65
2016-01-15,2016-01-15,"Project payment - Hernandez, Sanders and Williams",REF77468959,0.0,1000.07,17825.72
2016-01-15,2016-01-15,"Invoice payment - Horton, Adams and Smith",REF94711777,0.0,478.52,18304.24
2016-01-15,2016-01-15,"Invoice payment - Wilson, Murphy and Sanders",REF52636125,0.0,1341.2,19645.44
2016-01-15,2016-01-15,Business insurance premium,REF93778449,178.05,0.0,19467.39
2016-01-15,2016-01-15,"Payment from Hurley, Johnson and Bell",REF10016231,0.0,933.83,20401.22
2016-01-15,2016-01-15,Project payment - Lucero-Pope,REF46274311,0.0,579.13,20980.35
2016-01-15,2016-01-15,"Project payment - Hernandez, Jones and Adams",REF23686959,0.0,616.73,21597.08
2016-01-16,2016-01-16,Equipment purchase,REF34572622,159.54,0.0,21437.54
2016-01-21,2016-01-21,Professional software license,REF42059744,221.06,0.0,21216.48
2016-01-22,2016-01-22,Business meal,REF88679296,302.98,0.0,20913.5
2016-01-24,2016-01-24,Business meal,REF47416010,325.42,0.0,20588.08
2016-01-26,2016-01-26,Coworking space rental,REF67877147,486.16,0.0,20101.92
2016-01-27,2016-01-27,Business travel,REF37661285,485.72,0.0,19616.2
2016-01-30,2016-01-30,Marketing expenses,REF57174267,405.03,0.0,19211.17
2016-02-02,2016-02-02,Accounting expense,REF25757070,318.94,0.0,18892.23
2016-02-10,2016-02-10,Business travel,REF29167377,634.01,0.0,18258.22
2016-02-15,2016-02-15,"Project payment - Hernandez, Sanders and Williams",REF75648154,0.0,864.39,19122.61
2016-02-15,2016-02-15,Business insurance premium,REF81877328,168.43,0.0,18954.18
2016-02-15,2016-02-15,"Payment from Howard, Cunningham and Murphy",REF90668433,0.0,558.25,19512.43
2016-02-15,2016-02-15,Invoice payment - Wells Inc,REF92594771,0.0,483.67,19996.1
2016-02-15,2016-02-15,Invoice payment - Lucero-Pope,REF73508423,0.0,650.03,20646.13
2016-02-15,2016-02-15,"Project payment - Hernandez, Jones and Adams",REF28187441,0.0,620.34,21266.47
2016-02-15,2016-02-15,"Service payment - Horton, Adams and Smith",REF68673570,0.0,482.47,21748.94
2016-02-15,2016-02-15,"Service payment - Wilson, Murphy and Sanders",REF43911954,0.0,1083.46,22832.4
2016-02-15,2016-02-15,"Service payment - Hurley, Johnson and Bell",REF69045947,0.0,765.6,23598.0
2016-02-19,2016-02-19,Marketing expenses,REF57758292,326.63,0.0,23271.37
2016-02-21,2016-02-21,Professional software license,REF15870286,216.4,0.0,23054.97
2016-02-24,2016-02-24,Accounting expense,REF92210017,350.45,0.0,22704.52
2016-02-27,2016-02-27,Marketing expenses,REF50310954,253.89,0.0,22450.63
2016-03-08,2016-03-08,Accounting expense,REF45817550,214.21,0.0,22236.42
2016-03-09,2016-03-09,Business meal,REF30383279,241.34,0.0,21995.08
2016-03-15,2016-03-15,Business insurance premium,REF54885751,141.01,0.0,21854.07
2016-03-15,2016-03-15,"Service payment - Howard, Cunningham and Murphy",REF90138727,0.0,501.55,22355.62
2016-03-15,2016-03-15,"Payment from Hernandez, Jones and Adams",REF28028959,0.0,605.34,22960.96
2016-03-15,2016-03-15,"Payment from Hernandez, Sanders and Williams",REF75388851,0.0,598.6,23559.56
2016-03-15,2016-03-15,"Project payment - Horton, Adams and Smith",REF72134552,0.0,493.46,24053.02
2016-03-15,2016-03-15,"Project payment - Wilson, Murphy and Sanders",REF49184244,0.0,687.39,24740.41
2016-03-15,2016-03-15,Invoice payment - Wells Inc,REF41105179,0.0,512.91,25253.32
2016-03-15,2016-03-15,Coworking space rental,REF40456601,340.62,0.0,24912.7
2016-03-15,2016-03-15,Service payment - Lucero-Pope,REF83093331,0.0,676.79,25589.49
2016-03-15,2016-03-15,"Service payment - Hurley, Johnson and Bell",REF58953088,0.0,885.76,26475.25
2016-03-16,2016-03-16,Training/conference,REF14843089,213.22,0.0,26262.03
2016-03-19,2016-03-19,Business travel,REF95697704,432.2,0.0,25829.83
2016-03-21,2016-03-21,Professional software license,REF18380436,188.85,0.0,25640.98
2016-03-21,2016-03-21,Business meal,REF40913163,170.5,0.0,25470.48
2016-03-22,2016-03-22,Accounting expense,REF60802467,156.61,0.0,25313.87
2016-04-14,2016-04-14,Equipment purchase,REF79991664,145.81,0.0,25168.06
2016-04-15,2016-04-15,"Payment from Hurley, Johnson and Bell",REF75228666,0.0,601.79,25769.85
2016-04-15,2016-04-15,"Project payment - Horton, Adams and Smith",REF20790366,0.0,396.89,26166.74
2016-04-15,2016-04-15,Project payment - Wells Inc,REF91553753,0.0,339.56,26506.3
2016-04-15,2016-04-15,"Service payment - Hernandez, Sanders and Williams",REF53888441,0.0,727.39,27233.69
2016-04-15,2016-04-15,Service payment - Lucero-Pope,REF48688272,0.0,495.66,27729.35
2016-04-15,2016-04-15,"Project payment - Hernandez, Jones and Adams",REF61516645,0.0,610.41,28339.76
2016-04-15,2016-04-15,"Invoice payment - Howard, Cunningham and Murphy",REF63205319,0.0,563.16,28902.92
2016-04-15,2016-04-15,Business insurance premium,REF62690440,143.26,0.0,28759.66
2016-04-15,2016-04-15,"Invoice payment - Wilson, Murphy and Sanders",REF76275121,0.0,868.13,29627.79
2016-04-15,2016-04-15,Business travel,REF66135133,569.02,0.0,29058.77
2016-04-18,2016-04-18,Business travel,REF80994733,170.54,0.0,28888.23
2016-04-21,2016-04-21,Professional software license,REF35088065,192.99,0.0,28695.24
2016-04-25,2016-04-25,Marketing expenses,REF42496534,382.71,0.0,28312.53
2016-04-28,2016-04-28,Business travel,REF95759758,367.35,0.0,27945.18
2016-05-09,2016-05-09,Business travel,REF51816906,366.41,0.0,27578.77
2016-05-12,2016-05-12,Equipment purchase,REF62645359,26.62,0.0,27552.15
2016-05-15,2016-05-15,Business insurance premium,REF41469003,113.22,0.0,27438.93
2016-05-15,2016-05-15,"Project payment - Wilson, Murphy and Sanders",REF78111055,0.0,1270.63,28709.56
2016-05-15,2016-05-15,"Service payment - Hurley, Johnson and Bell",REF98022331,0.0,615.38,29324.94
2016-05-15,2016-05-15,Invoice payment - Lucero-Pope,REF26886408,0.0,418.63,29743.57
2016-05-15,2016-05-15,"Service payment - Hernandez, Sanders and Williams",REF71110963,0.0,585.37,30328.94
2016-05-15,2016-05-15,"Payment from Howard, Cunningham and Murphy",REF22416850,0.0,488.55,30817.49
2016-05-15,2016-05-15,Project payment - Wells Inc,REF89867132,0.0,331.67,31149.16
2016-05-15,2016-05-15,"Payment from Hernandez, Jones and Adams",REF69328983,0.0,553.43,31702.59
2016-05-15,2016-05-15,"Project payment - Horton, Adams and Smith",REF39176768,0.0,363.81,32066.4
2016-05-19,2016-05-19,Accounting expense,REF86110896,224.05,0.0,31842.35
2016-05-21,2016-05-21,Professional software license,REF99236006,183.57,0.0,31658.78
2016-05-21,2016-05-21,Accounting expense,REF61695729,157.65,0.0,31501.13
2016-05-23,2016-05-23,Training/conference,REF82820313,182.25,0.0,31318.88
2016-05-31,2016-05-31,Business travel,REF44672267,264.33,0.0,31054.55
2016-06-01,2016-06-01,Business meal,REF60284530,241.37,0.0,30813.18
2016-06-02,2016-06-02,Business meal,REF37452969,171.11,0.0,30642.07
2016-06-04,2016-06-04,Business travel,REF41808040,392.91,0.0,30249.16
2016-06-05,2016-06-05,Business travel,REF96959281,444.64,0.0,29804.52
2016-06-06,2016-06-06,Business meal,REF98825870,221.71,0.0,29582.81
2016-06-08,2016-06-08,Business travel,REF65708734,246.62,0.0,29336.19
2016-06-09,2016-06-09,Marketing expenses,REF22487640,318.31,0.0,29017.88
2016-06-10,2016-06-10,Marketing expenses,REF60514782,181.58,0.0,28836.3
2016-06-12,2016-06-12,Training/conference,REF53185087,106.86,0.0,28729.44
2016-06-15,2016-06-15,"Service payment - Horton, Adams and Smith",REF86838491,0.0,327.51,29056.95
2016-06-15,2016-06-15,"Invoice payment - Hernandez, Sanders and Williams",REF82992895,0.0,474.23,29531.18
2016-06-15,2016-06-15,"Payment from Hernandez, Jones and Adams",REF94488797,0.0,418.06,29949.24
2016-06-15,2016-06-15,Payment from Wells Inc,REF39264750,0.0,303.91,30253.15
2016-06-15,2016-06-15,"Payment from Howard, Cunningham and Murphy",REF30387078,0.0,399.66,30652.81
2016-06-15,2016-06-15,"Project payment - Wilson, Murphy and Sanders",REF23135118,0.0,814.28,31467.09
2016-06-15,2016-06-15,Project payment - Lucero-Pope,REF63141684,0.0,451.35,31918.44
2016-06-15,2016-06-15,Accounting expense,REF23106688,170.67,0.0,31747.77
2016-06-15,2016-06-15,"Invoice payment - Hurley, Johnson and Bell",REF56469613,0.0,461.44,32209.21
2016-06-15,2016-06-15,Business insurance premium,REF28772296,114.06,0.0,32095.15
2016-06-18,2016-06-18,Business travel,REF17212395,319.11,0.0,31776.04
2016-06-21,2016-06-21,Professional software license,REF42487495,167.56,0.0,31608.48
2016-06-25,2016-06-25,Business travel,REF45065491,476.86,0.0,31131.62
2016-06-26,2016-06-26,Coworking space rental,REF12901774,165.03,0.0,30966.59
2016-06-30,2016-06-30,Business travel,REF72974027,308.39,0.0,30658.2
2016-07-07,2016-07-07,Business meal,REF96235505,87.62,0.0,30570.58
2016-07-14,2016-07-14,Business meal,REF52742822,211.08,0.0,30359.5
2016-07-15,2016-07-15,"Invoice payment - Hernandez, Sanders and Williams",REF29390244,0.0,559.15,30918.65
2016-07-15,2016-07-15,"Service payment - Hernandez, Jones and Adams",REF94171140,0.0,381.88,31300.53
2016-07-15,2016-07-15,Service payment - Wells Inc,REF97123813,0.0,300.09,31600.62
2016-07-15,2016-07-15,Business insurance premium,REF75221255,101.37,0.0,31499.25
2016-07-15,2016-07-15,"Invoice payment - Wilson, Murphy and Sanders",REF46255389,0.0,613.05,32112.3
2016-07-15,2016-07-15,"Payment from Howard, Cunningham and Murphy",REF42767286,0.0,290.63,32402.93
2016-07-15,2016-07-15,"Payment from Hurley, Johnson and Bell",REF88081241,0.0,465.3,32868.23
2016-07-15,2016-07-15,Payment from Lucero-Pope,REF92084754,0.0,307.32,33175.55
2016-07-15,2016-07-15,"Project payment - Horton, Adams and Smith",REF52230542,0.0,258.68,33434.23
2016-07-17,2016-07-17,Business travel,REF49636712,163.59,0.0,33270.64
2016-07-18,2016-07-18,Business travel,REF29361218,160.87,0.0,33109.77
2016-07-20,2016-07-20,Marketing expenses,REF53792681,265.52,0.0,32844.25
2016-07-21,2016-07-21,Professional software license,REF32995784,139.75,0.0,32704.5
2016-07-25,2016-07-25,Marketing expenses,REF83641127,311.04,0.0,32393.46
2016-07-28,2016-07-28,Equipment purchase,REF98983494,102.73,0.0,32290.73
2016-07-30,2016-07-30,Training/conference,REF25878865,128.31,0.0,32162.42
2016-08-12,2016-08-12,Business meal,REF94176142,264.69,0.0,31897.73
2016-08-15,2016-08-15,"Payment from Hurley, Johnson and Bell",REF31984269,0.0,520.2,32417.93
2016-08-15,2016-08-15,"Project payment - Hernandez, Sanders and Williams",REF24625786,0.0,590.54,33008.47
2016-08-15,2016-08-15,Service payment - Lucero-Pope,REF50459825,0.0,572.0,33580.47
2016-08-15,2016-08-15,Business insurance premium,REF11204672,125.08,0.0,33455.39
2016-08-15,2016-08-15,"Invoice payment - Horton, Adams and Smith",REF17444222,0.0,410.94,33866.33
2016-08-15,2016-08-15,"Payment from Wilson, Murphy and Sanders",REF46349663,0.0,804.89,34671.22
2016-08-15,2016-08-15,"Payment from Hernandez, Jones and Adams",REF88325511,0.0,505.57,35176.79
2016-08-15,2016-08-15,Project payment - Wells Inc,REF39471353,0.0,326.86,35503.65
2016-08-21,2016-08-21,Professional software license,REF94938979,147.25,0.0,35356.4
2016-08-24,2016-08-24,Coworking space rental,REF97050527,233.31,0.0,35123.09
2016-08-31,2016-08-31,Accounting expense,REF45140151,218.45,0.0,34904.64
2016-09-03,2016-09-03,Marketing expenses,REF56003273,402.86,0.0,34501.78
2016-09-03,2016-09-03,Training/conference,REF85001048,184.35,0.0,34317.43
2016-09-05,2016-09-05,Business meal,REF17963688,144.56,0.0,34172.87
2016-09-06,2016-09-06,Training/conference,REF16662388,297.12,0.0,33875.75
2016-09-11,2016-09-11,Accounting expense,REF39207966,192.95,0.0,33682.8
2016-09-15,2016-09-15,Accounting expense,REF97781703,149.48,0.0,33533.32
2016-09-15,2016-09-15,"Project payment - Horton, Adams and Smith",REF19977593,0.0,565.53,34098.85
2016-09-15,2016-09-15,Service payment - Wells Inc,REF89256136,0.0,392.65,34491.5
2016-09-15,2016-09-15,"Service payment - Wilson, Murphy and Sanders",REF91646158,0.0,818.67,35310.17
2016-09-15,2016-09-15,"Service payment - Hernandez, Jones and Adams",REF15102584,0.0,645.05,35955.22
2016-09-15,2016-09-15,Business insurance premium,REF10156897,153.31,0.0,35801.91
2016-09-15,2016-09-15,"Payment from Hurley, Johnson and Bell",REF58061237,0.0,684.61,36486.52
2016-09-15,2016-09-15,Project payment - Lucero-Pope,REF70140793,0.0,650.68,37137.2
2016-09-15,2016-09-15,"Invoice payment - Howard, Cunningham and Murphy",REF49990473,0.0,549.75,37686.95
2016-09-15,2016-09-15,"Invoice payment - Hernandez, Sanders and Williams",REF43917163,0.0,555.55,38242.5
2016-09-16,2016-09-16,Equipment purchase,REF14966197,233.44,0.0,38009.06
2016-09-18,2016-09-18,Equipment purchase,REF72211630,130.42,0.0,37878.64
2016-09-19,2016-09-19,Coworking space rental,REF71518849,369.04,0.0,37509.6
2016-09-21,2016-09-21,Equipment purchase,REF42560381,178.98,0.0,37330.62
2016-09-21,2016-09-21,Professional software license,REF31636687,243.22,0.0,37087.4
2016-09-22,2016-09-22,Equipment purchase,REF25001417,231.52,0.0,36855.88
2016-09-27,2016-09-27,Coworking space rental,REF95218582,220.95,0.0,36634.93
2016-09-28,2016-09-28,Accounting expense,REF80303491,122.47,0.0,36512.46
2016-10-07,2016-10-07,Business travel,REF76911181,278.96,0.0,36233.5
2016-10-14,2016-10-14,Business meal,REF19517269,461.32,0.0,35772.18
2016-10-15,2016-10-15,Business insurance premium,REF95301039,171.95,0.0,35600.23
2016-10-15,2016-10-15,"Invoice payment - Hurley, Johnson and Bell",REF23588177,0.0,871.62,36471.85
2016-10-15,2016-10-15,Invoice payment - Wells Inc,REF13149971,0.0,538.65,37010.5
2016-10-15,2016-10-15,"Project payment - Wilson, Murphy and Sanders",REF81395144,0.0,1319.73,38330.23
2016-10-15,2016-10-15,Project payment - Lucero-Pope,REF29033017,0.0,669.66,38999.89
2016-10-15,2016-10-15,"Invoice payment - Hernandez, Jones and Adams",REF10007018,0.0,546.72,39546.61
2016-10-15,2016-10-15,"Service payment - Howard, Cunningham and Murphy",REF19146921,0.0,472.12,40018.73
2016-10-15,2016-10-15,"Project payment - Horton, Adams and Smith",REF19640000,0.0,635.09,40653.82
2016-10-15,2016-10-15,"Service payment - Hernandez, Sanders and Williams",REF90101878,0.0,727.12,41380.94
2016-10-16,2016-10-16,Business meal,REF79018150,369.36,0.0,41011.58
2016-10-18,2016-10-18,Business meal,REF93921145,326.0,0.0,40685.58
2016-10-19,2016-10-19,Business meal,REF79199973,423.15,0.0,40262.43
2016-10-21,2016-10-21,Accounting expense,REF69940541,197.69,0.0,40064.74
2016-10-21,2016-10-21,Professional software license,REF44045610,190.24,0.0,39874.5
2016-10-24,2016-10-24,Business meal,REF96099263,209.64,0.0,39664.86
2016-10-28,2016-10-28,Training/conference,REF43993940,170.59,0.0,39494.27
2016-11-10,2016-11-10,Accounting expense,REF17364785,178.07,0.0,39316.2
2016-11-13,2016-11-13,Accounting expense,REF91250605,170.66,0.0,39145.54
2016-11-15,2016-11-15,"Payment from Hurley, Johnson and Bell",REF35888130,0.0,748.48,39894.02
2016-11-15,2016-11-15,"Service payment - Hernandez, Sanders and Williams",REF31942685,0.0,729.04,40623.06
2016-11-15,2016-11-15,"Payment from Wilson, Murphy and Sanders",REF40623945,0.0,987.47,41610.53
2016-11-15,2016-11-15,"Service payment - Howard, Cunningham and Murphy",REF52521634,0.0,533.29,42143.82
2016-11-15,2016-11-15,Project payment - Lucero-Pope,REF99338296,0.0,547.52,42691.34
2016-11-15,2016-11-15,Business insurance premium,REF39245850,152.16,0.0,42539.18
2016-11-15,2016-11-15,"Service payment - Hernandez, Jones and Adams",REF31456174,0.0,575.41,43114.59
2016-11-15,2016-11-15,"Payment from Horton, Adams and Smith",REF11981300,0.0,557.06,43671.65
2016-11-15,2016-11-15,Invoice payment - Wells Inc,REF67858522,0.0,383.98,44055.63
2016-11-21,2016-11-21,Professional software license,REF24065611,211.49,0.0,43844.14
2016-11-24,2016-11-24,Coworking space rental,REF96178150,333.12,0.0,43511.02
2016-11-25,2016-11-25,Marketing expenses,REF75631011,161.34,0.0,43349.68
2016-11-27,2016-11-27,Equipment purchase,REF55525543,140.18,0.0,43209.5
2016-12-02,2016-12-02,Marketing expenses,REF29100971,304.19,0.0,42905.31
2016-12-06,2016-12-06,Training/conference,REF72625666,167.4,0.0,42737.91
2016-12-12,2016-12-12,Business travel,REF92183787,508.85,0.0,42229.06
2016-12-13,2016-12-13,Accounting expense,REF11957793,36.34,0.0,42192.72
2016-12-15,2016-12-15,"Service payment - Howard, Cunningham and Murphy",REF25179190,0.0,554.71,42747.43
2016-12-15,2016-12-15,Invoice payment - Wells Inc,REF83173410,0.0,364.26,43111.69
2016-12-15,2016-12-15,Payment from Lucero-Pope,REF14086929,0.0,650.13,43761.82
2016-12-15,2016-12-15,"Payment from Wilson, Murphy and Sanders",REF23983713,0.0,863.62,44625.44
2016-12-15,2016-12-15,"Service payment - Horton, Adams and Smith",REF53293920,0.0,426.21,45051.65
2016-12-15,2016-12-15,"Payment from Hernandez, Sanders and Williams",REF91360208,0.0,631.25,45682.9
2016-12-15,2016-12-15,Business insurance premium,REF99670522,122.83,0.0,45560.07
2016-12-21,2016-12-21,Professional software license,REF22303899,231.95,0.0,45328.12
2016-12-24,2016-12-24,Business travel,REF95863672,466.22,0.0,44861.9
2016-12-24,2016-12-24,Training/conference,REF20109005,199.48,0.0,44662.42
2016-12-26,2016-12-26,Equipment purchase,REF10725880,154.86,0.0,44507.56
2016-12-27,2016-12-27,Business travel,REF51429316,425.35,0.0,44082.21
2016-12-31,2016-12-31,Accounting expense,REF67763953,146.97,0.0,43935.24
2017-01-09,2017-01-09,Business travel,REF53592791,513.19,0.0,43422.05
2017-01-10,2017-01-10,Business travel,REF86171040,317.8,0.0,43104.25
2017-01-14,2017-01-14,Business meal,REF66145158,319.66,0.0,42784.59
2017-01-15,2017-01-15,"Service payment - Hernandez, Jones and Adams",REF70671773,0.0,598.41,43383.0
2017-01-15,2017-01-15,Coworking space rental,REF45934651,399.85,0.0,42983.15
2017-01-15,2017-01-15,Business insurance premium,REF51456756,180.88,0.0,42802.27
2017-01-15,2017-01-15,Invoice payment - Lucero-Pope,REF80689719,0.0,780.46,43582.73
2017-01-15,2017-01-15,"Service payment - Horton, Adams and Smith",REF47129717,0.0,538.74,44121.47
2017-01-15,2017-01-15,Project payment - Wells Inc,REF98978428,0.0,480.88,44602.35
2017-01-15,2017-01-15,"Project payment - Wilson, Murphy and Sanders",REF84526405,0.0,736.22,45338.57
2017-01-15,2017-01-15,"Invoice payment - Hurley, Johnson and Bell",REF90436378,0.0,693.47,46032.04
2017-01-15,2017-01-15,"Invoice payment - Howard, Cunningham and Murphy",REF53481505,0.0,610.7,46642.74
2017-01-15,2017-01-15,"Invoice payment - Hernandez, Sanders and Williams",REF83952999,0.0,792.01,47434.75
2017-01-16,2017-01-16,Business meal,REF23556234,155.35,0.0,47279.4
2017-01-19,2017-01-19,Business travel,REF89835984,237.33,0.0,47042.07
2017-01-21,2017-01-21,Professional software license,REF72426553,215.9,0.0,46826.17
2017-01-22,2017-01-22,Business meal,REF11524858,290.71,0.0,46535.46
2017-01-24,2017-01-24,Training/conference,REF85091354,175.58,0.0,46359.88
2017-01-27,2017-01-27,Business meal,REF30841214,66.4,0.0,46293.48
2017-01-27,2017-01-27,Business travel,REF66723945,304.52,0.0,45988.96
2017-01-28,2017-01-28,Accounting expense,REF63415870,285.95,0.0,45703.01
2017-01-30,2017-01-30,Equipment purchase,REF64021250,121.41,0.0,45581.6
2017-01-30,2017-01-30,Business travel,REF67615186,272.63,0.0,45308.97
2017-02-02,2017-02-02,Business meal,REF71826772,160.97,0.0,45148.0
2017-02-11,2017-02-11,Business meal,REF68739718,387.45,0.0,44760.55
2017-02-14,2017-02-14,Business travel,REF17539066,399.59,0.0,44360.96
2017-02-15,2017-02-15,"Project payment - Wilson, Murphy and Sanders",REF16532860,0.0,1350.38,45711.34
2017-02-15,2017-02-15,"Project payment - Hernandez, Sanders and Williams",REF34158698,0.0,676.78,46388.12
2017-02-15,2017-02-15,Service payment - Lucero-Pope,REF63779495,0.0,632.38,47020.5
2017-02-15,2017-02-15,Project payment - Wells Inc,REF66227665,0.0,468.52,47489.02
2017-02-15,2017-02-15,"Service payment - Hurley, Johnson and Bell",REF45433425,0.0,629.63,48118.65
2017-02-15,2017-02-15,"Service payment - Howard, Cunningham and Murphy",REF73536762,0.0,523.81,48642.46
2017-02-15,2017-02-15,"Project payment - Hernandez, Jones and Adams",REF23331577,0.0,558.5,49200.96
2017-02-15,2017-02-15,Business insurance premium,REF12793729,144.45,0.0,49056.51
2017-02-18,2017-02-18,Marketing expenses,REF89179688,208.99,0.0,48847.52
2017-02-20,2017-02-20,Training/conference,REF14768980,200.3,0.0,48647.22
2017-02-21,2017-02-21,Professional software license,REF51283671,217.37,0.0,48429.85
2017-02-26,2017-02-26,Accounting expense,REF40667898,255.35,0.0,48174.5
2017-02-27,2017-02-27,Marketing expenses,REF17633990,263.47,0.0,47911.03
2017-02-28,2017-02-28,Equipment purchase,REF50396335,192.07,0.0,47718.96
2017-03-09,2017-03-09,Equipment purchase,REF65950999,136.77,0.0,47582.19
2017-03-15,2017-03-15,Payment from Lucero-Pope,REF39191632,0.0,592.38,48174.57
2017-03-15,2017-03-15,Payment from Wells Inc,REF37823353,0.0,484.18,48658.75
2017-03-15,2017-03-15,"Project payment - Hernandez, Sanders and Williams",REF34071024,0.0,842.11,49500.86
2017-03-15,2017-03-15,Business insurance premium,REF28010502,140.93,0.0,49359.93
2017-03-15,2017-03-15,"Project payment - Horton, Adams and Smith",REF55962064,0.0,447.76,49807.69
2017-03-15,2017-03-15,"Service payment - Hernandez, Jones and Adams",REF25025557,0.0,633.25,50440.94
2017-03-15,2017-03-15,"Invoice payment - Hurley, Johnson and Bell",REF39312712,0.0,667.9,51108.84
2017-03-17,2017-03-17,Coworking space rental,REF71055619,296.34,0.0,50812.5
2017-03-18,2017-03-18,Business meal,REF58872815,289.35,0.0,50523.15
2017-03-21,2017-03-21,Professional software license,REF76216155,182.38,0.0,50340.77
2017-03-23,2017-03-23,Business meal,REF71219150,289.64,0.0,50051.13
2017-03-26,2017-03-26,Business meal,REF34625571,263.88,0.0,49787.25
2017-03-31,2017-03-31,Training/conference,REF41755049,227.2,0.0,49560.05
2017-04-01,2017-04-01,Business meal,REF32580230,308.62,0.0,49251.43
2017-04-01,2017-04-01,Equipment purchase,REF88052992,141.04,0.0,49110.39
2017-04-02,2017-04-02,Business travel,REF84465350,437.78,0.0,48672.61
2017-04-07,2017-04-07,Training/conference,REF70570010,168.23,0.0,48504.38
2017-04-08,2017-04-08,Coworking space rental,REF40886836,333.79,0.0,48170.59
2017-04-10,2017-04-10,Equipment purchase,REF37283620,160.75,0.0,48009.84
2017-04-11,2017-04-11,Business meal,REF64090285,264.74,0.0,47745.1
2017-04-13,2017-04-13,Business meal,REF76704059,150.83,0.0,47594.27
2017-04-15,2017-04-15,Business insurance premium,REF77629723,128.73,0.0,47465.54
2017-04-15,2017-04-15,Accounting expense,REF32372303,246.53,0.0,47219.01
2017-04-15,2017-04-15,"Invoice payment - Hurley, Johnson and Bell",REF51695456,0.0,673.79,47892.8
2017-04-15,2017-04-15,"Service payment - Hernandez, Jones and Adams",REF25551486,0.0,541.48,48434.28
2017-04-15,2017-04-15,Project payment - Lucero-Pope,REF38274844,0.0,615.92,49050.2
2017-04-15,2017-04-15,"Service payment - Hernandez, Sanders and Williams",REF21209933,0.0,673.19,49723.39
2017-04-15,2017-04-15,"Payment from Wilson, Murphy and Sanders",REF33350374,0.0,1033.87,50757.26
2017-04-15,2017-04-15,Invoice payment - Wells Inc,REF97909807,0.0,413.33,51170.59
2017-04-21,2017-04-21,Professional software license,REF58816765,198.07,0.0,50972.52
2017-04-30,2017-04-30,Accounting expense,REF79673552,196.33,0.0,50776.19
2017-05-01,2017-05-01,Equipment purchase,REF42546500,122.75,0.0,50653.44
2017-05-11,2017-05-11,Coworking space rental,REF33585427,287.77,0.0,50365.67
2017-05-15,2017-05-15,Invoice payment - Wells Inc,REF59491504,0.0,381.02,50746.69
2017-05-15,2017-05-15,"Service payment - Hernandez, Jones and Adams",REF40440144,0.0,470.73,51217.42
2017-05-15,2017-05-15,Payment from Lucero-Pope,REF80762675,0.0,519.1,51736.52
2017-05-15,2017-05-15,"Invoice payment - Horton, Adams and Smith",REF94001895,0.0,499.91,52236.43
2017-05-15,2017-05-15,"Payment from Hurley, Johnson and Bell",REF90522405,0.0,644.7,52881.13
2017-05-15,2017-05-15,"Project payment - Howard, Cunningham and Murphy",REF63257049,0.0,585.02,53466.15
2017-05-15,2017-05-15,"Payment from Wilson, Murphy and Sanders",REF62610691,0.0,1202.63,54668.78
2017-05-15,2017-05-15,"Project payment - Hernandez, Sanders and Williams",REF75306443,0.0,560.5,55229.28
2017-05-15,2017-05-15,Business insurance premium,REF34201707,120.74,0.0,55108.54
2017-05-19,2017-05-19,Coworking space rental,REF77306739,366.9,0.0,54741.64
2017-05-21,2017-05-21,Business meal,REF53305533,262.41,0.0,54479.23
2017-05-21,2017-05-21,Professional software license,REF45455954,158.53,0.0,54320.7
2017-05-27,2017-05-27,Business travel,REF51687343,484.14,0.0,53836.56
2017-05-30,2017-05-30,Accounting expense,REF45765016,191.64,0.0,53644.92
2017-05-31,2017-05-31,Marketing expenses,REF18553359,165.36,0.0,53479.56
2017-06-01,2017-06-01,Training/conference,REF21796092,118.7,0.0,53360.86
2017-06-02,2017-06-02,Training/conference,REF52211888,198.93,0.0,53161.93
2017-06-04,2017-06-04,Business travel,REF50191185,321.6,0.0,52840.33
2017-06-05,2017-06-05,Accounting expense,REF74211174,186.91,0.0,52653.42
2017-06-06,2017-06-06,Coworking space rental,REF98002951,257.45,0.0,52395.97
2017-06-07,2017-06-07,Marketing expenses,REF36719477,218.47,0.0,52177.5
2017-06-11,2017-06-11,Business travel,REF44593277,426.0,0.0,51751.5
2017-06-15,2017-06-15,Business travel,REF84924972,389.36,0.0,51362.14
2017-06-15,2017-06-15,"Payment from Howard, Cunningham and Murphy",REF39003711,0.0,402.26,51764.4
2017-06-15,2017-06-15,Service payment - Lucero-Pope,REF90579155,0.0,442.85,52207.25
2017-06-15,2017-06-15,"Service payment - Hernandez, Sanders and Williams",REF53821916,0.0,486.72,52693.97
2017-06-15,2017-06-15,"Service payment - Wilson, Murphy and Sanders",REF13409780,0.0,776.93,53470.9
2017-06-15,2017-06-15,"Project payment - Hernandez, Jones and Adams",REF66578453,0.0,563.43,54034.33
2017-06-15,2017-06-15,"Project payment - Horton, Adams and Smith",REF61748794,0.0,339.34,54373.67
2017-06-15,2017-06-15,Invoice payment - Wells Inc,REF16082808,0.0,248.82,54622.49
2017-06-15,2017-06-15,"Service payment - Hurley, Johnson and Bell",REF54296918,0.0,589.29,55211.78
2017-06-15,2017-06-15,Business insurance premium,REF36110190,116.4,0.0,55095.38
2017-06-16,2017-06-16,Equipment purchase,REF49144163,97.78,0.0,54997.6
2017-06-16,2017-06-16,Training/conference,REF99745781,232.27,0.0,54765.33
2017-06-21,2017-06-21,Professional software license,REF95937630,147.13,0.0,54618.2
2017-06-21,2017-06-21,Business travel,REF34263060,377.74,0.0,54240.46
2017-06-23,2017-06-23,Training/conference,REF71614133,229.54,0.0,54010.92
2017-06-25,2017-06-25,Business meal,REF46433958,229.68,0.0,53781.24
2017-07-01,2017-07-01,Business meal,REF50619013,205.76,0.0,53575.48
2017-07-01,2017-07-01,Business travel,REF45919845,350.13,0.0,53225.35
2017-07-03,2017-07-03,Equipment purchase,REF59498887,107.38,0.0,53117.97
2017-07-09,2017-07-09,Business meal,REF54500550,52.88,0.0,53065.09
2017-07-15,2017-07-15,Invoice payment - Lucero-Pope,REF15878717,0.0,410.27,53475.36
2017-07-15,2017-07-15,"Payment from Hernandez, Jones and Adams",REF74450602,0.0,436.42,53911.78
2017-07-15,2017-07-15,"Project payment - Hurley, Johnson and Bell",REF71370495,0.0,403.04,54314.82
2017-07-15,2017-07-15,Business insurance premium,REF54426863,101.52,0.0,54213.3
2017-07-15,2017-07-15,Service payment - Wells Inc,REF23347160,0.0,329.44,54542.74
2017-07-15,2017-07-15,"Payment from Hernandez, Sanders and Williams",REF75651227,0.0,400.61,54943.35
2017-07-15,2017-07-15,"Payment from Howard, Cunningham and Murphy",REF80112717,0.0,447.01,55390.36
2017-07-15,2017-07-15,"Payment from Horton, Adams and Smith",REF74800721,0.0,347.23,55737.59
2017-07-15,2017-07-15,"Service payment - Wilson, Murphy and Sanders",REF96904881,0.0,709.03,56446.62
2017-07-21,2017-07-21,Professional software license,REF56504427,141.67,0.0,56304.95
2017-07-25,2017-07-25,Equipment purchase,REF44185571,71.82,0.0,56233.13
2017-07-27,2017-07-27,Accounting expense,REF32940589,135.99,0.0,56097.14
2017-07-30,2017-07-30,Business meal,REF62594136,218.13,0.0,55879.01
2017-07-31,2017-07-31,Equipment purchase,REF62838444,137.58,0.0,55741.43
2017-08-07,2017-08-07,Coworking space rental,REF72229589,124.87,0.0,55616.56
2017-08-08,2017-08-08,Business travel,REF80370942,411.4,0.0,55205.16
2017-08-09,2017-08-09,Business meal,REF72939492,327.67,0.0,54877.49
2017-08-15,2017-08-15,Project payment - Wells Inc,REF37130634,0.0,294.61,55172.1
2017-08-15,2017-08-15,"Project payment - Hurley, Johnson and Bell",REF28893358,0.0,446.66,55618.76
2017-08-15,2017-08-15,"Project payment - Horton, Adams and Smith",REF45252591,0.0,394.07,56012.83
2017-08-15,2017-08-15,"Project payment - Howard, Cunningham and Murphy",REF11039810,0.0,400.22,56413.05
2017-08-15,2017-08-15,"Payment from Wilson, Murphy and Sanders",REF68629221,0.0,663.39,57076.44
2017-08-15,2017-08-15,"Service payment - Hernandez, Jones and Adams",REF30208645,0.0,462.93,57539.37
2017-08-15,2017-08-15,"Service payment - Hernandez, Sanders and Williams",REF16996263,0.0,563.15,58102.52
2017-08-15,2017-08-15,Invoice payment - Lucero-Pope,REF92726724,0.0,563.98,58666.5
2017-08-15,2017-08-15,Business insurance premium,REF47504333,116.25,0.0,58550.25
2017-08-16,2017-08-16,Coworking space rental,REF63100453,176.69,0.0,58373.56
2017-08-21,2017-08-21,Professional software license,REF84561425,159.09,0.0,58214.47
2017-08-21,2017-08-21,Coworking space rental,REF30579509,206.65,0.0,58007.82
2017-08-29,2017-08-29,Training/conference,REF22651925,149.58,0.0,57858.24
2017-09-06,2017-09-06,Training/conference,REF45488830,327.49,0.0,57530.75
2017-09-12,2017-09-12,Equipment purchase,REF12905037,120.03,0.0,57410.72
2017-09-15,2017-09-15,Business insurance premium,REF67890353,151.92,0.0,57258.8
2017-09-15,2017-09-15,"Payment from Wilson, Murphy and Sanders",REF56242968,0.0,1235.11,58493.91
2017-09-15,2017-09-15,Invoice payment - Lucero-Pope,REF68391569,0.0,593.07,59086.98
2017-09-15,2017-09-15,"Invoice payment - Howard, Cunningham and Murphy",REF10935092,0.0,551.8,59638.78
2017-09-15,2017-09-15,Invoice payment - Wells Inc,REF26839700,0.0,336.94,59975.72
2017-09-15,2017-09-15,"Service payment - Horton, Adams and Smith",REF53198977,0.0,544.79,60520.51
2017-09-15,2017-09-15,"Payment from Hernandez, Jones and Adams",REF67358306,0.0,466.99,60987.5
2017-09-21,2017-09-21,Business travel,REF88968166,678.61,0.0,60308.89
2017-09-21,2017-09-21,Professional software license,REF39906673,213.41,0.0,60095.48
2017-09-23,2017-09-23,Training/conference,REF21465760,248.89,0.0,59846.59
2017-09-26,2017-09-26,Business travel,REF63669410,416.25,0.0,59430.34
2017-09-27,2017-09-27,Marketing expenses,REF33246356,571.85,0.0,58858.49
2017-09-27,2017-09-27,Equipment purchase,REF16573250,148.44,0.0,58710.05
2017-10-03,2017-10-03,Coworking space rental,REF11814866,229.5,0.0,58480.55
2017-10-05,2017-10-05,Business meal,REF36001771,429.41,0.0,58051.14
2017-10-08,2017-10-08,Business travel,REF39498554,343.55,0.0,57707.59
2017-10-11,2017-10-11,Business meal,REF77148259,416.58,0.0,57291.01
2017-10-13,2017-10-13,Business travel,REF54909127,466.99,0.0,56824.02
2017-10-15,2017-10-15,"Service payment - Horton, Adams and Smith",REF12163582,0.0,499.83,57323.85
2017-10-15,2017-10-15,"Service payment - Hernandez, Jones and Adams",REF45435264,0.0,609.16,57933.01
2017-10-15,2017-10-15,Payment from Lucero-Pope,REF72439697,0.0,813.31,58746.32
2017-10-15,2017-10-15,Payment from Wells Inc,REF48138173,0.0,512.43,59258.75
2017-10-15,2017-10-15,Business insurance premium,REF51862792,156.65,0.0,59102.1
2017-10-15,2017-10-15,"Project payment - Howard, Cunningham and Murphy",REF42463277,0.0,751.94,59854.04
2017-10-15,2017-10-15,"Service payment - Wilson, Murphy and Sanders",REF53561138,0.0,1228.03,61082.07
2017-10-15,2017-10-15,"Project payment - Hernandez, Sanders and Williams",REF65531921,0.0,732.4,61814.47
2017-10-16,2017-10-16,Marketing expenses,REF95667464,313.86,0.0,61500.61
2017-10-21,2017-10-21,Professional software license,REF73555086,275.48,0.0,61225.13
2017-10-24,2017-10-24,Training/conference,REF39924591,124.2,0.0,61100.93
2017-10-25,2017-10-25,Training/conference,REF80337174,76.34,0.0,61024.59
2017-10-30,2017-10-30,Coworking space rental,REF82723580,422.25,0.0,60602.34
2017-11-01,2017-11-01,Business travel,REF39896962,364.0,0.0,60238.34
2017-11-02,2017-11-02,Business meal,REF70966495,362.3,0.0,59876.04
2017-11-03,2017-11-03,Accounting expense,REF56304516,244.89,0.0,59631.15
2017-11-04,2017-11-04,Business meal,REF21165632,434.3,0.0,59196.85
2017-11-15,2017-11-15,"Service payment - Wilson, Murphy and Sanders",REF13176643,0.0,1369.64,60566.49
2017-11-15,2017-11-15,"Service payment - Hernandez, Sanders and Williams",REF95504112,0.0,770.17,61336.66
2017-11-15,2017-11-15,"Invoice payment - Howard, Cunningham and Murphy",REF43346009,0.0,450.31,61786.97
2017-11-15,2017-11-15,Invoice payment - Wells Inc,REF18322951,0.0,337.32,62124.29
2017-11-15,2017-11-15,Invoice payment - Lucero-Pope,REF64461026,0.0,690.23,62814.52
2017-11-15,2017-11-15,Business insurance premium,REF64591598,163.48,0.0,62651.04
2017-11-15,2017-11-15,"Service payment - Hernandez, Jones and Adams",REF77278700,0.0,748.88,63399.92
2017-11-17,2017-11-17,Coworking space rental,REF62431914,317.71,0.0,63082.21
2017-11-21,2017-11-21,Professional software license,REF52349983,223.55,0.0,62858.66
2017-11-23,2017-11-23,Business meal,REF91167196,219.43,0.0,62639.23
2017-11-23,2017-11-23,Coworking space rental,REF13805474,326.81,0.0,62312.42
2017-11-30,2017-11-30,Training/conference,REF30294324,162.48,0.0,62149.94
2017-12-07,2017-12-07,Business travel,REF96157160,278.37,0.0,61871.57
2017-12-10,2017-12-10,Marketing expenses,REF46987316,295.14,0.0,61576.43
2017-12-12,2017-12-12,Business travel,REF85981064,272.8,0.0,61303.63
2017-12-15,2017-12-15,"Invoice payment - Hurley, Johnson and Bell",REF59107697,0.0,584.8,61888.43
2017-12-15,2017-12-15,"Service payment - Horton, Adams and Smith",REF21614871,0.0,463.15,62351.58
2017-12-15,2017-12-15,Payment from Wells Inc,REF52365381,0.0,387.11,62738.69
2017-12-15,2017-12-15,Business travel,REF93771747,416.37,0.0,62322.32
2017-12-15,2017-12-15,"Service payment - Hernandez, Sanders and Williams",REF83982610,0.0,521.89,62844.21
2017-12-15,2017-12-15,Invoice payment - Lucero-Pope,REF29528419,0.0,564.5,63408.71
2017-12-15,2017-12-15,Business insurance premium,REF33584459,133.71,0.0,63275.0
2017-12-15,2017-12-15,"Invoice payment - Howard, Cunningham and Murphy",REF76748762,0.0,338.37,63613.37
2017-12-16,2017-12-16,Marketing expenses,REF26175337,110.37,0.0,63503.0
2017-12-18,2017-12-18,Accounting expense,REF84347746,273.7,0.0,63229.3
2017-12-19,2017-12-19,Business meal,REF73271862,218.84,0.0,63010.46
2017-12-21,2017-12-21,Professional software license,REF34097721,209.12,0.0,62801.34
2017-12-21,2017-12-21,Training/conference,REF54718703,220.54,0.0,62580.8
2017-12-25,2017-12-25,Marketing expenses,REF68122865,128.7,0.0,62452.1
2018-01-03,2018-01-03,Training/conference,REF89003475,217.73,0.0,62234.37
2018-01-07,2018-01-07,Marketing expenses,REF32901327,264.9,0.0,61969.47
2018-01-09,2018-01-09,Accounting expense,REF92670402,314.07,0.0,61655.4
2018-01-12,2018-01-12,Equipment purchase,REF46564230,194.41,0.0,61460.99
2018-01-14,2018-01-14,Business meal,REF98222082,263.69,0.0,61197.3
2018-01-14,2018-01-14,Equipment purchase,REF85091599,204.44,0.0,60992.86
2018-01-15,2018-01-15,Business meal,REF14013536,411.41,0.0,60581.45
2018-01-15,2018-01-15,"Payment from Hernandez, Sanders and Williams",REF18221862,0.0,875.27,61456.72
2018-01-15,2018-01-15,Invoice payment - Lucero-Pope,REF65777401,0.0,749.21,62205.93
2018-01-15,2018-01-15,"Invoice payment - Hurley, Johnson and Bell",REF67046829,0.0,950.51,63156.44
2018-01-15,2018-01-15,Project payment - Wells Inc,REF70460930,0.0,736.16,63892.6
2018-01-15,2018-01-15,"Project payment - Howard, Cunningham and Murphy",REF97206214,0.0,499.43,64392.03
2018-01-15,2018-01-15,"Service payment - Horton, Adams and Smith",REF52019608,0.0,466.9,64858.93
2018-01-15,2018-01-15,"Service payment - Wilson, Murphy and Sanders",REF12634508,0.0,1027.78,65886.71
2018-01-15,2018-01-15,"Invoice payment - Hernandez, Jones and Adams",REF95796462,0.0,641.1,66527.81
2018-01-15,2018-01-15,Business insurance premium,REF25730269,175.42,0.0,66352.39
2018-01-17,2018-01-17,Training/conference,REF20160614,109.62,0.0,66242.77
2018-01-20,2018-01-20,Training/conference,REF71707111,168.9,0.0,66073.87
2018-01-21,2018-01-21,Business meal,REF40890147,314.02,0.0,65759.85
2018-01-21,2018-01-21,Professional software license,REF72564148,259.95,0.0,65499.9
2018-01-25,2018-01-25,Business meal,REF64160533,402.35,0.0,65097.55
2018-01-30,2018-01-30,Business travel,REF61208803,153.08,0.0,64944.47
2018-02-06,2018-02-06,Accounting expense,REF47542584,252.35,0.0,64692.12
2018-02-08,2018-02-08,Coworking space rental,REF90463006,355.28,0.0,64336.84
2018-02-15,2018-02-15,"Payment from Howard, Cunningham and Murphy",REF82299005,0.0,470.84,64807.68
2018-02-15,2018-02-15,"Project payment - Horton, Adams and Smith",REF87952155,0.0,556.88,65364.56
2018-02-15,2018-02-15,"Project payment - Hernandez, Jones and Adams",REF92158010,0.0,539.27,65903.83
2018-02-15,2018-02-15,"Project payment - Wilson, Murphy and Sanders",REF93019133,0.0,1197.39,67101.22
2018-02-15,2018-02-15,Project payment - Wells Inc,REF98171890,0.0,389.57,67490.79
2018-02-15,2018-02-15,Business travel,REF47079637,189.01,0.0,67301.78
2018-02-15,2018-02-15,"Payment from Hernandez, Sanders and Williams",REF39352270,0.0,654.32,67956.1
2018-02-15,2018-02-15,"Payment from Hurley, Johnson and Bell",REF74174023,0.0,696.97,68653.07
2018-02-15,2018-02-15,Service payment - Lucero-Pope,REF75566728,0.0,799.26,69452.33
2018-02-15,2018-02-15,Business insurance premium,REF61729178,154.03,0.0,69298.3
2018-02-19,2018-02-19,Marketing expenses,REF30888622,263.38,0.0,69034.92
2018-02-21,2018-02-21,Professional software license,REF93727496,209.62,0.0,68825.3
2018-02-25,2018-02-25,Equipment purchase,REF91183326,148.94,0.0,68676.36
2018-02-28,2018-02-28,Business travel,REF96160360,211.17,0.0,68465.19
2018-03-04,2018-03-04,Accounting expense,REF17235073,215.23,0.0,68249.96
2018-03-10,2018-03-10,Accounting expense,REF79603680,273.1,0.0,67976.86
2018-03-13,2018-03-13,Coworking space rental,REF49396159,315.66,0.0,67661.2
2018-03-13,2018-03-13,Business travel,REF18403758,458.68,0.0,67202.52
2018-03-15,2018-03-15,"Payment from Wilson, Murphy and Sanders",REF85193510,0.0,1185.07,68387.59
2018-03-15,2018-03-15,Business insurance premium,REF27763046,129.27,0.0,68258.32
2018-03-15,2018-03-15,"Project payment - Hurley, Johnson and Bell",REF26316326,0.0,795.13,69053.45
2018-03-15,2018-03-15,"Invoice payment - Howard, Cunningham and Murphy",REF80602916,0.0,562.46,69615.91
2018-03-15,2018-03-15,"Service payment - Hernandez, Jones and Adams",REF24494265,0.0,531.01,70146.92
2018-03-15,2018-03-15,Service payment - Wells Inc,REF37211965,0.0,313.92,70460.84
2018-03-15,2018-03-15,Invoice payment - Lucero-Pope,REF75336041,0.0,621.46,71082.3
2018-03-15,2018-03-15,"Service payment - Horton, Adams and Smith",REF36131458,0.0,646.46,71728.76
2018-03-15,2018-03-15,"Project payment - Hernandez, Sanders and Williams",REF64962619,0.0,732.61,72461.37
2018-03-21,2018-03-21,Professional software license,REF36714640,178.35,0.0,72283.02
2018-03-22,2018-03-22,Marketing expenses,REF57249524,309.49,0.0,71973.53
2018-03-22,2018-03-22,Accounting expense,REF32515489,255.66,0.0,71717.87
2018-03-23,2018-03-23,Business travel,REF11778750,344.86,0.0,71373.01
2018-03-23,2018-03-23,Business meal,REF61181067,297.53,0.0,71075.48
2018-03-24,2018-03-24,Accounting expense,REF25982564,134.99,0.0,70940.49
2018-04-11,2018-04-11,Coworking space rental,REF51753414,290.86,0.0,70649.63
2018-04-13,2018-04-13,Coworking space rental,REF35246561,303.7,0.0,70345.93
2018-04-15,2018-04-15,Business insurance premium,REF85370276,136.12,0.0,70209.81
2018-04-15,2018-04-15,"Service payment - Hernandez, Jones and Adams",REF47485674,0.0,605.1,70814.91
2018-04-15,2018-04-15,"Invoice payment - Wilson, Murphy and Sanders",REF68120650,0.0,874.97,71689.88
2018-04-15,2018-04-15,"Invoice payment - Howard, Cunningham and Murphy",REF95763964,0.0,527.67,72217.55
2018-04-15,2018-04-15,"Service payment - Horton, Adams and Smith",REF37319619,0.0,550.05,72767.6
2018-04-15,2018-04-15,"Invoice payment - Hernandez, Sanders and Williams",REF94161852,0.0,586.59,73354.19
2018-04-15,2018-04-15,Project payment - Lucero-Pope,REF79556243,0.0,717.81,74072.0
2018-04-15,2018-04-15,Project payment - Wells Inc,REF70615145,0.0,432.58,74504.58
2018-04-15,2018-04-15,"Invoice payment - Hurley, Johnson and Bell",REF10564947,0.0,619.61,75124.19
2018-04-19,2018-04-19,Equipment purchase,REF74127444,78.88,0.0,75045.31
2018-04-21,2018-04-21,Professional software license,REF19585788,212.51,0.0,74832.8
2018-05-02,2018-05-02,Business travel,REF35660229,602.18,0.0,74230.62
2018-05-05,2018-05-05,Business travel,REF44558597,286.89,0.0,73943.73
2018-05-05,2018-05-05,Accounting expense,REF62750898,238.8,0.0,73704.93
2018-05-06,2018-05-06,Equipment purchase,REF84994911,112.65,0.0,73592.28
2018-05-15,2018-05-15,Business insurance premium,REF83273008,126.26,0.0,73466.02
2018-05-15,2018-05-15,"Invoice payment - Wilson, Murphy and Sanders",REF91342736,0.0,795.74,74261.76
2018-05-15,2018-05-15,Coworking space rental,REF61495887,179.35,0.0,74082.41
2018-05-15,2018-05-15,"Payment from Hernandez, Jones and Adams",REF78349437,0.0,521.4,74603.81
2018-05-15,2018-05-15,"Project payment - Horton, Adams and Smith",REF65900230,0.0,452.74,75056.55
2018-05-15,2018-05-15,"Payment from Hurley, Johnson and Bell",REF17733578,0.0,805.62,75862.17
2018-05-15,2018-05-15,"Payment from Hernandez, Sanders and Williams",REF84487940,0.0,680.86,76543.03
2018-05-15,2018-05-15,Invoice payment - Lucero-Pope,REF15288315,0.0,548.37,77091.4
2018-05-15,2018-05-15,Project payment - Wells Inc,REF75661002,0.0,437.67,77529.07
2018-05-15,2018-05-15,"Invoice payment - Howard, Cunningham and Murphy",REF30720165,0.0,456.48,77985.55
2018-05-16,2018-05-16,Business meal,REF13386631,71.12,0.0,77914.43
2018-05-19,2018-05-19,Business travel,REF58171600,355.59,0.0,77558.84
2018-05-21,2018-05-21,Professional software license,REF70137935,173.97,0.0,77384.87
2018-05-23,2018-05-23,Business travel,REF76898916,395.65,0.0,76989.22
2018-05-30,2018-05-30,Training/conference,REF67357431,225.6,0.0,76763.62
2018-06-02,2018-06-02,Accounting expense,REF69663971,163.77,0.0,76599.85
2018-06-06,2018-06-06,Equipment purchase,REF72185710,58.2,0.0,76541.65
2018-06-12,2018-06-12,Accounting expense,REF15348664,144.68,0.0,76396.97
2018-06-14,2018-06-14,Business travel,REF68912391,460.02,0.0,75936.95
2018-06-15,2018-06-15,Invoice payment - Lucero-Pope,REF37419203,0.0,551.24,76488.19
2018-06-15,2018-06-15,Business insurance premium,REF16569651,112.71,0.0,76375.48
2018-06-15,2018-06-15,"Project payment - Horton, Adams and Smith",REF49349054,0.0,412.31,76787.79
2018-06-15,2018-06-15,Project payment - Wells Inc,REF18094954,0.0,259.42,77047.21
2018-06-15,2018-06-15,"Payment from Howard, Cunningham and Murphy",REF13900352,0.0,506.94,77554.15
2018-06-15,2018-06-15,"Invoice payment - Hernandez, Jones and Adams",REF91398847,0.0,433.63,77987.78
2018-06-15,2018-06-15,"Project payment - Hurley, Johnson and Bell",REF74329218,0.0,481.93,78469.71
2018-06-15,2018-06-15,"Invoice payment - Wilson, Murphy and Sanders",REF90693332,0.0,736.15,79205.86
2018-06-17,2018-06-17,Business meal,REF60428899,207.52,0.0,78998.34
2018-06-20,2018-06-20,Training/conference,REF71960431,60.47,0.0,78937.87
2018-06-21,2018-06-21,Professional software license,REF37824208,170.06,0.0,78767.81
2018-06-22,2018-06-22,Equipment purchase,REF27397004,170.13,0.0,78597.68
2018-06-25,2018-06-25,Business meal,REF40211190,155.45,0.0,78442.23
2018-06-29,2018-06-29,Marketing expenses,REF74840763,381.92,0.0,78060.31
2018-07-03,2018-07-03,Accounting expense,REF34745611,146.92,0.0,77913.39
2018-07-10,2018-07-10,Coworking space rental,REF12971115,276.7,0.0,77636.69
2018-07-11,2018-07-11,Business meal,REF25003636,218.04,0.0,77418.65
2018-07-13,2018-07-13,Equipment purchase,REF37980386,69.3,0.0,77349.35
2018-07-13,2018-07-13,Training/conference,REF74045132,160.09,0.0,77189.26
2018-07-15,2018-07-15,Business insurance premium,REF75890238,97.64,0.0,77091.62
2018-07-15,2018-07-15,"Project payment - Hernandez, Sanders and Williams",REF57667621,0.0,511.38,77603.0
2018-07-15,2018-07-15,"Invoice payment - Horton, Adams and Smith",REF42601437,0.0,276.52,77879.52
2018-07-15,2018-07-15,Payment from Lucero-Pope,REF66423598,0.0,436.45,78315.97
2018-07-15,2018-07-15,"Service payment - Howard, Cunningham and Murphy",REF33793586,0.0,354.51,78670.48
2018-07-15,2018-07-15,"Project payment - Hurley, Johnson and Bell",REF81102088,0.0,428.64,79099.12
2018-07-15,2018-07-15,"Invoice payment - Wilson, Murphy and Sanders",REF88638994,0.0,876.04,79975.16
2018-07-15,2018-07-15,Project payment - Wells Inc,REF31709483,0.0,250.47,80225.63
2018-07-16,2018-07-16,Coworking space rental,REF54762628,340.28,0.0,79885.35
2018-07-16,2018-07-16,Business travel,REF25067009,362.54,0.0,79522.81
2018-07-21,2018-07-21,Professional software license,REF58980899,128.9,0.0,79393.91
2018-07-26,2018-07-26,Business meal,REF19988754,57.52,0.0,79336.39
2018-07-28,2018-07-28,Training/conference,REF41939257,110.14,0.0,79226.25
2018-07-29,2018-07-29,Business travel,REF44598460,150.3,0.0,79075.95
2018-07-30,2018-07-30,Business travel,REF79881106,326.18,0.0,78749.77
2018-08-07,2018-08-07,Business travel,REF99838811,476.18,0.0,78273.59
2018-08-10,2018-08-10,Business meal,REF34735523,186.62,0.0,78086.97
2018-08-15,2018-08-15,"Service payment - Horton, Adams and Smith",REF50427214,0.0,461.14,78548.11
2018-08-15,2018-08-15,Invoice payment - Lucero-Pope,REF28792884,0.0,509.53,79057.64
2018-08-15,2018-08-15,Project payment - Wells Inc,REF40995827,0.0,336.69,79394.33
2018-08-15,2018-08-15,"Payment from Hernandez, Jones and Adams",REF30448369,0.0,594.6,79988.93
2018-08-15,2018-08-15,"Project payment - Wilson, Murphy and Sanders",REF33039225,0.0,934.03,80922.96
2018-08-15,2018-08-15,"Invoice payment - Hernandez, Sanders and Williams",REF53421358,0.0,668.47,81591.43
2018-08-15,2018-08-15,"Payment from Hurley, Johnson and Bell",REF92891642,0.0,551.84,82143.27
2018-08-15,2018-08-15,Business insurance premium,REF19242714,105.65,0.0,82037.62
2018-08-15,2018-08-15,"Invoice payment - Howard, Cunningham and Murphy",REF34465308,0.0,431.54,82469.16
2018-08-19,2018-08-19,Business meal,REF43729714,178.79,0.0,82290.37
2018-08-21,2018-08-21,Professional software license,REF63876107,157.09,0.0,82133.28
2018-08-21,2018-08-21,Equipment purchase,REF71393362,111.8,0.0,82021.48
2018-09-06,2018-09-06,Coworking space rental,REF28307893,324.42,0.0,81697.06
2018-09-08,2018-09-08,Business meal,REF22961793,208.46,0.0,81488.6
2018-09-08,2018-09-08,Business travel,REF56986010,492.33,0.0,80996.27
2018-09-11,2018-09-11,Coworking space rental,REF12491617,193.09,0.0,80803.18
2018-09-14,2018-09-14,Marketing expenses,REF39699607,401.08,0.0,80402.1
2018-09-15,2018-09-15,"Payment from Hernandez, Sanders and Williams",REF19805342,0.0,840.6,81242.7
2018-09-15,2018-09-15,Project payment - Wells Inc,REF80687555,0.0,472.7,81715.4
2018-09-15,2018-09-15,"Payment from Wilson, Murphy and Sanders",REF52653312,0.0,1074.85,82790.25
2018-09-15,2018-09-15,Payment from Lucero-Pope,REF19907790,0.0,672.56,83462.81
2018-09-15,2018-09-15,"Project payment - Horton, Adams and Smith",REF48056058,0.0,375.23,83838.04
2018-09-15,2018-09-15,"Payment from Howard, Cunningham and Murphy",REF66618235,0.0,484.99,84323.03
2018-09-15,2018-09-15,"Service payment - Hurley, Johnson and Bell",REF17880291,0.0,759.44,85082.47
2018-09-15,2018-09-15,Business insurance premium,REF64942893,151.63,0.0,84930.84
2018-09-17,2018-09-17,Business meal,REF73524120,268.34,0.0,84662.5
2018-09-21,2018-09-21,Professional software license,REF70820608,221.54,0.0,84440.96
2018-09-25,2018-09-25,Coworking space rental,REF64436089,302.03,0.0,84138.93
2018-09-29,2018-09-29,Coworking space rental,REF98227681,372.35,0.0,83766.58
2018-09-30,2018-09-30,Equipment purchase,REF35419566,172.31,0.0,83594.27
2018-10-02,2018-10-02,Business travel,REF72030909,311.55,0.0,83282.72
2018-10-07,2018-10-07,Business meal,REF35526428,311.36,0.0,82971.36
2018-10-14,2018-10-14,Training/conference,REF49064193,298.5,0.0,82672.86
2018-10-15,2018-10-15,Business insurance premium,REF54752070,158.67,0.0,82514.19
2018-10-15,2018-10-15,"Project payment - Hurley, Johnson and Bell",REF65871239,0.0,556.07,83070.26
2018-10-15,2018-10-15,"Service payment - Hernandez, Jones and Adams",REF32080177,0.0,480.3,83550.56
2018-10-15,2018-10-15,Project payment - Wells Inc,REF81458173,0.0,384.68,83935.24
2018-10-15,2018-10-15,"Payment from Hernandez, Sanders and Williams",REF90955493,0.0,748.9,84684.14
2018-10-15,2018-10-15,Service payment - Lucero-Pope,REF74101646,0.0,696.62,85380.76
2018-10-15,2018-10-15,"Payment from Horton, Adams and Smith",REF23118219,0.0,448.64,85829.4
2018-10-15,2018-10-15,"Project payment - Wilson, Murphy and Sanders",REF58679572,0.0,996.75,86826.15
2018-10-15,2018-10-15,"Service payment - Howard, Cunningham and Murphy",REF79809254,0.0,578.55,87404.7
2018-10-21,2018-10-21,Professional software license,REF57259252,226.05,0.0,87178.65
2018-10-21,2018-10-21,Training/conference,REF88238782,294.95,0.0,86883.7
2018-10-21,2018-10-21,Business travel,REF80937570,360.67,0.0,86523.03
2018-10-24,2018-10-24,Equipment purchase,REF78115086,19.1,0.0,86503.93
2018-10-26,2018-10-26,Coworking space rental,REF36808910,382.82,0.0,86121.11
2018-11-01,2018-11-01,Business travel,REF50349889,669.03,0.0,85452.08
2018-11-02,2018-11-02,Equipment purchase,REF86603813,163.77,0.0,85288.31
2018-11-02,2018-11-02,Training/conference,REF54188207,251.09,0.0,85037.22
2018-11-03,2018-11-03,Business meal,REF76939878,364.52,0.0,84672.7
2018-11-06,2018-11-06,Training/conference,REF69814467,208.42,0.0,84464.28
2018-11-10,2018-11-10,Business meal,REF19188530,350.96,0.0,84113.32
2018-11-13,2018-11-13,Equipment purchase,REF64623752,158.07,0.0,83955.25
2018-11-13,2018-11-13,Coworking space rental,REF11713751,275.16,0.0,83680.09
2018-11-15,2018-11-15,"Payment from Hernandez, Jones and Adams",REF12422262,0.0,795.62,84475.71
2018-11-15,2018-11-15,Service payment - Lucero-Pope,REF13535187,0.0,566.64,85042.35
2018-11-15,2018-11-15,Project payment - Wells Inc,REF39107748,0.0,385.65,85428.0
2018-11-15,2018-11-15,"Project payment - Howard, Cunningham and Murphy",REF94242791,0.0,599.47,86027.47
2018-11-15,2018-11-15,"Invoice payment - Hernandez, Sanders and Williams",REF42465127,0.0,638.75,86666.22
2018-11-15,2018-11-15,Business insurance premium,REF36613087,166.07,0.0,86500.15
2018-11-15,2018-11-15,"Invoice payment - Wilson, Murphy and Sanders",REF42692997,0.0,1230.53,87730.68
2018-11-15,2018-11-15,"Service payment - Horton, Adams and Smith",REF26292313,0.0,490.07,88220.75
2018-11-20,2018-11-20,Coworking space rental,REF96656112,355.51,0.0,87865.24
2018-11-21,2018-11-21,Professional software license,REF22372348,180.68,0.0,87684.56
2018-11-23,2018-11-23,Business meal,REF74260835,166.2,0.0,87518.36
2018-11-23,2018-11-23,Training/conference,REF13276950,227.25,0.0,87291.11
2018-11-25,2018-11-25,Marketing expenses,REF90327761,463.25,0.0,86827.86
2018-11-28,2018-11-28,Marketing expenses,REF22868408,333.94,0.0,86493.92
2018-12-03,2018-12-03,Training/conference,REF24658930,203.61,0.0,86290.31
2018-12-08,2018-12-08,Business meal,REF11522775,254.87,0.0,86035.44
2018-12-09,2018-12-09,Equipment purchase,REF81476498,106.36,0.0,85929.08
2018-12-12,2018-12-12,Business travel,REF92276308,372.46,0.0,85556.62
2018-12-15,2018-12-15,Payment from Lucero-Pope,REF14938392,0.0,410.36,85966.98
2018-12-15,2018-12-15,"Service payment - Hernandez, Jones and Adams",REF47257383,0.0,455.82,86422.8
2018-12-15,2018-12-15,"Project payment - Hernandez, Sanders and Williams",REF31879377,0.0,596.34,87019.14
2018-12-15,2018-12-15,"Payment from Howard, Cunningham and Murphy",REF38544045,0.0,420.27,87439.41
2018-12-15,2018-12-15,"Project payment - Wilson, Murphy and Sanders",REF34207356,0.0,1253.96,88693.37
2018-12-15,2018-12-15,Business insurance premium,REF21934192,123.54,0.0,88569.83
2018-12-15,2018-12-15,"Project payment - Hurley, Johnson and Bell",REF23066120,0.0,659.78,89229.61
2018-12-15,2018-12-15,"Service payment - Horton, Adams and Smith",REF11799564,0.0,422.74,89652.35
2018-12-15,2018-12-15,Invoice payment - Wells Inc,REF94282593,0.0,370.59,90022.94
2018-12-15,2018-12-15,Training/conference,REF93678356,250.33,0.0,89772.61
2018-12-17,2018-12-17,Coworking space rental,REF74121641,156.22,0.0,89616.39
2018-12-18,2018-12-18,Training/conference,REF36392491,118.53,0.0,89497.86
2018-12-19,2018-12-19,Business meal,REF19729285,269.75,0.0,89228.11
2018-12-21,2018-12-21,Business travel,REF59473663,311.11,0.0,88917.0
2018-12-21,2018-12-21,Professional software license,REF74949348,156.64,0.0,88760.36
2018-12-22,2018-12-22,Marketing expenses,REF95612939,332.74,0.0,88427.62
2018-12-29,2018-12-29,Business travel,REF76481476,343.83,0.0,88083.79
2019-01-07,2019-01-07,Equipment purchase,REF86207510,222.39,0.0,87861.4
2019-01-11,2019-01-11,Marketing expenses,REF84373324,390.21,0.0,87471.19
2019-01-13,2019-01-13,Business travel,REF67630959,420.05,0.0,87051.14
2019-01-15,2019-01-15,Business insurance premium,REF80190258,170.53,0.0,86880.61
2019-01-15,2019-01-15,Service payment - Wells Inc,REF57678190,0.0,390.35,87270.96
2019-01-15,2019-01-15,"Service payment - Hernandez, Jones and Adams",REF97455783,0.0,597.23,87868.19
2019-01-15,2019-01-15,"Service payment - Howard, Cunningham and Murphy",REF18446586,0.0,649.43,88517.62
2019-01-15,2019-01-15,"Project payment - Wilson, Murphy and Sanders",REF53089026,0.0,1570.82,90088.44
2019-01-15,2019-01-15,"Project payment - Horton, Adams and Smith",REF27020858,0.0,570.42,90658.86
2019-01-15,2019-01-15,"Payment from Hurley, Johnson and Bell",REF18560551,0.0,625.09,91283.95
2019-01-15,2019-01-15,"Invoice payment - Hernandez, Sanders and Williams",REF97191265,0.0,639.53,91923.48
2019-01-15,2019-01-15,Project payment - Lucero-Pope,REF84498084,0.0,613.74,92537.22
2019-01-21,2019-01-21,Accounting expense,REF11799531,239.49,0.0,92297.73
2019-01-21,2019-01-21,Professional software license,REF50356222,234.74,0.0,92062.99
2019-01-23,2019-01-23,Equipment purchase,REF91460333,245.68,0.0,91817.31
2019-01-30,2019-01-30,Business meal,REF69026416,222.94,0.0,91594.37
2019-02-01,2019-02-01,Business meal,REF71749340,322.38,0.0,91271.99
2019-02-09,2019-02-09,Accounting expense,REF33599155,181.39,0.0,91090.6
2019-02-15,2019-02-15,Business insurance premium,REF97950117,157.22,0.0,90933.38
2019-02-15,2019-02-15,"Service payment - Wilson, Murphy and Sanders",REF66618291,0.0,1060.59,91993.97
2019-02-15,2019-02-15,Invoice payment - Lucero-Pope,REF27430592,0.0,687.9,92681.87
2019-02-15,2019-02-15,"Payment from Howard, Cunningham and Murphy",REF68771466,0.0,402.87,93084.74
2019-02-15,2019-02-15,"Payment from Hernandez, Jones and Adams",REF77495993,0.0,611.83,93696.57
2019-02-15,2019-02-15,"Service payment - Hurley, Johnson and Bell",REF43419858,0.0,976.94,94673.51
2019-02-15,2019-02-15,"Service payment - Hernandez, Sanders and Williams",REF37489773,0.0,775.98,95449.49
2019-02-15,2019-02-15,"Invoice payment - Horton, Adams and Smith",REF25831776,0.0,574.83,96024.32
2019-02-15,2019-02-15,Invoice payment - Wells Inc,REF82596535,0.0,472.59,96496.91
2019-02-16,2019-02-16,Training/conference,REF15657103,208.22,0.0,96288.69
2019-02-21,2019-02-21,Professional software license,REF15698369,238.31,0.0,96050.38
2019-02-21,2019-02-21,Accounting expense,REF47310334,328.01,0.0,95722.37
2019-02-23,2019-02-23,Training/conference,REF61303364,199.11,0.0,95523.26
2019-03-04,2019-03-04,Equipment purchase,REF51787980,147.95,0.0,95375.31
2019-03-06,2019-03-06,Training/conference,REF85653752,207.87,0.0,95167.44
2019-03-11,2019-03-11,Business travel,REF78968453,411.53,0.0,94755.91
2019-03-15,2019-03-15,"Payment from Wilson, Murphy and Sanders",REF90846758,0.0,795.55,95551.46
2019-03-15,2019-03-15,Business insurance premium,REF98638613,129.01,0.0,95422.45
2019-03-15,2019-03-15,"Project payment - Hernandez, Jones and Adams",REF80743571,0.0,556.87,95979.32
2019-03-15,2019-03-15,"Service payment - Howard, Cunningham and Murphy",REF47798496,0.0,505.43,96484.75
2019-03-15,2019-03-15,"Invoice payment - Hurley, Johnson and Bell",REF37204089,0.0,735.11,97219.86
2019-03-15,2019-03-15,Payment from Lucero-Pope,REF32727824,0.0,644.9,97864.76
2019-03-15,2019-03-15,"Service payment - Horton, Adams and Smith",REF59311837,0.0,310.54,98175.3
2019-03-15,2019-03-15,Invoice payment - Wells Inc,REF57948511,0.0,366.3,98541.6
2019-03-15,2019-03-15,"Payment from Hernandez, Sanders and Williams",REF64765333,0.0,795.82,99337.42
2019-03-16,2019-03-16,Business meal,REF77903642,163.19,0.0,99174.23
2019-03-16,2019-03-16,Business travel,REF66108412,384.8,0.0,98789.43
2019-03-21,2019-03-21,Professional software license,REF74453813,256.25,0.0,98533.18
2019-03-22,2019-03-22,Coworking space rental,REF29802445,180.54,0.0,98352.64
2019-03-24,2019-03-24,Business travel,REF48721555,493.33,0.0,97859.31
2019-03-27,2019-03-27,Training/conference,REF26281934,178.66,0.0,97680.65
2019-03-28,2019-03-28,Business travel,REF78035426,547.33,0.0,97133.32
2019-03-30,2019-03-30,Business travel,REF74941817,266.02,0.0,96867.3
2019-04-10,2019-04-10,Accounting expense,REF56583174,143.95,0.0,96723.35
2019-04-14,2019-04-14,Training/conference,REF37844268,239.27,0.0,96484.08
2019-04-15,2019-04-15,Business insurance premium,REF92352291,137.96,0.0,96346.12
2019-04-15,2019-04-15,"Payment from Horton, Adams and Smith",REF44967363,0.0,529.15,96875.27
2019-04-15,2019-04-15,"Project payment - Hurley, Johnson and Bell",REF87232348,0.0,717.76,97593.03
2019-04-15,2019-04-15,"Invoice payment - Howard, Cunningham and Murphy",REF71780101,0.0,477.04,98070.07
2019-04-15,2019-04-15,Invoice payment - Lucero-Pope,REF45470879,0.0,511.98,98582.05
2019-04-15,2019-04-15,Payment from Wells Inc,REF95977499,0.0,341.4,98923.45
2019-04-15,2019-04-15,"Project payment - Hernandez, Jones and Adams",REF69413794,0.0,476.56,99400.01
2019-04-15,2019-04-15,"Invoice payment - Wilson, Murphy and Sanders",REF24069446,0.0,1073.89,100473.9
2019-04-16,2019-04-16,Business meal,REF52740163,349.11,0.0,100124.79
2019-04-18,2019-04-18,Marketing expenses,REF79969992,203.72,0.0,99921.07
2019-04-21,2019-04-21,Professional software license,REF45880022,202.44,0.0,99718.63
2019-04-21,2019-04-21,Coworking space rental,REF98662863,306.73,0.0,99411.9
2019-04-24,2019-04-24,Business meal,REF26309560,233.31,0.0,99178.59
2019-05-10,2019-05-10,Equipment purchase,REF19466760,110.39,0.0,99068.2
2019-05-15,2019-05-15,Business insurance premium,REF68807627,135.47,0.0,98932.73
2019-05-15,2019-05-15,Service payment - Wells Inc,REF72141167,0.0,360.72,99293.45
2019-05-15,2019-05-15,"Payment from Hurley, Johnson and Bell",REF98521501,0.0,617.63,99911.08
2019-05-15,2019-05-15,"Invoice payment - Hernandez, Sanders and Williams",REF27304851,0.0,651.33,100562.41
2019-05-15,2019-05-15,"Payment from Howard, Cunningham and Murphy",REF78920224,0.0,532.05,101094.46
2019-05-15,2019-05-15,Business travel,REF56918256,305.16,0.0,100789.3
2019-05-15,2019-05-15,"Project payment - Horton, Adams and Smith",REF80691582,0.0,467.15,101256.45
2019-05-15,2019-05-15,"Project payment - Hernandez, Jones and Adams",REF97550520,0.0,629.38,101885.83
2019-05-15,2019-05-15,"Payment from Wilson, Murphy and Sanders",REF16353817,0.0,986.96,102872.79
2019-05-19,2019-05-19,Business meal,REF85190606,201.84,0.0,102670.95
2019-05-21,2019-05-21,Professional software license,REF71729585,172.33,0.0,102498.62
2019-05-24,2019-05-24,Coworking space rental,REF12680107,235.32,0.0,102263.3
2019-05-26,2019-05-26,Business travel,REF63571549,256.2,0.0,102007.1
2019-06-14,2019-06-14,Business travel,REF54012492,260.24,0.0,101746.86
2019-06-15,2019-06-15,"Payment from Howard, Cunningham and Murphy",REF37370055,0.0,418.44,102165.3
2019-06-15,2019-06-15,Project payment - Lucero-Pope,REF65720955,0.0,574.61,102739.91
2019-06-15,2019-06-15,Business insurance premium,REF85447316,109.1,0.0,102630.81
2019-06-15,2019-06-15,"Project payment - Hernandez, Sanders and Williams",REF15914459,0.0,589.03,103219.84
2019-06-15,2019-06-15,Business travel,REF82896890,246.18,0.0,102973.66
2019-06-15,2019-06-15,"Service payment - Hernandez, Jones and Adams",REF83561034,0.0,427.1,103400.76
2019-06-15,2019-06-15,"Service payment - Wilson, Murphy and Sanders",REF19436143,0.0,800.67,104201.43
2019-06-15,2019-06-15,"Project payment - Horton, Adams and Smith",REF31516509,0.0,339.44,104540.87
2019-06-15,2019-06-15,Service payment - Wells Inc,REF62520873,0.0,319.17,104860.04
2019-06-21,2019-06-21,Professional software license,REF87909475,198.73,0.0,104661.31
2019-06-23,2019-06-23,Marketing expenses,REF81143035,310.0,0.0,104351.31
2019-06-25,2019-06-25,Marketing expenses,REF61223150,217.34,0.0,104133.97
2019-06-25,2019-06-25,Business travel,REF22871535,326.68,0.0,103807.29
2019-06-26,2019-06-26,Equipment purchase,REF23954691,96.6,0.0,103710.69
2019-06-28,2019-06-28,Business travel,REF65424190,315.81,0.0,103394.88
2019-06-28,2019-06-28,Marketing expenses,REF20863746,182.67,0.0,103212.21
2019-07-08,2019-07-08,Coworking space rental,REF70542246,151.47,0.0,103060.74
2019-07-09,2019-07-09,Business meal,REF62622442,84.99,0.0,102975.75
2019-07-12,2019-07-12,Accounting expense,REF32068338,126.75,0.0,102849.0
2019-07-15,2019-07-15,Business insurance premium,REF50733099,101.57,0.0,102747.43
2019-07-15,2019-07-15,"Payment from Wilson, Murphy and Sanders",REF27141652,0.0,765.85,103513.28
2019-07-15,2019-07-15,"Service payment - Hernandez, Jones and Adams",REF86003896,0.0,450.84,103964.12
2019-07-15,2019-07-15,"Service payment - Horton, Adams and Smith",REF82759128,0.0,377.96,104342.08
2019-07-15,2019-07-15,Project payment - Lucero-Pope,REF28106022,0.0,449.7,104791.78
2019-07-15,2019-07-15,"Invoice payment - Hernandez, Sanders and Williams",REF96147568,0.0,323.43,105115.21
2019-07-15,2019-07-15,Project payment - Wells Inc,REF59711352,0.0,286.71,105401.92
2019-07-15,2019-07-15,"Project payment - Howard, Cunningham and Murphy",REF84340019,0.0,316.61,105718.53
2019-07-15,2019-07-15,"Payment from Hurley, Johnson and Bell",REF25330888,0.0,523.6,106242.13
2019-07-15,2019-07-15,Business travel,REF83315142,129.48,0.0,106112.65
2019-07-17,2019-07-17,Business meal,REF35214898,267.25,0.0,105845.4
2019-07-21,2019-07-21,Professional software license,REF81634331,139.83,0.0,105705.57
2019-07-25,2019-07-25,Marketing expenses,REF67980983,204.43,0.0,105501.14
2019-07-25,2019-07-25,Business travel,REF15388498,362.65,0.0,105138.49
2019-07-26,2019-07-26,Coworking space rental,REF70349001,197.03,0.0,104941.46
2019-07-27,2019-07-27,Training/conference,REF67205464,180.26,0.0,104761.2
2019-07-28,2019-07-28,Business meal,REF22555391,206.64,0.0,104554.56
2019-08-09,2019-08-09,Coworking space rental,REF11588279,212.54,0.0,104342.02
2019-08-10,2019-08-10,Equipment purchase,REF42710310,138.3,0.0,104203.72
2019-08-15,2019-08-15,Invoice payment - Wells Inc,REF29379756,0.0,303.77,104507.49
2019-08-15,2019-08-15,"Project payment - Hernandez, Sanders and Williams",REF66482451,0.0,614.47,105121.96
2019-08-15,2019-08-15,Accounting expense,REF35336783,240.78,0.0,104881.18
2019-08-15,2019-08-15,"Invoice payment - Wilson, Murphy and Sanders",REF89387659,0.0,930.58,105811.76
2019-08-15,2019-08-15,Project payment - Lucero-Pope,REF28367980,0.0,343.13,106154.89
2019-08-15,2019-08-15,"Project payment - Hurley, Johnson and Bell",REF68583678,0.0,475.9,106630.79
2019-08-15,2019-08-15,"Project payment - Horton, Adams and Smith",REF57873905,0.0,458.13,107088.92
2019-08-15,2019-08-15,"Payment from Hernandez, Jones and Adams",REF20052675,0.0,360.6,107449.52
2019-08-15,2019-08-15,"Service payment - Howard, Cunningham and Murphy",REF99062843,0.0,437.87,107887.39
2019-08-15,2019-08-15,Business insurance premium,REF76665635,101.33,0.0,107786.06
2019-08-16,2019-08-16,Business meal,REF42517412,130.04,0.0,107656.02
2019-08-19,2019-08-19,Training/conference,REF59712764,77.49,0.0,107578.53
2019-08-21,2019-08-21,Professional software license,REF59538513,150.59,0.0,107427.94
2019-08-22,2019-08-22,Equipment purchase,REF49519849,122.15,0.0,107305.79
2019-08-24,2019-08-24,Marketing expenses,REF16043741,236.61,0.0,107069.18
2019-08-26,2019-08-26,Equipment purchase,REF68627008,168.26,0.0,106900.92
2019-08-30,2019-08-30,Business meal,REF80973643,231.94,0.0,106668.98
2019-09-02,2019-09-02,Coworking space rental,REF39067318,280.23,0.0,106388.75
2019-09-10,2019-09-10,Training/conference,REF55017095,184.27,0.0,106204.48
2019-09-11,2019-09-11,Training/conference,REF47418427,253.3,0.0,105951.18
2019-09-12,2019-09-12,Accounting expense,REF49139346,253.71,0.0,105697.47
2019-09-13,2019-09-13,Business travel,REF55535314,566.46,0.0,105131.01
2019-09-15,2019-09-15,"Service payment - Horton, Adams and Smith",REF91663257,0.0,434.07,105565.08
2019-09-15,2019-09-15,Project payment - Wells Inc,REF11694185,0.0,359.36,105924.44
2019-09-15,2019-09-15,"Payment from Wilson, Murphy and Sanders",REF52447761,0.0,1026.68,106951.12
2019-09-15,2019-09-15,"Invoice payment - Howard, Cunningham and Murphy",REF46579728,0.0,608.94,107560.06
2019-09-15,2019-09-15,"Service payment - Hernandez, Jones and Adams",REF26556672,0.0,649.84,108209.9
2019-09-15,2019-09-15,Business insurance premium,REF57776349,150.09,0.0,108059.81
2019-09-15,2019-09-15,"Invoice payment - Hurley, Johnson and Bell",REF19641927,0.0,777.0,108836.81
2019-09-16,2019-09-16,Coworking space rental,REF40235474,326.86,0.0,108509.95
2019-09-21,2019-09-21,Professional software license,REF65110481,247.38,0.0,108262.57
2019-09-25,2019-09-25,Accounting expense,REF60662208,196.75,0.0,108065.82
2019-09-25,2019-09-25,Business meal,REF76115868,223.02,0.0,107842.8
2019-09-28,2019-09-28,Equipment purchase,REF14625132,169.45,0.0,107673.35
2019-10-01,2019-10-01,Equipment purchase,REF85625773,138.18,0.0,107535.17
2019-10-01,2019-10-01,Coworking space rental,REF42734612,425.21,0.0,107109.96
2019-10-10,2019-10-10,Business travel,REF24134503,225.83,0.0,106884.13
2019-10-11,2019-10-11,Coworking space rental,REF68435068,425.84,0.0,106458.29
2019-10-15,2019-10-15,"Payment from Wilson, Murphy and Sanders",REF87392391,0.0,1376.51,107834.8
2019-10-15,2019-10-15,"Invoice payment - Hurley, Johnson and Bell",REF92047768,0.0,867.45,108702.25
2019-10-15,2019-10-15,Business insurance premium,REF61189431,165.61,0.0,108536.64
2019-10-15,2019-10-15,"Service payment - Howard, Cunningham and Murphy",REF34050445,0.0,561.46,109098.1
2019-10-15,2019-10-15,"Project payment - Horton, Adams and Smith",REF75503628,0.0,640.21,109738.31
2019-10-15,2019-10-15,"Project payment - Hernandez, Jones and Adams",REF62596594,0.0,658.34,110396.65
2019-10-15,2019-10-15,"Project payment - Hernandez, Sanders and Williams",REF65416906,0.0,934.87,111331.52
2019-10-21,2019-10-21,Professional software license,REF60907081,224.75,0.0,111106.77
2019-10-25,2019-10-25,Business travel,REF83252208,597.6,0.0,110509.17
2019-10-29,2019-10-29,Business travel,REF17607801,381.53,0.0,110127.64
2019-10-31,2019-10-31,Marketing expenses,REF40991643,339.51,0.0,109788.13
2019-11-05,2019-11-05,Coworking space rental,REF41663179,324.23,0.0,109463.9
2019-11-08,2019-11-08,Marketing expenses,REF94479252,405.89,0.0,109058.01
2019-11-10,2019-11-10,Coworking space rental,REF54446102,11.6,0.0,109046.41
2019-11-11,2019-11-11,Marketing expenses,REF48056306,425.22,0.0,108621.19
2019-11-11,2019-11-11,Business meal,REF70424253,144.09,0.0,108477.1
2019-11-13,2019-11-13,Equipment purchase,REF35979535,70.56,0.0,108406.54
2019-11-15,2019-11-15,"Service payment - Hernandez, Jones and Adams",REF31527619,0.0,558.32,108964.86
2019-11-15,2019-11-15,"Project payment - Hernandez, Sanders and Williams",REF82253869,0.0,718.24,109683.1
2019-11-15,2019-11-15,"Project payment - Howard, Cunningham and Murphy",REF86693549,0.0,694.26,110377.36
2019-11-15,2019-11-15,Service payment - Wells Inc,REF14119902,0.0,400.48,110777.84
2019-11-15,2019-11-15,"Payment from Horton, Adams and Smith",REF35962880,0.0,547.16,111325.0
2019-11-15,2019-11-15,"Invoice payment - Wilson, Murphy and Sanders",REF90563112,0.0,1131.57,112456.57
2019-11-15,2019-11-15,"Project payment - Hurley, Johnson and Bell",REF73718780,0.0,696.89,113153.46
2019-11-15,2019-11-15,Service payment - Lucero-Pope,REF32726556,0.0,527.23,113680.69
2019-11-15,2019-11-15,Business insurance premium,REF20626376,147.31,0.0,113533.38
2019-11-19,2019-11-19,Training/conference,REF48119538,207.51,0.0,113325.87
2019-11-21,2019-11-21,Professional software license,REF86783777,189.71,0.0,113136.16
2019-11-22,2019-11-22,Equipment purchase,REF61024230,114.2,0.0,113021.96
2019-11-25,2019-11-25,Business meal,REF44837971,196.86,0.0,112825.1
2019-11-30,2019-11-30,Business travel,REF87816277,407.69,0.0,112417.41
2019-11-30,2019-11-30,Accounting expense,REF91081569,221.56,0.0,112195.85
2019-12-12,2019-12-12,Marketing expenses,REF53415880,335.02,0.0,111860.83
2019-12-15,2019-12-15,"Project payment - Hernandez, Jones and Adams",REF78418933,0.0,594.31,112455.14
2019-12-15,2019-12-15,"Invoice payment - Howard, Cunningham and Murphy",REF82940412,0.0,401.01,112856.15
2019-12-15,2019-12-15,"Invoice payment - Hurley, Johnson and Bell",REF97749382,0.0,667.72,113523.87
2019-12-15,2019-12-15,Project payment - Wells Inc,REF51074355,0.0,308.73,113832.6
2019-12-15,2019-12-15,Invoice payment - Lucero-Pope,REF73248979,0.0,641.27,114473.87
2019-12-15,2019-12-15,"Service payment - Wilson, Murphy and Sanders",REF95363497,0.0,677.27,115151.14
2019-12-15,2019-12-15,Business insurance premium,REF46833831,119.33,0.0,115031.81
2019-12-16,2019-12-16,Accounting expense,REF25677961,162.26,0.0,114869.55
2019-12-17,2019-12-17,Business meal,REF73863344,369.16,0.0,114500.39
2019-12-21,2019-12-21,Professional software license,REF67777866,182.06,0.0,114318.33
2019-12-23,2019-12-23,Business meal,REF75317523,201.11,0.0,114117.22
2019-12-24,2019-12-24,Accounting expense,REF66754740,154.07,0.0,113963.15
2019-12-26,2019-12-26,Coworking space rental,REF74649676,201.4,0.0,113761.75
2019-12-27,2019-12-27,Business travel,REF91530217,224.97,0.0,113536.78
2020-01-07,2020-01-07,Business meal,REF76753567,352.4,0.0,113184.38
2020-01-08,2020-01-08,Business meal,REF90624024,317.43,0.0,112866.95
2020-01-11,2020-01-11,Business meal,REF50780720,234.33,0.0,112632.62
2020-01-14,2020-01-14,Business travel,REF67431881,331.15,0.0,112301.47
2020-01-15,2020-01-15,"Payment from Howard, Cunningham and Murphy",REF20738860,0.0,630.92,112932.39
2020-01-15,2020-01-15,Business insurance premium,REF22611836,164.53,0.0,112767.86
2020-01-15,2020-01-15,"Invoice payment - Hernandez, Jones and Adams",REF61838918,0.0,596.43,113364.29
2020-01-15,2020-01-15,"Project payment - Hernandez, Sanders and Williams",REF14105099,0.0,696.33,114060.62
2020-01-15,2020-01-15,"Project payment - Wilson, Murphy and Sanders",REF18864632,0.0,1110.64,115171.26
2020-01-15,2020-01-15,Service payment - Lucero-Pope,REF62895428,0.0,450.98,115622.24
2020-01-15,2020-01-15,Project payment - Wells Inc,REF84204851,0.0,485.36,116107.6
2020-01-16,2020-01-16,Equipment purchase,REF35173687,195.13,0.0,115912.47
2020-01-19,2020-01-19,Equipment purchase,REF35671585,160.33,0.0,115752.14
2020-01-21,2020-01-21,Professional software license,REF78879047,200.99,0.0,115551.15
2020-01-23,2020-01-23,Coworking space rental,REF66209036,401.71,0.0,115149.44
2020-01-26,2020-01-26,Accounting expense,REF98435508,184.81,0.0,114964.63
2020-01-30,2020-01-30,Accounting expense,REF98206045,286.24,0.0,114678.39
2020-02-05,2020-02-05,Business travel,REF86813630,669.8,0.0,114008.59
2020-02-07,2020-02-07,Business meal,REF45066325,240.12,0.0,113768.47
2020-02-10,2020-02-10,Marketing expenses,REF15100613,172.93,0.0,113595.54
2020-02-10,2020-02-10,Coworking space rental,REF55029948,428.93,0.0,113166.61
2020-02-11,2020-02-11,Equipment purchase,REF31129218,125.67,0.0,113040.94
2020-02-15,2020-02-15,"Invoice payment - Wilson, Murphy and Sanders",REF24363342,0.0,1409.21,114450.15
2020-02-15,2020-02-15,"Payment from Hurley, Johnson and Bell",REF15983135,0.0,765.36,115215.51
2020-02-15,2020-02-15,"Project payment - Hernandez, Jones and Adams",REF96237894,0.0,503.89,115719.4
2020-02-15,2020-02-15,Business insurance premium,REF27005890,155.41,0.0,115563.99
2020-02-15,2020-02-15,"Invoice payment - Hernandez, Sanders and Williams",REF70107898,0.0,589.32,116153.31
2020-02-15,2020-02-15,Project payment - Wells Inc,REF21399138,0.0,484.54,116637.85
2020-02-15,2020-02-15,"Service payment - Howard, Cunningham and Murphy",REF18753236,0.0,554.26,117192.11
2020-02-19,2020-02-19,Business travel,REF48598133,436.47,0.0,116755.64
2020-02-20,2020-02-20,Accounting expense,REF80117176,186.52,0.0,116569.12
2020-02-21,2020-02-21,Professional software license,REF61970044,210.47,0.0,116358.65
2020-02-21,2020-02-21,Business travel,REF87920474,776.9,0.0,115581.75
2020-02-23,2020-02-23,Business meal,REF81162783,244.36,0.0,115337.39
2020-02-25,2020-02-25,Business travel,REF51194500,481.95,0.0,114855.44
2020-03-02,2020-03-02,Training/conference,REF68970565,212.5,0.0,114642.94
2020-03-15,2020-03-15,"Payment from Howard, Cunningham and Murphy",REF89874885,0.0,465.78,115108.72
2020-03-15,2020-03-15,"Invoice payment - Horton, Adams and Smith",REF59202739,0.0,475.76,115584.48
2020-03-15,2020-03-15,"Project payment - Wilson, Murphy and Sanders",REF44418454,0.0,895.54,116480.02
2020-03-15,2020-03-15,"Payment from Hernandez, Jones and Adams",REF61087166,0.0,596.83,117076.85
2020-03-15,2020-03-15,Business insurance premium,REF47141572,140.51,0.0,116936.34
2020-03-15,2020-03-15,Project payment - Lucero-Pope,REF10176414,0.0,713.0,117649.34
2020-03-15,2020-03-15,Payment from Wells Inc,REF53632362,0.0,433.31,118082.65
2020-03-15,2020-03-15,"Payment from Hernandez, Sanders and Williams",REF27150438,0.0,485.77,118568.42
2020-03-15,2020-03-15,"Service payment - Hurley, Johnson and Bell",REF31928100,0.0,714.37,119282.79
2020-03-18,2020-03-18,Business meal,REF63962937,562.32,0.0,118720.47
2020-03-21,2020-03-21,Professional software license,REF42449943,211.29,0.0,118509.18
2020-03-24,2020-03-24,Equipment purchase,REF79320663,125.1,0.0,118384.08
2020-03-30,2020-03-30,Training/conference,REF94164374,127.57,0.0,118256.51
2020-03-30,2020-03-30,Accounting expense,REF37095456,275.97,0.0,117980.54
2020-04-01,2020-04-01,Coworking space rental,REF23378919,192.08,0.0,117788.46
2020-04-02,2020-04-02,Accounting expense,REF88682067,272.57,0.0,117515.89
2020-04-12,2020-04-12,Business meal,REF28001514,122.57,0.0,117393.32
2020-04-15,2020-04-15,"Project payment - Horton, Adams and Smith",REF80779165,0.0,418.96,117812.28
2020-04-15,2020-04-15,"Invoice payment - Hernandez, Sanders and Williams",REF18011848,0.0,748.58,118560.86
2020-04-15,2020-04-15,"Invoice payment - Wilson, Murphy and Sanders",REF94358047,0.0,882.26,119443.12
2020-04-15,2020-04-15,Payment from Lucero-Pope,REF79104871,0.0,539.55,119982.67
2020-04-15,2020-04-15,"Project payment - Hernandez, Jones and Adams",REF98944182,0.0,489.67,120472.34
2020-04-15,2020-04-15,"Payment from Hurley, Johnson and Bell",REF32036551,0.0,700.01,121172.35
2020-04-15,2020-04-15,Business insurance premium,REF65937355,128.9,0.0,121043.45
2020-04-15,2020-04-15,"Service payment - Howard, Cunningham and Murphy",REF16484354,0.0,532.34,121575.79
2020-04-15,2020-04-15,Invoice payment - Wells Inc,REF84149974,0.0,390.55,121966.34
2020-04-21,2020-04-21,Professional software license,REF75729417,204.53,0.0,121761.81
2020-04-23,2020-04-23,Training/conference,REF95563070,155.23,0.0,121606.58
2020-04-30,2020-04-30,Business travel,REF99683747,495.36,0.0,121111.22
2020-04-30,2020-04-30,Marketing expenses,REF93083503,323.91,0.0,120787.31
2020-05-02,2020-05-02,Coworking space rental,REF58216987,179.08,0.0,120608.23
2020-05-05,2020-05-05,Business travel,REF79659193,159.53,0.0,120448.7
2020-05-09,2020-05-09,Accounting expense,REF96439909,144.19,0.0,120304.51
2020-05-11,2020-05-11,Business travel,REF94562174,258.6,0.0,120045.91
2020-05-11,2020-05-11,Business meal,REF47592003,187.71,0.0,119858.2
2020-05-13,2020-05-13,Business meal,REF75583192,277.13,0.0,119581.07
2020-05-15,2020-05-15,Project payment - Lucero-Pope,REF30418122,0.0,517.88,120098.95
2020-05-15,2020-05-15,Project payment - Wells Inc,REF14902352,0.0,406.9,120505.85
2020-05-15,2020-05-15,"Invoice payment - Wilson, Murphy and Sanders",REF80835223,0.0,975.29,121481.14
2020-05-15,2020-05-15,Business insurance premium,REF86886909,130.4,0.0,121350.74
2020-05-15,2020-05-15,"Service payment - Horton, Adams and Smith",REF53585620,0.0,357.15,121707.89
2020-05-15,2020-05-15,"Service payment - Hernandez, Sanders and Williams",REF47149496,0.0,525.83,122233.72
2020-05-15,2020-05-15,"Invoice payment - Howard, Cunningham and Murphy",REF24038520,0.0,443.15,122676.87
2020-05-21,2020-05-21,Professional software license,REF61108338,167.69,0.0,122509.18
2020-05-29,2020-05-29,Coworking space rental,REF91015740,321.21,0.0,122187.97
2020-05-29,2020-05-29,Marketing expenses,REF83998938,243.99,0.0,121943.98
2020-05-31,2020-05-31,Marketing expenses,REF91074325,354.65,0.0,121589.33
2020-06-08,2020-06-08,Business meal,REF58166321,127.86,0.0,121461.47
2020-06-15,2020-06-15,Service payment - Lucero-Pope,REF59657296,0.0,429.98,121891.45
2020-06-15,2020-06-15,Business insurance premium,REF25398025,113.96,0.0,121777.49
2020-06-15,2020-06-15,"Project payment - Hurley, Johnson and Bell",REF37711839,0.0,464.13,122241.62
2020-06-15,2020-06-15,"Payment from Horton, Adams and Smith",REF79441669,0.0,421.28,122662.9
2020-06-15,2020-06-15,"Project payment - Wilson, Murphy and Sanders",REF25208157,0.0,809.92,123472.82
2020-06-15,2020-06-15,"Payment from Hernandez, Sanders and Williams",REF39155705,0.0,674.66,124147.48
2020-06-15,2020-06-15,"Service payment - Hernandez, Jones and Adams",REF89336298,0.0,432.71,124580.19
2020-06-15,2020-06-15,Payment from Wells Inc,REF27162296,0.0,214.24,124794.43
2020-06-18,2020-06-18,Accounting expense,REF90296615,175.85,0.0,124618.58
2020-06-21,2020-06-21,Professional software license,REF61289417,187.61,0.0,124430.97
2020-07-02,2020-07-02,Business travel,REF96524166,313.82,0.0,124117.15
2020-07-09,2020-07-09,Marketing expenses,REF98141399,128.53,0.0,123988.62
2020-07-12,2020-07-12,Business travel,REF19968954,202.1,0.0,123786.52
2020-07-15,2020-07-15,"Project payment - Horton, Adams and Smith",REF78499698,0.0,251.65,124038.17
2020-07-15,2020-07-15,Business insurance premium,REF77988322,90.98,0.0,123947.19
2020-07-15,2020-07-15,"Project payment - Hernandez, Sanders and Williams",REF69727996,0.0,617.82,124565.01
2020-07-15,2020-07-15,"Project payment - Howard, Cunningham and Murphy",REF95374551,0.0,343.71,124908.72
2020-07-15,2020-07-15,"Payment from Hurley, Johnson and Bell",REF21106016,0.0,497.17,125405.89
2020-07-15,2020-07-15,Service payment - Wells Inc,REF76547557,0.0,253.77,125659.66
2020-07-15,2020-07-15,Service payment - Lucero-Pope,REF17193294,0.0,407.38,126067.04
2020-07-15,2020-07-15,"Project payment - Wilson, Murphy and Sanders",REF84712654,0.0,755.2,126822.24
2020-07-15,2020-07-15,"Invoice payment - Hernandez, Jones and Adams",REF50156231,0.0,319.07,127141.31
2020-07-16,2020-07-16,Coworking space rental,REF81140237,220.77,0.0,126920.54
2020-07-18,2020-07-18,Accounting expense,REF62325639,128.05,0.0,126792.49
2020-07-21,2020-07-21,Professional software license,REF49468165,140.58,0.0,126651.91
2020-07-23,2020-07-23,Marketing expenses,REF69959300,208.69,0.0,126443.22
2020-07-26,2020-07-26,Business meal,REF64688300,104.42,0.0,126338.8
2020-07-31,2020-07-31,Accounting expense,REF55328852,156.37,0.0,126182.43
2020-08-08,2020-08-08,Coworking space rental,REF77704572,294.67,0.0,125887.76
2020-08-09,2020-08-09,Business meal,REF84916929,193.78,0.0,125693.98
2020-08-09,2020-08-09,Business travel,REF92419587,384.77,0.0,125309.21
2020-08-11,2020-08-11,Business travel,REF69568607,403.3,0.0,124905.91
2020-08-14,2020-08-14,Coworking space rental,REF61293476,301.47,0.0,124604.44
2020-08-15,2020-08-15,"Service payment - Horton, Adams and Smith",REF18274351,0.0,362.69,124967.13
2020-08-15,2020-08-15,"Invoice payment - Howard, Cunningham and Murphy",REF32184533,0.0,326.34,125293.47
2020-08-15,2020-08-15,Business insurance premium,REF20362658,127.15,0.0,125166.32
2020-08-15,2020-08-15,"Payment from Hernandez, Jones and Adams",REF95973789,0.0,386.91,125553.23
2020-08-15,2020-08-15,"Service payment - Wilson, Murphy and Sanders",REF58010418,0.0,1132.82,126686.05
2020-08-15,2020-08-15,Service payment - Lucero-Pope,REF96831850,0.0,514.88,127200.93
2020-08-15,2020-08-15,"Project payment - Hurley, Johnson and Bell",REF27385479,0.0,492.66,127693.59
2020-08-15,2020-08-15,"Project payment - Hernandez, Sanders and Williams",REF63087574,0.0,501.31,128194.9
2020-08-15,2020-08-15,Payment from Wells Inc,REF33082986,0.0,388.54,128583.44
2020-08-21,2020-08-21,Professional software license,REF44169111,173.36,0.0,128410.08
2020-08-26,2020-08-26,Marketing expenses,REF62753555,107.81,0.0,128302.27
2020-09-14,2020-09-14,Equipment purchase,REF57449736,112.06,0.0,128190.21
2020-09-15,2020-09-15,"Project payment - Howard, Cunningham and Murphy",REF91747093,0.0,645.78,128835.99
2020-09-15,2020-09-15,"Service payment - Wilson, Murphy and Sanders",REF36566984,0.0,945.9,129781.89
2020-09-15,2020-09-15,Project payment - Wells Inc,REF87468048,0.0,343.72,130125.61
2020-09-15,2020-09-15,Business insurance premium,REF16645445,159.89,0.0,129965.72
2020-09-15,2020-09-15,"Service payment - Horton, Adams and Smith",REF79320113,0.0,469.98,130435.7
2020-09-15,2020-09-15,"Project payment - Hernandez, Jones and Adams",REF67804767,0.0,635.32,131071.02
2020-09-15,2020-09-15,"Project payment - Hurley, Johnson and Bell",REF15909919,0.0,812.18,131883.2
2020-09-15,2020-09-15,"Project payment - Hernandez, Sanders and Williams",REF85397901,0.0,681.23,132564.43
2020-09-21,2020-09-21,Professional software license,REF16678672,211.33,0.0,132353.1
2020-09-30,2020-09-30,Training/conference,REF27464819,330.92,0.0,132022.18
2020-10-11,2020-10-11,Business meal,REF76958019,198.34,0.0,131823.84
2020-10-13,2020-10-13,Business travel,REF78429227,412.88,0.0,131410.96
2020-10-15,2020-10-15,Business insurance premium,REF58422035,155.75,0.0,131255.21
2020-10-15,2020-10-15,"Payment from Hurley, Johnson and Bell",REF31756673,0.0,680.5,131935.71
2020-10-15,2020-10-15,Invoice payment - Wells Inc,REF52898899,0.0,484.11,132419.82
2020-10-15,2020-10-15,"Invoice payment - Hernandez, Jones and Adams",REF41323761,0.0,756.81,133176.63
2020-10-15,2020-10-15,"Project payment - Horton, Adams and Smith",REF22601979,0.0,425.88,133602.51
2020-10-15,2020-10-15,Payment from Lucero-Pope,REF13570618,0.0,683.77,134286.28
2020-10-15,2020-10-15,"Invoice payment - Howard, Cunningham and Murphy",REF77630149,0.0,689.77,134976.05
2020-10-15,2020-10-15,"Project payment - Wilson, Murphy and Sanders",REF62133085,0.0,1134.46,136110.51
2020-10-15,2020-10-15,"Project payment - Hernandez, Sanders and Williams",REF10975560,0.0,699.01,136809.52
2020-10-20,2020-10-20,Coworking space rental,REF50257902,295.06,0.0,136514.46
2020-10-21,2020-10-21,Professional software license,REF46331584,235.0,0.0,136279.46
2020-10-31,2020-10-31,Training/conference,REF76665956,371.73,0.0,135907.73
2020-11-01,2020-11-01,Accounting expense,REF25611040,360.66,0.0,135547.07
2020-11-04,2020-11-04,Business travel,REF24368344,472.81,0.0,135074.26
2020-11-06,2020-11-06,Accounting expense,REF19551517,160.83,0.0,134913.43
2020-11-11,2020-11-11,Accounting expense,REF37649158,185.75,0.0,134727.68
2020-11-14,2020-11-14,Accounting expense,REF79288283,223.58,0.0,134504.1
2020-11-15,2020-11-15,Business insurance premium,REF54291709,154.86,0.0,134349.24
2020-11-15,2020-11-15,"Payment from Horton, Adams and Smith",REF44721554,0.0,535.13,134884.37
2020-11-15,2020-11-15,"Invoice payment - Howard, Cunningham and Murphy",REF60045243,0.0,458.17,135342.54
2020-11-15,2020-11-15,"Invoice payment - Wilson, Murphy and Sanders",REF20221199,0.0,1291.41,136633.95
2020-11-15,2020-11-15,"Invoice payment - Hernandez, Sanders and Williams",REF79290459,0.0,769.78,137403.73
2020-11-15,2020-11-15,Service payment - Lucero-Pope,REF40932474,0.0,753.33,138157.06
2020-11-15,2020-11-15,"Service payment - Hernandez, Jones and Adams",REF74673471,0.0,605.0,138762.06
2020-11-16,2020-11-16,Coworking space rental,REF92571709,238.43,0.0,138523.63
2020-11-16,2020-11-16,Business meal,REF12614985,354.84,0.0,138168.79
2020-11-21,2020-11-21,Professional software license,REF24813701,287.5,0.0,137881.29
2020-11-24,2020-11-24,Equipment purchase,REF16668726,113.3,0.0,137767.99
2020-11-28,2020-11-28,Business meal,REF98438815,256.99,0.0,137511.0
2020-12-12,2020-12-12,Business travel,REF16169372,209.48,0.0,137301.52
2020-12-15,2020-12-15,Business travel,REF27303389,391.95,0.0,136909.57
2020-12-15,2020-12-15,"Service payment - Hernandez, Sanders and Williams",REF37139312,0.0,547.55,137457.12
2020-12-15,2020-12-15,Project payment - Lucero-Pope,REF49282557,0.0,606.21,138063.33
2020-12-15,2020-12-15,Accounting expense,REF57522022,158.13,0.0,137905.2
2020-12-15,2020-12-15,Project payment - Wells Inc,REF33409799,0.0,445.47,138350.67
2020-12-15,2020-12-15,Business insurance premium,REF42907937,117.44,0.0,138233.23
2020-12-15,2020-12-15,"Service payment - Hernandez, Jones and Adams",REF63463310,0.0,450.79,138684.02
2020-12-15,2020-12-15,"Invoice payment - Wilson, Murphy and Sanders",REF43693801,0.0,983.31,139667.33
2020-12-15,2020-12-15,"Project payment - Howard, Cunningham and Murphy",REF58300324,0.0,304.95,139972.28
2020-12-21,2020-12-21,Professional software license,REF37084104,161.01,0.0,139811.27
2020-12-26,2020-12-26,Coworking space rental,REF88855068,188.79,0.0,139622.48
2020-12-28,2020-12-28,Equipment purchase,REF64693092,115.08,0.0,139507.4
2020-12-31,2020-12-31,Business meal,REF11159886,376.86,0.0,139130.54
2021-01-04,2021-01-04,Marketing expenses,REF46112931,606.83,0.0,138523.71
2021-01-09,2021-01-09,Business travel,REF15510267,585.22,0.0,137938.49
2021-01-14,2021-01-14,Accounting expense,REF20451404,265.54,0.0,137672.95
2021-01-15,2021-01-15,Business insurance premium,REF20177023,167.15,0.0,137505.8
2021-01-15,2021-01-15,"Invoice payment - Hurley, Johnson and Bell",REF92684860,0.0,714.55,138220.35
2021-01-15,2021-01-15,"Service payment - Horton, Adams and Smith",REF94422950,0.0,504.56,138724.91
2021-01-15,2021-01-15,Service payment - Lucero-Pope,REF61260170,0.0,872.6,139597.51
2021-01-15,2021-01-15,Service payment - Wells Inc,REF15322795,0.0,426.73,140024.24
2021-01-15,2021-01-15,"Invoice payment - Hernandez, Sanders and Williams",REF88235011,0.0,730.85,140755.09
2021-01-18,2021-01-18,Business travel,REF22899973,521.87,0.0,140233.22
2021-01-18,2021-01-18,Coworking space rental,REF30422684,403.68,0.0,139829.54
2021-01-19,2021-01-19,Accounting expense,REF77563939,314.66,0.0,139514.88
2021-01-20,2021-01-20,Accounting expense,REF62609916,337.91,0.0,139176.97
2021-01-21,2021-01-21,Professional software license,REF75378272,279.15,0.0,138897.82
2021-01-23,2021-01-23,Business meal,REF59512096,349.46,0.0,138548.36
2021-01-26,2021-01-26,Business meal,REF12757906,271.68,0.0,138276.68
2021-01-30,2021-01-30,Business meal,REF79655260,476.83,0.0,137799.85
2021-01-31,2021-01-31,Business meal,REF78489928,304.52,0.0,137495.33
2021-02-02,2021-02-02,Business travel,REF14405697,659.93,0.0,136835.4
2021-02-09,2021-02-09,Business meal,REF32486389,235.06,0.0,136600.34
2021-02-09,2021-02-09,Business travel,REF66640480,234.82,0.0,136365.52
2021-02-11,2021-02-11,Marketing expenses,REF29863198,227.63,0.0,136137.89
2021-02-15,2021-02-15,"Project payment - Hernandez, Sanders and Williams",REF47927227,0.0,640.12,136778.01
2021-02-15,2021-02-15,"Payment from Howard, Cunningham and Murphy",REF28315014,0.0,417.18,137195.19
2021-02-15,2021-02-15,Payment from Wells Inc,REF56044555,0.0,423.75,137618.94
2021-02-15,2021-02-15,Service payment - Lucero-Pope,REF57324376,0.0,569.96,138188.9
2021-02-15,2021-02-15,"Payment from Wilson, Murphy and Sanders",REF44331541,0.0,1071.44,139260.34
2021-02-15,2021-02-15,"Invoice payment - Hernandez, Jones and Adams",REF77258643,0.0,474.72,139735.06
2021-02-15,2021-02-15,"Project payment - Hurley, Johnson and Bell",REF83303470,0.0,884.25,140619.31
2021-02-15,2021-02-15,"Payment from Horton, Adams and Smith",REF45521730,0.0,614.43,141233.74
2021-02-15,2021-02-15,Business insurance premium,REF90618745,153.79,0.0,141079.95
2021-02-17,2021-02-17,Business travel,REF61541002,398.89,0.0,140681.06
2021-02-18,2021-02-18,Equipment purchase,REF41859043,172.94,0.0,140508.12
2021-02-21,2021-02-21,Accounting expense,REF66776895,89.31,0.0,140418.81
2021-02-21,2021-02-21,Professional software license,REF21371984,200.44,0.0,140218.37
2021-02-26,2021-02-26,Business meal,REF96984838,240.41,0.0,139977.96
2021-02-27,2021-02-27,Accounting expense,REF31499798,324.27,0.0,139653.69
2021-02-27,2021-02-27,Business travel,REF52047566,581.23,0.0,139072.46
2021-02-28,2021-02-28,Business meal,REF36191441,230.42,0.0,138842.04
2021-02-28,2021-02-28,Marketing expenses,REF76581841,189.52,0.0,138652.52
2021-03-01,2021-03-01,Coworking space rental,REF88581351,232.03,0.0,138420.49
2021-03-04,2021-03-04,Equipment purchase,REF31460365,106.55,0.0,138313.94
2021-03-08,2021-03-08,Training/conference,REF30197879,199.95,0.0,138113.99
2021-03-10,2021-03-10,Coworking space rental,REF56859060,258.32,0.0,137855.67
2021-03-11,2021-03-11,Training/conference,REF16354478,249.92,0.0,137605.75
2021-03-14,2021-03-14,Business travel,REF27632148,543.95,0.0,137061.8
2021-03-15,2021-03-15,"Project payment - Wilson, Murphy and Sanders",REF33645433,0.0,1336.8,138398.6
2021-03-15,2021-03-15,Payment from Wells Inc,REF41845949,0.0,360.31,138758.91
2021-03-15,2021-03-15,"Project payment - Hernandez, Sanders and Williams",REF16651707,0.0,646.06,139404.97
2021-03-15,2021-03-15,"Project payment - Horton, Adams and Smith",REF39270326,0.0,466.62,139871.59
2021-03-15,2021-03-15,"Invoice payment - Howard, Cunningham and Murphy",REF78042354,0.0,568.13,140439.72
2021-03-15,2021-03-15,Service payment - Lucero-Pope,REF65904014,0.0,473.96,140913.68
2021-03-15,2021-03-15,"Invoice payment - Hernandez, Jones and Adams",REF60427898,0.0,496.53,141410.21
2021-03-15,2021-03-15,Business insurance premium,REF44607540,148.77,0.0,141261.44
2021-03-16,2021-03-16,Business meal,REF35921985,434.95,0.0,140826.49
2021-03-17,2021-03-17,Coworking space rental,REF72427767,309.37,0.0,140517.12
2021-03-21,2021-03-21,Professional software license,REF54459128,216.14,0.0,140300.98
2021-03-24,2021-03-24,Business meal,REF45690732,228.14,0.0,140072.84
2021-03-30,2021-03-30,Equipment purchase,REF32233734,121.19,0.0,139951.65
2021-04-06,2021-04-06,Business travel,REF69748435,331.57,0.0,139620.08
2021-04-11,2021-04-11,Marketing expenses,REF97610653,428.92,0.0,139191.16
2021-04-12,2021-04-12,Business meal,REF80341340,369.97,0.0,138821.19
2021-04-15,2021-04-15,Business insurance premium,REF35944987,143.54,0.0,138677.65
2021-04-15,2021-04-15,"Invoice payment - Hernandez, Sanders and Williams",REF80569062,0.0,680.54,139358.19
2021-04-15,2021-04-15,"Service payment - Wilson, Murphy and Sanders",REF81451973,0.0,904.3,140262.49
2021-04-15,2021-04-15,"Project payment - Horton, Adams and Smith",REF30651905,0.0,511.37,140773.86
2021-04-15,2021-04-15,"Service payment - Hernandez, Jones and Adams",REF97477674,0.0,538.46,141312.32
2021-04-15,2021-04-15,Invoice payment - Lucero-Pope,REF22567269,0.0,534.64,141846.96
2021-04-15,2021-04-15,"Project payment - Hurley, Johnson and Bell",REF42950632,0.0,676.78,142523.74
2021-04-18,2021-04-18,Training/conference,REF42404278,130.97,0.0,142392.77
2021-04-21,2021-04-21,Professional software license,REF67345273,207.69,0.0,142185.08
2021-04-28,2021-04-28,Accounting expense,REF27581390,230.49,0.0,141954.59
2021-04-28,2021-04-28,Business meal,REF57850574,221.31,0.0,141733.28
2021-05-01,2021-05-01,Marketing expenses,REF21063544,369.53,0.0,141363.75
2021-05-02,2021-05-02,Marketing expenses,REF39786411,417.29,0.0,140946.46
2021-05-09,2021-05-09,Training/conference,REF30947421,244.92,0.0,140701.54
2021-05-12,2021-05-12,Business meal,REF43178637,174.67,0.0,140526.87
2021-05-14,2021-05-14,Coworking space rental,REF18523185,330.1,0.0,140196.77
2021-05-15,2021-05-15,"Service payment - Hurley, Johnson and Bell",REF54062758,0.0,704.99,140901.76
2021-05-15,2021-05-15,"Payment from Wilson, Murphy and Sanders",REF51214057,0.0,830.69,141732.45
2021-05-15,2021-05-15,Service payment - Wells Inc,REF73620343,0.0,296.88,142029.33
2021-05-15,2021-05-15,"Payment from Hernandez, Sanders and Williams",REF81091088,0.0,721.72,142751.05
2021-05-15,2021-05-15,"Service payment - Horton, Adams and Smith",REF10585047,0.0,452.23,143203.28
2021-05-15,2021-05-15,"Invoice payment - Howard, Cunningham and Murphy",REF17780795,0.0,498.74,143702.02
2021-05-15,2021-05-15,Business insurance premium,REF71295809,127.57,0.0,143574.45
2021-05-21,2021-05-21,Professional software license,REF82920327,187.42,0.0,143387.03
2021-05-21,2021-05-21,Training/conference,REF69630715,120.67,0.0,143266.36
2021-05-27,2021-05-27,Business meal,REF74956556,85.37,0.0,143180.99
2021-05-31,2021-05-31,Business meal,REF71235418,180.38,0.0,143000.61
2021-06-01,2021-06-01,Accounting expense,REF79807872,183.82,0.0,142816.79
2021-06-02,2021-06-02,Business travel,REF97270609,313.42,0.0,142503.37
2021-06-04,2021-06-04,Marketing expenses,REF98641427,309.51,0.0,142193.86
2021-06-04,2021-06-04,Coworking space rental,REF14447642,233.92,0.0,141959.94
2021-06-06,2021-06-06,Equipment purchase,REF99028436,81.44,0.0,141878.5
2021-06-08,2021-06-08,Training/conference,REF26299086,140.87,0.0,141737.63
2021-06-11,2021-06-11,Coworking space rental,REF66506329,212.68,0.0,141524.95
2021-06-15,2021-06-15,"Project payment - Howard, Cunningham and Murphy",REF23147943,0.0,346.68,141871.63
2021-06-15,2021-06-15,"Project payment - Hernandez, Sanders and Williams",REF65563492,0.0,458.12,142329.75
2021-06-15,2021-06-15,"Invoice payment - Hurley, Johnson and Bell",REF77097928,0.0,559.4,142889.15
2021-06-15,2021-06-15,Business insurance premium,REF56285912,111.46,0.0,142777.69
2021-06-15,2021-06-15,Invoice payment - Lucero-Pope,REF71424396,0.0,440.87,143218.56
2021-06-15,2021-06-15,"Payment from Hernandez, Jones and Adams",REF22412840,0.0,398.76,143617.32
2021-06-15,2021-06-15,"Invoice payment - Horton, Adams and Smith",REF93135653,0.0,348.48,143965.8
2021-06-15,2021-06-15,Payment from Wells Inc,REF96526200,0.0,364.46,144330.26
2021-06-19,2021-06-19,Business travel,REF70748197,583.16,0.0,143747.1
2021-06-20,2021-06-20,Training/conference,REF83448816,169.85,0.0,143577.25
2021-06-21,2021-06-21,Professional software license,REF62036623,173.29,0.0,143403.96
2021-06-27,2021-06-27,Equipment purchase,REF46660819,148.92,0.0,143255.04
2021-07-01,2021-07-01,Equipment purchase,REF71220310,93.16,0.0,143161.88
2021-07-02,2021-07-02,Accounting expense,REF18758080,86.13,0.0,143075.75
2021-07-02,2021-07-02,Training/conference,REF53474049,169.99,0.0,142905.76
2021-07-05,2021-07-05,Business travel,REF61440741,207.49,0.0,142698.27
2021-07-09,2021-07-09,Accounting expense,REF31804534,124.6,0.0,142573.67
2021-07-11,2021-07-11,Business travel,REF34510328,381.43,0.0,142192.24
2021-07-12,2021-07-12,Business meal,REF72277625,248.86,0.0,141943.38
2021-07-15,2021-07-15,"Project payment - Hurley, Johnson and Bell",REF56199003,0.0,415.88,142359.26
2021-07-15,2021-07-15,"Service payment - Howard, Cunningham and Murphy",REF21665724,0.0,433.67,142792.93
2021-07-15,2021-07-15,"Project payment - Wilson, Murphy and Sanders",REF62972191,0.0,734.59,143527.52
2021-07-15,2021-07-15,Accounting expense,REF35498451,153.03,0.0,143374.49
2021-07-15,2021-07-15,Payment from Wells Inc,REF93661395,0.0,268.24,143642.73
2021-07-15,2021-07-15,"Payment from Hernandez, Sanders and Williams",REF51955115,0.0,363.65,144006.38
2021-07-15,2021-07-15,Business insurance premium,REF58515387,101.58,0.0,143904.8
2021-07-16,2021-07-16,Coworking space rental,REF27739630,174.51,0.0,143730.29
2021-07-19,2021-07-19,Business travel,REF44282250,385.88,0.0,143344.41
2021-07-21,2021-07-21,Professional software license,REF11291351,141.11,0.0,143203.3
2021-07-21,2021-07-21,Business meal,REF40788282,168.36,0.0,143034.94
2021-07-24,2021-07-24,Accounting expense,REF45626510,165.95,0.0,142868.99
2021-07-25,2021-07-25,Training/conference,REF22302173,89.95,0.0,142779.04
2021-07-27,2021-07-27,Business travel,REF20523000,266.96,0.0,142512.08
2021-07-31,2021-07-31,Business meal,REF88141073,212.49,0.0,142299.59
2021-08-02,2021-08-02,Equipment purchase,REF65914411,102.92,0.0,142196.67
2021-08-09,2021-08-09,Equipment purchase,REF89860261,109.19,0.0,142087.48
2021-08-14,2021-08-14,Training/conference,REF11282150,131.74,0.0,141955.74
2021-08-15,2021-08-15,Business insurance premium,REF14545503,116.22,0.0,141839.52
2021-08-15,2021-08-15,Invoice payment - Wells Inc,REF57548345,0.0,292.54,142132.06
2021-08-15,2021-08-15,"Payment from Hernandez, Sanders and Williams",REF32349828,0.0,443.88,142575.94
2021-08-15,2021-08-15,"Invoice payment - Horton, Adams and Smith",REF36663982,0.0,370.45,142946.39
2021-08-15,2021-08-15,"Project payment - Wilson, Murphy and Sanders",REF24660696,0.0,694.63,143641.02
2021-08-15,2021-08-15,"Service payment - Howard, Cunningham and Murphy",REF66864690,0.0,413.35,144054.37
2021-08-15,2021-08-15,"Invoice payment - Hurley, Johnson and Bell",REF52414888,0.0,548.09,144602.46
2021-08-15,2021-08-15,Service payment - Lucero-Pope,REF44939958,0.0,422.24,145024.7
2021-08-19,2021-08-19,Business meal,REF39698343,217.48,0.0,144807.22
2021-08-21,2021-08-21,Professional software license,REF92820646,150.6,0.0,144656.62
2021-08-22,2021-08-22,Business travel,REF68231663,336.91,0.0,144319.71
2021-08-25,2021-08-25,Equipment purchase,REF80367880,176.99,0.0,144142.72
2021-08-30,2021-08-30,Coworking space rental,REF37002617,319.23,0.0,143823.49
2021-09-03,2021-09-03,Accounting expense,REF92429054,143.04,0.0,143680.45
2021-09-10,2021-09-10,Accounting expense,REF16958051,250.88,0.0,143429.57
2021-09-13,2021-09-13,Accounting expense,REF93977409,150.49,0.0,143279.08
2021-09-14,2021-09-14,Business travel,REF77173007,263.6,0.0,143015.48
2021-09-15,2021-09-15,Invoice payment - Lucero-Pope,REF48751562,0.0,589.6,143605.08
2021-09-15,2021-09-15,"Project payment - Horton, Adams and Smith",REF11701616,0.0,537.37,144142.45
2021-09-15,2021-09-15,Business insurance premium,REF96027798,147.8,0.0,143994.65
2021-09-15,2021-09-15,"Payment from Howard, Cunningham and Murphy",REF75232703,0.0,520.58,144515.23
2021-09-15,2021-09-15,"Invoice payment - Hernandez, Jones and Adams",REF18728917,0.0,649.1,145164.33
2021-09-15,2021-09-15,"Project payment - Hernandez, Sanders and Williams",REF43778012,0.0,546.26,145710.59
2021-09-15,2021-09-15,Invoice payment - Wells Inc,REF70502382,0.0,360.38,146070.97
2021-09-16,2021-09-16,Equipment purchase,REF36269892,184.28,0.0,145886.69
2021-09-21,2021-09-21,Professional software license,REF64317401,236.08,0.0,145650.61
2021-09-21,2021-09-21,Business travel,REF59713835,635.05,0.0,145015.56
2021-09-29,2021-09-29,Marketing expenses,REF55128578,381.11,0.0,144634.45
2021-10-02,2021-10-02,Business meal,REF87635139,373.82,0.0,144260.63
2021-10-04,2021-10-04,Business meal,REF24610858,321.13,0.0,143939.5
2021-10-11,2021-10-11,Equipment purchase,REF56015812,142.66,0.0,143796.84
2021-10-15,2021-10-15,Business insurance premium,REF36394231,156.22,0.0,143640.62
2021-10-15,2021-10-15,"Project payment - Hernandez, Sanders and Williams",REF74606652,0.0,738.24,144378.86
2021-10-15,2021-10-15,Service payment - Lucero-Pope,REF84160804,0.0,525.44,144904.3
2021-10-15,2021-10-15,"Payment from Hernandez, Jones and Adams",REF37595169,0.0,619.88,145524.18
2021-10-15,2021-10-15,"Service payment - Horton, Adams and Smith",REF23881268,0.0,584.97,146109.15
2021-10-15,2021-10-15,"Service payment - Wilson, Murphy and Sanders",REF29764105,0.0,1195.92,147305.07
2021-10-15,2021-10-15,"Project payment - Hurley, Johnson and Bell",REF95472307,0.0,821.03,148126.1
2021-10-15,2021-10-15,Invoice payment - Wells Inc,REF52070230,0.0,422.7,148548.8
2021-10-16,2021-10-16,Business meal,REF55017307,372.33,0.0,148176.47
2021-10-20,2021-10-20,Equipment purchase,REF92649331,174.49,0.0,148001.98
2021-10-21,2021-10-21,Professional software license,REF77523546,188.32,0.0,147813.66
2021-10-26,2021-10-26,Equipment purchase,REF36460302,197.08,0.0,147616.58
2021-10-27,2021-10-27,Business meal,REF90875034,202.32,0.0,147414.26
2021-11-01,2021-11-01,Business travel,REF69528088,253.29,0.0,147160.97
2021-11-07,2021-11-07,Business meal,REF82369839,272.94,0.0,146888.03
2021-11-12,2021-11-12,Business meal,REF32033865,214.98,0.0,146673.05
2021-11-15,2021-11-15,"Project payment - Hurley, Johnson and Bell",REF83629335,0.0,782.31,147455.36
2021-11-15,2021-11-15,"Project payment - Howard, Cunningham and Murphy",REF48873323,0.0,434.04,147889.4
2021-11-15,2021-11-15,Business insurance premium,REF98356139,157.65,0.0,147731.75
2021-11-15,2021-11-15,"Invoice payment - Horton, Adams and Smith",REF41006805,0.0,422.84,148154.59
2021-11-15,2021-11-15,Payment from Lucero-Pope,REF29747038,0.0,669.35,148823.94
2021-11-15,2021-11-15,"Payment from Hernandez, Jones and Adams",REF39863673,0.0,495.31,149319.25
2021-11-15,2021-11-15,Payment from Wells Inc,REF48528897,0.0,464.03,149783.28
2021-11-15,2021-11-15,"Payment from Hernandez, Sanders and Williams",REF76507908,0.0,861.37,150644.65
2021-11-16,2021-11-16,Business travel,REF55606480,327.42,0.0,150317.23
2021-11-16,2021-11-16,Accounting expense,REF51428943,245.43,0.0,150071.8
2021-11-18,2021-11-18,Coworking space rental,REF64670375,223.81,0.0,149847.99
2021-11-21,2021-11-21,Professional software license,REF96179263,176.11,0.0,149671.88
2021-11-27,2021-11-27,Marketing expenses,REF27771721,186.59,0.0,149485.29
2021-12-05,2021-12-05,Training/conference,REF68142344,205.1,0.0,149280.19
2021-12-06,2021-12-06,Coworking space rental,REF16274899,297.94,0.0,148982.25
2021-12-14,2021-12-14,Accounting expense,REF91008129,208.39,0.0,148773.86
2021-12-15,2021-12-15,Business insurance premium,REF99319671,120.65,0.0,148653.21
2021-12-15,2021-12-15,"Project payment - Hurley, Johnson and Bell",REF22999240,0.0,614.6,149267.81
2021-12-15,2021-12-15,Payment from Wells Inc,REF94357072,0.0,267.94,149535.75
2021-12-15,2021-12-15,"Project payment - Horton, Adams and Smith",REF76492546,0.0,467.71,150003.46
2021-12-15,2021-12-15,"Project payment - Hernandez, Sanders and Williams",REF36542844,0.0,563.17,150566.63
2021-12-15,2021-12-15,"Invoice payment - Howard, Cunningham and Murphy",REF69225130,0.0,504.12,151070.75
2021-12-15,2021-12-15,Service payment - Lucero-Pope,REF17534982,0.0,511.78,151582.53
2021-12-15,2021-12-15,"Invoice payment - Wilson, Murphy and Sanders",REF98768120,0.0,1069.45,152651.98
2021-12-15,2021-12-15,"Service payment - Hernandez, Jones and Adams",REF92746109,0.0,379.96,153031.94
2021-12-21,2021-12-21,Business meal,REF61427281,243.63,0.0,152788.31
2021-12-21,2021-12-21,Professional software license,REF67640213,178.53,0.0,152609.78
2021-12-29,2021-12-29,Equipment purchase,REF94794258,125.12,0.0,152484.66
2022-01-01,2022-01-01,Business meal,REF84768328,181.28,0.0,152303.38
2022-01-03,2022-01-03,Business meal,REF18180980,494.91,0.0,151808.47
2022-01-14,2022-01-14,Business meal,REF99414882,326.39,0.0,151482.08
2022-01-15,2022-01-15,"Project payment - Hernandez, Sanders and Williams",REF94877468,0.0,768.67,152250.75
2022-01-15,2022-01-15,"Service payment - Howard, Cunningham and Murphy",REF66536588,0.0,573.93,152824.68
2022-01-15,2022-01-15,Project payment - Wells Inc,REF45928863,0.0,321.12,153145.8
2022-01-15,2022-01-15,Accounting expense,REF99654585,232.82,0.0,152912.98
2022-01-15,2022-01-15,"Service payment - Wilson, Murphy and Sanders",REF61958446,0.0,1179.45,154092.43
2022-01-15,2022-01-15,Business insurance premium,REF83047592,177.98,0.0,153914.45
2022-01-15,2022-01-15,"Payment from Horton, Adams and Smith",REF80361365,0.0,566.9,154481.35
2022-01-15,2022-01-15,Invoice payment - Lucero-Pope,REF92892200,0.0,645.53,155126.88
2022-01-15,2022-01-15,"Project payment - Hernandez, Jones and Adams",REF31048627,0.0,605.74,155732.62
2022-01-21,2022-01-21,Professional software license,REF82936715,246.98,0.0,155485.64
2022-01-26,2022-01-26,Accounting expense,REF71398258,335.28,0.0,155150.36
2022-01-27,2022-01-27,Business travel,REF96402616,701.63,0.0,154448.73
2022-01-28,2022-01-28,Training/conference,REF76684136,141.41,0.0,154307.32
2022-01-30,2022-01-30,Coworking space rental,REF11437288,389.74,0.0,153917.58
2022-01-31,2022-01-31,Equipment purchase,REF64019181,171.78,0.0,153745.8
2022-02-01,2022-02-01,Equipment purchase,REF60700408,116.17,0.0,153629.63
2022-02-03,2022-02-03,Marketing expenses,REF33182993,231.6,0.0,153398.03
2022-02-03,2022-02-03,Accounting expense,REF60161799,181.0,0.0,153217.03
2022-02-03,2022-02-03,Business travel,REF58617301,490.17,0.0,152726.86
2022-02-04,2022-02-04,Training/conference,REF50648395,152.39,0.0,152574.47
2022-02-06,2022-02-06,Business meal,REF57250771,167.72,0.0,152406.75
2022-02-08,2022-02-08,Business meal,REF76647658,494.88,0.0,151911.87
2022-02-13,2022-02-13,Business travel,REF39671453,357.29,0.0,151554.58
2022-02-13,2022-02-13,Business meal,REF83844172,302.99,0.0,151251.59
2022-02-15,2022-02-15,"Payment from Hernandez, Jones and Adams",REF74979205,0.0,698.8,151950.39
2022-02-15,2022-02-15,"Service payment - Horton, Adams and Smith",REF59078281,0.0,602.43,152552.82
2022-02-15,2022-02-15,"Service payment - Wilson, Murphy and Sanders",REF17375426,0.0,957.38,153510.2
2022-02-15,2022-02-15,Business insurance premium,REF37584245,167.77,0.0,153342.43
2022-02-15,2022-02-15,"Service payment - Hurley, Johnson and Bell",REF61064945,0.0,757.0,154099.43
2022-02-15,2022-02-15,"Invoice payment - Howard, Cunningham and Murphy",REF43690624,0.0,604.76,154704.19
2022-02-15,2022-02-15,Service payment - Wells Inc,REF83538973,0.0,434.8,155138.99
2022-02-15,2022-02-15,"Service payment - Hernandez, Sanders and Williams",REF14885797,0.0,656.09,155795.08
2022-02-16,2022-02-16,Training/conference,REF77207749,379.21,0.0,155415.87
2022-02-17,2022-02-17,Business meal,REF24098356,305.88,0.0,155109.99
2022-02-19,2022-02-19,Accounting expense,REF58949130,302.75,0.0,154807.24
2022-02-20,2022-02-20,Coworking space rental,REF52839931,205.74,0.0,154601.5
2022-02-21,2022-02-21,Professional software license,REF60775962,232.55,0.0,154368.95
2022-02-28,2022-02-28,Coworking space rental,REF14216053,235.82,0.0,154133.13
2022-02-28,2022-02-28,Equipment purchase,REF31889398,162.87,0.0,153970.26
2022-03-02,2022-03-02,Accounting expense,REF79917118,312.41,0.0,153657.85
2022-03-03,2022-03-03,Business travel,REF89929450,556.03,0.0,153101.82
2022-03-04,2022-03-04,Business meal,REF48164357,228.42,0.0,152873.4
2022-03-13,2022-03-13,Coworking space rental,REF75376428,253.31,0.0,152620.09
2022-03-15,2022-03-15,"Project payment - Howard, Cunningham and Murphy",REF93960330,0.0,308.57,152928.66
2022-03-15,2022-03-15,Project payment - Wells Inc,REF76957583,0.0,463.93,153392.59
2022-03-15,2022-03-15,Payment from Lucero-Pope,REF30265704,0.0,580.24,153972.83
2022-03-15,2022-03-15,Business insurance premium,REF87453925,132.76,0.0,153840.07
2022-03-15,2022-03-15,"Service payment - Hurley, Johnson and Bell",REF11196163,0.0,727.03,154567.1
2022-03-15,2022-03-15,"Service payment - Hernandez, Jones and Adams",REF61691858,0.0,659.4,155226.5
2022-03-15,2022-03-15,"Project payment - Hernandez, Sanders and Williams",REF66611388,0.0,591.6,155818.1
2022-03-15,2022-03-15,"Invoice payment - Horton, Adams and Smith",REF47017627,0.0,509.62,156327.72
2022-03-16,2022-03-16,Marketing expenses,REF41224398,354.59,0.0,155973.13
2022-03-18,2022-03-18,Equipment purchase,REF39199461,67.37,0.0,155905.76
2022-03-19,2022-03-19,Accounting expense,REF68218575,229.92,0.0,155675.84
2022-03-21,2022-03-21,Professional software license,REF52556581,198.63,0.0,155477.21
2022-03-25,2022-03-25,Business meal,REF51690262,191.12,0.0,155286.09
2022-03-27,2022-03-27,Training/conference,REF82454174,143.95,0.0,155142.14
2022-03-30,2022-03-30,Training/conference,REF47147737,207.4,0.0,154934.74
2022-04-01,2022-04-01,Equipment purchase,REF30046586,223.78,0.0,154710.96
2022-04-04,2022-04-04,Business travel,REF75961027,529.45,0.0,154181.51
2022-04-10,2022-04-10,Training/conference,REF58989992,268.48,0.0,153913.03
2022-04-15,2022-04-15,Business insurance premium,REF27549331,138.52,0.0,153774.51
2022-04-15,2022-04-15,"Invoice payment - Hernandez, Jones and Adams",REF82222974,0.0,579.81,154354.32
2022-04-15,2022-04-15,"Project payment - Wilson, Murphy and Sanders",REF79629733,0.0,904.55,155258.87
2022-04-15,2022-04-15,"Payment from Hernandez, Sanders and Williams",REF37060156,0.0,542.89,155801.76
2022-04-15,2022-04-15,Payment from Wells Inc,REF18101189,0.0,353.39,156155.15
2022-04-15,2022-04-15,"Project payment - Hurley, Johnson and Bell",REF98009531,0.0,656.55,156811.7
2022-04-15,2022-04-15,Project payment - Lucero-Pope,REF85812136,0.0,518.57,157330.27
2022-04-15,2022-04-15,"Payment from Howard, Cunningham and Murphy",REF38517738,0.0,480.86,157811.13
2022-04-15,2022-04-15,"Service payment - Horton, Adams and Smith",REF34302055,0.0,517.72,158328.85
2022-04-19,2022-04-19,Equipment purchase,REF84583672,124.58,0.0,158204.27
2022-04-21,2022-04-21,Professional software license,REF73046132,222.37,0.0,157981.9
2022-05-05,2022-05-05,Training/conference,REF81556776,238.47,0.0,157743.43
2022-05-06,2022-05-06,Marketing expenses,REF27814846,275.16,0.0,157468.27
2022-05-14,2022-05-14,Marketing expenses,REF28516011,325.74,0.0,157142.53
2022-05-15,2022-05-15,"Payment from Hernandez, Jones and Adams",REF69089015,0.0,629.77,157772.3
2022-05-15,2022-05-15,Project payment - Wells Inc,REF49838187,0.0,334.09,158106.39
2022-05-15,2022-05-15,Invoice payment - Lucero-Pope,REF49769768,0.0,644.93,158751.32
2022-05-15,2022-05-15,"Project payment - Hurley, Johnson and Bell",REF46039363,0.0,744.83,159496.15
2022-05-15,2022-05-15,"Payment from Horton, Adams and Smith",REF23970968,0.0,433.98,159930.13
2022-05-15,2022-05-15,"Service payment - Wilson, Murphy and Sanders",REF89980022,0.0,1006.35,160936.48
2022-05-15,2022-05-15,Business insurance premium,REF27566730,139.36,0.0,160797.12
2022-05-15,2022-05-15,"Service payment - Hernandez, Sanders and Williams",REF28754831,0.0,602.46,161399.58
2022-05-17,2022-05-17,Accounting expense,REF66552632,196.34,0.0,161203.24
2022-05-18,2022-05-18,Business meal,REF91205503,165.1,0.0,161038.14
2022-05-19,2022-05-19,Equipment purchase,REF77225643,134.05,0.0,160904.09
2022-05-21,2022-05-21,Professional software license,REF61465718,186.81,0.0,160717.28
2022-05-29,2022-05-29,Business travel,REF27117936,422.18,0.0,160295.1
2022-06-04,2022-06-04,Business travel,REF71780851,281.03,0.0,160014.07
2022-06-15,2022-06-15,Business insurance premium,REF50612644,115.43,0.0,159898.64
2022-06-15,2022-06-15,"Payment from Howard, Cunningham and Murphy",REF64527662,0.0,426.28,160324.92
2022-06-15,2022-06-15,"Project payment - Horton, Adams and Smith",REF95458708,0.0,379.7,160704.62
2022-06-15,2022-06-15,"Service payment - Hernandez, Jones and Adams",REF28862173,0.0,513.25,161217.87
2022-06-15,2022-06-15,"Project payment - Wilson, Murphy and Sanders",REF44787807,0.0,924.1,162141.97
2022-06-15,2022-06-15,Invoice payment - Wells Inc,REF55556255,0.0,357.67,162499.64
2022-06-15,2022-06-15,Invoice payment - Lucero-Pope,REF57155818,0.0,495.01,162994.65
2022-06-15,2022-06-15,"Invoice payment - Hernandez, Sanders and Williams",REF25713785,0.0,517.8,163512.45
2022-06-15,2022-06-15,"Invoice payment - Hurley, Johnson and Bell",REF13480093,0.0,349.66,163862.11
2022-06-19,2022-06-19,Business meal,REF44650110,208.18,0.0,163653.93
2022-06-19,2022-06-19,Training/conference,REF46380417,183.85,0.0,163470.08
2022-06-21,2022-06-21,Professional software license,REF84002369,173.72,0.0,163296.36
2022-06-24,2022-06-24,Marketing expenses,REF70024593,262.59,0.0,163033.77
2022-07-01,2022-07-01,Business travel,REF62125401,348.96,0.0,162684.81
2022-07-03,2022-07-03,Training/conference,REF80219563,154.35,0.0,162530.46
2022-07-15,2022-07-15,Business travel,REF88639058,161.62,0.0,162368.84
2022-07-15,2022-07-15,Service payment - Wells Inc,REF84181792,0.0,293.73,162662.57
2022-07-15,2022-07-15,"Project payment - Hurley, Johnson and Bell",REF12703468,0.0,571.82,163234.39
2022-07-15,2022-07-15,Training/conference,REF56927017,245.12,0.0,162989.27
2022-07-15,2022-07-15,"Invoice payment - Horton, Adams and Smith",REF88852329,0.0,329.57,163318.84
2022-07-15,2022-07-15,Payment from Lucero-Pope,REF11253749,0.0,470.05,163788.89
2022-07-15,2022-07-15,Business insurance premium,REF83130839,99.48,0.0,163689.41
2022-07-15,2022-07-15,"Service payment - Wilson, Murphy and Sanders",REF65013794,0.0,789.21,164478.62
2022-07-15,2022-07-15,"Service payment - Hernandez, Jones and Adams",REF39754285,0.0,499.48,164978.1
2022-07-15,2022-07-15,"Service payment - Hernandez, Sanders and Williams",REF58720695,0.0,482.25,165460.35
2022-07-21,2022-07-21,Professional software license,REF12081480,131.21,0.0,165329.14
2022-07-22,2022-07-22,Equipment purchase,REF60012009,119.97,0.0,165209.17
2022-07-27,2022-07-27,Business meal,REF77653511,54.56,0.0,165154.61
2022-07-30,2022-07-30,Accounting expense,REF33875268,108.75,0.0,165045.86
2022-08-06,2022-08-06,Business travel,REF57959093,392.59,0.0,164653.27
2022-08-07,2022-08-07,Accounting expense,REF76439409,205.41,0.0,164447.86
2022-08-12,2022-08-12,Business travel,REF52243858,370.26,0.0,164077.6
2022-08-15,2022-08-15,"Service payment - Hernandez, Jones and Adams",REF83589721,0.0,386.92,164464.52
2022-08-15,2022-08-15,"Service payment - Howard, Cunningham and Murphy",REF65795582,0.0,360.15,164824.67
2022-08-15,2022-08-15,"Invoice payment - Hernandez, Sanders and Williams",REF24735914,0.0,554.14,165378.81
2022-08-15,2022-08-15,Service payment - Wells Inc,REF46748929,0.0,357.4,165736.21
2022-08-15,2022-08-15,"Payment from Wilson, Murphy and Sanders",REF57691124,0.0,874.8,166611.01
2022-08-15,2022-08-15,Payment from Lucero-Pope,REF62794981,0.0,422.15,167033.16
2022-08-15,2022-08-15,Business insurance premium,REF99955998,108.92,0.0,166924.24
2022-08-20,2022-08-20,Business meal,REF41752670,184.27,0.0,166739.97
2022-08-21,2022-08-21,Professional software license,REF29496848,168.96,0.0,166571.01
2022-08-23,2022-08-23,Accounting expense,REF64087469,153.93,0.0,166417.08
2022-08-29,2022-08-29,Coworking space rental,REF84710701,281.04,0.0,166136.04
2022-08-31,2022-08-31,Marketing expenses,REF76003884,320.69,0.0,165815.35
2022-09-01,2022-09-01,Business travel,REF62314265,601.49,0.0,165213.86
2022-09-02,2022-09-02,Marketing expenses,REF96990033,408.65,0.0,164805.21
2022-09-02,2022-09-02,Accounting expense,REF47425623,157.92,0.0,164647.29
2022-09-07,2022-09-07,Business meal,REF19736276,299.13,0.0,164348.16
2022-09-10,2022-09-10,Business travel,REF31036377,568.73,0.0,163779.43
2022-09-12,2022-09-12,Business meal,REF45809829,325.3,0.0,163454.13
2022-09-13,2022-09-13,Business travel,REF31989431,700.97,0.0,162753.16
2022-09-13,2022-09-13,Equipment purchase,REF85362519,213.21,0.0,162539.95
2022-09-15,2022-09-15,"Invoice payment - Horton, Adams and Smith",REF19155307,0.0,494.63,163034.58
2022-09-15,2022-09-15,"Payment from Wilson, Murphy and Sanders",REF77602054,0.0,1129.88,164164.46
2022-09-15,2022-09-15,Payment from Wells Inc,REF82527366,0.0,371.97,164536.43
2022-09-15,2022-09-15,"Invoice payment - Hernandez, Sanders and Williams",REF67788449,0.0,708.03,165244.46
2022-09-15,2022-09-15,"Invoice payment - Hurley, Johnson and Bell",REF39182121,0.0,648.45,165892.91
2022-09-15,2022-09-15,"Service payment - Hernandez, Jones and Adams",REF53735997,0.0,697.22,166590.13
2022-09-15,2022-09-15,Payment from Lucero-Pope,REF30516739,0.0,607.23,167197.36
2022-09-15,2022-09-15,Business insurance premium,REF65856297,158.89,0.0,167038.47
2022-09-15,2022-09-15,"Service payment - Howard, Cunningham and Murphy",REF71452124,0.0,612.15,167650.62
2022-09-20,2022-09-20,Business travel,REF77013936,399.69,0.0,167250.93
2022-09-21,2022-09-21,Professional software license,REF26524603,232.32,0.0,167018.61
2022-09-26,2022-09-26,Business travel,REF72651680,592.97,0.0,166425.64
2022-09-27,2022-09-27,Business meal,REF86680802,203.19,0.0,166222.45
2022-09-27,2022-09-27,Accounting expense,REF81898203,284.33,0.0,165938.12
2022-09-27,2022-09-27,Coworking space rental,REF93132628,223.56,0.0,165714.56
2022-09-28,2022-09-28,Business travel,REF82355055,229.23,0.0,165485.33
2022-09-28,2022-09-28,Business meal,REF90276197,252.16,0.0,165233.17
2022-09-30,2022-09-30,Equipment purchase,REF59948377,137.36,0.0,165095.81
2022-10-08,2022-10-08,Business meal,REF53397243,290.25,0.0,164805.56
2022-10-10,2022-10-10,Coworking space rental,REF38436458,369.9,0.0,164435.66
2022-10-14,2022-10-14,Accounting expense,REF78212963,309.93,0.0,164125.73
2022-10-15,2022-10-15,Accounting expense,REF60932977,152.7,0.0,163973.03
2022-10-15,2022-10-15,"Payment from Hernandez, Sanders and Williams",REF56724477,0.0,790.88,164763.91
2022-10-15,2022-10-15,"Project payment - Howard, Cunningham and Murphy",REF67287884,0.0,643.35,165407.26
2022-10-15,2022-10-15,Service payment - Wells Inc,REF33060753,0.0,498.82,165906.08
2022-10-15,2022-10-15,"Project payment - Hurley, Johnson and Bell",REF13487498,0.0,913.1,166819.18
2022-10-15,2022-10-15,"Service payment - Hernandez, Jones and Adams",REF32158051,0.0,679.79,167498.97
2022-10-15,2022-10-15,Invoice payment - Lucero-Pope,REF98520477,0.0,657.45,168156.42
2022-10-15,2022-10-15,Business insurance premium,REF24689784,167.49,0.0,167988.93
2022-10-15,2022-10-15,"Project payment - Horton, Adams and Smith",REF50885684,0.0,565.92,168554.85
2022-10-19,2022-10-19,Coworking space rental,REF64461743,143.68,0.0,168411.17
2022-10-21,2022-10-21,Professional software license,REF58592344,240.58,0.0,168170.59
2022-10-22,2022-10-22,Coworking space rental,REF59546283,554.6,0.0,167615.99
2022-10-26,2022-10-26,Business meal,REF24284322,341.56,0.0,167274.43
2022-10-31,2022-10-31,Accounting expense,REF45906118,318.55,0.0,166955.88
2022-11-03,2022-11-03,Coworking space rental,REF15426445,250.05,0.0,166705.83
2022-11-05,2022-11-05,Business travel,REF50858107,377.5,0.0,166328.33
2022-11-10,2022-11-10,Accounting expense,REF83838035,244.64,0.0,166083.69
2022-11-15,2022-11-15,"Invoice payment - Wilson, Murphy and Sanders",REF85646108,0.0,723.25,166806.94
2022-11-15,2022-11-15,"Service payment - Howard, Cunningham and Murphy",REF51086988,0.0,539.72,167346.66
2022-11-15,2022-11-15,"Service payment - Hernandez, Jones and Adams",REF66950761,0.0,649.22,167995.88
2022-11-15,2022-11-15,Business insurance premium,REF98484682,154.6,0.0,167841.28
2022-11-15,2022-11-15,"Service payment - Hurley, Johnson and Bell",REF62831869,0.0,748.08,168589.36
2022-11-15,2022-11-15,Project payment - Lucero-Pope,REF28530907,0.0,740.8,169330.16
2022-11-15,2022-11-15,"Invoice payment - Horton, Adams and Smith",REF54366276,0.0,556.43,169886.59
2022-11-15,2022-11-15,"Invoice payment - Hernandez, Sanders and Williams",REF88236010,0.0,771.35,170657.94
2022-11-16,2022-11-16,Coworking space rental,REF52036497,614.4,0.0,170043.54
2022-11-21,2022-11-21,Professional software license,REF42525240,248.87,0.0,169794.67
2022-11-29,2022-11-29,Training/conference,REF23486107,298.36,0.0,169496.31
2022-12-05,2022-12-05,Equipment purchase,REF87467509,147.53,0.0,169348.78
2022-12-06,2022-12-06,Marketing expenses,REF25023193,325.16,0.0,169023.62
2022-12-07,2022-12-07,Coworking space rental,REF80486847,368.21,0.0,168655.41
2022-12-09,2022-12-09,Equipment purchase,REF60883091,210.7,0.0,168444.71
2022-12-15,2022-12-15,"Project payment - Wilson, Murphy and Sanders",REF86028506,0.0,1093.71,169538.42
2022-12-15,2022-12-15,"Service payment - Horton, Adams and Smith",REF28132265,0.0,473.06,170011.48
2022-12-15,2022-12-15,"Invoice payment - Hurley, Johnson and Bell",REF52444695,0.0,798.8,170810.28
2022-12-15,2022-12-15,Payment from Wells Inc,REF69597616,0.0,311.81,171122.09
2022-12-15,2022-12-15,Business insurance premium,REF23965585,124.41,0.0,170997.68
2022-12-15,2022-12-15,Marketing expenses,REF61634616,368.51,0.0,170629.17
2022-12-15,2022-12-15,"Invoice payment - Hernandez, Sanders and Williams",REF23253190,0.0,599.18,171228.35
2022-12-15,2022-12-15,"Project payment - Howard, Cunningham and Murphy",REF44073800,0.0,381.78,171610.13
2022-12-21,2022-12-21,Coworking space rental,REF51030260,293.37,0.0,171316.76
2022-12-21,2022-12-21,Professional software license,REF49952061,173.29,0.0,171143.47
2022-12-25,2022-12-25,Accounting expense,REF35790857,97.94,0.0,171045.53
2023-01-01,2023-01-01,Training/conference,REF75065362,348.49,0.0,170697.04
2023-01-02,2023-01-02,Marketing expenses,REF23817828,461.37,0.0,170235.67
2023-01-06,2023-01-06,Business travel,REF50368194,352.68,0.0,169882.99
2023-01-07,2023-01-07,Accounting expense,REF95193500,276.01,0.0,169606.98
2023-01-07,2023-01-07,Coworking space rental,REF59936709,503.18,0.0,169103.8
2023-01-08,2023-01-08,Training/conference,REF72422421,220.37,0.0,168883.43
2023-01-10,2023-01-10,Accounting expense,REF34973334,151.5,0.0,168731.93
2023-01-13,2023-01-13,Training/conference,REF29199289,255.11,0.0,168476.82
2023-01-15,2023-01-15,"Invoice payment - Hernandez, Sanders and Williams",REF14702536,0.0,876.01,169352.83
2023-01-15,2023-01-15,Project payment - Wells Inc,REF21645968,0.0,485.26,169838.09
2023-01-15,2023-01-15,"Service payment - Hurley, Johnson and Bell",REF95051235,0.0,907.31,170745.4
2023-01-15,2023-01-15,"Invoice payment - Horton, Adams and Smith",REF16711610,0.0,649.26,171394.66
2023-01-15,2023-01-15,"Invoice payment - Howard, Cunningham and Murphy",REF38287760,0.0,583.08,171977.74
2023-01-15,2023-01-15,"Project payment - Wilson, Murphy and Sanders",REF68197512,0.0,1215.0,173192.74
2023-01-15,2023-01-15,Business insurance premium,REF63948033,173.63,0.0,173019.11
2023-01-15,2023-01-15,Payment from Lucero-Pope,REF82471939,0.0,709.88,173728.99
2023-01-18,2023-01-18,Marketing expenses,REF44130846,231.55,0.0,173497.44
2023-01-19,2023-01-19,Business meal,REF30733059,321.45,0.0,173175.99
2023-01-21,2023-01-21,Professional software license,REF53292549,252.78,0.0,172923.21
2023-01-23,2023-01-23,Training/conference,REF73699125,307.75,0.0,172615.46
2023-01-25,2023-01-25,Training/conference,REF79561787,177.33,0.0,172438.13
2023-01-25,2023-01-25,Equipment purchase,REF13298847,265.1,0.0,172173.03
2023-01-28,2023-01-28,Business meal,REF91676125,194.99,0.0,171978.04
2023-01-31,2023-01-31,Training/conference,REF92804671,241.89,0.0,171736.15
2023-02-02,2023-02-02,Business meal,REF36436900,237.65,0.0,171498.5
2023-02-04,2023-02-04,Business travel,REF25764603,449.35,0.0,171049.15
2023-02-04,2023-02-04,Business meal,REF40518328,255.87,0.0,170793.28
2023-02-10,2023-02-10,Training/conference,REF91820531,214.56,0.0,170578.72
2023-02-14,2023-02-14,Training/conference,REF32850791,209.47,0.0,170369.25
2023-02-15,2023-02-15,"Invoice payment - Horton, Adams and Smith",REF59839098,0.0,493.65,170862.9
2023-02-15,2023-02-15,"Payment from Hernandez, Sanders and Williams",REF71638537,0.0,760.06,171622.96
2023-02-15,2023-02-15,Invoice payment - Wells Inc,REF87081667,0.0,388.45,172011.41
2023-02-15,2023-02-15,"Payment from Hurley, Johnson and Bell",REF15942856,0.0,724.75,172736.16
2023-02-15,2023-02-15,"Invoice payment - Hernandez, Jones and Adams",REF56209560,0.0,618.56,173354.72
2023-02-15,2023-02-15,Payment from Lucero-Pope,REF11396316,0.0,738.31,174093.03
2023-02-15,2023-02-15,Business insurance premium,REF78768943,149.13,0.0,173943.9
2023-02-15,2023-02-15,"Payment from Howard, Cunningham and Murphy",REF38085276,0.0,547.87,174491.77
2023-02-15,2023-02-15,"Invoice payment - Wilson, Murphy and Sanders",REF71482058,0.0,1233.7,175725.47
2023-02-21,2023-02-21,Training/conference,REF44824166,192.33,0.0,175533.14
2023-02-21,2023-02-21,Professional software license,REF82086831,235.42,0.0,175297.72
2023-02-23,2023-02-23,Coworking space rental,REF74138243,438.53,0.0,174859.19
2023-02-28,2023-02-28,Training/conference,REF64898095,228.18,0.0,174631.01
2023-03-03,2023-03-03,Business meal,REF18548574,121.94,0.0,174509.07
2023-03-07,2023-03-07,Business meal,REF55581460,282.67,0.0,174226.4
2023-03-08,2023-03-08,Equipment purchase,REF77715148,136.18,0.0,174090.22
2023-03-09,2023-03-09,Accounting expense,REF63453141,146.68,0.0,173943.54
2023-03-15,2023-03-15,"Invoice payment - Horton, Adams and Smith",REF17193030,0.0,380.61,174324.15
2023-03-15,2023-03-15,"Service payment - Wilson, Murphy and Sanders",REF41828200,0.0,864.79,175188.94
2023-03-15,2023-03-15,"Project payment - Hurley, Johnson and Bell",REF28205857,0.0,924.39,176113.33
2023-03-15,2023-03-15,Project payment - Wells Inc,REF78892859,0.0,344.43,176457.76
2023-03-15,2023-03-15,Invoice payment - Lucero-Pope,REF11854131,0.0,662.57,177120.33
2023-03-15,2023-03-15,"Project payment - Howard, Cunningham and Murphy",REF25876943,0.0,496.22,177616.55
2023-03-15,2023-03-15,Business insurance premium,REF75387172,141.46,0.0,177475.09
2023-03-16,2023-03-16,Marketing expenses,REF52480574,253.12,0.0,177221.97
2023-03-21,2023-03-21,Professional software license,REF93912337,173.52,0.0,177048.45
2023-03-23,2023-03-23,Business meal,REF56136635,90.42,0.0,176958.03
2023-03-24,2023-03-24,Accounting expense,REF82452723,142.56,0.0,176815.47
2023-03-28,2023-03-28,Equipment purchase,REF15849896,204.01,0.0,176611.46
2023-03-30,2023-03-30,Coworking space rental,REF36505474,159.78,0.0,176451.68
2023-03-31,2023-03-31,Accounting expense,REF34995077,192.65,0.0,176259.03
2023-04-06,2023-04-06,Accounting expense,REF52946575,184.02,0.0,176075.01
2023-04-14,2023-04-14,Marketing expenses,REF76558044,366.91,0.0,175708.1
2023-04-15,2023-04-15,"Service payment - Hernandez, Jones and Adams",REF24746671,0.0,569.11,176277.21
2023-04-15,2023-04-15,Project payment - Lucero-Pope,REF58310546,0.0,545.59,176822.8
2023-04-15,2023-04-15,Payment from Wells Inc,REF20640710,0.0,286.87,177109.67
2023-04-15,2023-04-15,"Service payment - Hernandez, Sanders and Williams",REF85791411,0.0,651.07,177760.74
2023-04-15,2023-04-15,"Project payment - Wilson, Murphy and Sanders",REF69375031,0.0,797.72,178558.46
2023-04-15,2023-04-15,"Invoice payment - Horton, Adams and Smith",REF48615090,0.0,420.63,178979.09
2023-04-15,2023-04-15,"Project payment - Howard, Cunningham and Murphy",REF11894947,0.0,616.92,179596.01
2023-04-15,2023-04-15,"Payment from Hurley, Johnson and Bell",REF41666769,0.0,716.65,180312.66
2023-04-15,2023-04-15,Business insurance premium,REF52278090,144.76,0.0,180167.9
2023-04-16,2023-04-16,Coworking space rental,REF97265080,218.49,0.0,179949.41
2023-04-17,2023-04-17,Business travel,REF84125590,529.79,0.0,179419.62
2023-04-18,2023-04-18,Equipment purchase,REF10635722,167.49,0.0,179252.13
2023-04-19,2023-04-19,Business travel,REF45470107,491.85,0.0,178760.28
2023-04-21,2023-04-21,Professional software license,REF13618078,209.31,0.0,178550.97
2023-04-26,2023-04-26,Business meal,REF11289742,300.7,0.0,178250.27
2023-04-29,2023-04-29,Coworking space rental,REF81582465,294.48,0.0,177955.79
2023-04-29,2023-04-29,Business meal,REF24819595,203.06,0.0,177752.73
2023-05-01,2023-05-01,Business meal,REF92029890,392.75,0.0,177359.98
2023-05-02,2023-05-02,Coworking space rental,REF32518597,343.37,0.0,177016.61
2023-05-07,2023-05-07,Business meal,REF94270705,207.39,0.0,176809.22
2023-05-08,2023-05-08,Equipment purchase,REF83897860,170.3,0.0,176638.92
2023-05-09,2023-05-09,Coworking space rental,REF63349751,370.47,0.0,176268.45
2023-05-11,2023-05-11,Marketing expenses,REF72529925,191.77,0.0,176076.68
2023-05-12,2023-05-12,Marketing expenses,REF37193003,261.11,0.0,175815.57
2023-05-15,2023-05-15,Project payment - Wells Inc,REF21409474,0.0,368.57,176184.14
2023-05-15,2023-05-15,"Service payment - Wilson, Murphy and Sanders",REF99061403,0.0,832.68,177016.82
2023-05-15,2023-05-15,Business insurance premium,REF34800032,130.16,0.0,176886.66
2023-05-15,2023-05-15,"Service payment - Hernandez, Jones and Adams",REF53032596,0.0,370.88,177257.54
2023-05-15,2023-05-15,"Payment from Howard, Cunningham and Murphy",REF37140234,0.0,455.76,177713.3
2023-05-15,2023-05-15,"Project payment - Hernandez, Sanders and Williams",REF33818847,0.0,592.2,178305.5
2023-05-15,2023-05-15,"Invoice payment - Hurley, Johnson and Bell",REF57667608,0.0,552.84,178858.34
2023-05-16,2023-05-16,Business meal,REF38634649,236.18,0.0,178622.16
2023-05-21,2023-05-21,Professional software license,REF89058801,181.14,0.0,178441.02
2023-05-28,2023-05-28,Training/conference,REF58624915,192.07,0.0,178248.95
2023-05-29,2023-05-29,Marketing expenses,REF54825240,389.07,0.0,177859.88
2023-06-08,2023-06-08,Coworking space rental,REF63896540,93.32,0.0,177766.56
2023-06-11,2023-06-11,Business travel,REF98052380,382.69,0.0,177383.87
2023-06-13,2023-06-13,Accounting expense,REF77518688,133.25,0.0,177250.62
2023-06-14,2023-06-14,Equipment purchase,REF89432851,118.87,0.0,177131.75
2023-06-15,2023-06-15,Training/conference,REF16728487,212.65,0.0,176919.1
2023-06-15,2023-06-15,"Project payment - Howard, Cunningham and Murphy",REF27644741,0.0,361.43,177280.53
2023-06-15,2023-06-15,"Invoice payment - Wilson, Murphy and Sanders",REF42987132,0.0,726.05,178006.58
2023-06-15,2023-06-15,"Project payment - Hernandez, Jones and Adams",REF45562053,0.0,523.71,178530.29
2023-06-15,2023-06-15,"Invoice payment - Hurley, Johnson and Bell",REF40156914,0.0,538.01,179068.3
2023-06-15,2023-06-15,"Project payment - Horton, Adams and Smith",REF74037673,0.0,391.33,179459.63
2023-06-15,2023-06-15,Project payment - Wells Inc,REF80544316,0.0,407.33,179866.96
2023-06-15,2023-06-15,Payment from Lucero-Pope,REF76329229,0.0,473.38,180340.34
2023-06-15,2023-06-15,Business insurance premium,REF53281299,106.8,0.0,180233.54
2023-06-21,2023-06-21,Equipment purchase,REF72832141,142.21,0.0,180091.33
2023-06-21,2023-06-21,Professional software license,REF10665220,147.3,0.0,179944.03
2023-06-22,2023-06-22,Business meal,REF94390904,232.66,0.0,179711.37
2023-06-23,2023-06-23,Business travel,REF97789128,242.21,0.0,179469.16
2023-06-24,2023-06-24,Coworking space rental,REF76380315,236.38,0.0,179232.78
2023-06-29,2023-06-29,Training/conference,REF92728853,177.03,0.0,179055.75
2023-07-04,2023-07-04,Business meal,REF84166903,234.49,0.0,178821.26
2023-07-05,2023-07-05,Business meal,REF95470359,86.19,0.0,178735.07
2023-07-06,2023-07-06,Marketing expenses,REF67446458,207.98,0.0,178527.09
2023-07-07,2023-07-07,Accounting expense,REF53933795,103.22,0.0,178423.87
2023-07-12,2023-07-12,Business travel,REF81993087,318.57,0.0,178105.3
2023-07-15,2023-07-15,"Service payment - Horton, Adams and Smith",REF68364682,0.0,331.43,178436.73
2023-07-15,2023-07-15,Service payment - Lucero-Pope,REF14784897,0.0,461.36,178898.09
2023-07-15,2023-07-15,"Payment from Hernandez, Sanders and Williams",REF48230173,0.0,397.94,179296.03
2023-07-15,2023-07-15,Business insurance premium,REF46034169,99.35,0.0,179196.68
2023-07-15,2023-07-15,Service payment - Wells Inc,REF58164094,0.0,242.11,179438.79
2023-07-15,2023-07-15,"Invoice payment - Hurley, Johnson and Bell",REF99616684,0.0,533.65,179972.44
2023-07-15,2023-07-15,"Project payment - Wilson, Murphy and Sanders",REF88276330,0.0,634.43,180606.87
2023-07-21,2023-07-21,Professional software license,REF32886566,111.2,0.0,180495.67
2023-07-22,2023-07-22,Equipment purchase,REF27466474,67.42,0.0,180428.25
2023-07-26,2023-07-26,Coworking space rental,REF20683399,150.09,0.0,180278.16
2023-07-28,2023-07-28,Business meal,REF79175788,225.44,0.0,180052.72
2023-08-03,2023-08-03,Business meal,REF21108823,197.51,0.0,179855.21
2023-08-07,2023-08-07,Coworking space rental,REF53744298,256.55,0.0,179598.66
2023-08-10,2023-08-10,Training/conference,REF72161289,170.84,0.0,179427.82
2023-08-11,2023-08-11,Training/conference,REF55152908,297.69,0.0,179130.13
2023-08-12,2023-08-12,Coworking space rental,REF95825907,303.83,0.0,178826.3
2023-08-13,2023-08-13,Business meal,REF54961427,34.45,0.0,178791.85
2023-08-15,2023-08-15,"Invoice payment - Howard, Cunningham and Murphy",REF99532421,0.0,330.1,179121.95
2023-08-15,2023-08-15,"Project payment - Wilson, Murphy and Sanders",REF56381971,0.0,761.43,179883.38
2023-08-15,2023-08-15,"Project payment - Hernandez, Sanders and Williams",REF86255840,0.0,543.05,180426.43
2023-08-15,2023-08-15,Invoice payment - Lucero-Pope,REF11976636,0.0,498.0,180924.43
2023-08-15,2023-08-15,Invoice payment - Wells Inc,REF69789725,0.0,397.38,181321.81
2023-08-15,2023-08-15,"Project payment - Hurley, Johnson and Bell",REF59086029,0.0,501.55,181823.36
2023-08-15,2023-08-15,"Payment from Hernandez, Jones and Adams",REF61886505,0.0,405.62,182228.98
2023-08-15,2023-08-15,"Project payment - Horton, Adams and Smith",REF33021737,0.0,470.81,182699.79
2023-08-15,2023-08-15,Business insurance premium,REF28238465,114.66,0.0,182585.13
2023-08-16,2023-08-16,Coworking space rental,REF36034345,246.02,0.0,182339.11
2023-08-19,2023-08-19,Coworking space rental,REF13127995,275.94,0.0,182063.17
2023-08-21,2023-08-21,Professional software license,REF30107912,190.41,0.0,181872.76
2023-08-23,2023-08-23,Business meal,REF75029326,187.77,0.0,181684.99
2023-08-23,2023-08-23,Training/conference,REF70196505,93.0,0.0,181591.99
2023-08-26,2023-08-26,Accounting expense,REF20773616,183.34,0.0,181408.65
2023-08-27,2023-08-27,Business travel,REF33867999,288.07,0.0,181120.58
2023-08-28,2023-08-28,Marketing expenses,REF20261162,259.85,0.0,180860.73
2023-09-06,2023-09-06,Business meal,REF76562734,348.23,0.0,180512.5
2023-09-11,2023-09-11,Business meal,REF76025633,255.41,0.0,180257.09
2023-09-12,2023-09-12,Equipment purchase,REF49896824,149.65,0.0,180107.44
2023-09-14,2023-09-14,Marketing expenses,REF88269458,239.8,0.0,179867.64
2023-09-14,2023-09-14,Business meal,REF31800084,180.26,0.0,179687.38
2023-09-15,2023-09-15,"Payment from Wilson, Murphy and Sanders",REF70983170,0.0,750.22,180437.6
2023-09-15,2023-09-15,Service payment - Lucero-Pope,REF65376169,0.0,596.33,181033.93
2023-09-15,2023-09-15,"Service payment - Horton, Adams and Smith",REF43297193,0.0,579.23,181613.16
2023-09-15,2023-09-15,Project payment - Wells Inc,REF49643063,0.0,581.92,182195.08
2023-09-15,2023-09-15,Business insurance premium,REF74033372,158.75,0.0,182036.33
2023-09-15,2023-09-15,"Payment from Hernandez, Sanders and Williams",REF41368755,0.0,839.03,182875.36
2023-09-15,2023-09-15,"Project payment - Howard, Cunningham and Murphy",REF87284892,0.0,662.52,183537.88
2023-09-15,2023-09-15,Business travel,REF29102554,154.16,0.0,183383.72
2023-09-15,2023-09-15,"Project payment - Hurley, Johnson and Bell",REF67525944,0.0,694.68,184078.4
2023-09-15,2023-09-15,"Service payment - Hernandez, Jones and Adams",REF79977342,0.0,651.84,184730.24
2023-09-16,2023-09-16,Accounting expense,REF51953216,159.42,0.0,184570.82
2023-09-18,2023-09-18,Coworking space rental,REF36846107,321.47,0.0,184249.35
2023-09-20,2023-09-20,Coworking space rental,REF54336480,308.54,0.0,183940.81
2023-09-21,2023-09-21,Professional software license,REF39169608,210.05,0.0,183730.76
2023-09-22,2023-09-22,Accounting expense,REF22035526,193.39,0.0,183537.37
2023-09-23,2023-09-23,Training/conference,REF52829077,298.66,0.0,183238.71
2023-09-27,2023-09-27,Business meal,REF83373400,182.47,0.0,183056.24
2023-10-02,2023-10-02,Equipment purchase,REF99036835,151.37,0.0,182904.87
2023-10-10,2023-10-10,Equipment purchase,REF16814460,166.21,0.0,182738.66
2023-10-12,2023-10-12,Business travel,REF13984276,469.08,0.0,182269.58
2023-10-15,2023-10-15,Business insurance premium,REF40625833,179.28,0.0,182090.3
2023-10-15,2023-10-15,"Service payment - Hurley, Johnson and Bell",REF89101411,0.0,745.87,182836.17
2023-10-15,2023-10-15,Project payment - Lucero-Pope,REF87408152,0.0,788.76,183624.93
2023-10-15,2023-10-15,"Invoice payment - Howard, Cunningham and Murphy",REF23751777,0.0,759.81,184384.74
2023-10-15,2023-10-15,"Project payment - Wilson, Murphy and Sanders",REF25936043,0.0,1411.31,185796.05
2023-10-15,2023-10-15,"Payment from Hernandez, Sanders and Williams",REF62423615,0.0,685.28,186481.33
2023-10-15,2023-10-15,"Project payment - Hernandez, Jones and Adams",REF80608048,0.0,941.3,187422.63
2023-10-15,2023-10-15,"Payment from Horton, Adams and Smith",REF32654547,0.0,517.47,187940.1
2023-10-15,2023-10-15,Service payment - Wells Inc,REF86890899,0.0,414.24,188354.34
2023-10-19,2023-10-19,Business meal,REF72170816,397.59,0.0,187956.75
2023-10-21,2023-10-21,Coworking space rental,REF61616744,517.02,0.0,187439.73
2023-10-21,2023-10-21,Professional software license,REF32719420,234.01,0.0,187205.72
2023-10-22,2023-10-22,Marketing expenses,REF29270151,297.44,0.0,186908.28
2023-10-23,2023-10-23,Business travel,REF55802010,450.08,0.0,186458.2
2023-10-24,2023-10-24,Business meal,REF69974146,235.24,0.0,186222.96
2023-10-25,2023-10-25,Business travel,REF52953473,429.26,0.0,185793.7
2023-10-26,2023-10-26,Business meal,REF43834573,219.38,0.0,185574.32
2023-10-27,2023-10-27,Business meal,REF39974620,375.2,0.0,185199.12
2023-10-29,2023-10-29,Equipment purchase,REF75541101,100.02,0.0,185099.1
2023-11-04,2023-11-04,Accounting expense,REF18301120,177.92,0.0,184921.18
2023-11-06,2023-11-06,Equipment purchase,REF18746357,200.18,0.0,184721.0
2023-11-06,2023-11-06,Business travel,REF23679638,757.9,0.0,183963.1
2023-11-09,2023-11-09,Accounting expense,REF99873608,255.05,0.0,183708.05
2023-11-10,2023-11-10,Business travel,REF71353935,486.9,0.0,183221.15
2023-11-11,2023-11-11,Training/conference,REF80573410,160.04,0.0,183061.11
2023-11-14,2023-11-14,Training/conference,REF63702153,248.72,0.0,182812.39
2023-11-15,2023-11-15,"Payment from Hernandez, Jones and Adams",REF89199429,0.0,801.03,183613.42
2023-11-15,2023-11-15,"Payment from Horton, Adams and Smith",REF48726773,0.0,561.32,184174.74
2023-11-15,2023-11-15,Invoice payment - Wells Inc,REF38004251,0.0,444.11,184618.85
2023-11-15,2023-11-15,"Service payment - Hernandez, Sanders and Williams",REF69576482,0.0,737.46,185356.31
2023-11-15,2023-11-15,"Payment from Wilson, Murphy and Sanders",REF37162459,0.0,1434.09,186790.4
2023-11-15,2023-11-15,"Service payment - Howard, Cunningham and Murphy",REF61783596,0.0,613.15,187403.55
2023-11-15,2023-11-15,Project payment - Lucero-Pope,REF97339647,0.0,656.66,188060.21
2023-11-15,2023-11-15,Business insurance premium,REF16735232,151.11,0.0,187909.1
2023-11-18,2023-11-18,Business meal,REF10457566,154.4,0.0,187754.7
2023-11-21,2023-11-21,Professional software license,REF11380359,241.21,0.0,187513.49
2023-11-27,2023-11-27,Business travel,REF88168341,340.63,0.0,187172.86
2023-11-30,2023-11-30,Accounting expense,REF85802716,316.4,0.0,186856.46
2023-12-09,2023-12-09,Business meal,REF48831709,279.64,0.0,186576.82
2023-12-11,2023-12-11,Equipment purchase,REF65619964,122.73,0.0,186454.09
2023-12-14,2023-12-14,Marketing expenses,REF27904957,64.86,0.0,186389.23
2023-12-15,2023-12-15,Business insurance premium,REF57189520,130.43,0.0,186258.8
2023-12-15,2023-12-15,Project payment - Wells Inc,REF48428076,0.0,361.0,186619.8
2023-12-15,2023-12-15,"Invoice payment - Horton, Adams and Smith",REF92545035,0.0,311.51,186931.31
2023-12-15,2023-12-15,Invoice payment - Lucero-Pope,REF98606490,0.0,460.81,187392.12
2023-12-15,2023-12-15,"Payment from Wilson, Murphy and Sanders",REF93527010,0.0,893.31,188285.43
2023-12-15,2023-12-15,"Service payment - Hernandez, Jones and Adams",REF72242460,0.0,519.2,188804.63
2023-12-15,2023-12-15,"Service payment - Hernandez, Sanders and Williams",REF79556064,0.0,625.14,189429.77
2023-12-15,2023-12-15,"Service payment - Hurley, Johnson and Bell",REF25088754,0.0,523.66,189953.43
2023-12-16,2023-12-16,Business travel,REF35548267,401.32,0.0,189552.11
2023-12-18,2023-12-18,Coworking space rental,REF26211259,199.58,0.0,189352.53
2023-12-18,2023-12-18,Accounting expense,REF40921286,117.11,0.0,189235.42
2023-12-21,2023-12-21,Professional software license,REF98640190,190.61,0.0,189044.81
2023-12-24,2023-12-24,Equipment purchase,REF74216265,134.46,0.0,188910.35
2023-12-25,2023-12-25,Business travel,REF96324940,501.77,0.0,188408.58
2023-12-28,2023-12-28,Business meal,REF61759105,174.66,0.0,188233.92
2024-01-03,2024-01-03,Marketing expenses,REF59450306,349.33,0.0,187884.59
2024-01-04,2024-01-04,Business travel,REF71533712,541.45,0.0,187343.14
2024-01-04,2024-01-04,Training/conference,REF30293140,322.63,0.0,187020.51
2024-01-07,2024-01-07,Business travel,REF87266233,244.91,0.0,186775.6
2024-01-07,2024-01-07,Training/conference,REF73501562,197.54,0.0,186578.06
2024-01-09,2024-01-09,Accounting expense,REF91846240,265.56,0.0,186312.5
2024-01-15,2024-01-15,"Payment from Horton, Adams and Smith",REF74804513,0.0,526.75,186839.25
2024-01-15,2024-01-15,Invoice payment - Wells Inc,REF15921995,0.0,452.78,187292.03
2024-01-15,2024-01-15,Business insurance premium,REF71717048,174.44,0.0,187117.59
2024-01-15,2024-01-15,"Payment from Hurley, Johnson and Bell",REF43334049,0.0,650.86,187768.45
2024-01-15,2024-01-15,"Project payment - Hernandez, Sanders and Williams",REF82942815,0.0,680.22,188448.67
2024-01-15,2024-01-15,"Payment from Hernandez, Jones and Adams",REF97737677,0.0,578.12,189026.79
2024-01-15,2024-01-15,Payment from Lucero-Pope,REF45549394,0.0,672.57,189699.36
2024-01-18,2024-01-18,Business travel,REF37939810,196.47,0.0,189502.89
2024-01-19,2024-01-19,Business meal,REF19335027,189.51,0.0,189313.38
2024-01-21,2024-01-21,Professional software license,REF17349566,238.27,0.0,189075.11
2024-01-29,2024-01-29,Business meal,REF17208444,426.64,0.0,188648.47
2024-02-06,2024-02-06,Marketing expenses,REF26645459,208.49,0.0,188439.98
2024-02-07,2024-02-07,Business travel,REF68781747,65.58,0.0,188374.4
2024-02-15,2024-02-15,"Project payment - Howard, Cunningham and Murphy",REF46613969,0.0,630.21,189004.61
2024-02-15,2024-02-15,"Service payment - Hurley, Johnson and Bell",REF66962848,0.0,758.95,189763.56
2024-02-15,2024-02-15,"Service payment - Wilson, Murphy and Sanders",REF17458801,0.0,1209.78,190973.34
2024-02-15,2024-02-15,Invoice payment - Wells Inc,REF17886861,0.0,401.39,191374.73
2024-02-15,2024-02-15,Business insurance premium,REF78069816,160.14,0.0,191214.59
2024-02-15,2024-02-15,Service payment - Lucero-Pope,REF36137467,0.0,601.37,191815.96
2024-02-15,2024-02-15,"Project payment - Hernandez, Sanders and Williams",REF58879663,0.0,715.67,192531.63
2024-02-15,2024-02-15,"Invoice payment - Horton, Adams and Smith",REF56734494,0.0,471.69,193003.32
2024-02-21,2024-02-21,Professional software license,REF86698205,237.22,0.0,192766.1
2024-02-23,2024-02-23,Business meal,REF64804277,446.0,0.0,192320.1
2024-02-25,2024-02-25,Accounting expense,REF56764902,237.62,0.0,192082.48
2024-02-25,2024-02-25,Business travel,REF39393109,491.0,0.0,191591.48
2024-02-27,2024-02-27,Marketing expenses,REF94008268,274.43,0.0,191317.05
2024-03-03,2024-03-03,Coworking space rental,REF75719196,250.72,0.0,191066.33
2024-03-07,2024-03-07,Business travel,REF15937599,501.48,0.0,190564.85
2024-03-10,2024-03-10,Business meal,REF68527479,332.43,0.0,190232.42
2024-03-11,2024-03-11,Business travel,REF18140841,241.77,0.0,189990.65
2024-03-15,2024-03-15,Business insurance premium,REF12597531,136.22,0.0,189854.43
2024-03-15,2024-03-15,"Project payment - Hernandez, Sanders and Williams",REF30731946,0.0,512.89,190367.32
2024-03-15,2024-03-15,"Service payment - Hurley, Johnson and Bell",REF15594128,0.0,695.83,191063.15
2024-03-15,2024-03-15,"Invoice payment - Horton, Adams and Smith",REF51095122,0.0,431.43,191494.58
2024-03-15,2024-03-15,Invoice payment - Lucero-Pope,REF75488496,0.0,646.36,192140.94
2024-03-15,2024-03-15,Payment from Wells Inc,REF10246203,0.0,476.36,192617.3
2024-03-15,2024-03-15,"Invoice payment - Wilson, Murphy and Sanders",REF66063763,0.0,972.13,193589.43
2024-03-20,2024-03-20,Equipment purchase,REF25765632,141.44,0.0,193447.99
2024-03-20,2024-03-20,Business meal,REF67823964,307.07,0.0,193140.92
2024-03-21,2024-03-21,Business meal,REF26257862,246.0,0.0,192894.92
2024-03-21,2024-03-21,Professional software license,REF58768961,200.9,0.0,192694.02
2024-03-24,2024-03-24,Coworking space rental,REF56151687,267.9,0.0,192426.12
2024-03-26,2024-03-26,Training/conference,REF95955831,257.47,0.0,192168.65
2024-03-27,2024-03-27,Business travel,REF12623800,431.17,0.0,191737.48
2024-03-28,2024-03-28,Training/conference,REF99859575,222.01,0.0,191515.47
2024-03-30,2024-03-30,Business meal,REF11767805,276.21,0.0,191239.26
2024-03-31,2024-03-31,Business travel,REF86483816,410.78,0.0,190828.48
2024-04-07,2024-04-07,Business travel,REF21394670,529.55,0.0,190298.93
2024-04-15,2024-04-15,Business insurance premium,REF29615631,145.31,0.0,190153.62
2024-04-15,2024-04-15,Equipment purchase,REF72058003,216.66,0.0,189936.96
2024-04-15,2024-04-15,"Service payment - Wilson, Murphy and Sanders",REF63326425,0.0,742.46,190679.42
2024-04-15,2024-04-15,"Project payment - Hurley, Johnson and Bell",REF11669596,0.0,712.72,191392.14
2024-04-15,2024-04-15,"Payment from Horton, Adams and Smith",REF74141121,0.0,423.47,191815.61
2024-04-15,2024-04-15,"Invoice payment - Howard, Cunningham and Murphy",REF64166229,0.0,478.62,192294.23
2024-04-15,2024-04-15,"Service payment - Hernandez, Sanders and Williams",REF86089885,0.0,548.22,192842.45
2024-04-15,2024-04-15,"Project payment - Hernandez, Jones and Adams",REF97209883,0.0,511.02,193353.47
2024-04-15,2024-04-15,Project payment - Wells Inc,REF25355948,0.0,342.0,193695.47
2024-04-16,2024-04-16,Training/conference,REF68925398,217.48,0.0,193477.99
2024-04-20,2024-04-20,Training/conference,REF84627947,227.14,0.0,193250.85
2024-04-20,2024-04-20,Marketing expenses,REF88484803,219.49,0.0,193031.36
2024-04-20,2024-04-20,Business travel,REF97137787,431.94,0.0,192599.42
2024-04-21,2024-04-21,Professional software license,REF85821525,211.49,0.0,192387.93
2024-04-23,2024-04-23,Business travel,REF20966131,605.98,0.0,191781.95
2024-04-28,2024-04-28,Accounting expense,REF94106681,233.73,0.0,191548.22
2024-05-11,2024-05-11,Business meal,REF91750113,337.08,0.0,191211.14
2024-05-15,2024-05-15,Business insurance premium,REF10712344,125.52,0.0,191085.62
2024-05-15,2024-05-15,Service payment - Lucero-Pope,REF65316351,0.0,569.62,191655.24
2024-05-15,2024-05-15,"Project payment - Howard, Cunningham and Murphy",REF49879516,0.0,455.07,192110.31
2024-05-15,2024-05-15,Payment from Wells Inc,REF28625814,0.0,366.95,192477.26
2024-05-15,2024-05-15,"Service payment - Hernandez, Jones and Adams",REF23781653,0.0,502.18,192979.44
2024-05-15,2024-05-15,"Service payment - Horton, Adams and Smith",REF81935387,0.0,474.26,193453.7
2024-05-15,2024-05-15,"Service payment - Hernandez, Sanders and Williams",REF17490372,0.0,495.68,193949.38
2024-05-15,2024-05-15,"Payment from Wilson, Murphy and Sanders",REF60149564,0.0,759.94,194709.32
2024-05-15,2024-05-15,Business meal,REF68284224,270.8,0.0,194438.52
2024-05-20,2024-05-20,Accounting expense,REF47908054,143.84,0.0,194294.68
2024-05-20,2024-05-20,Business travel,REF48437115,545.56,0.0,193749.12
2024-05-21,2024-05-21,Professional software license,REF14214883,209.62,0.0,193539.5
2024-05-25,2024-05-25,Business travel,REF39889505,392.52,0.0,193146.98
2024-05-26,2024-05-26,Accounting expense,REF98754809,326.18,0.0,192820.8
2024-06-04,2024-06-04,Business meal,REF82579656,201.75,0.0,192619.05
2024-06-04,2024-06-04,Coworking space rental,REF34109222,296.26,0.0,192322.79
2024-06-11,2024-06-11,Business meal,REF99661672,197.87,0.0,192124.92
2024-06-12,2024-06-12,Marketing expenses,REF97616661,311.98,0.0,191812.94
2024-06-14,2024-06-14,Business meal,REF24548791,100.46,0.0,191712.48
2024-06-14,2024-06-14,Equipment purchase,REF70595463,125.45,0.0,191587.03
2024-06-15,2024-06-15,"Payment from Howard, Cunningham and Murphy",REF94699124,0.0,299.58,191886.61
2024-06-15,2024-06-15,"Invoice payment - Wilson, Murphy and Sanders",REF80465871,0.0,940.21,192826.82
2024-06-15,2024-06-15,"Invoice payment - Hernandez, Jones and Adams",REF67838159,0.0,405.63,193232.45
2024-06-15,2024-06-15,Project payment - Wells Inc,REF77971129,0.0,378.68,193611.13
2024-06-15,2024-06-15,"Invoice payment - Hurley, Johnson and Bell",REF87121034,0.0,583.92,194195.05
2024-06-15,2024-06-15,"Project payment - Hernandez, Sanders and Williams",REF18436888,0.0,438.83,194633.88
2024-06-15,2024-06-15,"Payment from Horton, Adams and Smith",REF74554936,0.0,331.87,194965.75
2024-06-15,2024-06-15,Payment from Lucero-Pope,REF89110951,0.0,374.75,195340.5
2024-06-15,2024-06-15,Business insurance premium,REF10400791,116.83,0.0,195223.67
2024-06-17,2024-06-17,Accounting expense,REF66864249,104.61,0.0,195119.06
2024-06-21,2024-06-21,Business travel,REF64415396,138.12,0.0,194980.94
2024-06-21,2024-06-21,Professional software license,REF29260910,142.16,0.0,194838.78
2024-07-15,2024-07-15,"Invoice payment - Howard, Cunningham and Murphy",REF97034468,0.0,314.44,195153.22
2024-07-15,2024-07-15,"Service payment - Wilson, Murphy and Sanders",REF48369801,0.0,758.82,195912.04
2024-07-15,2024-07-15,Business insurance premium,REF42257255,104.31,0.0,195807.73
2024-07-15,2024-07-15,Invoice payment - Lucero-Pope,REF64321721,0.0,372.4,196180.13
2024-07-15,2024-07-15,"Service payment - Hurley, Johnson and Bell",REF80717319,0.0,589.69,196769.82
2024-07-15,2024-07-15,"Invoice payment - Horton, Adams and Smith",REF50563349,0.0,317.21,197087.03
2024-07-15,2024-07-15,"Invoice payment - Hernandez, Sanders and Williams",REF67112550,0.0,529.45,197616.48
2024-07-15,2024-07-15,"Payment from Hernandez, Jones and Adams",REF37478701,0.0,364.42,197980.9
2024-07-15,2024-07-15,Project payment - Wells Inc,REF85180592,0.0,241.43,198222.33
2024-07-16,2024-07-16,Accounting expense,REF20815626,175.8,0.0,198046.53
2024-07-21,2024-07-21,Professional software license,REF33706615,173.78,0.0,197872.75
2024-07-26,2024-07-26,Equipment purchase,REF86575643,124.93,0.0,197747.82
2024-07-26,2024-07-26,Business travel,REF33929285,296.65,0.0,197451.17
2024-07-29,2024-07-29,Business travel,REF13613633,286.08,0.0,197165.09
2024-08-01,2024-08-01,Accounting expense,REF13709766,201.23,0.0,196963.86
2024-08-01,2024-08-01,Marketing expenses,REF57141223,284.18,0.0,196679.68
2024-08-03,2024-08-03,Equipment purchase,REF23445334,79.84,0.0,196599.84
2024-08-03,2024-08-03,Coworking space rental,REF37224215,249.37,0.0,196350.47
2024-08-08,2024-08-08,Marketing expenses,REF27193565,242.35,0.0,196108.12
2024-08-10,2024-08-10,Equipment purchase,REF51103640,73.96,0.0,196034.16
2024-08-13,2024-08-13,Business meal,REF24024594,143.66,0.0,195890.5
2024-08-15,2024-08-15,Invoice payment - Wells Inc,REF47884054,0.0,295.51,196186.01
2024-08-15,2024-08-15,"Service payment - Hurley, Johnson and Bell",REF23031243,0.0,571.81,196757.82
2024-08-15,2024-08-15,Business insurance premium,REF39134158,117.36,0.0,196640.46
2024-08-15,2024-08-15,"Service payment - Howard, Cunningham and Murphy",REF20714999,0.0,319.87,196960.33
2024-08-15,2024-08-15,Project payment - Lucero-Pope,REF99780080,0.0,565.36,197525.69
2024-08-15,2024-08-15,"Service payment - Hernandez, Sanders and Williams",REF15316914,0.0,397.66,197923.35
2024-08-15,2024-08-15,"Service payment - Wilson, Murphy and Sanders",REF82765724,0.0,883.76,198807.11
2024-08-15,2024-08-15,"Service payment - Hernandez, Jones and Adams",REF48128896,0.0,449.43,199256.54
2024-08-15,2024-08-15,"Invoice payment - Horton, Adams and Smith",REF87355635,0.0,401.13,199657.67
2016-08-21,2016-08-21,Coworking space rental,REF66461007,214.59,0.0,3698.04
2016-08-21,2016-08-21,Professional software license,REF52058610,121.55,0.0,3576.49
2016-08-27,2016-08-27,Business meal,REF85186782,211.34,0.0,3365.15
2016-09-09,2016-09-09,Accounting expense,REF57938732,240.67,0.0,3124.48
2016-09-09,2016-09-09,Business travel,REF85671422,243.45,0.0,2881.03
2016-09-15,2016-09-15,Business travel,REF93629397,570.77,0.0,2310.26
2016-09-15,2016-09-15,"Service payment - Franklin, Smith and Farrell",REF40705329,0.0,1243.94,3554.2
2016-09-15,2016-09-15,Project payment - Freeman PLC,REF66368819,0.0,600.12,4154.32
2016-09-15,2016-09-15,"Payment from Luna, Quinn and Wilson",REF79863837,0.0,887.09,5041.41
2016-09-15,2016-09-15,Payment from Shannon PLC,REF43551897,0.0,758.88,5800.29
2016-09-15,2016-09-15,"Service payment - Williams, Martinez and Smith",REF13708768,0.0,1031.93,6832.22
2016-09-15,2016-09-15,Business insurance premium,REF73886734,157.9,0.0,6674.32
2016-09-15,2016-09-15,Project payment - Campbell Inc,REF84776996,0.0,1019.92,7694.24
2016-09-15,2016-09-15,"Invoice payment - Christian, Morris and Weaver",REF33895051,0.0,734.42,8428.66
2016-09-19,2016-09-19,Equipment purchase,REF44798727,101.09,0.0,8327.57
2016-09-21,2016-09-21,Professional software license,REF45496884,201.84,0.0,8125.73
2016-09-22,2016-09-22,Marketing expenses,REF66175308,340.82,0.0,7784.91
2016-09-25,2016-09-25,Business meal,REF73468490,318.2,0.0,7466.71
2016-09-28,2016-09-28,Accounting expense,REF99472949,265.64,0.0,7201.07
2016-09-29,2016-09-29,Equipment purchase,REF66088533,193.98,0.0,7007.09
2016-10-04,2016-10-04,Training/conference,REF78342058,319.87,0.0,6687.22
2016-10-09,2016-10-09,Business meal,REF96263933,264.83,0.0,6422.39
2016-10-15,2016-10-15,Business insurance premium,REF28347137,170.22,0.0,6252.17
2016-10-15,2016-10-15,"Invoice payment - Christian, Morris and Weaver",REF42793531,0.0,1117.95,7370.12
2016-10-15,2016-10-15,"Service payment - Williams, Martinez and Smith",REF92646806,0.0,1177.78,8547.9
2016-10-15,2016-10-15,Payment from Campbell Inc,REF20325312,0.0,1151.78,9699.68
2016-10-15,2016-10-15,"Invoice payment - Luna, Quinn and Wilson",REF54779325,0.0,766.21,10465.89
2016-10-15,2016-10-15,Invoice payment - Shannon PLC,REF21311440,0.0,677.42,11143.31
2016-10-15,2016-10-15,Invoice payment - Freeman PLC,REF52695424,0.0,614.15,11757.46
2016-10-15,2016-10-15,"Service payment - Franklin, Smith and Farrell",REF89478484,0.0,1260.54,13018.0
2016-10-21,2016-10-21,Professional software license,REF76733144,239.32,0.0,12778.68
2016-10-25,2016-10-25,Training/conference,REF54378052,163.13,0.0,12615.55
2016-11-02,2016-11-02,Training/conference,REF35984930,112.1,0.0,12503.45
2016-11-06,2016-11-06,Coworking space rental,REF64554031,280.51,0.0,12222.94
2016-11-06,2016-11-06,Business meal,REF95350156,218.58,0.0,12004.36
2016-11-09,2016-11-09,Equipment purchase,REF94236471,28.35,0.0,11976.01
2016-11-09,2016-11-09,Business meal,REF52766013,120.48,0.0,11855.53
2016-11-15,2016-11-15,"Service payment - Williams, Martinez and Smith",REF58084161,0.0,772.25,12627.78
2016-11-15,2016-11-15,Business insurance premium,REF78060093,152.97,0.0,12474.81
2016-11-15,2016-11-15,"Payment from Franklin, Smith and Farrell",REF19413290,0.0,1223.36,13698.17
2016-11-15,2016-11-15,Invoice payment - Campbell Inc,REF49452936,0.0,984.62,14682.79
2016-11-15,2016-11-15,"Project payment - Luna, Quinn and Wilson",REF33028807,0.0,464.41,15147.2
2016-11-15,2016-11-15,Invoice payment - Shannon PLC,REF92703059,0.0,633.73,15780.93
2016-11-15,2016-11-15,Project payment - Smith Inc,REF75364467,0.0,962.47,16743.4
2016-11-15,2016-11-15,"Invoice payment - Christian, Morris and Weaver",REF11363840,0.0,977.32,17720.72
2016-11-17,2016-11-17,Coworking space rental,REF99161257,467.99,0.0,17252.73
2016-11-18,2016-11-18,Training/conference,REF28217923,217.36,0.0,17035.37
2016-11-20,2016-11-20,Business meal,REF12031900,286.84,0.0,16748.53
2016-11-21,2016-11-21,Professional software license,REF91955805,232.87,0.0,16515.66
2016-11-21,2016-11-21,Business meal,REF33105119,428.58,0.0,16087.08
2016-11-26,2016-11-26,Equipment purchase,REF70145601,182.31,0.0,15904.77
2016-11-27,2016-11-27,Business travel,REF56252283,510.14,0.0,15394.63
2016-11-27,2016-11-27,Business meal,REF23554697,245.3,0.0,15149.33
2016-12-02,2016-12-02,Business meal,REF78953562,169.42,0.0,14979.91
2016-12-03,2016-12-03,Training/conference,REF23601852,228.33,0.0,14751.58
2016-12-11,2016-12-11,Equipment purchase,REF13923442,76.12,0.0,14675.46
2016-12-15,2016-12-15,Invoice payment - Campbell Inc,REF35514299,0.0,947.42,15622.88
2016-12-15,2016-12-15,Project payment - Smith Inc,REF80846042,0.0,637.12,16260.0
2016-12-15,2016-12-15,"Payment from Luna, Quinn and Wilson",REF38221360,0.0,462.15,16722.15
2016-12-15,2016-12-15,"Payment from Williams, Martinez and Smith",REF42618978,0.0,789.3,17511.45
2016-12-15,2016-12-15,"Service payment - Franklin, Smith and Farrell",REF42247943,0.0,1106.88,18618.33
2016-12-15,2016-12-15,Invoice payment - Freeman PLC,REF70390104,0.0,484.71,19103.04
2016-12-15,2016-12-15,"Payment from Christian, Morris and Weaver",REF64266905,0.0,655.6,19758.64
2016-12-15,2016-12-15,Service payment - Shannon PLC,REF92127002,0.0,788.63,20547.27
2016-12-15,2016-12-15,Business insurance premium,REF73329999,132.43,0.0,20414.84
2016-12-21,2016-12-21,Business meal,REF96653945,199.78,0.0,20215.06
2016-12-21,2016-12-21,Professional software license,REF62351241,178.11,0.0,20036.95
2016-12-24,2016-12-24,Equipment purchase,REF84783074,86.26,0.0,19950.69
2016-12-26,2016-12-26,Coworking space rental,REF32283732,246.57,0.0,19704.12
2017-01-06,2017-01-06,Equipment purchase,REF90816593,112.68,0.0,19591.44
2017-01-08,2017-01-08,Business travel,REF98734686,440.02,0.0,19151.42
2017-01-11,2017-01-11,Business travel,REF39629934,332.89,0.0,18818.53
2017-01-12,2017-01-12,Business meal,REF45506098,206.87,0.0,18611.66
2017-01-15,2017-01-15,"Service payment - Christian, Morris and Weaver",REF53101455,0.0,1212.01,19823.67
2017-01-15,2017-01-15,"Invoice payment - Franklin, Smith and Farrell",REF14717529,0.0,1573.15,21396.82
2017-01-15,2017-01-15,Project payment - Smith Inc,REF63120385,0.0,777.05,22173.87
2017-01-15,2017-01-15,"Project payment - Luna, Quinn and Wilson",REF75386731,0.0,798.64,22972.51
2017-01-15,2017-01-15,Payment from Shannon PLC,REF44326511,0.0,1025.15,23997.66
2017-01-15,2017-01-15,Payment from Freeman PLC,REF56861643,0.0,673.55,24671.21
2017-01-15,2017-01-15,"Service payment - Williams, Martinez and Smith",REF64089174,0.0,1134.23,25805.44
2017-01-15,2017-01-15,Invoice payment - Campbell Inc,REF59934612,0.0,1211.22,27016.66
2017-01-15,2017-01-15,Business insurance premium,REF52775423,165.18,0.0,26851.48
2017-01-16,2017-01-16,Equipment purchase,REF25663937,74.26,0.0,26777.22
2017-01-16,2017-01-16,Marketing expenses,REF96449416,434.0,0.0,26343.22
2017-01-21,2017-01-21,Professional software license,REF16365067,251.76,0.0,26091.46
2017-01-22,2017-01-22,Business meal,REF53706696,214.77,0.0,25876.69
2017-01-22,2017-01-22,Accounting expense,REF22640527,223.78,0.0,25652.91
2017-01-23,2017-01-23,Accounting expense,REF96064440,200.37,0.0,25452.54
2017-02-05,2017-02-05,Coworking space rental,REF52022987,279.68,0.0,25172.86
2017-02-06,2017-02-06,Training/conference,REF40639648,301.8,0.0,24871.06
2017-02-14,2017-02-14,Marketing expenses,REF62011488,403.98,0.0,24467.08
2017-02-15,2017-02-15,"Project payment - Franklin, Smith and Farrell",REF42248300,0.0,1206.94,25674.02
2017-02-15,2017-02-15,Invoice payment - Smith Inc,REF60688943,0.0,759.11,26433.13
2017-02-15,2017-02-15,Invoice payment - Shannon PLC,REF13149264,0.0,789.25,27222.38
2017-02-15,2017-02-15,"Service payment - Luna, Quinn and Wilson",REF35071994,0.0,520.83,27743.21
2017-02-15,2017-02-15,Invoice payment - Freeman PLC,REF67372810,0.0,661.64,28404.85
2017-02-15,2017-02-15,"Service payment - Christian, Morris and Weaver",REF59801834,0.0,715.58,29120.43
2017-02-15,2017-02-15,Invoice payment - Campbell Inc,REF69486036,0.0,1651.47,30771.9
2017-02-15,2017-02-15,Business insurance premium,REF72707987,149.82,0.0,30622.08
2017-02-15,2017-02-15,"Invoice payment - Williams, Martinez and Smith",REF14326324,0.0,783.63,31405.71
2017-02-17,2017-02-17,Business meal,REF53808351,206.67,0.0,31199.04
2017-02-20,2017-02-20,Business meal,REF33468820,387.56,0.0,30811.48
2017-02-20,2017-02-20,Training/conference,REF92417505,140.86,0.0,30670.62
2017-02-21,2017-02-21,Professional software license,REF24874835,215.74,0.0,30454.88
2017-02-22,2017-02-22,Business meal,REF33250417,232.93,0.0,30221.95
2017-03-01,2017-03-01,Marketing expenses,REF74811047,236.54,0.0,29985.41
2017-03-01,2017-03-01,Accounting expense,REF14896386,256.8,0.0,29728.61
2017-03-09,2017-03-09,Coworking space rental,REF24697903,373.34,0.0,29355.27
2017-03-15,2017-03-15,"Payment from Luna, Quinn and Wilson",REF85087965,0.0,496.06,29851.33
2017-03-15,2017-03-15,Invoice payment - Freeman PLC,REF10296942,0.0,327.83,30179.16
2017-03-15,2017-03-15,Project payment - Smith Inc,REF13198071,0.0,725.47,30904.63
2017-03-15,2017-03-15,Business insurance premium,REF77373679,137.26,0.0,30767.37
2017-03-15,2017-03-15,Payment from Shannon PLC,REF11210239,0.0,813.65,31581.02
2017-03-15,2017-03-15,Project payment - Campbell Inc,REF23529590,0.0,1190.19,32771.21
2017-03-15,2017-03-15,"Invoice payment - Williams, Martinez and Smith",REF74726841,0.0,754.91,33526.12
2017-03-15,2017-03-15,"Payment from Christian, Morris and Weaver",REF41705546,0.0,867.63,34393.75
2017-03-15,2017-03-15,"Project payment - Franklin, Smith and Farrell",REF80756364,0.0,1452.51,35846.26
2017-03-18,2017-03-18,Marketing expenses,REF10203118,320.38,0.0,35525.88
2017-03-21,2017-03-21,Professional software license,REF61935549,165.23,0.0,35360.65
2017-04-01,2017-04-01,Business travel,REF31447209,378.67,0.0,34981.98
2017-04-02,2017-04-02,Coworking space rental,REF80392341,315.3,0.0,34666.68
2017-04-13,2017-04-13,Business travel,REF53786125,558.93,0.0,34107.75
2017-04-15,2017-04-15,Business insurance premium,REF72857594,131.95,0.0,33975.8
2017-04-15,2017-04-15,Payment from Shannon PLC,REF94864709,0.0,802.51,34778.31
2017-04-15,2017-04-15,"Invoice payment - Williams, Martinez and Smith",REF39036295,0.0,975.21,35753.52
2017-04-15,2017-04-15,"Invoice payment - Franklin, Smith and Farrell",REF97048175,0.0,1263.64,37017.16
2017-04-15,2017-04-15,"Payment from Luna, Quinn and Wilson",REF37845736,0.0,558.02,37575.18
2017-04-15,2017-04-15,Invoice payment - Smith Inc,REF74945641,0.0,776.58,38351.76
2017-04-15,2017-04-15,Invoice payment - Freeman PLC,REF79617711,0.0,475.34,38827.1
2017-04-15,2017-04-15,Invoice payment - Campbell Inc,REF90461032,0.0,941.78,39768.88
2017-04-21,2017-04-21,Professional software license,REF43860066,180.66,0.0,39588.22
2017-04-25,2017-04-25,Business travel,REF54489473,632.03,0.0,38956.19
2017-04-26,2017-04-26,Marketing expenses,REF21503453,309.56,0.0,38646.63
2017-04-27,2017-04-27,Coworking space rental,REF60417376,200.06,0.0,38446.57
2017-04-27,2017-04-27,Accounting expense,REF48041696,265.92,0.0,38180.65
2017-04-28,2017-04-28,Accounting expense,REF98692661,115.11,0.0,38065.54
2017-04-29,2017-04-29,Coworking space rental,REF27830250,187.45,0.0,37878.09
2017-04-30,2017-04-30,Accounting expense,REF53880416,43.96,0.0,37834.13
2017-05-01,2017-05-01,Training/conference,REF64198776,200.83,0.0,37633.3
2017-05-05,2017-05-05,Training/conference,REF91414245,133.69,0.0,37499.61
2017-05-05,2017-05-05,Business meal,REF11358596,317.78,0.0,37181.83
2017-05-07,2017-05-07,Coworking space rental,REF47813829,327.84,0.0,36853.99
2017-05-08,2017-05-08,Coworking space rental,REF39241071,224.01,0.0,36629.98
2017-05-10,2017-05-10,Business travel,REF99980439,475.88,0.0,36154.1
2017-05-11,2017-05-11,Marketing expenses,REF37858383,348.41,0.0,35805.69
2017-05-13,2017-05-13,Business meal,REF36846260,283.77,0.0,35521.92
2017-05-15,2017-05-15,"Invoice payment - Luna, Quinn and Wilson",REF50703824,0.0,438.58,35960.5
2017-05-15,2017-05-15,"Service payment - Franklin, Smith and Farrell",REF21411942,0.0,943.85,36904.35
2017-05-15,2017-05-15,Training/conference,REF29037039,192.86,0.0,36711.49
2017-05-15,2017-05-15,Service payment - Freeman PLC,REF77056599,0.0,423.2,37134.69
2017-05-15,2017-05-15,Business insurance premium,REF29595255,123.54,0.0,37011.15
2017-05-15,2017-05-15,Project payment - Smith Inc,REF78030959,0.0,489.0,37500.15
2017-05-15,2017-05-15,"Payment from Christian, Morris and Weaver",REF50982790,0.0,911.12,38411.27
2017-05-15,2017-05-15,Service payment - Shannon PLC,REF78601933,0.0,640.68,39051.95
2017-05-20,2017-05-20,Accounting expense,REF76512058,58.63,0.0,38993.32
2017-05-21,2017-05-21,Professional software license,REF55908726,202.1,0.0,38791.22
2017-05-28,2017-05-28,Business meal,REF89304542,210.56,0.0,38580.66
2017-05-28,2017-05-28,Accounting expense,REF75866484,221.18,0.0,38359.48
2017-05-31,2017-05-31,Business travel,REF13488783,341.99,0.0,38017.49
2017-06-06,2017-06-06,Business meal,REF78769031,157.3,0.0,37860.19
2017-06-12,2017-06-12,Training/conference,REF70173914,235.4,0.0,37624.79
2017-06-12,2017-06-12,Business travel,REF79198448,359.39,0.0,37265.4
2017-06-15,2017-06-15,Business insurance premium,REF86582649,103.69,0.0,37161.71
2017-06-15,2017-06-15,Invoice payment - Smith Inc,REF82779606,0.0,511.63,37673.34
2017-06-15,2017-06-15,Service payment - Campbell Inc,REF98546793,0.0,1172.87,38846.21
2017-06-15,2017-06-15,"Project payment - Franklin, Smith and Farrell",REF30123475,0.0,854.73,39700.94
2017-06-15,2017-06-15,Invoice payment - Freeman PLC,REF30559370,0.0,367.58,40068.52
2017-06-15,2017-06-15,Project payment - Shannon PLC,REF66361773,0.0,643.77,40712.29
2017-06-15,2017-06-15,"Payment from Christian, Morris and Weaver",REF43452938,0.0,816.8,41529.09
2017-06-15,2017-06-15,"Project payment - Williams, Martinez and Smith",REF22324433,0.0,713.9,42242.99
2017-06-15,2017-06-15,"Payment from Luna, Quinn and Wilson",REF37633112,0.0,652.07,42895.06
2017-06-18,2017-06-18,Business travel,REF24196154,376.18,0.0,42518.88
2017-06-21,2017-06-21,Professional software license,REF17467405,152.01,0.0,42366.87
2017-06-28,2017-06-28,Training/conference,REF46674242,113.98,0.0,42252.89
2017-06-29,2017-06-29,Accounting expense,REF57340543,104.07,0.0,42148.82
2017-07-02,2017-07-02,Training/conference,REF91894230,231.63,0.0,41917.19
2017-07-03,2017-07-03,Training/conference,REF54051366,113.94,0.0,41803.25
2017-07-03,2017-07-03,Business travel,REF48994611,209.62,0.0,41593.63
2017-07-08,2017-07-08,Training/conference,REF85087379,191.14,0.0,41402.49
2017-07-11,2017-07-11,Training/conference,REF79493828,111.15,0.0,41291.34
2017-07-11,2017-07-11,Business travel,REF79253266,185.19,0.0,41106.15
2017-07-11,2017-07-11,Equipment purchase,REF51005851,151.95,0.0,40954.2
2017-07-12,2017-07-12,Training/conference,REF49144802,92.1,0.0,40862.1
2017-07-15,2017-07-15,"Payment from Franklin, Smith and Farrell",REF90739925,0.0,952.99,41815.09
2017-07-15,2017-07-15,Business insurance premium,REF42100541,95.74,0.0,41719.35
2017-07-15,2017-07-15,Coworking space rental,REF32386307,259.12,0.0,41460.23
2017-07-15,2017-07-15,"Service payment - Williams, Martinez and Smith",REF71243125,0.0,581.02,42041.25
2017-07-15,2017-07-15,Payment from Freeman PLC,REF34345738,0.0,310.29,42351.54
2017-07-15,2017-07-15,Service payment - Shannon PLC,REF11255923,0.0,483.05,42834.59
2017-07-15,2017-07-15,"Invoice payment - Christian, Morris and Weaver",REF80047288,0.0,684.82,43519.41
2017-07-15,2017-07-15,Project payment - Campbell Inc,REF90697720,0.0,770.6,44290.01
2017-07-15,2017-07-15,"Project payment - Luna, Quinn and Wilson",REF62787091,0.0,392.01,44682.02
2017-07-15,2017-07-15,Payment from Smith Inc,REF34376011,0.0,373.31,45055.33
2017-07-16,2017-07-16,Coworking space rental,REF31372622,169.67,0.0,44885.66
2017-07-21,2017-07-21,Professional software license,REF39164261,135.05,0.0,44750.61
2017-07-22,2017-07-22,Coworking space rental,REF85490959,173.85,0.0,44576.76
2017-07-25,2017-07-25,Accounting expense,REF39908854,145.56,0.0,44431.2
2017-07-26,2017-07-26,Business travel,REF98064498,188.1,0.0,44243.1
2017-07-28,2017-07-28,Coworking space rental,REF85069570,217.64,0.0,44025.46
2017-07-30,2017-07-30,Equipment purchase,REF99229552,72.25,0.0,43953.21
2017-08-03,2017-08-03,Accounting expense,REF80652610,148.2,0.0,43805.01
2017-08-04,2017-08-04,Business travel,REF84964848,282.11,0.0,43522.9
2017-08-05,2017-08-05,Training/conference,REF85854895,176.38,0.0,43346.52
2017-08-06,2017-08-06,Business travel,REF73678156,281.0,0.0,43065.52
2017-08-07,2017-08-07,Business meal,REF41058945,228.15,0.0,42837.37
2017-08-09,2017-08-09,Coworking space rental,REF33004277,268.33,0.0,42569.04
2017-08-15,2017-08-15,Business insurance premium,REF19777192,125.42,0.0,42443.62
2017-08-15,2017-08-15,"Payment from Christian, Morris and Weaver",REF27325244,0.0,676.86,43120.48
2017-08-15,2017-08-15,Payment from Freeman PLC,REF15543475,0.0,450.87,43571.35
2017-08-15,2017-08-15,"Project payment - Williams, Martinez and Smith",REF53449179,0.0,604.37,44175.72
2017-08-15,2017-08-15,Marketing expenses,REF94162837,223.05,0.0,43952.67
2017-08-15,2017-08-15,Invoice payment - Campbell Inc,REF54678835,0.0,790.14,44742.81
2017-08-15,2017-08-15,Invoice payment - Shannon PLC,REF18188113,0.0,642.93,45385.74
2017-08-15,2017-08-15,"Invoice payment - Franklin, Smith and Farrell",REF60421617,0.0,961.17,46346.91
2017-08-21,2017-08-21,Professional software license,REF89826695,169.95,0.0,46176.96
2017-08-23,2017-08-23,Training/conference,REF39141431,92.01,0.0,46084.95
2017-08-25,2017-08-25,Business meal,REF14467506,141.5,0.0,45943.45
2017-08-25,2017-08-25,Equipment purchase,REF42837258,123.89,0.0,45819.56
2017-08-29,2017-08-29,Business meal,REF99904445,192.18,0.0,45627.38
2017-09-01,2017-09-01,Equipment purchase,REF32339026,158.19,0.0,45469.19
2017-09-03,2017-09-03,Marketing expenses,REF58197591,375.68,0.0,45093.51
2017-09-04,2017-09-04,Business travel,REF67777374,281.75,0.0,44811.76
2017-09-04,2017-09-04,Marketing expenses,REF11703614,221.06,0.0,44590.7
2017-09-15,2017-09-15,"Payment from Christian, Morris and Weaver",REF23781334,0.0,1144.39,45735.09
2017-09-15,2017-09-15,Payment from Shannon PLC,REF82353846,0.0,629.26,46364.35
2017-09-15,2017-09-15,Payment from Smith Inc,REF84107926,0.0,730.99,47095.34
2017-09-15,2017-09-15,Service payment - Freeman PLC,REF50019461,0.0,496.59,47591.93
2017-09-15,2017-09-15,"Payment from Williams, Martinez and Smith",REF56459133,0.0,1082.68,48674.61
2017-09-15,2017-09-15,Payment from Campbell Inc,REF62261328,0.0,1398.1,50072.71
2017-09-15,2017-09-15,Business insurance premium,REF19757844,152.56,0.0,49920.15
2017-09-15,2017-09-15,"Project payment - Franklin, Smith and Farrell",REF12215585,0.0,1457.93,51378.08
2017-09-15,2017-09-15,"Project payment - Luna, Quinn and Wilson",REF71594270,0.0,655.08,52033.16
2017-09-16,2017-09-16,Equipment purchase,REF11125412,203.01,0.0,51830.15
2017-09-21,2017-09-21,Professional software license,REF65732808,218.58,0.0,51611.57
2017-09-23,2017-09-23,Business travel,REF86830187,627.89,0.0,50983.68
2017-09-23,2017-09-23,Accounting expense,REF52523392,154.45,0.0,50829.23
2017-10-06,2017-10-06,Training/conference,REF14142248,214.35,0.0,50614.88
2017-10-09,2017-10-09,Marketing expenses,REF39991337,252.17,0.0,50362.71
2017-10-12,2017-10-12,Equipment purchase,REF61390138,168.52,0.0,50194.19
2017-10-13,2017-10-13,Accounting expense,REF93700803,232.14,0.0,49962.05
2017-10-15,2017-10-15,Business insurance premium,REF50222651,172.24,0.0,49789.81
2017-10-15,2017-10-15,Invoice payment - Shannon PLC,REF59011417,0.0,843.94,50633.75
2017-10-15,2017-10-15,Invoice payment - Freeman PLC,REF63134445,0.0,589.85,51223.6
2017-10-15,2017-10-15,Invoice payment - Campbell Inc,REF61558852,0.0,1841.62,53065.22
2017-10-15,2017-10-15,"Service payment - Williams, Martinez and Smith",REF83134415,0.0,919.47,53984.69
2017-10-15,2017-10-15,"Project payment - Luna, Quinn and Wilson",REF83681391,0.0,922.7,54907.39
2017-10-15,2017-10-15,Invoice payment - Smith Inc,REF22748415,0.0,1001.85,55909.24
2017-10-15,2017-10-15,"Payment from Franklin, Smith and Farrell",REF36098425,0.0,1609.02,57518.26
2017-10-16,2017-10-16,Business meal,REF21436826,444.47,0.0,57073.79
2017-10-19,2017-10-19,Training/conference,REF90332007,159.05,0.0,56914.74
2017-10-19,2017-10-19,Accounting expense,REF11665274,217.25,0.0,56697.49
2017-10-21,2017-10-21,Professional software license,REF93331190,242.47,0.0,56455.02
2017-10-22,2017-10-22,Business travel,REF97251407,578.39,0.0,55876.63
2017-11-03,2017-11-03,Business travel,REF20336368,350.13,0.0,55526.5
2017-11-03,2017-11-03,Marketing expenses,REF51936093,333.52,0.0,55192.98
2017-11-05,2017-11-05,Coworking space rental,REF10701359,143.74,0.0,55049.24
2017-11-06,2017-11-06,Business travel,REF90974853,414.37,0.0,54634.87
2017-11-10,2017-11-10,Accounting expense,REF76178163,189.22,0.0,54445.65
2017-11-11,2017-11-11,Business meal,REF68449198,391.92,0.0,54053.73
2017-11-12,2017-11-12,Marketing expenses,REF19118413,174.04,0.0,53879.69
2017-11-12,2017-11-12,Coworking space rental,REF56059982,336.36,0.0,53543.33
2017-11-15,2017-11-15,Business meal,REF12341789,384.49,0.0,53158.84
2017-11-15,2017-11-15,Payment from Campbell Inc,REF43995357,0.0,1022.94,54181.78
2017-11-15,2017-11-15,"Project payment - Franklin, Smith and Farrell",REF64611490,0.0,1070.09,55251.87
2017-11-15,2017-11-15,Business insurance premium,REF63813092,154.61,0.0,55097.26
2017-11-15,2017-11-15,Project payment - Smith Inc,REF86288105,0.0,838.16,55935.42
2017-11-15,2017-11-15,Invoice payment - Freeman PLC,REF36777102,0.0,587.09,56522.51
2017-11-15,2017-11-15,"Service payment - Christian, Morris and Weaver",REF10841371,0.0,1094.06,57616.57
2017-11-15,2017-11-15,Project payment - Shannon PLC,REF65326454,0.0,768.88,58385.45
2017-11-15,2017-11-15,"Project payment - Luna, Quinn and Wilson",REF28349400,0.0,500.96,58886.41
2017-11-17,2017-11-17,Marketing expenses,REF92521332,264.3,0.0,58622.11
2017-11-21,2017-11-21,Professional software license,REF44210678,214.66,0.0,58407.45
2017-12-01,2017-12-01,Equipment purchase,REF41878117,149.76,0.0,58257.69
2017-12-02,2017-12-02,Marketing expenses,REF99148131,337.71,0.0,57919.98
2017-12-03,2017-12-03,Business travel,REF21376497,309.51,0.0,57610.47
2017-12-07,2017-12-07,Coworking space rental,REF59679331,199.45,0.0,57411.02
2017-12-09,2017-12-09,Accounting expense,REF82704354,162.13,0.0,57248.89
2017-12-13,2017-12-13,Accounting expense,REF59423459,172.73,0.0,57076.16
2017-12-15,2017-12-15,Service payment - Campbell Inc,REF15073846,0.0,1185.68,58261.84
2017-12-15,2017-12-15,"Invoice payment - Franklin, Smith and Farrell",REF51968577,0.0,1033.51,59295.35
2017-12-15,2017-12-15,"Project payment - Christian, Morris and Weaver",REF63580247,0.0,702.99,59998.34
2017-12-15,2017-12-15,Project payment - Smith Inc,REF64592069,0.0,535.93,60534.27
2017-12-15,2017-12-15,Service payment - Freeman PLC,REF14430603,0.0,392.95,60927.22
2017-12-15,2017-12-15,"Service payment - Williams, Martinez and Smith",REF72303395,0.0,836.79,61764.01
2017-12-15,2017-12-15,Business insurance premium,REF28866916,122.74,0.0,61641.27
2017-12-15,2017-12-15,"Project payment - Luna, Quinn and Wilson",REF78769179,0.0,482.29,62123.56
2017-12-15,2017-12-15,Payment from Shannon PLC,REF40447524,0.0,694.62,62818.18
2017-12-15,2017-12-15,Business travel,REF29778023,448.6,0.0,62369.58
2017-12-18,2017-12-18,Business meal,REF44618498,93.6,0.0,62275.98
2017-12-18,2017-12-18,Accounting expense,REF55055258,158.46,0.0,62117.52
2017-12-19,2017-12-19,Equipment purchase,REF10336298,108.92,0.0,62008.6
2017-12-21,2017-12-21,Business meal,REF89508515,283.2,0.0,61725.4
2017-12-21,2017-12-21,Professional software license,REF40152908,189.13,0.0,61536.27
2017-12-24,2017-12-24,Accounting expense,REF32570666,201.94,0.0,61334.33
2017-12-26,2017-12-26,Business travel,REF35706521,373.3,0.0,60961.03
2017-12-29,2017-12-29,Business travel,REF82579989,116.72,0.0,60844.31
2018-01-07,2018-01-07,Business meal,REF75547406,318.78,0.0,60525.53
2018-01-12,2018-01-12,Accounting expense,REF52451921,241.02,0.0,60284.51
2018-01-15,2018-01-15,"Invoice payment - Christian, Morris and Weaver",REF23395862,0.0,1164.48,61448.99
2018-01-15,2018-01-15,"Service payment - Luna, Quinn and Wilson",REF46887888,0.0,698.39,62147.38
2018-01-15,2018-01-15,Service payment - Shannon PLC,REF99332148,0.0,824.31,62971.69
2018-01-15,2018-01-15,Payment from Campbell Inc,REF57848724,0.0,1434.35,64406.04
2018-01-15,2018-01-15,Business insurance premium,REF74974001,166.93,0.0,64239.11
2018-01-15,2018-01-15,Payment from Smith Inc,REF72184500,0.0,828.45,65067.56
2018-01-15,2018-01-15,"Invoice payment - Williams, Martinez and Smith",REF26606334,0.0,1116.91,66184.47
2018-01-16,2018-01-16,Training/conference,REF52027351,280.61,0.0,65903.86
2018-01-20,2018-01-20,Business meal,REF70249467,302.65,0.0,65601.21
2018-01-21,2018-01-21,Professional software license,REF33272554,255.65,0.0,65345.56
2018-01-23,2018-01-23,Marketing expenses,REF79226322,253.75,0.0,65091.81
2018-01-26,2018-01-26,Business travel,REF52690239,533.34,0.0,64558.47
2018-01-27,2018-01-27,Business meal,REF13073786,282.81,0.0,64275.66
2018-01-30,2018-01-30,Business travel,REF85608028,645.8,0.0,63629.86
2018-01-31,2018-01-31,Accounting expense,REF39802562,335.89,0.0,63293.97
2018-02-13,2018-02-13,Training/conference,REF80916487,265.57,0.0,63028.4
2018-02-15,2018-02-15,Service payment - Smith Inc,REF45900239,0.0,785.24,63813.64
2018-02-15,2018-02-15,"Payment from Franklin, Smith and Farrell",REF43514994,0.0,1227.1,65040.74
2018-02-15,2018-02-15,"Payment from Christian, Morris and Weaver",REF36650803,0.0,1079.56,66120.3
2018-02-15,2018-02-15,Project payment - Freeman PLC,REF93391693,0.0,544.33,66664.63
2018-02-15,2018-02-15,"Service payment - Luna, Quinn and Wilson",REF53951732,0.0,530.52,67195.15
2018-02-15,2018-02-15,Invoice payment - Campbell Inc,REF53634541,0.0,966.69,68161.84
2018-02-15,2018-02-15,"Invoice payment - Williams, Martinez and Smith",REF88412992,0.0,777.48,68939.32
2018-02-15,2018-02-15,Payment from Shannon PLC,REF25708478,0.0,590.85,69530.17
2018-02-15,2018-02-15,Business insurance premium,REF94347110,139.59,0.0,69390.58
2018-02-15,2018-02-15,Business meal,REF54437505,264.51,0.0,69126.07
2018-02-21,2018-02-21,Professional software license,REF80196486,218.51,0.0,68907.56
2018-02-23,2018-02-23,Business meal,REF93673140,311.03,0.0,68596.53
2018-03-07,2018-03-07,Business travel,REF65754269,365.27,0.0,68231.26
2018-03-09,2018-03-09,Coworking space rental,REF62867614,350.11,0.0,67881.15
2018-03-11,2018-03-11,Training/conference,REF90760172,133.94,0.0,67747.21
2018-03-15,2018-03-15,Project payment - Freeman PLC,REF51405680,0.0,412.87,68160.08
2018-03-15,2018-03-15,"Invoice payment - Williams, Martinez and Smith",REF83816870,0.0,790.43,68950.51
2018-03-15,2018-03-15,"Project payment - Luna, Quinn and Wilson",REF67581242,0.0,505.17,69455.68
2018-03-15,2018-03-15,Service payment - Smith Inc,REF49681377,0.0,824.93,70280.61
2018-03-15,2018-03-15,Business insurance premium,REF14699274,138.87,0.0,70141.74
2018-03-15,2018-03-15,Invoice payment - Campbell Inc,REF78628842,0.0,1528.86,71670.6
2018-03-15,2018-03-15,"Payment from Franklin, Smith and Farrell",REF97162131,0.0,986.08,72656.68
2018-03-15,2018-03-15,Invoice payment - Shannon PLC,REF24308064,0.0,838.79,73495.47
2018-03-21,2018-03-21,Professional software license,REF48260615,212.56,0.0,73282.91
2018-03-25,2018-03-25,Business meal,REF98460120,194.04,0.0,73088.87
2018-04-06,2018-04-06,Equipment purchase,REF55747434,90.13,0.0,72998.74
2018-04-12,2018-04-12,Business travel,REF55203454,351.9,0.0,72646.84
2018-04-12,2018-04-12,Business meal,REF91559403,291.19,0.0,72355.65
2018-04-15,2018-04-15,"Project payment - Williams, Martinez and Smith",REF35061742,0.0,784.98,73140.63
2018-04-15,2018-04-15,Invoice payment - Freeman PLC,REF90629124,0.0,563.7,73704.33
2018-04-15,2018-04-15,Service payment - Campbell Inc,REF93996805,0.0,1045.9,74750.23
2018-04-15,2018-04-15,Business insurance premium,REF32888832,136.3,0.0,74613.93
2018-04-15,2018-04-15,"Invoice payment - Christian, Morris and Weaver",REF13108510,0.0,1034.14,75648.07
2018-04-15,2018-04-15,Payment from Smith Inc,REF36001784,0.0,760.87,76408.94
2018-04-15,2018-04-15,"Service payment - Luna, Quinn and Wilson",REF33347725,0.0,689.23,77098.17
2018-04-18,2018-04-18,Training/conference,REF97581389,246.75,0.0,76851.42
2018-04-18,2018-04-18,Business travel,REF98436759,299.56,0.0,76551.86
2018-04-18,2018-04-18,Business meal,REF45577972,187.64,0.0,76364.22
2018-04-19,2018-04-19,Business meal,REF20032207,321.42,0.0,76042.8
2018-04-21,2018-04-21,Professional software license,REF52464315,197.61,0.0,75845.19
2018-04-22,2018-04-22,Training/conference,REF75629543,301.39,0.0,75543.8
2018-04-27,2018-04-27,Coworking space rental,REF63531356,262.56,0.0,75281.24
2018-04-28,2018-04-28,Accounting expense,REF52486030,252.9,0.0,75028.34
2018-05-05,2018-05-05,Marketing expenses,REF71962025,295.47,0.0,74732.87
2018-05-15,2018-05-15,"Project payment - Luna, Quinn and Wilson",REF58114113,0.0,501.51,75234.38
2018-05-15,2018-05-15,Payment from Shannon PLC,REF65173184,0.0,722.11,75956.49
2018-05-15,2018-05-15,"Invoice payment - Christian, Morris and Weaver",REF77776882,0.0,768.5,76724.99
2018-05-15,2018-05-15,Payment from Campbell Inc,REF52637952,0.0,976.17,77701.16
2018-05-15,2018-05-15,Project payment - Freeman PLC,REF60711540,0.0,545.32,78246.48
2018-05-15,2018-05-15,"Service payment - Williams, Martinez and Smith",REF30466944,0.0,625.48,78871.96
2018-05-15,2018-05-15,Business insurance premium,REF69462556,131.04,0.0,78740.92
2018-05-15,2018-05-15,Payment from Smith Inc,REF78052835,0.0,786.59,79527.51
2018-05-15,2018-05-15,"Service payment - Franklin, Smith and Farrell",REF11722912,0.0,1280.69,80808.2
2018-05-19,2018-05-19,Training/conference,REF14214528,148.12,0.0,80660.08
2018-05-21,2018-05-21,Professional software license,REF44940560,172.82,0.0,80487.26
2018-05-26,2018-05-26,Business meal,REF63958530,202.4,0.0,80284.86
2018-05-27,2018-05-27,Business meal,REF56319040,94.37,0.0,80190.49
2018-05-29,2018-05-29,Accounting expense,REF19934667,100.39,0.0,80090.1
2018-06-03,2018-06-03,Coworking space rental,REF73318251,130.09,0.0,79960.01
2018-06-07,2018-06-07,Training/conference,REF64729591,265.67,0.0,79694.34
2018-06-11,2018-06-11,Business travel,REF57409635,423.31,0.0,79271.03
2018-06-12,2018-06-12,Accounting expense,REF80065199,137.42,0.0,79133.61
2018-06-15,2018-06-15,Business insurance premium,REF40348606,110.59,0.0,79023.02
2018-06-15,2018-06-15,Payment from Campbell Inc,REF50993832,0.0,979.09,80002.11
2018-06-15,2018-06-15,Project payment - Shannon PLC,REF33186654,0.0,424.99,80427.1
2018-06-15,2018-06-15,"Payment from Luna, Quinn and Wilson",REF77394849,0.0,534.89,80961.99
2018-06-15,2018-06-15,Payment from Smith Inc,REF56633337,0.0,473.36,81435.35
2018-06-15,2018-06-15,Invoice payment - Freeman PLC,REF48472679,0.0,356.22,81791.57
2018-06-15,2018-06-15,"Project payment - Williams, Martinez and Smith",REF41884806,0.0,788.59,82580.16
2018-06-15,2018-06-15,"Project payment - Christian, Morris and Weaver",REF74783272,0.0,836.85,83417.01
2018-06-16,2018-06-16,Coworking space rental,REF35194567,217.62,0.0,83199.39
2018-06-19,2018-06-19,Accounting expense,REF42614344,279.22,0.0,82920.17
2018-06-21,2018-06-21,Professional software license,REF72561723,146.92,0.0,82773.25
2018-06-22,2018-06-22,Training/conference,REF49427797,83.94,0.0,82689.31
2018-06-25,2018-06-25,Business travel,REF87740187,422.52,0.0,82266.79
2018-06-26,2018-06-26,Business travel,REF28631502,533.22,0.0,81733.57
2018-07-06,2018-07-06,Business meal,REF55336354,90.96,0.0,81642.61
2018-07-13,2018-07-13,Equipment purchase,REF59812160,143.64,0.0,81498.97
2018-07-15,2018-07-15,Payment from Shannon PLC,REF86878055,0.0,578.86,82077.83
2018-07-15,2018-07-15,"Service payment - Luna, Quinn and Wilson",REF10966411,0.0,375.26,82453.09
2018-07-15,2018-07-15,Service payment - Freeman PLC,REF87853734,0.0,421.15,82874.24
2018-07-15,2018-07-15,Business insurance premium,REF58836726,92.02,0.0,82782.22
2018-07-15,2018-07-15,"Project payment - Franklin, Smith and Farrell",REF12730840,0.0,872.59,83654.81
2018-07-15,2018-07-15,Payment from Smith Inc,REF49759730,0.0,476.58,84131.39
2018-07-15,2018-07-15,Payment from Campbell Inc,REF97890410,0.0,695.72,84827.11
2018-07-15,2018-07-15,"Service payment - Williams, Martinez and Smith",REF95260149,0.0,715.09,85542.2
2018-07-15,2018-07-15,"Payment from Christian, Morris and Weaver",REF37192927,0.0,593.4,86135.6
2018-07-19,2018-07-19,Training/conference,REF73412575,166.36,0.0,85969.24
2018-07-21,2018-07-21,Professional software license,REF75861269,160.91,0.0,85808.33
2018-07-24,2018-07-24,Business travel,REF10391365,65.72,0.0,85742.61
2018-07-28,2018-07-28,Training/conference,REF30269897,134.52,0.0,85608.09
2018-07-29,2018-07-29,Training/conference,REF92855205,110.03,0.0,85498.06
2018-08-01,2018-08-01,Business meal,REF16981798,134.37,0.0,85363.69
2018-08-02,2018-08-02,Accounting expense,REF70115031,151.98,0.0,85211.71
2018-08-12,2018-08-12,Marketing expenses,REF54270134,331.53,0.0,84880.18
2018-08-15,2018-08-15,"Project payment - Luna, Quinn and Wilson",REF37767816,0.0,542.02,85422.2
2018-08-15,2018-08-15,Service payment - Smith Inc,REF44650433,0.0,544.12,85966.32
2018-08-15,2018-08-15,Service payment - Shannon PLC,REF18734002,0.0,636.17,86602.49
2018-08-15,2018-08-15,"Payment from Williams, Martinez and Smith",REF41768743,0.0,753.34,87355.83
2018-08-15,2018-08-15,Payment from Freeman PLC,REF24797918,0.0,250.5,87606.33
2018-08-15,2018-08-15,"Project payment - Franklin, Smith and Farrell",REF87333844,0.0,1228.85,88835.18
2018-08-15,2018-08-15,"Payment from Christian, Morris and Weaver",REF25543898,0.0,597.71,89432.89
2018-08-15,2018-08-15,Project payment - Campbell Inc,REF73114440,0.0,721.76,90154.65
2018-08-15,2018-08-15,Business insurance premium,REF55281245,112.42,0.0,90042.23
2018-08-16,2018-08-16,Training/conference,REF19786663,52.48,0.0,89989.75
2018-08-21,2018-08-21,Professional software license,REF43521463,192.12,0.0,89797.63
2018-09-03,2018-09-03,Business meal,REF11466058,125.18,0.0,89672.45
2018-09-05,2018-09-05,Business meal,REF84037402,67.61,0.0,89604.84
2018-09-07,2018-09-07,Business travel,REF65241052,450.6,0.0,89154.24
2018-09-12,2018-09-12,Training/conference,REF85871425,323.3,0.0,88830.94
2018-09-15,2018-09-15,"Payment from Williams, Martinez and Smith",REF60739241,0.0,973.46,89804.4
2018-09-15,2018-09-15,Invoice payment - Smith Inc,REF12288920,0.0,831.04,90635.44
2018-09-15,2018-09-15,"Invoice payment - Luna, Quinn and Wilson",REF92274447,0.0,628.43,91263.87
2018-09-15,2018-09-15,Payment from Campbell Inc,REF14798086,0.0,1152.74,92416.61
2018-09-15,2018-09-15,"Payment from Christian, Morris and Weaver",REF80275594,0.0,973.08,93389.69
2018-09-15,2018-09-15,Business insurance premium,REF45602381,154.26,0.0,93235.43
2018-09-15,2018-09-15,Payment from Freeman PLC,REF29801010,0.0,503.6,93739.03
2018-09-15,2018-09-15,Invoice payment - Shannon PLC,REF88828632,0.0,758.57,94497.6
2018-09-17,2018-09-17,Training/conference,REF40235948,291.52,0.0,94206.08
2018-09-20,2018-09-20,Accounting expense,REF66820725,203.84,0.0,94002.24
2018-09-20,2018-09-20,Training/conference,REF98044398,238.77,0.0,93763.47
2018-09-21,2018-09-21,Professional software license,REF13806506,226.54,0.0,93536.93
2018-09-29,2018-09-29,Coworking space rental,REF40745483,518.03,0.0,93018.9
2018-10-05,2018-10-05,Training/conference,REF98301088,316.35,0.0,92702.55
2018-10-08,2018-10-08,Coworking space rental,REF88046252,325.16,0.0,92377.39
2018-10-10,2018-10-10,Business meal,REF79841919,201.85,0.0,92175.54
2018-10-11,2018-10-11,Equipment purchase,REF48958958,150.44,0.0,92025.1
2018-10-15,2018-10-15,Project payment - Shannon PLC,REF10371795,0.0,1049.87,93074.97
2018-10-15,2018-10-15,"Project payment - Luna, Quinn and Wilson",REF92105970,0.0,918.42,93993.39
2018-10-15,2018-10-15,"Invoice payment - Christian, Morris and Weaver",REF90571613,0.0,936.31,94929.7
2018-10-15,2018-10-15,Business insurance premium,REF74337786,165.66,0.0,94764.04
2018-10-15,2018-10-15,Service payment - Freeman PLC,REF96837056,0.0,493.93,95257.97
2018-10-15,2018-10-15,"Invoice payment - Franklin, Smith and Farrell",REF21251255,0.0,1555.34,96813.31
2018-10-15,2018-10-15,Project payment - Campbell Inc,REF99507082,0.0,1302.27,98115.58
2018-10-19,2018-10-19,Business travel,REF92260043,402.09,0.0,97713.49
2018-10-21,2018-10-21,Professional software license,REF94058327,259.77,0.0,97453.72
2018-10-26,2018-10-26,Marketing expenses,REF27569551,359.36,0.0,97094.36
2018-10-26,2018-10-26,Business meal,REF66096994,279.08,0.0,96815.28
2018-11-04,2018-11-04,Business travel,REF83651828,402.23,0.0,96413.05
2018-11-05,2018-11-05,Equipment purchase,REF23094242,220.25,0.0,96192.8
2018-11-10,2018-11-10,Business travel,REF79086043,575.97,0.0,95616.83
2018-11-10,2018-11-10,Equipment purchase,REF28730156,188.5,0.0,95428.33
2018-11-14,2018-11-14,Marketing expenses,REF60092267,293.39,0.0,95134.94
2018-11-15,2018-11-15,Service payment - Shannon PLC,REF49966576,0.0,847.22,95982.16
2018-11-15,2018-11-15,Payment from Smith Inc,REF67568932,0.0,628.25,96610.41
2018-11-15,2018-11-15,Business insurance premium,REF98955450,160.84,0.0,96449.57
2018-11-15,2018-11-15,"Invoice payment - Williams, Martinez and Smith",REF24809531,0.0,1002.34,97451.91
2018-11-15,2018-11-15,"Project payment - Luna, Quinn and Wilson",REF49628003,0.0,651.58,98103.49
2018-11-15,2018-11-15,Payment from Campbell Inc,REF84005788,0.0,1000.72,99104.21
2018-11-15,2018-11-15,"Payment from Christian, Morris and Weaver",REF89969795,0.0,897.11,100001.32
2018-11-15,2018-11-15,"Invoice payment - Franklin, Smith and Farrell",REF11124739,0.0,1662.02,101663.34
2018-11-17,2018-11-17,Business meal,REF37737260,185.08,0.0,101478.26
2018-11-21,2018-11-21,Professional software license,REF79963179,192.49,0.0,101285.77
2018-11-23,2018-11-23,Training/conference,REF33299824,324.36,0.0,100961.41
2018-11-24,2018-11-24,Marketing expenses,REF27379173,310.62,0.0,100650.79
2018-12-01,2018-12-01,Accounting expense,REF77640877,165.55,0.0,100485.24
2018-12-02,2018-12-02,Business meal,REF59368430,215.98,0.0,100269.26
2018-12-07,2018-12-07,Equipment purchase,REF98513000,163.86,0.0,100105.4
2018-12-15,2018-12-15,Service payment - Smith Inc,REF62026548,0.0,588.26,100693.66
2018-12-15,2018-12-15,"Service payment - Luna, Quinn and Wilson",REF86411933,0.0,484.62,101178.28
2018-12-15,2018-12-15,"Service payment - Williams, Martinez and Smith",REF97886657,0.0,827.79,102006.07
2018-12-15,2018-12-15,"Payment from Christian, Morris and Weaver",REF40257414,0.0,679.58,102685.65
2018-12-15,2018-12-15,"Invoice payment - Franklin, Smith and Farrell",REF62224420,0.0,1195.94,103881.59
2018-12-15,2018-12-15,Service payment - Shannon PLC,REF84719990,0.0,721.66,104603.25
2018-12-15,2018-12-15,Service payment - Campbell Inc,REF31362305,0.0,1099.56,105702.81
2018-12-15,2018-12-15,Service payment - Freeman PLC,REF46224268,0.0,417.03,106119.84
2018-12-15,2018-12-15,Business insurance premium,REF74530474,124.4,0.0,105995.44
2018-12-18,2018-12-18,Business travel,REF79388512,424.07,0.0,105571.37
2018-12-21,2018-12-21,Professional software license,REF63668176,199.58,0.0,105371.79
2018-12-29,2018-12-29,Business meal,REF41675246,284.87,0.0,105086.92
2019-01-02,2019-01-02,Marketing expenses,REF33487628,435.8,0.0,104651.12
2019-01-10,2019-01-10,Business travel,REF43724082,649.45,0.0,104001.67
2019-01-12,2019-01-12,Marketing expenses,REF57398995,353.0,0.0,103648.67
2019-01-15,2019-01-15,"Service payment - Williams, Martinez and Smith",REF80945146,0.0,988.7,104637.37
2019-01-15,2019-01-15,Payment from Shannon PLC,REF28959743,0.0,1048.99,105686.36
2019-01-15,2019-01-15,"Invoice payment - Franklin, Smith and Farrell",REF56287413,0.0,1470.07,107156.43
2019-01-15,2019-01-15,"Payment from Luna, Quinn and Wilson",REF48236285,0.0,814.69,107971.12
2019-01-15,2019-01-15,Payment from Smith Inc,REF75686700,0.0,472.15,108443.27
2019-01-15,2019-01-15,Service payment - Freeman PLC,REF15872911,0.0,626.39,109069.66
2019-01-15,2019-01-15,"Payment from Christian, Morris and Weaver",REF83238558,0.0,1034.24,110103.9
2019-01-15,2019-01-15,Business insurance premium,REF87918019,170.94,0.0,109932.96
2019-01-15,2019-01-15,Invoice payment - Campbell Inc,REF10702348,0.0,1143.98,111076.94
2019-01-21,2019-01-21,Professional software license,REF94417516,294.51,0.0,110782.43
2019-02-08,2019-02-08,Business travel,REF32206519,292.15,0.0,110490.28
2019-02-08,2019-02-08,Coworking space rental,REF94015819,277.2,0.0,110213.08
2019-02-09,2019-02-09,Equipment purchase,REF98933140,274.17,0.0,109938.91
2019-02-12,2019-02-12,Business travel,REF97780978,592.89,0.0,109346.02
2019-02-15,2019-02-15,Project payment - Shannon PLC,REF17652968,0.0,846.43,110192.45
2019-02-15,2019-02-15,Payment from Freeman PLC,REF10515999,0.0,600.24,110792.69
2019-02-15,2019-02-15,Project payment - Campbell Inc,REF89051461,0.0,1242.58,112035.27
2019-02-15,2019-02-15,"Project payment - Franklin, Smith and Farrell",REF97098320,0.0,1212.45,113247.72
2019-02-15,2019-02-15,Project payment - Smith Inc,REF96772992,0.0,785.53,114033.25
2019-02-15,2019-02-15,"Project payment - Luna, Quinn and Wilson",REF22307141,0.0,746.96,114780.21
2019-02-15,2019-02-15,"Service payment - Christian, Morris and Weaver",REF41098768,0.0,881.07,115661.28
2019-02-15,2019-02-15,Business insurance premium,REF29871768,154.22,0.0,115507.06
2019-02-21,2019-02-21,Professional software license,REF69981282,235.79,0.0,115271.27
2019-02-23,2019-02-23,Business travel,REF40769415,387.69,0.0,114883.58
2019-02-24,2019-02-24,Business travel,REF43222253,559.1,0.0,114324.48
2019-02-24,2019-02-24,Marketing expenses,REF56161435,348.11,0.0,113976.37
2019-02-28,2019-02-28,Coworking space rental,REF52565144,510.83,0.0,113465.54
2019-03-02,2019-03-02,Business meal,REF69671613,162.73,0.0,113302.81
2019-03-03,2019-03-03,Business meal,REF86241816,192.0,0.0,113110.81
2019-03-07,2019-03-07,Equipment purchase,REF53647387,131.28,0.0,112979.53
2019-03-08,2019-03-08,Accounting expense,REF49609706,318.8,0.0,112660.73
2019-03-10,2019-03-10,Equipment purchase,REF44585518,213.47,0.0,112447.26
2019-03-15,2019-03-15,"Project payment - Williams, Martinez and Smith",REF77160974,0.0,779.88,113227.14
2019-03-15,2019-03-15,"Payment from Franklin, Smith and Farrell",REF99569376,0.0,1277.11,114504.25
2019-03-15,2019-03-15,Business insurance premium,REF24544856,139.11,0.0,114365.14
2019-03-15,2019-03-15,Project payment - Shannon PLC,REF38522909,0.0,907.78,115272.92
2019-03-15,2019-03-15,Invoice payment - Freeman PLC,REF29042268,0.0,572.48,115845.4
2019-03-15,2019-03-15,Invoice payment - Campbell Inc,REF54561536,0.0,1241.19,117086.59
2019-03-15,2019-03-15,"Payment from Luna, Quinn and Wilson",REF10277081,0.0,634.88,117721.47
2019-03-15,2019-03-15,Payment from Smith Inc,REF11905765,0.0,740.9,118462.37
2019-03-15,2019-03-15,"Service payment - Christian, Morris and Weaver",REF10974182,0.0,849.76,119312.13
2019-03-18,2019-03-18,Business travel,REF49436774,529.57,0.0,118782.56
2019-03-21,2019-03-21,Professional software license,REF87208878,210.84,0.0,118571.72
2019-03-23,2019-03-23,Equipment purchase,REF69045962,209.13,0.0,118362.59
2019-03-24,2019-03-24,Business meal,REF38264107,202.41,0.0,118160.18
2019-04-14,2019-04-14,Business meal,REF20082921,237.45,0.0,117922.73
2019-04-15,2019-04-15,Business meal,REF96098646,152.58,0.0,117770.15
2019-04-15,2019-04-15,"Service payment - Franklin, Smith and Farrell",REF30510784,0.0,1633.78,119403.93
2019-04-15,2019-04-15,Project payment - Smith Inc,REF28562703,0.0,823.05,120226.98
2019-04-15,2019-04-15,"Invoice payment - Williams, Martinez and Smith",REF26514193,0.0,656.71,120883.69
2019-04-15,2019-04-15,Project payment - Shannon PLC,REF58828277,0.0,653.55,121537.24
2019-04-15,2019-04-15,Invoice payment - Freeman PLC,REF46698171,0.0,463.4,122000.64
2019-04-15,2019-04-15,Business insurance premium,REF17388705,158.69,0.0,121841.95
2019-04-15,2019-04-15,"Project payment - Christian, Morris and Weaver",REF43285108,0.0,989.9,122831.85
2019-04-15,2019-04-15,Project payment - Campbell Inc,REF57466907,0.0,908.93,123740.78
2019-04-19,2019-04-19,Business travel,REF12952267,377.8,0.0,123362.98
2019-04-21,2019-04-21,Business travel,REF84776828,421.33,0.0,122941.65
2019-04-21,2019-04-21,Professional software license,REF91327342,179.19,0.0,122762.46
2019-04-28,2019-04-28,Business meal,REF13675513,345.4,0.0,122417.06
2019-04-30,2019-04-30,Accounting expense,REF48914009,263.78,0.0,122153.28
2019-05-05,2019-05-05,Business travel,REF45069785,383.77,0.0,121769.51
2019-05-06,2019-05-06,Coworking space rental,REF18067730,208.74,0.0,121560.77
2019-05-15,2019-05-15,Business insurance premium,REF31166559,118.49,0.0,121442.28
2019-05-15,2019-05-15,Payment from Freeman PLC,REF40577901,0.0,403.34,121845.62
2019-05-15,2019-05-15,"Payment from Christian, Morris and Weaver",REF14315071,0.0,696.86,122542.48
2019-05-15,2019-05-15,"Project payment - Williams, Martinez and Smith",REF54665576,0.0,719.81,123262.29
2019-05-15,2019-05-15,Payment from Campbell Inc,REF72866031,0.0,921.72,124184.01
2019-05-15,2019-05-15,Invoice payment - Shannon PLC,REF25288533,0.0,412.6,124596.61
2019-05-19,2019-05-19,Coworking space rental,REF49160683,237.6,0.0,124359.01
2019-05-21,2019-05-21,Professional software license,REF97309341,155.56,0.0,124203.45
2019-05-22,2019-05-22,Training/conference,REF76397957,111.43,0.0,124092.02
2019-05-30,2019-05-30,Training/conference,REF50688477,199.85,0.0,123892.17
2019-06-03,2019-06-03,Marketing expenses,REF79798159,295.85,0.0,123596.32
2019-06-12,2019-06-12,Business travel,REF54345601,300.31,0.0,123296.01
2019-06-15,2019-06-15,Business insurance premium,REF18140399,109.46,0.0,123186.55
2019-06-15,2019-06-15,Payment from Campbell Inc,REF93882330,0.0,1014.88,124201.43
2019-06-15,2019-06-15,"Service payment - Franklin, Smith and Farrell",REF21040570,0.0,1074.77,125276.2
2019-06-15,2019-06-15,Payment from Shannon PLC,REF73963843,0.0,521.53,125797.73
2019-06-15,2019-06-15,Invoice payment - Freeman PLC,REF35470757,0.0,337.45,126135.18
2019-06-15,2019-06-15,"Service payment - Christian, Morris and Weaver",REF12237563,0.0,653.99,126789.17
2019-06-15,2019-06-15,"Payment from Williams, Martinez and Smith",REF26886724,0.0,722.38,127511.55
2019-06-15,2019-06-15,"Service payment - Luna, Quinn and Wilson",REF81998984,0.0,560.8,128072.35
2019-06-15,2019-06-15,Project payment - Smith Inc,REF71227542,0.0,555.74,128628.09
2019-06-21,2019-06-21,Professional software license,REF11258478,165.35,0.0,128462.74
2019-06-21,2019-06-21,Business meal,REF28612298,164.6,0.0,128298.14
2019-06-23,2019-06-23,Business travel,REF81013798,284.52,0.0,128013.62
2019-06-25,2019-06-25,Equipment purchase,REF12096679,135.35,0.0,127878.27
2019-06-28,2019-06-28,Business meal,REF75977788,177.39,0.0,127700.88
2019-07-11,2019-07-11,Coworking space rental,REF68312529,161.81,0.0,127539.07
2019-07-15,2019-07-15,Project payment - Smith Inc,REF65817934,0.0,440.33,127979.4
2019-07-15,2019-07-15,Business travel,REF20410886,399.62,0.0,127579.78
2019-07-15,2019-07-15,Business insurance premium,REF64993438,94.39,0.0,127485.39
2019-07-15,2019-07-15,"Payment from Franklin, Smith and Farrell",REF39950472,0.0,1016.81,128502.2
2019-07-15,2019-07-15,"Invoice payment - Williams, Martinez and Smith",REF38634966,0.0,609.99,129112.19
2019-07-15,2019-07-15,"Payment from Luna, Quinn and Wilson",REF87313504,0.0,434.13,129546.32
2019-07-15,2019-07-15,Project payment - Shannon PLC,REF35941267,0.0,458.74,130005.06
2019-07-15,2019-07-15,Payment from Campbell Inc,REF28433284,0.0,790.53,130795.59
2019-07-15,2019-07-15,"Payment from Christian, Morris and Weaver",REF13963877,0.0,555.46,131351.05
2019-07-20,2019-07-20,Equipment purchase,REF98533448,83.49,0.0,131267.56
2019-07-21,2019-07-21,Professional software license,REF22907502,149.59,0.0,131117.97
2019-07-28,2019-07-28,Equipment purchase,REF50638192,133.06,0.0,130984.91
2019-07-29,2019-07-29,Business meal,REF38721900,101.58,0.0,130883.33
2019-07-29,2019-07-29,Training/conference,REF23164170,140.44,0.0,130742.89
2019-08-15,2019-08-15,Project payment - Shannon PLC,REF90631594,0.0,535.68,131278.57
2019-08-15,2019-08-15,"Service payment - Christian, Morris and Weaver",REF43349737,0.0,677.79,131956.36
2019-08-15,2019-08-15,Accounting expense,REF88829493,125.12,0.0,131831.24
2019-08-15,2019-08-15,Project payment - Smith Inc,REF55749011,0.0,475.14,132306.38
2019-08-15,2019-08-15,"Invoice payment - Williams, Martinez and Smith",REF42808920,0.0,609.34,132915.72
2019-08-15,2019-08-15,"Service payment - Franklin, Smith and Farrell",REF41370205,0.0,933.05,133848.77
2019-08-15,2019-08-15,Project payment - Campbell Inc,REF73798392,0.0,961.84,134810.61
2019-08-15,2019-08-15,Business insurance premium,REF23578259,101.0,0.0,134709.61
2019-08-15,2019-08-15,"Service payment - Luna, Quinn and Wilson",REF19509616,0.0,645.46,135355.07
2019-08-21,2019-08-21,Professional software license,REF62423385,156.63,0.0,135198.44
2019-08-29,2019-08-29,Business meal,REF13677537,259.0,0.0,134939.44
2019-09-14,2019-09-14,Coworking space rental,REF79704514,400.92,0.0,134538.52
2019-09-15,2019-09-15,Service payment - Campbell Inc,REF15262225,0.0,1085.93,135624.45
2019-09-15,2019-09-15,"Invoice payment - Luna, Quinn and Wilson",REF41456256,0.0,488.52,136112.97
2019-09-15,2019-09-15,Payment from Freeman PLC,REF71442140,0.0,438.23,136551.2
2019-09-15,2019-09-15,"Project payment - Christian, Morris and Weaver",REF25964323,0.0,938.86,137490.06
2019-09-15,2019-09-15,Payment from Smith Inc,REF63224315,0.0,790.23,138280.29
2019-09-15,2019-09-15,Business insurance premium,REF22613962,157.14,0.0,138123.15
2019-09-15,2019-09-15,"Project payment - Williams, Martinez and Smith",REF84013944,0.0,915.07,139038.22
2019-09-15,2019-09-15,Payment from Shannon PLC,REF20682663,0.0,710.57,139748.79
2019-09-20,2019-09-20,Business meal,REF16266103,216.81,0.0,139531.98
2019-09-21,2019-09-21,Professional software license,REF41027447,223.27,0.0,139308.71
2019-09-24,2019-09-24,Accounting expense,REF95634305,222.39,0.0,139086.32
2019-09-25,2019-09-25,Business meal,REF29990664,185.01,0.0,138901.31
2019-09-26,2019-09-26,Training/conference,REF66900902,329.31,0.0,138572.0
2019-10-03,2019-10-03,Business meal,REF57143634,376.1,0.0,138195.9
2019-10-03,2019-10-03,Marketing expenses,REF56247067,394.04,0.0,137801.86
2019-10-04,2019-10-04,Business travel,REF15876229,526.79,0.0,137275.07
2019-10-07,2019-10-07,Business travel,REF31840276,344.22,0.0,136930.85
2019-10-12,2019-10-12,Business travel,REF75300468,713.47,0.0,136217.38
2019-10-14,2019-10-14,Business meal,REF65656649,182.97,0.0,136034.41
2019-10-15,2019-10-15,Invoice payment - Campbell Inc,REF64387744,0.0,1157.45,137191.86
2019-10-15,2019-10-15,"Project payment - Luna, Quinn and Wilson",REF52540782,0.0,788.82,137980.68
2019-10-15,2019-10-15,"Service payment - Christian, Morris and Weaver",REF64793041,0.0,1302.72,139283.4
2019-10-15,2019-10-15,Payment from Smith Inc,REF84338036,0.0,673.35,139956.75
2019-10-15,2019-10-15,"Payment from Franklin, Smith and Farrell",REF19831636,0.0,1815.0,141771.75
2019-10-15,2019-10-15,"Invoice payment - Williams, Martinez and Smith",REF85171872,0.0,1125.72,142897.47
2019-10-15,2019-10-15,Invoice payment - Shannon PLC,REF73115265,0.0,846.52,143743.99
2019-10-15,2019-10-15,Business insurance premium,REF47203985,173.49,0.0,143570.5
2019-10-18,2019-10-18,Business travel,REF25966297,449.28,0.0,143121.22
2019-10-20,2019-10-20,Accounting expense,REF55541965,257.09,0.0,142864.13
2019-10-21,2019-10-21,Professional software license,REF32073616,223.81,0.0,142640.32
2019-10-22,2019-10-22,Business meal,REF35645665,310.78,0.0,142329.54
2019-10-23,2019-10-23,Business meal,REF47138205,318.12,0.0,142011.42
2019-10-26,2019-10-26,Coworking space rental,REF74717528,343.72,0.0,141667.7
2019-10-26,2019-10-26,Business meal,REF20568540,172.72,0.0,141494.98
2019-10-29,2019-10-29,Training/conference,REF95798148,126.64,0.0,141368.34
2019-11-02,2019-11-02,Marketing expenses,REF96582385,326.74,0.0,141041.6
2019-11-05,2019-11-05,Business travel,REF76333220,529.28,0.0,140512.32
2019-11-08,2019-11-08,Business travel,REF13855157,479.14,0.0,140033.18
2019-11-09,2019-11-09,Equipment purchase,REF76917041,185.74,0.0,139847.44
2019-11-15,2019-11-15,Payment from Shannon PLC,REF74133310,0.0,1004.55,140851.99
2019-11-15,2019-11-15,"Service payment - Williams, Martinez and Smith",REF25876501,0.0,1057.61,141909.6
2019-11-15,2019-11-15,"Payment from Christian, Morris and Weaver",REF66514259,0.0,1239.34,143148.94
2019-11-15,2019-11-15,Service payment - Freeman PLC,REF79044609,0.0,497.62,143646.56
2019-11-15,2019-11-15,Service payment - Smith Inc,REF40959967,0.0,875.52,144522.08
2019-11-15,2019-11-15,Business insurance premium,REF19852459,145.08,0.0,144377.0
2019-11-15,2019-11-15,Service payment - Campbell Inc,REF26931937,0.0,1154.11,145531.11
2019-11-15,2019-11-15,"Service payment - Luna, Quinn and Wilson",REF62426816,0.0,683.23,146214.34
2019-11-21,2019-11-21,Professional software license,REF40128390,184.76,0.0,146029.58
2019-11-23,2019-11-23,Business meal,REF14694023,198.5,0.0,145831.08
2019-12-01,2019-12-01,Business meal,REF59081766,275.63,0.0,145555.45
2019-12-05,2019-12-05,Accounting expense,REF35187586,182.18,0.0,145373.27
2019-12-11,2019-12-11,Equipment purchase,REF33364627,193.4,0.0,145179.87
2019-12-13,2019-12-13,Coworking space rental,REF65590782,322.69,0.0,144857.18
2019-12-15,2019-12-15,Business insurance premium,REF43768934,117.38,0.0,144739.8
2019-12-15,2019-12-15,"Project payment - Luna, Quinn and Wilson",REF66903424,0.0,353.55,145093.35
2019-12-15,2019-12-15,Service payment - Freeman PLC,REF10705555,0.0,367.36,145460.71
2019-12-15,2019-12-15,Invoice payment - Campbell Inc,REF66370415,0.0,962.6,146423.31
2019-12-15,2019-12-15,Payment from Shannon PLC,REF58469584,0.0,599.74,147023.05
2019-12-15,2019-12-15,"Payment from Franklin, Smith and Farrell",REF25774309,0.0,1336.98,148360.03
2019-12-15,2019-12-15,Project payment - Smith Inc,REF35161264,0.0,630.24,148990.27
2019-12-15,2019-12-15,"Service payment - Christian, Morris and Weaver",REF82249048,0.0,848.68,149838.95
2019-12-15,2019-12-15,"Project payment - Williams, Martinez and Smith",REF59394918,0.0,753.91,150592.86
2019-12-15,2019-12-15,Training/conference,REF16138490,293.15,0.0,150299.71
2019-12-16,2019-12-16,Business meal,REF11636347,181.45,0.0,150118.26
2019-12-21,2019-12-21,Professional software license,REF62576441,182.81,0.0,149935.45
2019-12-23,2019-12-23,Marketing expenses,REF93024286,345.13,0.0,149590.32
2019-12-30,2019-12-30,Business meal,REF18354546,201.54,0.0,149388.78
2020-01-03,2020-01-03,Accounting expense,REF54805681,206.18,0.0,149182.6
2020-01-04,2020-01-04,Marketing expenses,REF55273601,429.81,0.0,148752.79
2020-01-07,2020-01-07,Coworking space rental,REF79296841,337.08,0.0,148415.71
2020-01-08,2020-01-08,Equipment purchase,REF95501903,139.14,0.0,148276.57
2020-01-09,2020-01-09,Coworking space rental,REF82343532,529.5,0.0,147747.07
2020-01-14,2020-01-14,Accounting expense,REF56044551,159.93,0.0,147587.14
2020-01-15,2020-01-15,Payment from Freeman PLC,REF67166026,0.0,553.1,148140.24
2020-01-15,2020-01-15,"Payment from Franklin, Smith and Farrell",REF36371586,0.0,1601.34,149741.58
2020-01-15,2020-01-15,"Project payment - Williams, Martinez and Smith",REF78953273,0.0,1122.21,150863.79
2020-01-15,2020-01-15,Business insurance premium,REF45860410,169.11,0.0,150694.68
2020-01-15,2020-01-15,Project payment - Smith Inc,REF20413857,0.0,674.03,151368.71
2020-01-15,2020-01-15,"Invoice payment - Christian, Morris and Weaver",REF78782855,0.0,966.49,152335.2
2020-01-15,2020-01-15,"Service payment - Luna, Quinn and Wilson",REF36509877,0.0,773.8,153109.0
2020-01-19,2020-01-19,Training/conference,REF69878872,225.06,0.0,152883.94
2020-01-21,2020-01-21,Professional software license,REF90943572,233.94,0.0,152650.0
2020-01-22,2020-01-22,Business meal,REF45684761,324.85,0.0,152325.15
2020-01-24,2020-01-24,Equipment purchase,REF30955806,160.62,0.0,152164.53
2020-01-27,2020-01-27,Accounting expense,REF37984583,259.1,0.0,151905.43
2020-01-31,2020-01-31,Accounting expense,REF36353528,198.4,0.0,151707.03
2020-02-08,2020-02-08,Marketing expenses,REF55516841,363.93,0.0,151343.1
2020-02-09,2020-02-09,Business meal,REF12251391,339.65,0.0,151003.45
2020-02-15,2020-02-15,"Payment from Williams, Martinez and Smith",REF66741919,0.0,977.4,151980.85
2020-02-15,2020-02-15,"Project payment - Christian, Morris and Weaver",REF10545359,0.0,854.95,152835.8
2020-02-15,2020-02-15,Service payment - Smith Inc,REF41029057,0.0,624.94,153460.74
2020-02-15,2020-02-15,Invoice payment - Campbell Inc,REF64671253,0.0,1040.54,154501.28
2020-02-15,2020-02-15,"Project payment - Luna, Quinn and Wilson",REF21086332,0.0,562.98,155064.26
2020-02-15,2020-02-15,"Payment from Franklin, Smith and Farrell",REF52874812,0.0,1873.74,156938.0
2020-02-15,2020-02-15,Invoice payment - Freeman PLC,REF28416288,0.0,567.51,157505.51
2020-02-15,2020-02-15,Payment from Shannon PLC,REF17463424,0.0,844.04,158349.55
2020-02-15,2020-02-15,Business insurance premium,REF46783054,162.93,0.0,158186.62
2020-02-21,2020-02-21,Professional software license,REF18148526,218.33,0.0,157968.29
2020-02-22,2020-02-22,Training/conference,REF55611522,231.49,0.0,157736.8
2020-02-27,2020-02-27,Training/conference,REF54973347,263.21,0.0,157473.59
2020-02-28,2020-02-28,Equipment purchase,REF10513533,107.56,0.0,157366.03
2020-03-02,2020-03-02,Business travel,REF56214315,247.06,0.0,157118.97
2020-03-10,2020-03-10,Business meal,REF13640000,326.14,0.0,156792.83
2020-03-14,2020-03-14,Coworking space rental,REF55022063,325.93,0.0,156466.9
2020-03-15,2020-03-15,Invoice payment - Freeman PLC,REF39185888,0.0,504.93,156971.83
2020-03-15,2020-03-15,Payment from Shannon PLC,REF15372822,0.0,706.52,157678.35
2020-03-15,2020-03-15,"Invoice payment - Luna, Quinn and Wilson",REF76408565,0.0,623.0,158301.35
2020-03-15,2020-03-15,"Payment from Franklin, Smith and Farrell",REF46633033,0.0,1387.55,159688.9
2020-03-15,2020-03-15,Service payment - Smith Inc,REF33779047,0.0,606.51,160295.41
2020-03-15,2020-03-15,"Project payment - Williams, Martinez and Smith",REF20942505,0.0,939.84,161235.25
2020-03-15,2020-03-15,"Service payment - Christian, Morris and Weaver",REF68746510,0.0,806.83,162042.08
2020-03-15,2020-03-15,Payment from Campbell Inc,REF54291183,0.0,1046.71,163088.79
2020-03-15,2020-03-15,Business insurance premium,REF42560678,143.93,0.0,162944.86
2020-03-16,2020-03-16,Business meal,REF69616717,151.95,0.0,162792.91
2020-03-17,2020-03-17,Training/conference,REF93313472,66.21,0.0,162726.7
2020-03-21,2020-03-21,Professional software license,REF71434368,215.28,0.0,162511.42
2020-03-29,2020-03-29,Accounting expense,REF89905613,261.47,0.0,162249.95
2020-03-29,2020-03-29,Equipment purchase,REF98182635,159.62,0.0,162090.33
2020-03-30,2020-03-30,Business meal,REF58078184,196.39,0.0,161893.94
2020-04-02,2020-04-02,Business travel,REF92991153,424.11,0.0,161469.83
2020-04-02,2020-04-02,Training/conference,REF13355318,247.66,0.0,161222.17
2020-04-03,2020-04-03,Accounting expense,REF65073077,151.7,0.0,161070.47
2020-04-06,2020-04-06,Marketing expenses,REF17210953,269.13,0.0,160801.34
2020-04-07,2020-04-07,Business meal,REF72961548,143.21,0.0,160658.13
2020-04-09,2020-04-09,Marketing expenses,REF21674809,256.08,0.0,160402.05
2020-04-15,2020-04-15,Business meal,REF53489775,331.43,0.0,160070.62
2020-04-15,2020-04-15,Business insurance premium,REF62656628,139.91,0.0,159930.71
2020-04-15,2020-04-15,Invoice payment - Smith Inc,REF19624530,0.0,718.12,160648.83
2020-04-15,2020-04-15,Invoice payment - Campbell Inc,REF35577249,0.0,913.71,161562.54
2020-04-15,2020-04-15,"Invoice payment - Franklin, Smith and Farrell",REF36810849,0.0,1118.7,162681.24
2020-04-15,2020-04-15,Payment from Freeman PLC,REF54351874,0.0,532.12,163213.36
2020-04-15,2020-04-15,"Service payment - Luna, Quinn and Wilson",REF16755061,0.0,618.02,163831.38
2020-04-15,2020-04-15,"Project payment - Christian, Morris and Weaver",REF69298027,0.0,992.93,164824.31
2020-04-17,2020-04-17,Business meal,REF26039205,177.31,0.0,164647.0
2020-04-18,2020-04-18,Equipment purchase,REF38289126,230.5,0.0,164416.5
2020-04-19,2020-04-19,Business travel,REF65890550,675.67,0.0,163740.83
2020-04-21,2020-04-21,Professional software license,REF91251998,207.0,0.0,163533.83
2020-04-26,2020-04-26,Equipment purchase,REF97455670,142.59,0.0,163391.24
2020-04-28,2020-04-28,Business meal,REF41249321,347.02,0.0,163044.22
2020-05-01,2020-05-01,Business travel,REF55167097,501.36,0.0,162542.86
2020-05-02,2020-05-02,Equipment purchase,REF62735713,119.85,0.0,162423.01
2020-05-03,2020-05-03,Coworking space rental,REF58653690,236.56,0.0,162186.45
2020-05-15,2020-05-15,Invoice payment - Smith Inc,REF91348710,0.0,565.69,162752.14
2020-05-15,2020-05-15,"Invoice payment - Franklin, Smith and Farrell",REF58565129,0.0,1250.03,164002.17
2020-05-15,2020-05-15,"Payment from Christian, Morris and Weaver",REF18791771,0.0,722.3,164724.47
2020-05-15,2020-05-15,Payment from Freeman PLC,REF33978137,0.0,364.83,165089.3
2020-05-15,2020-05-15,Invoice payment - Campbell Inc,REF54960616,0.0,1048.64,166137.94
2020-05-15,2020-05-15,"Service payment - Luna, Quinn and Wilson",REF83280582,0.0,531.05,166668.99
2020-05-15,2020-05-15,"Service payment - Williams, Martinez and Smith",REF71540691,0.0,1096.63,167765.62
2020-05-15,2020-05-15,Business insurance premium,REF77651010,127.66,0.0,167637.96
2020-05-15,2020-05-15,Project payment - Shannon PLC,REF13723643,0.0,545.98,168183.94
2020-05-16,2020-05-16,Training/conference,REF42372822,217.17,0.0,167966.77
2020-05-20,2020-05-20,Accounting expense,REF95643727,115.44,0.0,167851.33
2020-05-20,2020-05-20,Training/conference,REF67758010,22.32,0.0,167829.01
2020-05-21,2020-05-21,Professional software license,REF39886445,198.79,0.0,167630.22
2020-05-27,2020-05-27,Accounting expense,REF83062690,189.85,0.0,167440.37
2020-05-28,2020-05-28,Coworking space rental,REF81458551,462.71,0.0,166977.66
2020-06-01,2020-06-01,Training/conference,REF95204832,130.31,0.0,166847.35
2020-06-03,2020-06-03,Business meal,REF20809653,125.99,0.0,166721.36
2020-06-13,2020-06-13,Business meal,REF60769780,112.04,0.0,166609.32
2020-06-15,2020-06-15,Business insurance premium,REF99139030,106.36,0.0,166502.96
2020-06-15,2020-06-15,Service payment - Campbell Inc,REF62194474,0.0,831.85,167334.81
2020-06-15,2020-06-15,"Project payment - Williams, Martinez and Smith",REF53073039,0.0,670.46,168005.27
2020-06-15,2020-06-15,Invoice payment - Freeman PLC,REF10925857,0.0,454.57,168459.84
2020-06-15,2020-06-15,"Payment from Franklin, Smith and Farrell",REF64399816,0.0,751.59,169211.43
2020-06-15,2020-06-15,"Service payment - Luna, Quinn and Wilson",REF99047819,0.0,429.48,169640.91
2020-06-15,2020-06-15,Project payment - Smith Inc,REF76302535,0.0,635.64,170276.55
2020-06-15,2020-06-15,Invoice payment - Shannon PLC,REF29208217,0.0,705.93,170982.48
2020-06-15,2020-06-15,"Payment from Christian, Morris and Weaver",REF61745384,0.0,693.41,171675.89
2020-06-21,2020-06-21,Professional software license,REF51174483,174.58,0.0,171501.31
2020-07-01,2020-07-01,Business travel,REF26790351,214.81,0.0,171286.5
2020-07-07,2020-07-07,Business travel,REF88588636,212.67,0.0,171073.83
2020-07-07,2020-07-07,Training/conference,REF73661488,214.29,0.0,170859.54
2020-07-08,2020-07-08,Equipment purchase,REF53677373,78.53,0.0,170781.01
2020-07-15,2020-07-15,"Service payment - Christian, Morris and Weaver",REF35726076,0.0,605.4,171386.41
2020-07-15,2020-07-15,"Payment from Williams, Martinez and Smith",REF28865475,0.0,633.55,172019.96
2020-07-15,2020-07-15,Invoice payment - Smith Inc,REF58646370,0.0,583.54,172603.5
2020-07-15,2020-07-15,"Invoice payment - Luna, Quinn and Wilson",REF11996832,0.0,433.03,173036.53
2020-07-15,2020-07-15,Project payment - Freeman PLC,REF80557501,0.0,368.06,173404.59
2020-07-15,2020-07-15,"Project payment - Franklin, Smith and Farrell",REF34120385,0.0,836.01,174240.6
2020-07-15,2020-07-15,Payment from Shannon PLC,REF99429474,0.0,510.04,174750.64
2020-07-15,2020-07-15,Business insurance premium,REF96973965,100.24,0.0,174650.4
2020-07-17,2020-07-17,Business meal,REF72618030,92.43,0.0,174557.97
2020-07-19,2020-07-19,Business travel,REF73126525,479.15,0.0,174078.82
2020-07-19,2020-07-19,Coworking space rental,REF16823566,348.04,0.0,173730.78
2020-07-21,2020-07-21,Professional software license,REF43578950,124.43,0.0,173606.35
2020-07-22,2020-07-22,Accounting expense,REF86957153,169.82,0.0,173436.53
2020-07-27,2020-07-27,Business meal,REF53677597,208.51,0.0,173228.02
2020-07-29,2020-07-29,Accounting expense,REF24481834,142.31,0.0,173085.71
2020-07-31,2020-07-31,Business meal,REF75893466,210.21,0.0,172875.5
2020-08-01,2020-08-01,Marketing expenses,REF70563608,261.54,0.0,172613.96
2020-08-03,2020-08-03,Accounting expense,REF97396741,164.96,0.0,172449.0
2020-08-06,2020-08-06,Accounting expense,REF61782778,157.43,0.0,172291.57
2020-08-07,2020-08-07,Coworking space rental,REF97924237,233.5,0.0,172058.07
2020-08-12,2020-08-12,Business travel,REF59665022,328.34,0.0,171729.73
2020-08-15,2020-08-15,"Project payment - Williams, Martinez and Smith",REF77188776,0.0,642.57,172372.3
2020-08-15,2020-08-15,"Invoice payment - Christian, Morris and Weaver",REF30320746,0.0,684.35,173056.65
2020-08-15,2020-08-15,Business insurance premium,REF48055083,109.05,0.0,172947.6
2020-08-15,2020-08-15,Payment from Campbell Inc,REF72434521,0.0,938.79,173886.39
2020-08-15,2020-08-15,Project payment - Freeman PLC,REF74018977,0.0,381.13,174267.52
2020-08-15,2020-08-15,Invoice payment - Shannon PLC,REF95491126,0.0,672.99,174940.51
2020-08-15,2020-08-15,"Payment from Franklin, Smith and Farrell",REF59348423,0.0,1350.07,176290.58
2020-08-21,2020-08-21,Professional software license,REF33126750,143.64,0.0,176146.94
2020-08-27,2020-08-27,Training/conference,REF47910720,49.26,0.0,176097.68
2020-08-30,2020-08-30,Business travel,REF59599421,220.85,0.0,175876.83
2020-09-01,2020-09-01,Business travel,REF76242984,546.83,0.0,175330.0
2020-09-09,2020-09-09,Business travel,REF86350781,542.01,0.0,174787.99
2020-09-12,2020-09-12,Coworking space rental,REF48684417,423.12,0.0,174364.87
2020-09-13,2020-09-13,Equipment purchase,REF79109161,165.53,0.0,174199.34
2020-09-15,2020-09-15,"Project payment - Luna, Quinn and Wilson",REF83455926,0.0,718.6,174917.94
2020-09-15,2020-09-15,Equipment purchase,REF49026937,155.86,0.0,174762.08
2020-09-15,2020-09-15,Invoice payment - Shannon PLC,REF81432102,0.0,959.91,175721.99
2020-09-15,2020-09-15,"Payment from Franklin, Smith and Farrell",REF17986243,0.0,1269.64,176991.63
2020-09-15,2020-09-15,Project payment - Campbell Inc,REF64349504,0.0,1169.74,178161.37
2020-09-15,2020-09-15,"Invoice payment - Williams, Martinez and Smith",REF79954788,0.0,1061.74,179223.11
2020-09-15,2020-09-15,"Project payment - Christian, Morris and Weaver",REF16502914,0.0,1094.99,180318.1
2020-09-15,2020-09-15,Business insurance premium,REF71862659,163.96,0.0,180154.14
2020-09-15,2020-09-15,Invoice payment - Smith Inc,REF41093530,0.0,702.04,180856.18
2020-09-21,2020-09-21,Professional software license,REF72060447,214.09,0.0,180642.09
2020-09-21,2020-09-21,Coworking space rental,REF35405575,394.75,0.0,180247.34
2020-09-24,2020-09-24,Accounting expense,REF30777406,184.2,0.0,180063.14
2020-09-25,2020-09-25,Business meal,REF37683887,365.63,0.0,179697.51
2020-09-26,2020-09-26,Business travel,REF30952345,150.2,0.0,179547.31
2020-09-28,2020-09-28,Business travel,REF15142218,246.86,0.0,179300.45
2020-10-01,2020-10-01,Marketing expenses,REF53552227,376.9,0.0,178923.55
2020-10-06,2020-10-06,Equipment purchase,REF76611946,246.59,0.0,178676.96
2020-10-07,2020-10-07,Accounting expense,REF70645245,202.82,0.0,178474.14
2020-10-15,2020-10-15,"Invoice payment - Christian, Morris and Weaver",REF11324871,0.0,1001.02,179475.16
2020-10-15,2020-10-15,"Payment from Luna, Quinn and Wilson",REF34125426,0.0,836.74,180311.9
2020-10-15,2020-10-15,"Service payment - Franklin, Smith and Farrell",REF78818712,0.0,1560.91,181872.81
2020-10-15,2020-10-15,"Invoice payment - Williams, Martinez and Smith",REF34111991,0.0,1173.23,183046.04
2020-10-15,2020-10-15,Payment from Freeman PLC,REF41212570,0.0,628.1,183674.14
2020-10-15,2020-10-15,Business insurance premium,REF25556252,170.44,0.0,183503.7
2020-10-15,2020-10-15,Project payment - Smith Inc,REF98522807,0.0,957.96,184461.66
2020-10-15,2020-10-15,Invoice payment - Campbell Inc,REF20015951,0.0,1564.68,186026.34
2020-10-15,2020-10-15,Invoice payment - Shannon PLC,REF23930660,0.0,1061.19,187087.53
2020-10-21,2020-10-21,Professional software license,REF96028743,210.6,0.0,186876.93
2020-10-23,2020-10-23,Business travel,REF93675451,333.2,0.0,186543.73
2020-10-24,2020-10-24,Accounting expense,REF74118034,302.69,0.0,186241.04
2020-10-26,2020-10-26,Marketing expenses,REF28340212,472.97,0.0,185768.07
2020-11-02,2020-11-02,Business travel,REF43974232,310.0,0.0,185458.07
2020-11-07,2020-11-07,Business meal,REF65499911,124.08,0.0,185333.99
2020-11-14,2020-11-14,Business travel,REF34684435,502.25,0.0,184831.74
2020-11-14,2020-11-14,Business meal,REF43569129,398.57,0.0,184433.17
2020-11-14,2020-11-14,Coworking space rental,REF32228743,274.97,0.0,184158.2
2020-11-15,2020-11-15,Project payment - Freeman PLC,REF48418923,0.0,470.63,184628.83
2020-11-15,2020-11-15,Payment from Campbell Inc,REF39561753,0.0,1156.26,185785.09
2020-11-15,2020-11-15,Service payment - Shannon PLC,REF25925699,0.0,681.28,186466.37
2020-11-15,2020-11-15,"Invoice payment - Christian, Morris and Weaver",REF77357601,0.0,1050.16,187516.53
2020-11-15,2020-11-15,"Service payment - Luna, Quinn and Wilson",REF87292167,0.0,705.38,188221.91
2020-11-15,2020-11-15,"Payment from Franklin, Smith and Farrell",REF59546784,0.0,1397.72,189619.63
2020-11-15,2020-11-15,Business insurance premium,REF54674463,161.56,0.0,189458.07
2020-11-15,2020-11-15,Invoice payment - Smith Inc,REF16078611,0.0,703.16,190161.23
2020-11-15,2020-11-15,"Invoice payment - Williams, Martinez and Smith",REF88498187,0.0,925.4,191086.63
2020-11-16,2020-11-16,Business meal,REF76826974,408.86,0.0,190677.77
2020-11-21,2020-11-21,Professional software license,REF43362987,194.6,0.0,190483.17
2020-11-22,2020-11-22,Marketing expenses,REF11187929,216.44,0.0,190266.73
2020-11-24,2020-11-24,Training/conference,REF30269582,123.4,0.0,190143.33
2020-11-25,2020-11-25,Equipment purchase,REF49499775,181.14,0.0,189962.19
2020-12-10,2020-12-10,Marketing expenses,REF49387903,332.51,0.0,189629.68
2020-12-11,2020-12-11,Accounting expense,REF80193760,218.13,0.0,189411.55
2020-12-14,2020-12-14,Business meal,REF50280075,315.62,0.0,189095.93
2020-12-15,2020-12-15,Payment from Campbell Inc,REF21164400,0.0,1033.17,190129.1
2020-12-15,2020-12-15,"Invoice payment - Luna, Quinn and Wilson",REF50935831,0.0,435.12,190564.22
2020-12-15,2020-12-15,"Invoice payment - Franklin, Smith and Farrell",REF16918876,0.0,1004.44,191568.66
2020-12-15,2020-12-15,"Service payment - Christian, Morris and Weaver",REF85318582,0.0,640.7,192209.36
2020-12-15,2020-12-15,Business insurance premium,REF61757016,119.27,0.0,192090.09
2020-12-15,2020-12-15,Service payment - Freeman PLC,REF29998897,0.0,405.7,192495.79
2020-12-15,2020-12-15,Invoice payment - Smith Inc,REF55760186,0.0,714.69,193210.48
2020-12-15,2020-12-15,"Payment from Williams, Martinez and Smith",REF21093899,0.0,963.7,194174.18
2020-12-15,2020-12-15,Project payment - Shannon PLC,REF68679024,0.0,655.02,194829.2
2020-12-17,2020-12-17,Training/conference,REF60774833,208.47,0.0,194620.73
2020-12-17,2020-12-17,Accounting expense,REF99027420,250.48,0.0,194370.25
2020-12-20,2020-12-20,Business travel,REF57920630,422.37,0.0,193947.88
2020-12-21,2020-12-21,Professional software license,REF43389960,198.93,0.0,193748.95
2020-12-29,2020-12-29,Coworking space rental,REF49626062,392.56,0.0,193356.39
2020-12-31,2020-12-31,Business meal,REF10374514,275.62,0.0,193080.77
2021-01-02,2021-01-02,Equipment purchase,REF56918929,153.22,0.0,192927.55
2021-01-02,2021-01-02,Business meal,REF73080932,209.71,0.0,192717.84
2021-01-06,2021-01-06,Business meal,REF90109494,496.55,0.0,192221.29
2021-01-13,2021-01-13,Business travel,REF30312290,511.62,0.0,191709.67
2021-01-15,2021-01-15,Business insurance premium,REF28986043,171.56,0.0,191538.11
2021-01-15,2021-01-15,Invoice payment - Smith Inc,REF89745385,0.0,891.01,192429.12
2021-01-15,2021-01-15,Project payment - Campbell Inc,REF73477711,0.0,738.11,193167.23
2021-01-15,2021-01-15,"Project payment - Williams, Martinez and Smith",REF62509577,0.0,1310.51,194477.74
2021-01-15,2021-01-15,"Project payment - Luna, Quinn and Wilson",REF61496909,0.0,836.93,195314.67
2021-01-15,2021-01-15,Payment from Freeman PLC,REF10117191,0.0,515.72,195830.39
2021-01-15,2021-01-15,"Service payment - Christian, Morris and Weaver",REF99870914,0.0,947.63,196778.02
2021-01-15,2021-01-15,Project payment - Shannon PLC,REF90021859,0.0,788.59,197566.61
2021-01-15,2021-01-15,"Project payment - Franklin, Smith and Farrell",REF37925074,0.0,1746.75,199313.36
2021-01-20,2021-01-20,Business travel,REF33194438,544.44,0.0,198768.92
2021-01-21,2021-01-21,Professional software license,REF58411304,232.73,0.0,198536.19
2021-01-21,2021-01-21,Business travel,REF62045179,470.85,0.0,198065.34
2021-01-22,2021-01-22,Accounting expense,REF28377435,311.98,0.0,197753.36
2021-01-24,2021-01-24,Business meal,REF35812954,319.02,0.0,197434.34
2021-01-27,2021-01-27,Marketing expenses,REF52357809,334.79,0.0,197099.55
2021-02-02,2021-02-02,Accounting expense,REF52827211,377.31,0.0,196722.24
2021-02-03,2021-02-03,Equipment purchase,REF65758744,196.94,0.0,196525.3
2021-02-04,2021-02-04,Business travel,REF30520300,251.26,0.0,196274.04
2021-02-07,2021-02-07,Business travel,REF41252627,420.6,0.0,195853.44
2021-02-08,2021-02-08,Coworking space rental,REF69267211,381.48,0.0,195471.96
2021-02-12,2021-02-12,Training/conference,REF96566245,188.67,0.0,195283.29
2021-02-15,2021-02-15,"Project payment - Luna, Quinn and Wilson",REF68533611,0.0,560.47,195843.76
2021-02-15,2021-02-15,Payment from Smith Inc,REF42448010,0.0,841.46,196685.22
2021-02-15,2021-02-15,"Service payment - Christian, Morris and Weaver",REF90064800,0.0,689.26,197374.48
2021-02-15,2021-02-15,Payment from Freeman PLC,REF19028565,0.0,527.35,197901.83
2021-02-15,2021-02-15,"Service payment - Williams, Martinez and Smith",REF24715667,0.0,924.16,198825.99
2021-02-15,2021-02-15,Payment from Shannon PLC,REF48708799,0.0,642.37,199468.36
2021-02-15,2021-02-15,Service payment - Campbell Inc,REF50117297,0.0,1105.24,200573.6
2021-02-15,2021-02-15,"Service payment - Franklin, Smith and Farrell",REF65045672,0.0,1189.59,201763.19
2021-02-15,2021-02-15,Business insurance premium,REF35560341,147.64,0.0,201615.55
2021-02-19,2021-02-19,Equipment purchase,REF81563760,242.15,0.0,201373.4
2021-02-21,2021-02-21,Professional software license,REF56053536,216.45,0.0,201156.95
2021-02-22,2021-02-22,Business travel,REF50231240,475.39,0.0,200681.56
2021-02-24,2021-02-24,Equipment purchase,REF87860001,83.94,0.0,200597.62
2021-02-28,2021-02-28,Business travel,REF26085217,494.82,0.0,200102.8
2021-03-01,2021-03-01,Business travel,REF84887137,424.09,0.0,199678.71
2021-03-03,2021-03-03,Training/conference,REF90499012,155.37,0.0,199523.34
2021-03-12,2021-03-12,Business travel,REF82414072,675.38,0.0,198847.96
2021-03-15,2021-03-15,Business insurance premium,REF42499405,152.13,0.0,198695.83
2021-03-15,2021-03-15,"Invoice payment - Williams, Martinez and Smith",REF14122776,0.0,972.59,199668.42
2021-03-15,2021-03-15,Project payment - Campbell Inc,REF33880138,0.0,962.09,200630.51
2021-03-15,2021-03-15,"Service payment - Luna, Quinn and Wilson",REF31374420,0.0,627.78,201258.29
2021-03-15,2021-03-15,"Payment from Franklin, Smith and Farrell",REF57786611,0.0,1180.53,202438.82
2021-03-15,2021-03-15,Payment from Smith Inc,REF42228979,0.0,798.56,203237.38
2021-03-15,2021-03-15,Project payment - Freeman PLC,REF66548034,0.0,554.27,203791.65
2021-03-15,2021-03-15,Payment from Shannon PLC,REF40550365,0.0,651.57,204443.22
2021-03-15,2021-03-15,"Payment from Christian, Morris and Weaver",REF44564465,0.0,901.81,205345.03
2021-03-16,2021-03-16,Training/conference,REF97424211,258.34,0.0,205086.69
2021-03-19,2021-03-19,Business travel,REF48837599,656.57,0.0,204430.12
2021-03-21,2021-03-21,Professional software license,REF14226570,193.79,0.0,204236.33
2021-03-27,2021-03-27,Training/conference,REF47169954,155.52,0.0,204080.81
2021-03-29,2021-03-29,Business travel,REF44116359,291.37,0.0,203789.44
2021-03-29,2021-03-29,Accounting expense,REF36415571,208.69,0.0,203580.75
2021-04-05,2021-04-05,Accounting expense,REF97800083,225.27,0.0,203355.48
2021-04-11,2021-04-11,Business travel,REF98930047,431.82,0.0,202923.66
2021-04-13,2021-04-13,Accounting expense,REF66308191,183.1,0.0,202740.56
2021-04-14,2021-04-14,Accounting expense,REF84932858,138.42,0.0,202602.14
2021-04-15,2021-04-15,"Payment from Luna, Quinn and Wilson",REF44326369,0.0,464.1,203066.24
2021-04-15,2021-04-15,Project payment - Shannon PLC,REF16745096,0.0,590.16,203656.4
2021-04-15,2021-04-15,"Invoice payment - Williams, Martinez and Smith",REF34199364,0.0,794.2,204450.6
2021-04-15,2021-04-15,Service payment - Smith Inc,REF19925350,0.0,781.66,205232.26
2021-04-15,2021-04-15,"Invoice payment - Christian, Morris and Weaver",REF62728608,0.0,624.48,205856.74
2021-04-15,2021-04-15,Business insurance premium,REF11248139,144.03,0.0,205712.71
2021-04-15,2021-04-15,Payment from Campbell Inc,REF16199836,0.0,1307.0,207019.71
2021-04-15,2021-04-15,"Service payment - Franklin, Smith and Farrell",REF17357382,0.0,1183.93,208203.64
2021-04-15,2021-04-15,Payment from Freeman PLC,REF61739798,0.0,512.57,208716.21
2021-04-18,2021-04-18,Business meal,REF86612919,341.65,0.0,208374.56
2021-04-21,2021-04-21,Accounting expense,REF89643442,243.4,0.0,208131.16
2021-04-21,2021-04-21,Professional software license,REF73248188,189.59,0.0,207941.57
2021-04-22,2021-04-22,Equipment purchase,REF76831989,94.67,0.0,207846.9
2021-04-23,2021-04-23,Business meal,REF78664970,206.87,0.0,207640.03
2021-04-25,2021-04-25,Training/conference,REF44253226,296.02,0.0,207344.01
2021-04-27,2021-04-27,Training/conference,REF17154162,134.99,0.0,207209.02
2021-05-03,2021-05-03,Equipment purchase,REF89464861,162.98,0.0,207046.04
2021-05-03,2021-05-03,Accounting expense,REF81974042,121.85,0.0,206924.19
2021-05-05,2021-05-05,Accounting expense,REF91078623,189.24,0.0,206734.95
2021-05-09,2021-05-09,Marketing expenses,REF77973398,287.43,0.0,206447.52
2021-05-12,2021-05-12,Training/conference,REF88184214,165.03,0.0,206282.49
2021-05-14,2021-05-14,Equipment purchase,REF38970477,136.19,0.0,206146.3
2021-05-15,2021-05-15,Invoice payment - Smith Inc,REF86593454,0.0,401.13,206547.43
2021-05-15,2021-05-15,"Payment from Williams, Martinez and Smith",REF41017153,0.0,1037.65,207585.08
2021-05-15,2021-05-15,Business insurance premium,REF43805166,115.74,0.0,207469.34
2021-05-15,2021-05-15,Invoice payment - Campbell Inc,REF44876073,0.0,883.05,208352.39
2021-05-15,2021-05-15,Invoice payment - Freeman PLC,REF81890790,0.0,578.05,208930.44
2021-05-15,2021-05-15,"Service payment - Luna, Quinn and Wilson",REF17495306,0.0,528.59,209459.03
2021-05-15,2021-05-15,"Invoice payment - Christian, Morris and Weaver",REF31085299,0.0,853.55,210312.58
2021-05-15,2021-05-15,"Invoice payment - Franklin, Smith and Farrell",REF77581327,0.0,1020.9,211333.48
2021-05-15,2021-05-15,Project payment - Shannon PLC,REF54054462,0.0,828.88,212162.36
2021-05-18,2021-05-18,Business meal,REF57461393,204.14,0.0,211958.22
2021-05-19,2021-05-19,Accounting expense,REF28027549,228.27,0.0,211729.95
2021-05-21,2021-05-21,Professional software license,REF18607456,166.37,0.0,211563.58
2021-05-23,2021-05-23,Business meal,REF43676761,243.49,0.0,211320.09
2021-05-24,2021-05-24,Business travel,REF86919035,430.94,0.0,210889.15
2021-05-25,2021-05-25,Marketing expenses,REF55341628,244.64,0.0,210644.51
2021-05-26,2021-05-26,Business meal,REF56559941,306.82,0.0,210337.69
2021-06-01,2021-06-01,Business meal,REF19301098,349.76,0.0,209987.93
2021-06-01,2021-06-01,Training/conference,REF55343374,184.08,0.0,209803.85
2021-06-15,2021-06-15,"Project payment - Franklin, Smith and Farrell",REF15751803,0.0,906.54,210710.39
2021-06-15,2021-06-15,Project payment - Campbell Inc,REF57027918,0.0,844.48,211554.87
2021-06-15,2021-06-15,Service payment - Smith Inc,REF46006587,0.0,445.71,212000.58
2021-06-15,2021-06-15,Payment from Shannon PLC,REF89038520,0.0,756.48,212757.06
2021-06-15,2021-06-15,"Payment from Christian, Morris and Weaver",REF92084331,0.0,714.85,213471.91
2021-06-15,2021-06-15,Business insurance premium,REF50169792,111.27,0.0,213360.64
2021-06-17,2021-06-17,Business meal,REF87959985,133.62,0.0,213227.02
2021-06-21,2021-06-21,Professional software license,REF25606936,152.57,0.0,213074.45
2021-06-22,2021-06-22,Marketing expenses,REF28169824,153.56,0.0,212920.89
2021-06-22,2021-06-22,Business meal,REF14560490,155.21,0.0,212765.68
2021-06-23,2021-06-23,Business travel,REF65668122,367.7,0.0,212397.98
2021-06-26,2021-06-26,Equipment purchase,REF29623692,161.86,0.0,212236.12
2021-07-02,2021-07-02,Marketing expenses,REF97053965,265.54,0.0,211970.58
2021-07-02,2021-07-02,Business meal,REF57166715,197.86,0.0,211772.72
2021-07-09,2021-07-09,Business meal,REF78032157,123.03,0.0,211649.69
2021-07-12,2021-07-12,Accounting expense,REF58978225,149.47,0.0,211500.22
2021-07-15,2021-07-15,"Payment from Franklin, Smith and Farrell",REF39000776,0.0,588.92,212089.14
2021-07-15,2021-07-15,Payment from Smith Inc,REF84241741,0.0,460.13,212549.27
2021-07-15,2021-07-15,Invoice payment - Freeman PLC,REF83876975,0.0,249.96,212799.23
2021-07-15,2021-07-15,"Project payment - Christian, Morris and Weaver",REF95061381,0.0,816.92,213616.15
2021-07-15,2021-07-15,Project payment - Shannon PLC,REF15297523,0.0,492.68,214108.83
2021-07-15,2021-07-15,"Service payment - Luna, Quinn and Wilson",REF46475833,0.0,487.69,214596.52
2021-07-15,2021-07-15,Invoice payment - Campbell Inc,REF49098270,0.0,954.68,215551.2
2021-07-15,2021-07-15,Equipment purchase,REF95308484,56.23,0.0,215494.97
2021-07-15,2021-07-15,Business insurance premium,REF81748148,97.45,0.0,215397.52
2021-07-15,2021-07-15,"Project payment - Williams, Martinez and Smith",REF70287824,0.0,629.05,216026.57
2021-07-18,2021-07-18,Accounting expense,REF34208545,162.75,0.0,215863.82
2021-07-21,2021-07-21,Professional software license,REF13778978,134.24,0.0,215729.58
2021-07-22,2021-07-22,Coworking space rental,REF12195717,248.03,0.0,215481.55
2021-07-23,2021-07-23,Business travel,REF16616851,344.59,0.0,215136.96
2021-07-26,2021-07-26,Business travel,REF23727356,294.21,0.0,214842.75
2021-07-31,2021-07-31,Coworking space rental,REF51796401,150.98,0.0,214691.77
2021-08-02,2021-08-02,Coworking space rental,REF82549705,297.83,0.0,214393.94
2021-08-05,2021-08-05,Marketing expenses,REF35935017,128.08,0.0,214265.86
2021-08-05,2021-08-05,Coworking space rental,REF38819611,165.63,0.0,214100.23
2021-08-11,2021-08-11,Training/conference,REF83777848,238.64,0.0,213861.59
2021-08-11,2021-08-11,Business travel,REF20444967,339.33,0.0,213522.26
2021-08-15,2021-08-15,"Project payment - Christian, Morris and Weaver",REF46927801,0.0,732.58,214254.84
2021-08-15,2021-08-15,Invoice payment - Campbell Inc,REF57660496,0.0,929.11,215183.95
2021-08-15,2021-08-15,Project payment - Freeman PLC,REF60952547,0.0,423.93,215607.88
2021-08-15,2021-08-15,"Invoice payment - Luna, Quinn and Wilson",REF14186167,0.0,585.38,216193.26
2021-08-15,2021-08-15,Invoice payment - Smith Inc,REF89042690,0.0,782.67,216975.93
2021-08-15,2021-08-15,Invoice payment - Shannon PLC,REF49792990,0.0,487.51,217463.44
2021-08-15,2021-08-15,Business insurance premium,REF27682824,109.6,0.0,217353.84
2021-08-21,2021-08-21,Professional software license,REF57461825,148.88,0.0,217204.96
2021-08-25,2021-08-25,Business travel,REF46176152,372.74,0.0,216832.22
2021-08-28,2021-08-28,Business travel,REF88442087,276.93,0.0,216555.29
2021-08-29,2021-08-29,Training/conference,REF99270126,113.83,0.0,216441.46
2021-08-31,2021-08-31,Business meal,REF21076896,195.82,0.0,216245.64
2021-09-04,2021-09-04,Accounting expense,REF98457655,263.59,0.0,215982.05
2021-09-06,2021-09-06,Business travel,REF65563532,367.47,0.0,215614.58
2021-09-09,2021-09-09,Business meal,REF25836526,325.53,0.0,215289.05
2021-09-15,2021-09-15,Project payment - Shannon PLC,REF80419188,0.0,848.76,216137.81
2021-09-15,2021-09-15,"Service payment - Franklin, Smith and Farrell",REF58053298,0.0,1660.44,217798.25
2021-09-15,2021-09-15,Service payment - Smith Inc,REF94364497,0.0,880.86,218679.11
2021-09-15,2021-09-15,Payment from Freeman PLC,REF31816953,0.0,555.6,219234.71
2021-09-15,2021-09-15,"Invoice payment - Christian, Morris and Weaver",REF97470615,0.0,825.24,220059.95
2021-09-15,2021-09-15,Service payment - Campbell Inc,REF74185694,0.0,1041.0,221100.95
2021-09-15,2021-09-15,"Project payment - Williams, Martinez and Smith",REF47125112,0.0,1003.37,222104.32
2021-09-15,2021-09-15,"Payment from Luna, Quinn and Wilson",REF15934016,0.0,791.56,222895.88
2021-09-15,2021-09-15,Business insurance premium,REF40629867,153.7,0.0,222742.18
2021-09-21,2021-09-21,Professional software license,REF76844110,230.71,0.0,222511.47
2021-09-24,2021-09-24,Accounting expense,REF60086031,177.81,0.0,222333.66
2021-09-27,2021-09-27,Marketing expenses,REF63143227,263.88,0.0,222069.78
2021-09-27,2021-09-27,Training/conference,REF38848004,176.11,0.0,221893.67
2021-09-30,2021-09-30,Business travel,REF58471853,335.63,0.0,221558.04
2021-10-02,2021-10-02,Business travel,REF64694451,492.92,0.0,221065.12
2021-10-03,2021-10-03,Equipment purchase,REF53270089,272.31,0.0,220792.81
2021-10-04,2021-10-04,Equipment purchase,REF35621015,261.14,0.0,220531.67
2021-10-07,2021-10-07,Marketing expenses,REF50338331,252.45,0.0,220279.22
2021-10-08,2021-10-08,Equipment purchase,REF20396444,264.68,0.0,220014.54
2021-10-15,2021-10-15,"Project payment - Luna, Quinn and Wilson",REF29432559,0.0,528.62,220543.16
2021-10-15,2021-10-15,"Payment from Franklin, Smith and Farrell",REF46103650,0.0,1377.18,221920.34
2021-10-15,2021-10-15,Project payment - Campbell Inc,REF37545190,0.0,995.16,222915.5
2021-10-15,2021-10-15,"Payment from Christian, Morris and Weaver",REF48659347,0.0,838.09,223753.59
2021-10-15,2021-10-15,Service payment - Shannon PLC,REF42071648,0.0,997.08,224750.67
2021-10-15,2021-10-15,Project payment - Freeman PLC,REF94384689,0.0,527.5,225278.17
2021-10-15,2021-10-15,Service payment - Smith Inc,REF94091727,0.0,836.94,226115.11
2021-10-15,2021-10-15,Business insurance premium,REF22293461,170.14,0.0,225944.97
2021-10-16,2021-10-16,Accounting expense,REF28771730,403.78,0.0,225541.19
2021-10-16,2021-10-16,Business meal,REF97311336,415.14,0.0,225126.05
2021-10-21,2021-10-21,Professional software license,REF93784377,253.78,0.0,224872.27
2021-10-23,2021-10-23,Business travel,REF56021858,304.63,0.0,224567.64
2021-11-07,2021-11-07,Business meal,REF17103567,403.23,0.0,224164.41
2021-11-08,2021-11-08,Accounting expense,REF79959071,297.2,0.0,223867.21
2021-11-12,2021-11-12,Business travel,REF45636448,403.75,0.0,223463.46
2021-11-15,2021-11-15,Business insurance premium,REF75769610,154.53,0.0,223308.93
2021-11-15,2021-11-15,"Service payment - Christian, Morris and Weaver",REF85353705,0.0,895.77,224204.7
2021-11-15,2021-11-15,Project payment - Freeman PLC,REF79703883,0.0,494.52,224699.22
2021-11-15,2021-11-15,Invoice payment - Shannon PLC,REF73113824,0.0,734.47,225433.69
2021-11-15,2021-11-15,"Invoice payment - Williams, Martinez and Smith",REF64331392,0.0,1114.66,226548.35
2021-11-15,2021-11-15,Payment from Smith Inc,REF35725467,0.0,816.73,227365.08
2021-11-15,2021-11-15,Invoice payment - Campbell Inc,REF17167869,0.0,1131.02,228496.1
2021-11-15,2021-11-15,"Service payment - Franklin, Smith and Farrell",REF24292576,0.0,1325.82,229821.92
2021-11-15,2021-11-15,"Invoice payment - Luna, Quinn and Wilson",REF76947018,0.0,715.51,230537.43
2021-11-21,2021-11-21,Professional software license,REF64562307,259.44,0.0,230277.99
2021-11-25,2021-11-25,Business meal,REF12519702,117.6,0.0,230160.39
2021-11-26,2021-11-26,Business meal,REF63661001,344.43,0.0,229815.96
2021-11-29,2021-11-29,Business travel,REF82921745,547.45,0.0,229268.51
2021-12-06,2021-12-06,Marketing expenses,REF87174086,299.79,0.0,228968.72
2021-12-07,2021-12-07,Business travel,REF95771252,354.02,0.0,228614.7
2021-12-09,2021-12-09,Business meal,REF37581501,251.82,0.0,228362.88
2021-12-14,2021-12-14,Marketing expenses,REF94282109,313.43,0.0,228049.45
2021-12-14,2021-12-14,Equipment purchase,REF94847915,138.68,0.0,227910.77
2021-12-15,2021-12-15,Payment from Freeman PLC,REF14133449,0.0,493.7,228404.47
2021-12-15,2021-12-15,Business insurance premium,REF75874523,123.51,0.0,228280.96
2021-12-15,2021-12-15,"Service payment - Franklin, Smith and Farrell",REF70176844,0.0,1320.96,229601.92
2021-12-15,2021-12-15,Invoice payment - Shannon PLC,REF59831370,0.0,701.71,230303.63
2021-12-15,2021-12-15,"Payment from Luna, Quinn and Wilson",REF85376863,0.0,513.21,230816.84
2021-12-15,2021-12-15,Service payment - Campbell Inc,REF19214632,0.0,1120.14,231936.98
2021-12-15,2021-12-15,Service payment - Smith Inc,REF87195206,0.0,500.94,232437.92
2021-12-20,2021-12-20,Coworking space rental,REF85380186,247.17,0.0,232190.75
2021-12-21,2021-12-21,Professional software license,REF11029059,150.56,0.0,232040.19
2021-12-23,2021-12-23,Accounting expense,REF65885648,229.12,0.0,231811.07
2021-12-25,2021-12-25,Business travel,REF31050860,155.09,0.0,231655.98
2021-12-29,2021-12-29,Business meal,REF10260244,144.7,0.0,231511.28
2021-12-29,2021-12-29,Marketing expenses,REF61772062,257.36,0.0,231253.92
2021-12-30,2021-12-30,Equipment purchase,REF10628934,196.67,0.0,231057.25
2022-01-01,2022-01-01,Business travel,REF38795887,727.51,0.0,230329.74
2022-01-02,2022-01-02,Accounting expense,REF86044365,188.44,0.0,230141.3
2022-01-03,2022-01-03,Business meal,REF23868156,255.16,0.0,229886.14
2022-01-04,2022-01-04,Marketing expenses,REF36003659,390.95,0.0,229495.19
2022-01-08,2022-01-08,Business meal,REF91189446,318.47,0.0,229176.72
2022-01-12,2022-01-12,Business meal,REF46027789,225.27,0.0,228951.45
2022-01-14,2022-01-14,Business meal,REF26101979,146.99,0.0,228804.46
2022-01-15,2022-01-15,Business insurance premium,REF46450701,155.27,0.0,228649.19
2022-01-15,2022-01-15,Payment from Freeman PLC,REF20921185,0.0,468.61,229117.8
2022-01-15,2022-01-15,Invoice payment - Campbell Inc,REF95445657,0.0,1075.62,230193.42
2022-01-15,2022-01-15,"Service payment - Williams, Martinez and Smith",REF24699683,0.0,1021.5,231214.92
2022-01-15,2022-01-15,"Service payment - Luna, Quinn and Wilson",REF99967200,0.0,556.45,231771.37
2022-01-15,2022-01-15,"Payment from Franklin, Smith and Farrell",REF88943572,0.0,1594.07,233365.44
2022-01-15,2022-01-15,Invoice payment - Smith Inc,REF80552413,0.0,762.26,234127.7
2022-01-15,2022-01-15,Project payment - Shannon PLC,REF65555166,0.0,1158.9,235286.6
2022-01-15,2022-01-15,"Payment from Christian, Morris and Weaver",REF91421060,0.0,1273.48,236560.08
2022-01-17,2022-01-17,Marketing expenses,REF52130844,522.5,0.0,236037.58
2022-01-21,2022-01-21,Professional software license,REF71653463,267.3,0.0,235770.28
2022-01-24,2022-01-24,Coworking space rental,REF59159072,251.69,0.0,235518.59
2022-01-30,2022-01-30,Business travel,REF51598391,558.75,0.0,234959.84
2022-02-01,2022-02-01,Equipment purchase,REF30885543,167.29,0.0,234792.55
2022-02-08,2022-02-08,Marketing expenses,REF20122262,261.55,0.0,234531.0
2022-02-09,2022-02-09,Marketing expenses,REF20883506,184.05,0.0,234346.95
2022-02-15,2022-02-15,Project payment - Freeman PLC,REF10342984,0.0,580.44,234927.39
2022-02-15,2022-02-15,"Service payment - Luna, Quinn and Wilson",REF92626786,0.0,748.63,235676.02
2022-02-15,2022-02-15,Invoice payment - Campbell Inc,REF60172411,0.0,1048.7,236724.72
2022-02-15,2022-02-15,"Project payment - Franklin, Smith and Farrell",REF72156921,0.0,1751.02,238475.74
2022-02-15,2022-02-15,Service payment - Smith Inc,REF44574460,0.0,538.65,239014.39
2022-02-15,2022-02-15,"Project payment - Williams, Martinez and Smith",REF64698929,0.0,897.56,239911.95
2022-02-15,2022-02-15,"Project payment - Christian, Morris and Weaver",REF58414755,0.0,1060.06,240972.01
2022-02-15,2022-02-15,Payment from Shannon PLC,REF66746791,0.0,863.64,241835.65
2022-02-15,2022-02-15,Business insurance premium,REF83049860,160.57,0.0,241675.08
2022-02-18,2022-02-18,Equipment purchase,REF53920786,191.6,0.0,241483.48
2022-02-21,2022-02-21,Marketing expenses,REF31473821,383.46,0.0,241100.02
2022-02-21,2022-02-21,Professional software license,REF67205319,200.28,0.0,240899.74
2022-02-26,2022-02-26,Training/conference,REF65050603,249.19,0.0,240650.55
2022-03-09,2022-03-09,Business meal,REF52411731,185.35,0.0,240465.2
2022-03-10,2022-03-10,Coworking space rental,REF70026070,285.98,0.0,240179.22
2022-03-15,2022-03-15,Business insurance premium,REF22760515,146.59,0.0,240032.63
2022-03-15,2022-03-15,"Invoice payment - Franklin, Smith and Farrell",REF81758189,0.0,1574.48,241607.11
2022-03-15,2022-03-15,Service payment - Campbell Inc,REF96610405,0.0,1130.87,242737.98
2022-03-15,2022-03-15,"Invoice payment - Williams, Martinez and Smith",REF54356221,0.0,767.2,243505.18
2022-03-15,2022-03-15,"Service payment - Christian, Morris and Weaver",REF65679468,0.0,1081.05,244586.23
2022-03-15,2022-03-15,"Project payment - Luna, Quinn and Wilson",REF51199238,0.0,665.92,245252.15
2022-03-15,2022-03-15,Project payment - Freeman PLC,REF29559023,0.0,474.86,245727.01
2022-03-15,2022-03-15,Service payment - Smith Inc,REF35523257,0.0,705.44,246432.45
2022-03-19,2022-03-19,Equipment purchase,REF82181891,151.98,0.0,246280.47
2022-03-21,2022-03-21,Professional software license,REF28853283,201.0,0.0,246079.47
2022-03-27,2022-03-27,Business travel,REF89620842,358.78,0.0,245720.69
2022-04-10,2022-04-10,Business travel,REF43509379,418.38,0.0,245302.31
2022-04-14,2022-04-14,Equipment purchase,REF89794576,184.41,0.0,245117.9
2022-04-15,2022-04-15,Service payment - Freeman PLC,REF56986739,0.0,356.28,245474.18
2022-04-15,2022-04-15,"Service payment - Christian, Morris and Weaver",REF64319908,0.0,915.29,246389.47
2022-04-15,2022-04-15,Business insurance premium,REF31086002,135.83,0.0,246253.64
2022-04-15,2022-04-15,"Service payment - Williams, Martinez and Smith",REF28085737,0.0,778.9,247032.54
2022-04-15,2022-04-15,Invoice payment - Campbell Inc,REF95864194,0.0,900.67,247933.21
2022-04-15,2022-04-15,"Service payment - Luna, Quinn and Wilson",REF19309947,0.0,674.2,248607.41
2022-04-15,2022-04-15,Invoice payment - Smith Inc,REF68644495,0.0,852.23,249459.64
2022-04-15,2022-04-15,"Project payment - Franklin, Smith and Farrell",REF92991768,0.0,1205.45,250665.09
2022-04-15,2022-04-15,Invoice payment - Shannon PLC,REF25684101,0.0,481.39,251146.48
2022-04-16,2022-04-16,Accounting expense,REF44980916,228.7,0.0,250917.78
2022-04-17,2022-04-17,Accounting expense,REF56153644,197.5,0.0,250720.28
2022-04-21,2022-04-21,Professional software license,REF67700563,179.84,0.0,250540.44
2022-04-23,2022-04-23,Marketing expenses,REF24076703,394.41,0.0,250146.03
2022-04-24,2022-04-24,Equipment purchase,REF46334076,133.17,0.0,250012.86
2022-04-30,2022-04-30,Business meal,REF63319959,149.79,0.0,249863.07
2022-05-04,2022-05-04,Business travel,REF32756984,361.98,0.0,249501.09
2022-05-09,2022-05-09,Business travel,REF72971980,307.49,0.0,249193.6
2022-05-12,2022-05-12,Marketing expenses,REF45362750,214.68,0.0,248978.92
2022-05-15,2022-05-15,Business insurance premium,REF69052559,126.64,0.0,248852.28
2022-05-15,2022-05-15,Payment from Freeman PLC,REF23868544,0.0,410.84,249263.12
2022-05-15,2022-05-15,"Payment from Williams, Martinez and Smith",REF79885324,0.0,764.4,250027.52
2022-05-15,2022-05-15,Invoice payment - Campbell Inc,REF23089767,0.0,1109.24,251136.76
2022-05-15,2022-05-15,"Payment from Franklin, Smith and Farrell",REF67035890,0.0,1276.15,252412.91
2022-05-15,2022-05-15,"Service payment - Luna, Quinn and Wilson",REF40537761,0.0,611.35,253024.26
2022-05-15,2022-05-15,"Project payment - Christian, Morris and Weaver",REF57856458,0.0,746.44,253770.7
2022-05-15,2022-05-15,Project payment - Shannon PLC,REF15551683,0.0,486.42,254257.12
2022-05-16,2022-05-16,Business travel,REF85716169,555.39,0.0,253701.73
2022-05-21,2022-05-21,Professional software license,REF70297570,180.7,0.0,253521.03
2022-05-29,2022-05-29,Business meal,REF91221916,224.65,0.0,253296.38
2022-05-29,2022-05-29,Equipment purchase,REF12633789,132.54,0.0,253163.84
2022-06-03,2022-06-03,Accounting expense,REF55523138,77.89,0.0,253085.95
2022-06-04,2022-06-04,Training/conference,REF76879707,175.85,0.0,252910.1
2022-06-04,2022-06-04,Business travel,REF38193917,475.61,0.0,252434.49
2022-06-13,2022-06-13,Marketing expenses,REF67920299,234.87,0.0,252199.62
2022-06-15,2022-06-15,"Invoice payment - Williams, Martinez and Smith",REF23055602,0.0,641.26,252840.88
2022-06-15,2022-06-15,"Service payment - Franklin, Smith and Farrell",REF76718873,0.0,1087.32,253928.2
2022-06-15,2022-06-15,"Service payment - Luna, Quinn and Wilson",REF53046251,0.0,550.31,254478.51
2022-06-15,2022-06-15,Payment from Smith Inc,REF93779328,0.0,391.15,254869.66
2022-06-15,2022-06-15,"Payment from Christian, Morris and Weaver",REF85426245,0.0,736.59,255606.25
2022-06-15,2022-06-15,Project payment - Freeman PLC,REF28292171,0.0,440.09,256046.34
2022-06-15,2022-06-15,Service payment - Shannon PLC,REF54468538,0.0,539.17,256585.51
2022-06-15,2022-06-15,Business insurance premium,REF43911445,112.0,0.0,256473.51
2022-06-20,2022-06-20,Business travel,REF37871796,411.44,0.0,256062.07
2022-06-21,2022-06-21,Professional software license,REF88773073,170.97,0.0,255891.1
2022-06-24,2022-06-24,Coworking space rental,REF70618552,172.18,0.0,255718.92
2022-06-24,2022-06-24,Equipment purchase,REF78097778,110.39,0.0,255608.53
2022-06-29,2022-06-29,Business meal,REF46649810,165.75,0.0,255442.78
2022-06-30,2022-06-30,Business travel,REF84903589,405.06,0.0,255037.72
2022-07-02,2022-07-02,Marketing expenses,REF87472590,223.82,0.0,254813.9
2022-07-03,2022-07-03,Business travel,REF44130950,212.1,0.0,254601.8
2022-07-04,2022-07-04,Business travel,REF51501814,184.55,0.0,254417.25
2022-07-05,2022-07-05,Marketing expenses,REF75859059,286.48,0.0,254130.77
2022-07-07,2022-07-07,Marketing expenses,REF31919560,223.85,0.0,253906.92
2022-07-08,2022-07-08,Business meal,REF72542261,222.49,0.0,253684.43
2022-07-09,2022-07-09,Business travel,REF95444887,311.47,0.0,253372.96
2022-07-10,2022-07-10,Coworking space rental,REF22142965,123.8,0.0,253249.16
2022-07-12,2022-07-12,Training/conference,REF30601604,98.54,0.0,253150.62
2022-07-14,2022-07-14,Business meal,REF23115689,81.5,0.0,253069.12
2022-07-15,2022-07-15,Business insurance premium,REF29873647,99.14,0.0,252969.98
2022-07-15,2022-07-15,Payment from Smith Inc,REF35318281,0.0,543.91,253513.89
2022-07-15,2022-07-15,"Invoice payment - Franklin, Smith and Farrell",REF32623474,0.0,946.04,254459.93
2022-07-15,2022-07-15,"Project payment - Williams, Martinez and Smith",REF31558520,0.0,888.67,255348.6
2022-07-15,2022-07-15,"Service payment - Christian, Morris and Weaver",REF99379049,0.0,476.26,255824.86
2022-07-15,2022-07-15,Payment from Freeman PLC,REF22001186,0.0,361.62,256186.48
2022-07-15,2022-07-15,Service payment - Campbell Inc,REF85802904,0.0,854.24,257040.72
2022-07-15,2022-07-15,Invoice payment - Shannon PLC,REF74622533,0.0,635.24,257675.96
2022-07-15,2022-07-15,"Project payment - Luna, Quinn and Wilson",REF49575042,0.0,458.05,258134.01
2022-07-18,2022-07-18,Business travel,REF45575831,341.95,0.0,257792.06
2022-07-19,2022-07-19,Business travel,REF56186495,459.41,0.0,257332.65
2022-07-21,2022-07-21,Professional software license,REF78793218,131.03,0.0,257201.62
2022-07-22,2022-07-22,Accounting expense,REF46309600,151.39,0.0,257050.23
2022-07-22,2022-07-22,Equipment purchase,REF53887501,88.91,0.0,256961.32
2022-07-23,2022-07-23,Business meal,REF72256513,245.02,0.0,256716.3
2022-07-26,2022-07-26,Coworking space rental,REF84506526,228.68,0.0,256487.62
2022-08-04,2022-08-04,Marketing expenses,REF72274803,307.57,0.0,256180.05
2022-08-15,2022-08-15,"Project payment - Christian, Morris and Weaver",REF62154232,0.0,789.36,256969.41
2022-08-15,2022-08-15,Invoice payment - Shannon PLC,REF22668111,0.0,515.54,257484.95
2022-08-15,2022-08-15,Project payment - Campbell Inc,REF71488367,0.0,869.45,258354.4
2022-08-15,2022-08-15,Project payment - Freeman PLC,REF36174536,0.0,328.77,258683.17
2022-08-15,2022-08-15,"Project payment - Williams, Martinez and Smith",REF66997241,0.0,608.11,259291.28
2022-08-15,2022-08-15,"Invoice payment - Luna, Quinn and Wilson",REF47844578,0.0,287.85,259579.13
2022-08-15,2022-08-15,Business insurance premium,REF39691115,120.03,0.0,259459.1
2022-08-15,2022-08-15,"Project payment - Franklin, Smith and Farrell",REF41751627,0.0,840.05,260299.15
2022-08-18,2022-08-18,Accounting expense,REF75566335,94.66,0.0,260204.49
2022-08-20,2022-08-20,Business travel,REF93197611,317.14,0.0,259887.35
2022-08-20,2022-08-20,Accounting expense,REF77956089,184.22,0.0,259703.13
2022-08-21,2022-08-21,Professional software license,REF70014005,125.51,0.0,259577.62
2022-08-21,2022-08-21,Equipment purchase,REF80840258,129.08,0.0,259448.54
2022-08-28,2022-08-28,Business meal,REF40122772,56.73,0.0,259391.81
2022-08-29,2022-08-29,Training/conference,REF63062547,85.52,0.0,259306.29
2022-08-31,2022-08-31,Business travel,REF99404902,204.89,0.0,259101.4
2022-09-04,2022-09-04,Training/conference,REF22066268,160.65,0.0,258940.75
2022-09-15,2022-09-15,Project payment - Smith Inc,REF63436741,0.0,728.25,259669.0
2022-09-15,2022-09-15,Business insurance premium,REF39164863,157.99,0.0,259511.01
2022-09-15,2022-09-15,"Project payment - Luna, Quinn and Wilson",REF59201627,0.0,720.55,260231.56
2022-09-15,2022-09-15,Project payment - Freeman PLC,REF23976464,0.0,489.74,260721.3
2022-09-15,2022-09-15,"Service payment - Williams, Martinez and Smith",REF61705954,0.0,872.05,261593.35
2022-09-15,2022-09-15,Service payment - Shannon PLC,REF98984897,0.0,798.13,262391.48
2022-09-15,2022-09-15,"Service payment - Christian, Morris and Weaver",REF23011871,0.0,972.3,263363.78
2022-09-15,2022-09-15,"Payment from Franklin, Smith and Farrell",REF27299154,0.0,1282.83,264646.61
2022-09-15,2022-09-15,Payment from Campbell Inc,REF69437883,0.0,1260.17,265906.78
2022-09-21,2022-09-21,Professional software license,REF66752373,229.03,0.0,265677.75
2022-09-23,2022-09-23,Marketing expenses,REF94526663,286.82,0.0,265390.93
2022-09-23,2022-09-23,Business travel,REF38078814,413.5,0.0,264977.43
2022-09-24,2022-09-24,Marketing expenses,REF17528748,135.54,0.0,264841.89
2022-09-26,2022-09-26,Marketing expenses,REF17572329,285.78,0.0,264556.11
2022-09-30,2022-09-30,Accounting expense,REF33264891,34.42,0.0,264521.69
2022-09-30,2022-09-30,Training/conference,REF70077765,234.26,0.0,264287.43
2022-10-07,2022-10-07,Training/conference,REF84549459,229.27,0.0,264058.16
2022-10-08,2022-10-08,Training/conference,REF22124626,248.56,0.0,263809.6
2022-10-15,2022-10-15,Invoice payment - Campbell Inc,REF25833643,0.0,1069.33,264878.93
2022-10-15,2022-10-15,Service payment - Freeman PLC,REF51689066,0.0,613.92,265492.85
2022-10-15,2022-10-15,"Service payment - Williams, Martinez and Smith",REF72889669,0.0,793.3,266286.15
2022-10-15,2022-10-15,Service payment - Smith Inc,REF68444471,0.0,728.88,267015.03
2022-10-15,2022-10-15,"Payment from Franklin, Smith and Farrell",REF26470654,0.0,1196.33,268211.36
2022-10-15,2022-10-15,"Service payment - Christian, Morris and Weaver",REF13523929,0.0,1094.08,269305.44
2022-10-15,2022-10-15,Business insurance premium,REF75784672,162.8,0.0,269142.64
2022-10-15,2022-10-15,"Project payment - Luna, Quinn and Wilson",REF31236022,0.0,784.99,269927.63
2022-10-15,2022-10-15,Service payment - Shannon PLC,REF80416727,0.0,874.13,270801.76
2022-10-21,2022-10-21,Professional software license,REF48906292,218.58,0.0,270583.18
2022-10-21,2022-10-21,Business meal,REF87898138,399.65,0.0,270183.53
2022-10-26,2022-10-26,Business travel,REF30843315,501.48,0.0,269682.05
2022-10-30,2022-10-30,Marketing expenses,REF95639216,407.41,0.0,269274.64
2022-10-31,2022-10-31,Coworking space rental,REF17513250,246.0,0.0,269028.64
2022-11-01,2022-11-01,Training/conference,REF50796845,206.79,0.0,268821.85
2022-11-05,2022-11-05,Business travel,REF39672201,413.38,0.0,268408.47
2022-11-05,2022-11-05,Equipment purchase,REF79648760,168.89,0.0,268239.58
2022-11-06,2022-11-06,Training/conference,REF59268200,72.79,0.0,268166.79
2022-11-07,2022-11-07,Training/conference,REF54497082,262.12,0.0,267904.67
2022-11-15,2022-11-15,Business insurance premium,REF49126515,135.54,0.0,267769.13
2022-11-15,2022-11-15,"Service payment - Franklin, Smith and Farrell",REF18465719,0.0,879.52,268648.65
2022-11-15,2022-11-15,Invoice payment - Shannon PLC,REF77986899,0.0,791.71,269440.36
2022-11-15,2022-11-15,Invoice payment - Smith Inc,REF28354367,0.0,678.47,270118.83
2022-11-15,2022-11-15,"Project payment - Williams, Martinez and Smith",REF35624746,0.0,933.74,271052.57
2022-11-15,2022-11-15,"Project payment - Luna, Quinn and Wilson",REF16201838,0.0,758.39,271810.96
2022-11-15,2022-11-15,Business meal,REF99319846,104.19,0.0,271706.77
2022-11-15,2022-11-15,"Service payment - Christian, Morris and Weaver",REF92973224,0.0,882.55,272589.32
2022-11-15,2022-11-15,Invoice payment - Freeman PLC,REF45104122,0.0,532.13,273121.45
2022-11-15,2022-11-15,Project payment - Campbell Inc,REF68827913,0.0,1445.78,274567.23
2022-11-18,2022-11-18,Marketing expenses,REF74010390,205.42,0.0,274361.81
2022-11-21,2022-11-21,Professional software license,REF41434485,202.83,0.0,274158.98
2022-11-25,2022-11-25,Equipment purchase,REF88657321,83.11,0.0,274075.87
2022-11-28,2022-11-28,Business travel,REF97472351,627.74,0.0,273448.13
2022-11-28,2022-11-28,Business meal,REF32226338,194.11,0.0,273254.02
2022-11-30,2022-11-30,Training/conference,REF44374498,187.71,0.0,273066.31
2022-11-30,2022-11-30,Coworking space rental,REF12872778,197.29,0.0,272869.02
2022-12-02,2022-12-02,Coworking space rental,REF56726438,194.27,0.0,272674.75
2022-12-03,2022-12-03,Coworking space rental,REF88871247,332.81,0.0,272341.94
2022-12-12,2022-12-12,Business meal,REF25942675,277.79,0.0,272064.15
2022-12-12,2022-12-12,Training/conference,REF64254314,145.73,0.0,271918.42
2022-12-15,2022-12-15,Invoice payment - Freeman PLC,REF19280871,0.0,372.24,272290.66
2022-12-15,2022-12-15,"Project payment - Luna, Quinn and Wilson",REF28208873,0.0,575.88,272866.54
2022-12-15,2022-12-15,Project payment - Shannon PLC,REF95143580,0.0,691.96,273558.5
2022-12-15,2022-12-15,"Service payment - Christian, Morris and Weaver",REF43081114,0.0,762.75,274321.25
2022-12-15,2022-12-15,Payment from Smith Inc,REF99091729,0.0,628.0,274949.25
2022-12-15,2022-12-15,Payment from Campbell Inc,REF48670407,0.0,1090.33,276039.58
2022-12-15,2022-12-15,Business insurance premium,REF83638290,129.75,0.0,275909.83
2022-12-15,2022-12-15,"Payment from Franklin, Smith and Farrell",REF62385196,0.0,1230.37,277140.2
2022-12-15,2022-12-15,"Payment from Williams, Martinez and Smith",REF23705133,0.0,652.93,277793.13
2022-12-15,2022-12-15,Training/conference,REF16594074,209.44,0.0,277583.69
2022-12-20,2022-12-20,Accounting expense,REF16347703,124.7,0.0,277458.99
2022-12-21,2022-12-21,Professional software license,REF65172580,174.05,0.0,277284.94
2022-12-22,2022-12-22,Business travel,REF21194529,322.04,0.0,276962.9
2022-12-27,2022-12-27,Business travel,REF26746157,263.4,0.0,276699.5
2022-12-29,2022-12-29,Accounting expense,REF21568254,222.69,0.0,276476.81
2022-12-29,2022-12-29,Business meal,REF30875292,153.28,0.0,276323.53
2022-12-31,2022-12-31,Business meal,REF10934208,235.88,0.0,276087.65
2023-01-01,2023-01-01,Equipment purchase,REF66536106,208.93,0.0,275878.72
2023-01-09,2023-01-09,Coworking space rental,REF33886379,346.95,0.0,275531.77
2023-01-11,2023-01-11,Business travel,REF93192269,571.96,0.0,274959.81
2023-01-15,2023-01-15,Business meal,REF62390455,258.25,0.0,274701.56
2023-01-15,2023-01-15,"Invoice payment - Luna, Quinn and Wilson",REF26047185,0.0,568.99,275270.55
2023-01-15,2023-01-15,Invoice payment - Smith Inc,REF13440411,0.0,875.1,276145.65
2023-01-15,2023-01-15,Service payment - Campbell Inc,REF98759651,0.0,1479.47,277625.12
2023-01-15,2023-01-15,"Project payment - Christian, Morris and Weaver",REF65069139,0.0,1038.78,278663.9
2023-01-15,2023-01-15,Invoice payment - Freeman PLC,REF19795336,0.0,520.65,279184.55
2023-01-15,2023-01-15,"Service payment - Williams, Martinez and Smith",REF18732297,0.0,1359.59,280544.14
2023-01-15,2023-01-15,"Payment from Franklin, Smith and Farrell",REF28753087,0.0,1261.42,281805.56
2023-01-15,2023-01-15,Business insurance premium,REF37122347,167.74,0.0,281637.82
2023-01-21,2023-01-21,Professional software license,REF62583637,217.21,0.0,281420.61
2023-01-26,2023-01-26,Business meal,REF59367054,357.18,0.0,281063.43
2023-01-31,2023-01-31,Marketing expenses,REF69605341,357.31,0.0,280706.12
2023-02-03,2023-02-03,Business meal,REF25690910,204.72,0.0,280501.4
2023-02-09,2023-02-09,Business travel,REF35647574,421.55,0.0,280079.85
2023-02-13,2023-02-13,Business meal,REF49852137,314.44,0.0,279765.41
2023-02-15,2023-02-15,"Invoice payment - Williams, Martinez and Smith",REF21309082,0.0,582.58,280347.99
2023-02-15,2023-02-15,"Service payment - Christian, Morris and Weaver",REF55225188,0.0,1089.29,281437.28
2023-02-15,2023-02-15,Payment from Shannon PLC,REF25417566,0.0,657.46,282094.74
2023-02-15,2023-02-15,"Payment from Franklin, Smith and Farrell",REF47537225,0.0,1318.22,283412.96
2023-02-15,2023-02-15,Project payment - Smith Inc,REF91861998,0.0,885.76,284298.72
2023-02-15,2023-02-15,Business insurance premium,REF73117235,161.34,0.0,284137.38
2023-02-15,2023-02-15,"Invoice payment - Luna, Quinn and Wilson",REF91135297,0.0,558.41,284695.79
2023-02-15,2023-02-15,Project payment - Freeman PLC,REF92965891,0.0,470.37,285166.16
2023-02-16,2023-02-16,Equipment purchase,REF60221508,130.82,0.0,285035.34
2023-02-16,2023-02-16,Coworking space rental,REF62839656,166.25,0.0,284869.09
2023-02-21,2023-02-21,Professional software license,REF51425906,219.86,0.0,284649.23
2023-03-03,2023-03-03,Business meal,REF54970483,289.71,0.0,284359.52
2023-03-06,2023-03-06,Marketing expenses,REF73592580,324.9,0.0,284034.62
2023-03-08,2023-03-08,Equipment purchase,REF25373984,98.78,0.0,283935.84
2023-03-09,2023-03-09,Business meal,REF26636138,323.09,0.0,283612.75
2023-03-09,2023-03-09,Training/conference,REF71591045,193.52,0.0,283419.23
2023-03-11,2023-03-11,Business meal,REF87223717,118.15,0.0,283301.08
2023-03-13,2023-03-13,Business travel,REF10612874,200.28,0.0,283100.8
2023-03-15,2023-03-15,Service payment - Freeman PLC,REF36002176,0.0,562.25,283663.05
2023-03-15,2023-03-15,"Payment from Christian, Morris and Weaver",REF18654736,0.0,711.4,284374.45
2023-03-15,2023-03-15,"Invoice payment - Franklin, Smith and Farrell",REF55955973,0.0,1089.69,285464.14
2023-03-15,2023-03-15,Business insurance premium,REF78523422,150.83,0.0,285313.31
2023-03-15,2023-03-15,Service payment - Smith Inc,REF36424724,0.0,615.11,285928.42
2023-03-15,2023-03-15,Project payment - Campbell Inc,REF17834980,0.0,1176.44,287104.86
2023-03-15,2023-03-15,Service payment - Shannon PLC,REF80162649,0.0,559.12,287663.98
2023-03-15,2023-03-15,"Service payment - Luna, Quinn and Wilson",REF33104907,0.0,688.72,288352.7
2023-03-15,2023-03-15,"Invoice payment - Williams, Martinez and Smith",REF54141837,0.0,717.82,289070.52
2023-03-19,2023-03-19,Training/conference,REF29168168,192.97,0.0,288877.55
2023-03-21,2023-03-21,Professional software license,REF30406569,175.87,0.0,288701.68
2023-03-24,2023-03-24,Business travel,REF68148809,250.56,0.0,288451.12
2023-03-25,2023-03-25,Training/conference,REF39776189,197.38,0.0,288253.74
2023-03-27,2023-03-27,Coworking space rental,REF36821472,234.38,0.0,288019.36
2023-03-28,2023-03-28,Coworking space rental,REF23644850,468.43,0.0,287550.93
2023-03-30,2023-03-30,Training/conference,REF80266186,80.0,0.0,287470.93
2023-04-07,2023-04-07,Marketing expenses,REF10222208,225.58,0.0,287245.35
2023-04-09,2023-04-09,Training/conference,REF73988663,177.36,0.0,287067.99
2023-04-15,2023-04-15,Business insurance premium,REF93951974,143.02,0.0,286924.97
2023-04-15,2023-04-15,Payment from Campbell Inc,REF44691077,0.0,1095.71,288020.68
2023-04-15,2023-04-15,"Payment from Christian, Morris and Weaver",REF54458115,0.0,1107.95,289128.63
2023-04-15,2023-04-15,"Project payment - Luna, Quinn and Wilson",REF81763413,0.0,853.67,289982.3
2023-04-15,2023-04-15,"Invoice payment - Williams, Martinez and Smith",REF91997814,0.0,666.96,290649.26
2023-04-15,2023-04-15,Service payment - Freeman PLC,REF65539294,0.0,416.91,291066.17
2023-04-15,2023-04-15,Service payment - Smith Inc,REF89502884,0.0,811.78,291877.95
2023-04-15,2023-04-15,"Payment from Franklin, Smith and Farrell",REF75171133,0.0,871.08,292749.03
2023-04-17,2023-04-17,Accounting expense,REF36386637,239.18,0.0,292509.85
2023-04-19,2023-04-19,Coworking space rental,REF60747414,184.24,0.0,292325.61
2023-04-21,2023-04-21,Professional software license,REF10456007,204.04,0.0,292121.57
2023-04-21,2023-04-21,Training/conference,REF27942280,233.19,0.0,291888.38
2023-04-23,2023-04-23,Business meal,REF95186106,124.59,0.0,291763.79
2023-04-27,2023-04-27,Business meal,REF71699699,323.25,0.0,291440.54
2023-04-30,2023-04-30,Accounting expense,REF61212667,171.97,0.0,291268.57
2023-04-30,2023-04-30,Training/conference,REF35396576,250.52,0.0,291018.05
2023-05-07,2023-05-07,Equipment purchase,REF42329613,139.08,0.0,290878.97
2023-05-07,2023-05-07,Coworking space rental,REF53394068,369.77,0.0,290509.2
2023-05-09,2023-05-09,Training/conference,REF20149784,196.21,0.0,290312.99
2023-05-12,2023-05-12,Business travel,REF52916468,491.68,0.0,289821.31
2023-05-15,2023-05-15,Business insurance premium,REF56035217,126.95,0.0,289694.36
2023-05-15,2023-05-15,Payment from Smith Inc,REF83397727,0.0,817.54,290511.9
2023-05-15,2023-05-15,"Invoice payment - Luna, Quinn and Wilson",REF34775345,0.0,536.31,291048.21
2023-05-15,2023-05-15,"Invoice payment - Williams, Martinez and Smith",REF44767018,0.0,817.21,291865.42
2023-05-15,2023-05-15,Payment from Freeman PLC,REF13218774,0.0,528.85,292394.27
2023-05-15,2023-05-15,"Service payment - Christian, Morris and Weaver",REF66322506,0.0,915.31,293309.58
2023-05-15,2023-05-15,Service payment - Shannon PLC,REF78114907,0.0,743.25,294052.83
2023-05-15,2023-05-15,Payment from Campbell Inc,REF51727406,0.0,1266.44,295319.27
2023-05-19,2023-05-19,Training/conference,REF80653215,246.01,0.0,295073.26
2023-05-19,2023-05-19,Coworking space rental,REF29949610,208.62,0.0,294864.64
2023-05-21,2023-05-21,Professional software license,REF32506922,178.57,0.0,294686.07
2023-05-24,2023-05-24,Accounting expense,REF27743138,178.89,0.0,294507.18
2023-05-26,2023-05-26,Accounting expense,REF10399171,207.38,0.0,294299.8
2023-05-27,2023-05-27,Business meal,REF92617030,184.53,0.0,294115.27
2023-05-28,2023-05-28,Business travel,REF95172562,502.99,0.0,293612.28
2023-05-31,2023-05-31,Accounting expense,REF60717746,144.75,0.0,293467.53
2023-06-03,2023-06-03,Accounting expense,REF99820037,213.42,0.0,293254.11
2023-06-04,2023-06-04,Coworking space rental,REF93798760,319.67,0.0,292934.44
2023-06-11,2023-06-11,Accounting expense,REF39299583,105.13,0.0,292829.31
2023-06-12,2023-06-12,Coworking space rental,REF21310733,339.55,0.0,292489.76
2023-06-15,2023-06-15,Payment from Campbell Inc,REF62888543,0.0,725.66,293215.42
2023-06-15,2023-06-15,Service payment - Smith Inc,REF50330937,0.0,440.56,293655.98
2023-06-15,2023-06-15,Training/conference,REF80956259,209.49,0.0,293446.49
2023-06-15,2023-06-15,Business insurance premium,REF79076829,107.23,0.0,293339.26
2023-06-15,2023-06-15,Payment from Shannon PLC,REF61638556,0.0,619.62,293958.88
2023-06-15,2023-06-15,Service payment - Freeman PLC,REF75082032,0.0,419.87,294378.75
2023-06-15,2023-06-15,"Payment from Williams, Martinez and Smith",REF85721487,0.0,681.11,295059.86
2023-06-15,2023-06-15,"Payment from Christian, Morris and Weaver",REF70221448,0.0,544.88,295604.74
2023-06-19,2023-06-19,Coworking space rental,REF95763919,127.71,0.0,295477.03
2023-06-19,2023-06-19,Equipment purchase,REF76360550,149.93,0.0,295327.1
2023-06-19,2023-06-19,Accounting expense,REF17520027,19.91,0.0,295307.19
2023-06-21,2023-06-21,Professional software license,REF67138944,174.05,0.0,295133.14
2023-06-22,2023-06-22,Business meal,REF28208767,188.59,0.0,294944.55
2023-06-25,2023-06-25,Training/conference,REF36888069,192.74,0.0,294751.81
2023-06-26,2023-06-26,Business meal,REF12904672,50.68,0.0,294701.13
2023-06-28,2023-06-28,Business meal,REF87152963,243.47,0.0,294457.66
2023-07-02,2023-07-02,Training/conference,REF54818593,152.74,0.0,294304.92
2023-07-15,2023-07-15,"Project payment - Luna, Quinn and Wilson",REF39269039,0.0,421.91,294726.83
2023-07-15,2023-07-15,Business insurance premium,REF35290500,93.2,0.0,294633.63
2023-07-15,2023-07-15,"Invoice payment - Christian, Morris and Weaver",REF11402162,0.0,529.62,295163.25
2023-07-15,2023-07-15,Invoice payment - Freeman PLC,REF37198277,0.0,236.31,295399.56
2023-07-15,2023-07-15,"Service payment - Franklin, Smith and Farrell",REF85202488,0.0,1042.59,296442.15
2023-07-15,2023-07-15,Payment from Campbell Inc,REF55893366,0.0,865.92,297308.07
2023-07-15,2023-07-15,Service payment - Smith Inc,REF94823689,0.0,428.75,297736.82
2023-07-15,2023-07-15,Project payment - Shannon PLC,REF14103272,0.0,531.45,298268.27
2023-07-19,2023-07-19,Coworking space rental,REF54759381,318.44,0.0,297949.83
2023-07-21,2023-07-21,Professional software license,REF37846113,122.83,0.0,297827.0
2023-07-22,2023-07-22,Equipment purchase,REF52175774,136.76,0.0,297690.24
2023-07-27,2023-07-27,Business travel,REF71234627,342.27,0.0,297347.97
2023-07-27,2023-07-27,Marketing expenses,REF24132941,221.03,0.0,297126.94
2023-08-02,2023-08-02,Training/conference,REF36112329,139.56,0.0,296987.38
2023-08-03,2023-08-03,Business meal,REF65274109,259.12,0.0,296728.26
2023-08-04,2023-08-04,Equipment purchase,REF11155530,131.0,0.0,296597.26
2023-08-08,2023-08-08,Equipment purchase,REF53480037,114.18,0.0,296483.08
2023-08-10,2023-08-10,Training/conference,REF70839589,248.08,0.0,296235.0
2023-08-13,2023-08-13,Accounting expense,REF13559169,121.37,0.0,296113.63
2023-08-13,2023-08-13,Coworking space rental,REF51602902,229.41,0.0,295884.22
2023-08-14,2023-08-14,Training/conference,REF45169444,172.25,0.0,295711.97
2023-08-15,2023-08-15,Business insurance premium,REF77944117,112.06,0.0,295599.91
2023-08-15,2023-08-15,Project payment - Campbell Inc,REF93487043,0.0,952.17,296552.08
2023-08-15,2023-08-15,"Project payment - Luna, Quinn and Wilson",REF75596173,0.0,551.01,297103.09
2023-08-15,2023-08-15,"Project payment - Williams, Martinez and Smith",REF40731915,0.0,544.3,297647.39
2023-08-15,2023-08-15,"Payment from Christian, Morris and Weaver",REF60143500,0.0,669.07,298316.46
2023-08-15,2023-08-15,Invoice payment - Smith Inc,REF98477345,0.0,389.32,298705.78
2023-08-15,2023-08-15,"Service payment - Franklin, Smith and Farrell",REF58627105,0.0,1005.09,299710.87
2023-08-15,2023-08-15,Project payment - Freeman PLC,REF16359582,0.0,449.86,300160.73
2023-08-18,2023-08-18,Business travel,REF18512848,109.84,0.0,300050.89
2023-08-21,2023-08-21,Professional software license,REF87035089,126.88,0.0,299924.01
2023-08-25,2023-08-25,Equipment purchase,REF62455503,92.86,0.0,299831.15
2023-08-29,2023-08-29,Coworking space rental,REF44007166,221.17,0.0,299609.98
2023-08-31,2023-08-31,Accounting expense,REF59345625,207.78,0.0,299402.2
2023-09-05,2023-09-05,Equipment purchase,REF55565963,273.22,0.0,299128.98
2023-09-07,2023-09-07,Business travel,REF25958949,178.2,0.0,298950.78
2023-09-08,2023-09-08,Business travel,REF36426572,353.62,0.0,298597.16
2023-09-10,2023-09-10,Training/conference,REF74683074,272.29,0.0,298324.87
2023-09-13,2023-09-13,Marketing expenses,REF61122314,438.4,0.0,297886.47
2023-09-15,2023-09-15,Business insurance premium,REF10813192,151.82,0.0,297734.65
2023-09-15,2023-09-15,"Project payment - Christian, Morris and Weaver",REF92672517,0.0,981.8,298716.45
2023-09-15,2023-09-15,Service payment - Freeman PLC,REF24827084,0.0,393.85,299110.3
2023-09-15,2023-09-15,Payment from Shannon PLC,REF43745781,0.0,650.85,299761.15
2023-09-15,2023-09-15,Payment from Campbell Inc,REF67037400,0.0,1398.3,301159.45
2023-09-15,2023-09-15,"Service payment - Luna, Quinn and Wilson",REF46544353,0.0,777.81,301937.26
2023-09-15,2023-09-15,"Project payment - Franklin, Smith and Farrell",REF33284590,0.0,1544.56,303481.82
2023-09-18,2023-09-18,Coworking space rental,REF20117425,405.02,0.0,303076.8
2023-09-19,2023-09-19,Business travel,REF92617151,427.08,0.0,302649.72
2023-09-20,2023-09-20,Marketing expenses,REF19699677,165.54,0.0,302484.18
2023-09-21,2023-09-21,Professional software license,REF48677179,270.72,0.0,302213.46
2023-09-25,2023-09-25,Business travel,REF89654736,568.15,0.0,301645.31
2023-10-04,2023-10-04,Accounting expense,REF66856194,201.93,0.0,301443.38
2023-10-06,2023-10-06,Business meal,REF83784151,519.2,0.0,300924.18
2023-10-07,2023-10-07,Training/conference,REF36221551,199.3,0.0,300724.88
2023-10-11,2023-10-11,Training/conference,REF22963653,201.44,0.0,300523.44
2023-10-15,2023-10-15,Invoice payment - Campbell Inc,REF46594979,0.0,1624.94,302148.38
2023-10-15,2023-10-15,Invoice payment - Shannon PLC,REF74096825,0.0,1072.73,303221.11
2023-10-15,2023-10-15,"Project payment - Franklin, Smith and Farrell",REF54304217,0.0,2215.28,305436.39
2023-10-15,2023-10-15,Business insurance premium,REF34485219,172.55,0.0,305263.84
2023-10-15,2023-10-15,Project payment - Smith Inc,REF81184338,0.0,680.45,305944.29
2023-10-15,2023-10-15,"Invoice payment - Christian, Morris and Weaver",REF33651611,0.0,1184.3,307128.59
2023-10-15,2023-10-15,"Project payment - Luna, Quinn and Wilson",REF86786178,0.0,671.44,307800.03
2023-10-15,2023-10-15,"Project payment - Williams, Martinez and Smith",REF49589291,0.0,902.65,308702.68
2023-10-21,2023-10-21,Professional software license,REF47436049,262.9,0.0,308439.78
2023-10-22,2023-10-22,Coworking space rental,REF22398102,135.71,0.0,308304.07
2023-10-23,2023-10-23,Coworking space rental,REF24096904,465.94,0.0,307838.13
2023-10-27,2023-10-27,Business travel,REF11792067,551.08,0.0,307287.05
2023-10-29,2023-10-29,Marketing expenses,REF51230057,340.41,0.0,306946.64
2023-10-31,2023-10-31,Business travel,REF16453989,521.38,0.0,306425.26
2023-11-03,2023-11-03,Business travel,REF66148006,127.57,0.0,306297.69
2023-11-03,2023-11-03,Coworking space rental,REF71133887,329.49,0.0,305968.2
2023-11-03,2023-11-03,Business meal,REF24010432,336.85,0.0,305631.35
2023-11-06,2023-11-06,Business meal,REF93623437,435.66,0.0,305195.69
2023-11-13,2023-11-13,Business travel,REF20870936,512.27,0.0,304683.42
2023-11-13,2023-11-13,Accounting expense,REF25833761,163.43,0.0,304519.99
2023-11-15,2023-11-15,Payment from Campbell Inc,REF35033516,0.0,1236.21,305756.2
2023-11-15,2023-11-15,"Invoice payment - Luna, Quinn and Wilson",REF49582725,0.0,730.05,306486.25
2023-11-15,2023-11-15,"Project payment - Franklin, Smith and Farrell",REF57121677,0.0,1858.97,308345.22
2023-11-15,2023-11-15,Project payment - Shannon PLC,REF39063917,0.0,925.46,309270.68
2023-11-15,2023-11-15,Project payment - Freeman PLC,REF83208205,0.0,642.63,309913.31
2023-11-15,2023-11-15,Service payment - Smith Inc,REF70521325,0.0,825.41,310738.72
2023-11-15,2023-11-15,"Payment from Williams, Martinez and Smith",REF79789323,0.0,890.72,311629.44
2023-11-15,2023-11-15,Business insurance premium,REF35488878,134.49,0.0,311494.95
2023-11-18,2023-11-18,Accounting expense,REF93270455,297.58,0.0,311197.37
2023-11-19,2023-11-19,Business travel,REF16689968,299.39,0.0,310897.98
2023-11-21,2023-11-21,Business meal,REF41174036,234.8,0.0,310663.18
2023-11-21,2023-11-21,Professional software license,REF13562667,232.33,0.0,310430.85
2023-11-22,2023-11-22,Training/conference,REF79040699,168.24,0.0,310262.61
2023-11-29,2023-11-29,Business travel,REF16629880,346.55,0.0,309916.06
2023-12-04,2023-12-04,Accounting expense,REF76793369,143.79,0.0,309772.27
2023-12-12,2023-12-12,Accounting expense,REF12620396,129.95,0.0,309642.32
2023-12-14,2023-12-14,Accounting expense,REF96630140,258.29,0.0,309384.03
2023-12-15,2023-12-15,"Invoice payment - Christian, Morris and Weaver",REF33352097,0.0,942.37,310326.4
2023-12-15,2023-12-15,Invoice payment - Smith Inc,REF85240338,0.0,677.17,311003.57
2023-12-15,2023-12-15,"Project payment - Franklin, Smith and Farrell",REF15451022,0.0,1255.57,312259.14
2023-12-15,2023-12-15,"Payment from Luna, Quinn and Wilson",REF44621138,0.0,499.37,312758.51
2023-12-15,2023-12-15,Project payment - Freeman PLC,REF51256533,0.0,381.71,313140.22
2023-12-15,2023-12-15,Business insurance premium,REF37785347,120.25,0.0,313019.97
2023-12-15,2023-12-15,"Project payment - Williams, Martinez and Smith",REF95162558,0.0,871.9,313891.87
2023-12-15,2023-12-15,Invoice payment - Campbell Inc,REF21275618,0.0,922.1,314813.97
2023-12-21,2023-12-21,Professional software license,REF32910943,146.93,0.0,314667.04
2023-12-24,2023-12-24,Equipment purchase,REF54528708,134.5,0.0,314532.54
2023-12-25,2023-12-25,Marketing expenses,REF88292267,342.72,0.0,314189.82
2024-01-05,2024-01-05,Marketing expenses,REF80582991,214.41,0.0,313975.41
2024-01-07,2024-01-07,Marketing expenses,REF63199792,426.56,0.0,313548.85
2024-01-09,2024-01-09,Business travel,REF56449973,384.84,0.0,313164.01
2024-01-09,2024-01-09,Accounting expense,REF13592496,194.45,0.0,312969.56
2024-01-12,2024-01-12,Business travel,REF34608678,850.99,0.0,312118.57
2024-01-15,2024-01-15,Business insurance premium,REF28722874,174.23,0.0,311944.34
2024-01-15,2024-01-15,Invoice payment - Freeman PLC,REF28010761,0.0,651.02,312595.36
2024-01-15,2024-01-15,Invoice payment - Campbell Inc,REF48629505,0.0,1580.98,314176.34
2024-01-15,2024-01-15,Invoice payment - Smith Inc,REF69955100,0.0,706.83,314883.17
2024-01-15,2024-01-15,"Payment from Franklin, Smith and Farrell",REF87684770,0.0,1626.51,316509.68
2024-01-15,2024-01-15,"Payment from Christian, Morris and Weaver",REF59911613,0.0,1158.2,317667.88
2024-01-15,2024-01-15,"Service payment - Luna, Quinn and Wilson",REF62168568,0.0,810.51,318478.39
2024-01-15,2024-01-15,"Service payment - Williams, Martinez and Smith",REF67273721,0.0,1320.19,319798.58
2024-01-16,2024-01-16,Training/conference,REF77193104,293.12,0.0,319505.46
2024-01-21,2024-01-21,Professional software license,REF59621600,254.02,0.0,319251.44
2024-01-27,2024-01-27,Marketing expenses,REF77871905,241.17,0.0,319010.27
2024-02-06,2024-02-06,Business meal,REF18272030,344.91,0.0,318665.36
2024-02-06,2024-02-06,Coworking space rental,REF89698449,338.56,0.0,318326.8
2024-02-07,2024-02-07,Business meal,REF64825018,214.6,0.0,318112.2
2024-02-11,2024-02-11,Business travel,REF46318589,478.36,0.0,317633.84
2024-02-15,2024-02-15,"Payment from Luna, Quinn and Wilson",REF69740794,0.0,942.32,318576.16
2024-02-15,2024-02-15,"Project payment - Christian, Morris and Weaver",REF61315939,0.0,868.43,319444.59
2024-02-15,2024-02-15,Project payment - Smith Inc,REF65854321,0.0,769.3,320213.89
2024-02-15,2024-02-15,"Project payment - Franklin, Smith and Farrell",REF50299248,0.0,1269.46,321483.35
2024-02-15,2024-02-15,"Invoice payment - Williams, Martinez and Smith",REF62993058,0.0,978.2,322461.55
2024-02-15,2024-02-15,Service payment - Shannon PLC,REF32078066,0.0,805.09,323266.64
2024-02-15,2024-02-15,Business insurance premium,REF77126267,148.05,0.0,323118.59
2024-02-15,2024-02-15,Project payment - Freeman PLC,REF68443721,0.0,560.14,323678.73
2024-02-19,2024-02-19,Accounting expense,REF91347234,197.48,0.0,323481.25
2024-02-19,2024-02-19,Training/conference,REF72791904,203.32,0.0,323277.93
2024-02-21,2024-02-21,Professional software license,REF48262979,209.13,0.0,323068.8
2024-02-22,2024-02-22,Business meal,REF53216286,250.15,0.0,322818.65
2024-02-23,2024-02-23,Business meal,REF77223021,358.45,0.0,322460.2
2024-02-24,2024-02-24,Equipment purchase,REF72027838,178.75,0.0,322281.45
2024-02-26,2024-02-26,Equipment purchase,REF14453066,186.5,0.0,322094.95
2024-02-28,2024-02-28,Business travel,REF96084277,472.63,0.0,321622.32
2024-03-04,2024-03-04,Marketing expenses,REF86598960,281.22,0.0,321341.1
2024-03-05,2024-03-05,Business meal,REF94058973,145.92,0.0,321195.18
2024-03-06,2024-03-06,Training/conference,REF79633464,132.93,0.0,321062.25
2024-03-07,2024-03-07,Training/conference,REF40944186,222.88,0.0,320839.37
2024-03-09,2024-03-09,Business meal,REF76468338,341.22,0.0,320498.15
2024-03-15,2024-03-15,Business insurance premium,REF56227329,144.94,0.0,320353.21
2024-03-15,2024-03-15,Payment from Shannon PLC,REF56541127,0.0,639.45,320992.66
2024-03-15,2024-03-15,Project payment - Freeman PLC,REF79801257,0.0,394.13,321386.79
2024-03-15,2024-03-15,"Project payment - Franklin, Smith and Farrell",REF82795845,0.0,1276.69,322663.48
2024-03-15,2024-03-15,Project payment - Smith Inc,REF30992465,0.0,620.84,323284.32
2024-03-15,2024-03-15,"Project payment - Christian, Morris and Weaver",REF18341361,0.0,721.02,324005.34
2024-03-15,2024-03-15,"Service payment - Luna, Quinn and Wilson",REF72500482,0.0,646.24,324651.58
2024-03-16,2024-03-16,Equipment purchase,REF45868032,184.29,0.0,324467.29
2024-03-16,2024-03-16,Business travel,REF99098914,249.86,0.0,324217.43
2024-03-16,2024-03-16,Business meal,REF59829967,283.16,0.0,323934.27
2024-03-20,2024-03-20,Business travel,REF32570737,277.33,0.0,323656.94
2024-03-21,2024-03-21,Professional software license,REF23011435,201.96,0.0,323454.98
2024-04-04,2024-04-04,Business travel,REF86244957,424.46,0.0,323030.52
2024-04-04,2024-04-04,Coworking space rental,REF43012066,238.66,0.0,322791.86
2024-04-07,2024-04-07,Marketing expenses,REF79647078,351.06,0.0,322440.8
2024-04-07,2024-04-07,Business meal,REF36978553,313.94,0.0,322126.86
2024-04-15,2024-04-15,"Service payment - Luna, Quinn and Wilson",REF79092762,0.0,614.47,322741.33
2024-04-15,2024-04-15,"Project payment - Christian, Morris and Weaver",REF85816574,0.0,840.84,323582.17
2024-04-15,2024-04-15,Accounting expense,REF29062480,215.35,0.0,323366.82
2024-04-15,2024-04-15,Project payment - Campbell Inc,REF20654864,0.0,1242.74,324609.56
2024-04-15,2024-04-15,"Service payment - Williams, Martinez and Smith",REF60968832,0.0,741.15,325350.71
2024-04-15,2024-04-15,Project payment - Shannon PLC,REF34616331,0.0,735.76,326086.47
2024-04-15,2024-04-15,Project payment - Smith Inc,REF55624165,0.0,747.52,326833.99
2024-04-15,2024-04-15,"Invoice payment - Franklin, Smith and Farrell",REF54234079,0.0,1647.09,328481.08
2024-04-15,2024-04-15,Project payment - Freeman PLC,REF45827664,0.0,432.95,328914.03
2024-04-15,2024-04-15,Business insurance premium,REF75419405,134.65,0.0,328779.38
2024-04-18,2024-04-18,Business travel,REF19986770,201.89,0.0,328577.49
2024-04-18,2024-04-18,Training/conference,REF94676424,208.68,0.0,328368.81
2024-04-20,2024-04-20,Training/conference,REF89637233,131.93,0.0,328236.88
2024-04-21,2024-04-21,Coworking space rental,REF33358631,349.46,0.0,327887.42
2024-04-21,2024-04-21,Professional software license,REF31670898,188.29,0.0,327699.13
2024-04-25,2024-04-25,Marketing expenses,REF41373165,347.96,0.0,327351.17
2024-04-25,2024-04-25,Business meal,REF39609051,224.78,0.0,327126.39
2024-04-27,2024-04-27,Accounting expense,REF48727759,186.33,0.0,326940.06
2024-04-29,2024-04-29,Business meal,REF89536899,267.39,0.0,326672.67
2024-05-01,2024-05-01,Business travel,REF76884196,340.24,0.0,326332.43
2024-05-06,2024-05-06,Business travel,REF76065231,349.08,0.0,325983.35
2024-05-09,2024-05-09,Coworking space rental,REF55726733,272.5,0.0,325710.85
2024-05-10,2024-05-10,Equipment purchase,REF21934712,192.11,0.0,325518.74
2024-05-13,2024-05-13,Coworking space rental,REF86735075,248.23,0.0,325270.51
2024-05-13,2024-05-13,Business meal,REF59010501,171.47,0.0,325099.04
2024-05-15,2024-05-15,Business insurance premium,REF80281268,140.8,0.0,324958.24
2024-05-15,2024-05-15,"Invoice payment - Williams, Martinez and Smith",REF43558455,0.0,745.66,325703.9
2024-05-15,2024-05-15,Service payment - Freeman PLC,REF84621347,0.0,499.83,326203.73
2024-05-15,2024-05-15,Project payment - Campbell Inc,REF93439810,0.0,888.52,327092.25
2024-05-15,2024-05-15,Project payment - Shannon PLC,REF39269220,0.0,645.4,327737.65
2024-05-15,2024-05-15,"Payment from Christian, Morris and Weaver",REF16659998,0.0,626.72,328364.37
2024-05-15,2024-05-15,Service payment - Smith Inc,REF85625817,0.0,668.48,329032.85
2024-05-15,2024-05-15,"Service payment - Franklin, Smith and Farrell",REF47097944,0.0,1288.78,330321.63
2024-05-15,2024-05-15,Accounting expense,REF28475946,111.89,0.0,330209.74
2024-05-16,2024-05-16,Marketing expenses,REF57177696,218.72,0.0,329991.02
2024-05-17,2024-05-17,Business travel,REF99891895,294.15,0.0,329696.87
2024-05-21,2024-05-21,Training/conference,REF82352273,238.96,0.0,329457.91
2024-05-21,2024-05-21,Professional software license,REF60934951,142.47,0.0,329315.44
2024-05-22,2024-05-22,Business meal,REF53047800,260.76,0.0,329054.68
2024-05-23,2024-05-23,Business travel,REF21916844,440.23,0.0,328614.45
2024-05-26,2024-05-26,Coworking space rental,REF89104303,277.13,0.0,328337.32
2024-05-28,2024-05-28,Accounting expense,REF81078834,211.75,0.0,328125.57
2024-05-30,2024-05-30,Business meal,REF34075900,185.8,0.0,327939.77
2024-06-04,2024-06-04,Training/conference,REF90634154,51.74,0.0,327888.03
2024-06-15,2024-06-15,Training/conference,REF63842870,162.51,0.0,327725.52
2024-06-15,2024-06-15,Equipment purchase,REF82400260,158.51,0.0,327567.01
2024-06-15,2024-06-15,Project payment - Smith Inc,REF92219412,0.0,537.52,328104.53
2024-06-15,2024-06-15,"Invoice payment - Franklin, Smith and Farrell",REF55360281,0.0,824.43,328928.96
2024-06-15,2024-06-15,Invoice payment - Shannon PLC,REF19414545,0.0,643.07,329572.03
2024-06-15,2024-06-15,"Service payment - Christian, Morris and Weaver",REF19656426,0.0,588.09,330160.12
2024-06-15,2024-06-15,Business insurance premium,REF52276959,106.49,0.0,330053.63
2024-06-15,2024-06-15,"Service payment - Williams, Martinez and Smith",REF63641284,0.0,721.32,330774.95
2024-06-15,2024-06-15,Service payment - Freeman PLC,REF61278363,0.0,374.76,331149.71
2024-06-15,2024-06-15,Invoice payment - Campbell Inc,REF53651264,0.0,954.64,332104.35
2024-06-21,2024-06-21,Professional software license,REF79106943,179.84,0.0,331924.51
2024-06-26,2024-06-26,Training/conference,REF12480607,138.25,0.0,331786.26
2024-07-02,2024-07-02,Business meal,REF88856252,124.82,0.0,331661.44
2024-07-07,2024-07-07,Coworking space rental,REF11777004,138.06,0.0,331523.38
2024-07-15,2024-07-15,Business insurance premium,REF30046609,90.52,0.0,331432.86
2024-07-15,2024-07-15,Service payment - Campbell Inc,REF92415709,0.0,874.91,332307.77
2024-07-15,2024-07-15,"Service payment - Christian, Morris and Weaver",REF84206802,0.0,677.97,332985.74
2024-07-15,2024-07-15,"Service payment - Williams, Martinez and Smith",REF71580169,0.0,546.43,333532.17
2024-07-15,2024-07-15,"Project payment - Franklin, Smith and Farrell",REF96834321,0.0,547.78,334079.95
2024-07-15,2024-07-15,Invoice payment - Freeman PLC,REF35332977,0.0,450.75,334530.7
2024-07-15,2024-07-15,Invoice payment - Smith Inc,REF42526865,0.0,517.53,335048.23
2024-07-18,2024-07-18,Equipment purchase,REF77806012,116.42,0.0,334931.81
2024-07-19,2024-07-19,Coworking space rental,REF80458945,233.62,0.0,334698.19
2024-07-21,2024-07-21,Professional software license,REF26967631,140.43,0.0,334557.76
2024-07-25,2024-07-25,Business meal,REF24838202,236.29,0.0,334321.47
2024-07-27,2024-07-27,Equipment purchase,REF19390511,149.08,0.0,334172.39
2024-07-27,2024-07-27,Marketing expenses,REF12082508,239.8,0.0,333932.59
2024-07-29,2024-07-29,Coworking space rental,REF35488594,73.19,0.0,333859.4
2024-07-30,2024-07-30,Coworking space rental,REF20021148,209.01,0.0,333650.39
2024-08-02,2024-08-02,Business travel,REF79359429,524.0,0.0,333126.39
2024-08-03,2024-08-03,Accounting expense,REF28729327,166.74,0.0,332959.65
2024-08-04,2024-08-04,Equipment purchase,REF55528073,230.89,0.0,332728.76
2024-08-06,2024-08-06,Marketing expenses,REF93817796,304.33,0.0,332424.43
2024-08-07,2024-08-07,Business travel,REF20598080,310.02,0.0,332114.41
2024-08-07,2024-08-07,Accounting expense,REF92039097,147.29,0.0,331967.12
2024-08-08,2024-08-08,Training/conference,REF28546409,50.19,0.0,331916.93
2024-08-13,2024-08-13,Accounting expense,REF96128934,121.17,0.0,331795.76
2024-08-15,2024-08-15,"Invoice payment - Luna, Quinn and Wilson",REF83167630,0.0,508.88,332304.64
2024-08-15,2024-08-15,Business insurance premium,REF71549015,118.92,0.0,332185.72
2024-08-15,2024-08-15,Payment from Campbell Inc,REF70272715,0.0,724.72,332910.44
2024-08-15,2024-08-15,"Invoice payment - Williams, Martinez and Smith",REF56162309,0.0,729.33,333639.77
2024-08-15,2024-08-15,Invoice payment - Smith Inc,REF37240188,0.0,579.96,334219.73
2024-08-15,2024-08-15,"Service payment - Christian, Morris and Weaver",REF74734608,0.0,668.61,334888.34
2024-08-16,2024-08-16,Business travel,REF59590718,362.45,0.0,334525.89
2017-08-21,2017-08-21,Professional software license,REF62108256,155.49,0.0,4829.24
2017-08-24,2017-08-24,Accounting expense,REF99664708,119.48,0.0,4709.76
2017-08-29,2017-08-29,Marketing expenses,REF67644446,257.63,0.0,4452.13
2017-09-03,2017-09-03,Business meal,REF76064678,262.15,0.0,4189.98
2017-09-08,2017-09-08,Business travel,REF63322957,442.0,0.0,3747.98
2017-09-12,2017-09-12,Coworking space rental,REF96226576,332.05,0.0,3415.93
2017-09-15,2017-09-15,Service payment - Campbell-Willis,REF33036512,0.0,760.36,4176.29
2017-09-15,2017-09-15,Business insurance premium,REF29880943,156.41,0.0,4019.88
2017-09-15,2017-09-15,Payment from Erickson-Price,REF47026348,0.0,1172.51,5192.39
2017-09-15,2017-09-15,Service payment - Simpson Inc,REF77747086,0.0,1348.09,6540.48
2017-09-15,2017-09-15,Service payment - Pugh and Sons,REF82227811,0.0,856.43,7396.91
2017-09-15,2017-09-15,"Project payment - Dennis, Henderson and Anderson",REF15525175,0.0,203.42,7600.33
2017-09-15,2017-09-15,"Payment from Miranda, Rodriguez and Myers",REF85996635,0.0,555.12,8155.45
2017-09-21,2017-09-21,Professional software license,REF85985246,234.99,0.0,7920.46
2017-09-21,2017-09-21,Business meal,REF70897212,314.39,0.0,7606.07
2017-09-23,2017-09-23,Marketing expenses,REF52716957,391.69,0.0,7214.38
2017-09-29,2017-09-29,Accounting expense,REF96650941,189.88,0.0,7024.5
2017-09-30,2017-09-30,Accounting expense,REF34479229,108.66,0.0,6915.84
2017-10-04,2017-10-04,Business meal,REF35455148,192.42,0.0,6723.42
2017-10-12,2017-10-12,Business travel,REF78658251,607.2,0.0,6116.22
2017-10-15,2017-10-15,Payment from Simpson Inc,REF70259376,0.0,1156.94,7273.16
2017-10-15,2017-10-15,Business insurance premium,REF37220840,176.31,0.0,7096.85
2017-10-15,2017-10-15,Service payment - Spears-Brown,REF68638888,0.0,591.7,7688.55
2017-10-15,2017-10-15,Service payment - Campbell-Willis,REF87132297,0.0,713.27,8401.82
2017-10-15,2017-10-15,Project payment - Erickson-Price,REF15143898,0.0,945.91,9347.73
2017-10-15,2017-10-15,Project payment - Pugh and Sons,REF93007691,0.0,896.0,10243.73
2017-10-15,2017-10-15,Invoice payment - White LLC,REF74581932,0.0,1154.68,11398.41
2017-10-15,2017-10-15,"Project payment - Miranda, Rodriguez and Myers",REF43294037,0.0,540.46,11938.87
2017-10-15,2017-10-15,"Project payment - Dennis, Henderson and Anderson",REF97783183,0.0,211.86,12150.73
2017-10-18,2017-10-18,Business travel,REF86740307,501.32,0.0,11649.41
2017-10-21,2017-10-21,Equipment purchase,REF67823851,114.27,0.0,11535.14
2017-10-21,2017-10-21,Professional software license,REF86950725,245.22,0.0,11289.92
2017-10-23,2017-10-23,Training/conference,REF90005572,339.79,0.0,10950.13
2017-10-30,2017-10-30,Business travel,REF15489333,370.47,0.0,10579.66
2017-11-02,2017-11-02,Accounting expense,REF88310246,190.31,0.0,10389.35
2017-11-05,2017-11-05,Business meal,REF33903184,216.02,0.0,10173.33
2017-11-09,2017-11-09,Accounting expense,REF35371865,335.63,0.0,9837.7
2017-11-10,2017-11-10,Marketing expenses,REF99625587,427.44,0.0,9410.26
2017-11-15,2017-11-15,Business travel,REF93632695,364.78,0.0,9045.48
2017-11-15,2017-11-15,Service payment - Pugh and Sons,REF95169381,0.0,718.48,9763.96
2017-11-15,2017-11-15,"Payment from Miranda, Rodriguez and Myers",REF71302123,0.0,651.3,10415.26
2017-11-15,2017-11-15,Invoice payment - Campbell-Willis,REF74307390,0.0,952.46,11367.72
2017-11-15,2017-11-15,Payment from Spears-Brown,REF49686898,0.0,448.88,11816.6
2017-11-15,2017-11-15,Service payment - White LLC,REF22819626,0.0,666.46,12483.06
2017-11-15,2017-11-15,Payment from Simpson Inc,REF54621194,0.0,1151.16,13634.22
2017-11-15,2017-11-15,"Invoice payment - Dennis, Henderson and Anderson",REF13928886,0.0,176.08,13810.3
2017-11-15,2017-11-15,Business insurance premium,REF74052111,156.36,0.0,13653.94
2017-11-17,2017-11-17,Equipment purchase,REF86274990,117.88,0.0,13536.06
2017-11-20,2017-11-20,Coworking space rental,REF63921535,286.73,0.0,13249.33
2017-11-20,2017-11-20,Business travel,REF63579404,536.64,0.0,12712.69
2017-11-21,2017-11-21,Professional software license,REF84761527,230.91,0.0,12481.78
2017-11-24,2017-11-24,Business travel,REF63686592,552.14,0.0,11929.64
2017-11-26,2017-11-26,Coworking space rental,REF53995866,404.8,0.0,11524.84
2017-11-30,2017-11-30,Coworking space rental,REF50878039,411.51,0.0,11113.33
2017-12-08,2017-12-08,Marketing expenses,REF48842591,291.88,0.0,10821.45
2017-12-10,2017-12-10,Coworking space rental,REF19616090,241.31,0.0,10580.14
2017-12-11,2017-12-11,Coworking space rental,REF51974592,236.07,0.0,10344.07
2017-12-13,2017-12-13,Business meal,REF52258364,79.62,0.0,10264.45
2017-12-15,2017-12-15,Business insurance premium,REF81804270,123.29,0.0,10141.16
2017-12-15,2017-12-15,Invoice payment - Pugh and Sons,REF19827636,0.0,722.2,10863.36
2017-12-15,2017-12-15,Payment from Simpson Inc,REF23602560,0.0,999.2,11862.56
2017-12-15,2017-12-15,"Service payment - Dennis, Henderson and Anderson",REF84899003,0.0,188.35,12050.91
2017-12-15,2017-12-15,Invoice payment - White LLC,REF48003271,0.0,767.11,12818.02
2017-12-15,2017-12-15,Project payment - Erickson-Price,REF94239606,0.0,996.09,13814.11
2017-12-15,2017-12-15,Project payment - Campbell-Willis,REF50448587,0.0,542.73,14356.84
2017-12-16,2017-12-16,Coworking space rental,REF66778144,328.27,0.0,14028.57
2017-12-21,2017-12-21,Professional software license,REF53052931,158.88,0.0,13869.69
2017-12-22,2017-12-22,Business travel,REF41882908,244.98,0.0,13624.71
2017-12-23,2017-12-23,Business meal,REF48293156,260.3,0.0,13364.41
2017-12-24,2017-12-24,Marketing expenses,REF77825746,181.63,0.0,13182.78
2017-12-25,2017-12-25,Business travel,REF19303496,301.25,0.0,12881.53
2017-12-30,2017-12-30,Business meal,REF55355333,255.98,0.0,12625.55
2018-01-01,2018-01-01,Coworking space rental,REF85464793,379.65,0.0,12245.9
2018-01-03,2018-01-03,Business meal,REF65962633,263.74,0.0,11982.16
2018-01-06,2018-01-06,Business meal,REF43228606,315.37,0.0,11666.79
2018-01-12,2018-01-12,Marketing expenses,REF97918320,273.62,0.0,11393.17
2018-01-14,2018-01-14,Business travel,REF91187323,671.38,0.0,10721.79
2018-01-15,2018-01-15,Invoice payment - Erickson-Price,REF54087847,0.0,1345.1,12066.89
2018-01-15,2018-01-15,"Service payment - Miranda, Rodriguez and Myers",REF26971875,0.0,485.69,12552.58
2018-01-15,2018-01-15,Business insurance premium,REF37506034,162.72,0.0,12389.86
2018-01-15,2018-01-15,Invoice payment - Pugh and Sons,REF77710300,0.0,997.8,13387.66
2018-01-15,2018-01-15,Invoice payment - Spears-Brown,REF50060379,0.0,671.13,14058.79
2018-01-15,2018-01-15,Service payment - Campbell-Willis,REF33966742,0.0,677.22,14736.01
2018-01-15,2018-01-15,Payment from Simpson Inc,REF86834518,0.0,1164.23,15900.24
2018-01-15,2018-01-15,Project payment - White LLC,REF79560652,0.0,861.24,16761.48
2018-01-15,2018-01-15,"Invoice payment - Dennis, Henderson and Anderson",REF63001793,0.0,252.23,17013.71
2018-01-20,2018-01-20,Business meal,REF41573789,333.62,0.0,16680.09
2018-01-21,2018-01-21,Professional software license,REF95812609,215.17,0.0,16464.92
2018-01-24,2018-01-24,Marketing expenses,REF14119069,467.88,0.0,15997.04
2018-02-01,2018-02-01,Business meal,REF64968533,255.78,0.0,15741.26
2018-02-04,2018-02-04,Training/conference,REF58479779,155.5,0.0,15585.76
2018-02-05,2018-02-05,Business travel,REF39652945,357.02,0.0,15228.74
2018-02-11,2018-02-11,Coworking space rental,REF65592516,323.23,0.0,14905.51
2018-02-15,2018-02-15,"Payment from Dennis, Henderson and Anderson",REF65148448,0.0,208.06,15113.57
2018-02-15,2018-02-15,"Payment from Miranda, Rodriguez and Myers",REF51745378,0.0,495.89,15609.46
2018-02-15,2018-02-15,Project payment - Campbell-Willis,REF44728359,0.0,846.24,16455.7
2018-02-15,2018-02-15,Payment from Erickson-Price,REF28445248,0.0,1036.94,17492.64
2018-02-15,2018-02-15,Service payment - White LLC,REF96950718,0.0,982.82,18475.46
2018-02-15,2018-02-15,Service payment - Spears-Brown,REF18650243,0.0,419.08,18894.54
2018-02-15,2018-02-15,Payment from Simpson Inc,REF53530879,0.0,1422.97,20317.51
2018-02-15,2018-02-15,Business insurance premium,REF33648695,151.94,0.0,20165.57
2018-02-16,2018-02-16,Marketing expenses,REF46331023,429.19,0.0,19736.38
2018-02-16,2018-02-16,Coworking space rental,REF78004624,445.05,0.0,19291.33
2018-02-21,2018-02-21,Professional software license,REF10610651,213.22,0.0,19078.11
2018-02-24,2018-02-24,Business meal,REF85708105,245.45,0.0,18832.66
2018-03-07,2018-03-07,Business travel,REF89806444,525.93,0.0,18306.73
2018-03-08,2018-03-08,Business travel,REF99849958,419.25,0.0,17887.48
2018-03-11,2018-03-11,Accounting expense,REF75760416,86.55,0.0,17800.93
2018-03-12,2018-03-12,Business travel,REF50058878,245.88,0.0,17555.05
2018-03-15,2018-03-15,Invoice payment - Erickson-Price,REF54309258,0.0,991.31,18546.36
2018-03-15,2018-03-15,Payment from Simpson Inc,REF64491499,0.0,965.3,19511.66
2018-03-15,2018-03-15,"Invoice payment - Dennis, Henderson and Anderson",REF81876517,0.0,173.72,19685.38
2018-03-15,2018-03-15,Project payment - Spears-Brown,REF42987003,0.0,459.01,20144.39
2018-03-15,2018-03-15,Invoice payment - White LLC,REF32471431,0.0,876.97,21021.36
2018-03-15,2018-03-15,Project payment - Pugh and Sons,REF19173390,0.0,709.51,21730.87
2018-03-15,2018-03-15,"Payment from Miranda, Rodriguez and Myers",REF68142884,0.0,394.64,22125.51
2018-03-15,2018-03-15,Business insurance premium,REF56729676,130.23,0.0,21995.28
2018-03-16,2018-03-16,Training/conference,REF75607750,85.71,0.0,21909.57
2018-03-17,2018-03-17,Marketing expenses,REF21772180,296.77,0.0,21612.8
2018-03-21,2018-03-21,Professional software license,REF75561654,210.88,0.0,21401.92
2018-03-22,2018-03-22,Business meal,REF81159751,199.87,0.0,21202.05
2018-04-07,2018-04-07,Accounting expense,REF60883510,214.22,0.0,20987.83
2018-04-08,2018-04-08,Training/conference,REF77611624,256.69,0.0,20731.14
2018-04-09,2018-04-09,Coworking space rental,REF42264413,337.14,0.0,20394.0
2018-04-10,2018-04-10,Business travel,REF99645526,368.1,0.0,20025.9
2018-04-12,2018-04-12,Business travel,REF78034942,462.94,0.0,19562.96
2018-04-15,2018-04-15,Project payment - Erickson-Price,REF53147104,0.0,675.21,20238.17
2018-04-15,2018-04-15,Payment from Pugh and Sons,REF74796010,0.0,636.85,20875.02
2018-04-15,2018-04-15,"Payment from Dennis, Henderson and Anderson",REF26222830,0.0,209.24,21084.26
2018-04-15,2018-04-15,Invoice payment - Campbell-Willis,REF56137512,0.0,615.93,21700.19
2018-04-15,2018-04-15,Payment from Spears-Brown,REF21081980,0.0,443.61,22143.8
2018-04-15,2018-04-15,Project payment - Simpson Inc,REF86575511,0.0,1007.46,23151.26
2018-04-15,2018-04-15,Invoice payment - White LLC,REF18819617,0.0,677.21,23828.47
2018-04-15,2018-04-15,"Project payment - Miranda, Rodriguez and Myers",REF21205049,0.0,455.49,24283.96
2018-04-15,2018-04-15,Business insurance premium,REF27046399,126.95,0.0,24157.01
2018-04-17,2018-04-17,Business travel,REF55036769,640.85,0.0,23516.16
2018-04-21,2018-04-21,Professional software license,REF86302752,207.86,0.0,23308.3
2018-04-21,2018-04-21,Coworking space rental,REF84973094,514.74,0.0,22793.56
2018-04-23,2018-04-23,Training/conference,REF70888004,250.43,0.0,22543.13
2018-04-28,2018-04-28,Business travel,REF76300875,418.78,0.0,22124.35
2018-05-07,2018-05-07,Marketing expenses,REF15440356,224.85,0.0,21899.5
2018-05-15,2018-05-15,"Payment from Dennis, Henderson and Anderson",REF58977570,0.0,151.97,22051.47
2018-05-15,2018-05-15,Service payment - Spears-Brown,REF71750603,0.0,401.53,22453.0
2018-05-15,2018-05-15,Business travel,REF66333040,656.47,0.0,21796.53
2018-05-15,2018-05-15,Project payment - White LLC,REF64631490,0.0,502.33,22298.86
2018-05-15,2018-05-15,Business insurance premium,REF29974989,129.51,0.0,22169.35
2018-05-15,2018-05-15,Project payment - Simpson Inc,REF49784196,0.0,863.93,23033.28
2018-05-15,2018-05-15,"Project payment - Miranda, Rodriguez and Myers",REF89600462,0.0,273.36,23306.64
2018-05-15,2018-05-15,Service payment - Campbell-Willis,REF20877019,0.0,832.96,24139.6
2018-05-15,2018-05-15,Payment from Pugh and Sons,REF13110436,0.0,708.39,24847.99
2018-05-16,2018-05-16,Business travel,REF68470430,519.2,0.0,24328.79
2018-05-18,2018-05-18,Marketing expenses,REF23029955,411.86,0.0,23916.93
2018-05-21,2018-05-21,Professional software license,REF67369248,169.8,0.0,23747.13
2018-05-24,2018-05-24,Business travel,REF70470590,326.21,0.0,23420.92
2018-05-29,2018-05-29,Business travel,REF23117985,503.95,0.0,22916.97
2018-06-06,2018-06-06,Accounting expense,REF21163011,197.19,0.0,22719.78
2018-06-07,2018-06-07,Business meal,REF89493880,157.78,0.0,22562.0
2018-06-12,2018-06-12,Coworking space rental,REF29879695,223.6,0.0,22338.4
2018-06-13,2018-06-13,Coworking space rental,REF36943405,245.03,0.0,22093.37
2018-06-15,2018-06-15,Invoice payment - Campbell-Willis,REF36679836,0.0,508.12,22601.49
2018-06-15,2018-06-15,"Invoice payment - Miranda, Rodriguez and Myers",REF31909206,0.0,353.47,22954.96
2018-06-15,2018-06-15,Service payment - White LLC,REF23728810,0.0,550.11,23505.07
2018-06-15,2018-06-15,Business insurance premium,REF95753602,120.2,0.0,23384.87
2018-06-15,2018-06-15,Project payment - Simpson Inc,REF44426590,0.0,897.3,24282.17
2018-06-15,2018-06-15,Service payment - Pugh and Sons,REF75219534,0.0,613.81,24895.98
2018-06-15,2018-06-15,"Invoice payment - Dennis, Henderson and Anderson",REF91236657,0.0,132.01,25027.99
2018-06-15,2018-06-15,Project payment - Spears-Brown,REF52434247,0.0,394.77,25422.76
2018-06-15,2018-06-15,Accounting expense,REF17885253,60.08,0.0,25362.68
2018-06-21,2018-06-21,Professional software license,REF69696885,155.03,0.0,25207.65
2018-06-25,2018-06-25,Accounting expense,REF74378331,124.71,0.0,25082.94
2018-06-27,2018-06-27,Equipment purchase,REF48118341,52.99,0.0,25029.95
2018-07-02,2018-07-02,Equipment purchase,REF29562543,60.15,0.0,24969.8
2018-07-03,2018-07-03,Training/conference,REF68393798,142.97,0.0,24826.83
2018-07-15,2018-07-15,"Service payment - Dennis, Henderson and Anderson",REF99945891,0.0,166.3,24993.13
2018-07-15,2018-07-15,Service payment - Erickson-Price,REF12475315,0.0,661.79,25654.92
2018-07-15,2018-07-15,Payment from Pugh and Sons,REF57014855,0.0,524.67,26179.59
2018-07-15,2018-07-15,"Invoice payment - Miranda, Rodriguez and Myers",REF64521890,0.0,361.65,26541.24
2018-07-15,2018-07-15,Service payment - White LLC,REF70490360,0.0,588.35,27129.59
2018-07-15,2018-07-15,Project payment - Campbell-Willis,REF41685354,0.0,530.6,27660.19
2018-07-15,2018-07-15,Business insurance premium,REF45276114,98.76,0.0,27561.43
2018-07-19,2018-07-19,Equipment purchase,REF42068222,68.84,0.0,27492.59
2018-07-21,2018-07-21,Professional software license,REF64831208,133.43,0.0,27359.16
2018-07-24,2018-07-24,Accounting expense,REF42810114,149.01,0.0,27210.15
2018-08-05,2018-08-05,Coworking space rental,REF49116394,330.63,0.0,26879.52
2018-08-05,2018-08-05,Training/conference,REF69191426,193.9,0.0,26685.62
2018-08-13,2018-08-13,Coworking space rental,REF40931454,316.1,0.0,26369.52
2018-08-15,2018-08-15,Business insurance premium,REF17560970,113.54,0.0,26255.98
2018-08-15,2018-08-15,Payment from Erickson-Price,REF70937391,0.0,1028.57,27284.55
2018-08-15,2018-08-15,"Service payment - Miranda, Rodriguez and Myers",REF97972131,0.0,439.98,27724.53
2018-08-15,2018-08-15,Project payment - Simpson Inc,REF13404682,0.0,880.79,28605.32
2018-08-15,2018-08-15,Payment from Pugh and Sons,REF74368743,0.0,532.54,29137.86
2018-08-15,2018-08-15,Business travel,REF88370735,366.17,0.0,28771.69
2018-08-15,2018-08-15,Project payment - Campbell-Willis,REF44261560,0.0,515.6,29287.29
2018-08-15,2018-08-15,Payment from Spears-Brown,REF28886983,0.0,298.66,29585.95
2018-08-15,2018-08-15,"Project payment - Dennis, Henderson and Anderson",REF76364036,0.0,132.63,29718.58
2018-08-18,2018-08-18,Business travel,REF54929776,304.89,0.0,29413.69
2018-08-21,2018-08-21,Professional software license,REF54618241,124.41,0.0,29289.28
2018-08-26,2018-08-26,Accounting expense,REF79701714,157.03,0.0,29132.25
2018-08-27,2018-08-27,Equipment purchase,REF38438893,62.44,0.0,29069.81
2018-08-28,2018-08-28,Business meal,REF57806248,289.81,0.0,28780.0
2018-09-11,2018-09-11,Business travel,REF11539642,404.47,0.0,28375.53
2018-09-15,2018-09-15,Business insurance premium,REF30741045,148.27,0.0,28227.26
2018-09-15,2018-09-15,"Payment from Miranda, Rodriguez and Myers",REF54502571,0.0,450.56,28677.82
2018-09-15,2018-09-15,Project payment - Pugh and Sons,REF62451150,0.0,938.59,29616.41
2018-09-15,2018-09-15,Marketing expenses,REF45535452,334.11,0.0,29282.3
2018-09-15,2018-09-15,Payment from Campbell-Willis,REF30787371,0.0,770.87,30053.17
2018-09-15,2018-09-15,Service payment - Erickson-Price,REF31152103,0.0,1099.0,31152.17
2018-09-15,2018-09-15,"Payment from Dennis, Henderson and Anderson",REF78621690,0.0,228.56,31380.73
2018-09-15,2018-09-15,Project payment - Spears-Brown,REF18180597,0.0,486.01,31866.74
2018-09-15,2018-09-15,Business meal,REF84443536,196.53,0.0,31670.21
2018-09-15,2018-09-15,Service payment - Simpson Inc,REF29135098,0.0,749.95,32420.16
2018-09-21,2018-09-21,Professional software license,REF52375556,205.27,0.0,32214.89
2018-10-02,2018-10-02,Equipment purchase,REF84687297,110.7,0.0,32104.19
2018-10-07,2018-10-07,Business meal,REF53100416,476.86,0.0,31627.33
2018-10-07,2018-10-07,Accounting expense,REF11302461,252.7,0.0,31374.63
2018-10-08,2018-10-08,Coworking space rental,REF60747225,388.53,0.0,30986.1
2018-10-09,2018-10-09,Coworking space rental,REF66895339,338.12,0.0,30647.98
2018-10-10,2018-10-10,Business meal,REF70913466,218.35,0.0,30429.63
2018-10-11,2018-10-11,Equipment purchase,REF18854952,150.67,0.0,30278.96
2018-10-11,2018-10-11,Business meal,REF87312943,476.31,0.0,29802.65
2018-10-13,2018-10-13,Accounting expense,REF15897294,261.11,0.0,29541.54
2018-10-15,2018-10-15,Invoice payment - Spears-Brown,REF14714235,0.0,586.93,30128.47
2018-10-15,2018-10-15,"Project payment - Dennis, Henderson and Anderson",REF16792983,0.0,212.7,30341.17
2018-10-15,2018-10-15,Payment from Pugh and Sons,REF35450394,0.0,483.35,30824.52
2018-10-15,2018-10-15,Invoice payment - White LLC,REF87156053,0.0,814.27,31638.79
2018-10-15,2018-10-15,Invoice payment - Campbell-Willis,REF43974199,0.0,850.72,32489.51
2018-10-15,2018-10-15,Invoice payment - Simpson Inc,REF99578301,0.0,1558.84,34048.35
2018-10-15,2018-10-15,Project payment - Erickson-Price,REF62641434,0.0,1279.36,35327.71
2018-10-15,2018-10-15,Business insurance premium,REF32499519,173.44,0.0,35154.27
2018-10-15,2018-10-15,"Project payment - Miranda, Rodriguez and Myers",REF84550797,0.0,443.19,35597.46
2018-10-16,2018-10-16,Coworking space rental,REF44929009,549.19,0.0,35048.27
2018-10-18,2018-10-18,Marketing expenses,REF64304927,280.23,0.0,34768.04
2018-10-21,2018-10-21,Professional software license,REF70158458,266.93,0.0,34501.11
2018-10-25,2018-10-25,Training/conference,REF35146070,164.08,0.0,34337.03
2018-10-27,2018-10-27,Marketing expenses,REF96926832,122.32,0.0,34214.71
2018-10-27,2018-10-27,Business travel,REF23985203,137.67,0.0,34077.04
2018-11-04,2018-11-04,Business travel,REF15214699,626.7,0.0,33450.34
2018-11-04,2018-11-04,Accounting expense,REF57223639,203.74,0.0,33246.6
2018-11-06,2018-11-06,Accounting expense,REF49838050,251.78,0.0,32994.82
2018-11-13,2018-11-13,Business meal,REF93026123,171.87,0.0,32822.95
2018-11-15,2018-11-15,"Project payment - Miranda, Rodriguez and Myers",REF78482723,0.0,599.82,33422.77
2018-11-15,2018-11-15,Payment from Pugh and Sons,REF99146080,0.0,750.43,34173.2
2018-11-15,2018-11-15,Project payment - Erickson-Price,REF78509571,0.0,1088.45,35261.65
2018-11-15,2018-11-15,Business travel,REF78270167,444.75,0.0,34816.9
2018-11-15,2018-11-15,Project payment - Simpson Inc,REF88195230,0.0,1241.58,36058.48
2018-11-15,2018-11-15,Project payment - Spears-Brown,REF25704237,0.0,579.69,36638.17
2018-11-15,2018-11-15,Payment from Campbell-Willis,REF99330401,0.0,723.36,37361.53
2018-11-15,2018-11-15,"Service payment - Dennis, Henderson and Anderson",REF90858159,0.0,209.53,37571.06
2018-11-15,2018-11-15,Business insurance premium,REF32645596,166.79,0.0,37404.27
2018-11-16,2018-11-16,Training/conference,REF63513622,223.51,0.0,37180.76
2018-11-21,2018-11-21,Professional software license,REF63338483,221.01,0.0,36959.75
2018-11-23,2018-11-23,Marketing expenses,REF30961511,324.99,0.0,36634.76
2018-12-05,2018-12-05,Accounting expense,REF13633059,99.57,0.0,36535.19
2018-12-09,2018-12-09,Business meal,REF26944457,246.08,0.0,36289.11
2018-12-11,2018-12-11,Business travel,REF70347676,436.29,0.0,35852.82
2018-12-15,2018-12-15,Payment from White LLC,REF60504189,0.0,742.67,36595.49
2018-12-15,2018-12-15,"Invoice payment - Dennis, Henderson and Anderson",REF28580096,0.0,226.98,36822.47
2018-12-15,2018-12-15,"Project payment - Miranda, Rodriguez and Myers",REF48917448,0.0,447.0,37269.47
2018-12-15,2018-12-15,Project payment - Erickson-Price,REF58574190,0.0,746.34,38015.81
2018-12-15,2018-12-15,Business insurance premium,REF49148792,132.46,0.0,37883.35
2018-12-15,2018-12-15,Project payment - Simpson Inc,REF39578916,0.0,872.72,38756.07
2018-12-15,2018-12-15,Project payment - Campbell-Willis,REF14696001,0.0,538.0,39294.07
2018-12-15,2018-12-15,Invoice payment - Pugh and Sons,REF15762382,0.0,554.31,39848.38
2018-12-16,2018-12-16,Training/conference,REF72224132,199.92,0.0,39648.46
2018-12-19,2018-12-19,Business travel,REF64034273,323.67,0.0,39324.79
2018-12-21,2018-12-21,Professional software license,REF76934617,143.51,0.0,39181.28
2018-12-29,2018-12-29,Business meal,REF44031718,287.48,0.0,38893.8
2019-01-03,2019-01-03,Business meal,REF30988274,205.85,0.0,38687.95
2019-01-06,2019-01-06,Coworking space rental,REF31266728,585.3,0.0,38102.65
2019-01-07,2019-01-07,Coworking space rental,REF69885145,340.9,0.0,37761.75
2019-01-08,2019-01-08,Equipment purchase,REF86618625,251.23,0.0,37510.52
2019-01-09,2019-01-09,Equipment purchase,REF73965689,185.32,0.0,37325.2
2019-01-10,2019-01-10,Business meal,REF60423499,283.21,0.0,37041.99
2019-01-14,2019-01-14,Business meal,REF81877306,435.51,0.0,36606.48
2019-01-15,2019-01-15,Project payment - Erickson-Price,REF43977793,0.0,1386.21,37992.69
2019-01-15,2019-01-15,Payment from Pugh and Sons,REF75207949,0.0,964.59,38957.28
2019-01-15,2019-01-15,Invoice payment - Simpson Inc,REF80102123,0.0,1115.37,40072.65
2019-01-15,2019-01-15,Project payment - White LLC,REF93271519,0.0,564.9,40637.55
2019-01-15,2019-01-15,Business insurance premium,REF19461493,164.59,0.0,40472.96
2019-01-15,2019-01-15,"Payment from Miranda, Rodriguez and Myers",REF60768079,0.0,590.23,41063.19
2019-01-18,2019-01-18,Business travel,REF49926257,485.02,0.0,40578.17
2019-01-21,2019-01-21,Professional software license,REF76073271,255.7,0.0,40322.47
2019-01-29,2019-01-29,Coworking space rental,REF45034637,256.23,0.0,40066.24
2019-01-30,2019-01-30,Business travel,REF77911242,408.95,0.0,39657.29
2019-02-12,2019-02-12,Coworking space rental,REF69316401,289.11,0.0,39368.18
2019-02-13,2019-02-13,Business meal,REF42538538,237.33,0.0,39130.85
2019-02-15,2019-02-15,"Project payment - Miranda, Rodriguez and Myers",REF19817189,0.0,492.78,39623.63
2019-02-15,2019-02-15,"Invoice payment - Dennis, Henderson and Anderson",REF79231031,0.0,197.48,39821.11
2019-02-15,2019-02-15,Service payment - Simpson Inc,REF58836385,0.0,1201.57,41022.68
2019-02-15,2019-02-15,Project payment - White LLC,REF24745462,0.0,899.69,41922.37
2019-02-15,2019-02-15,Accounting expense,REF34868594,174.42,0.0,41747.95
2019-02-15,2019-02-15,Invoice payment - Pugh and Sons,REF51957455,0.0,800.6,42548.55
2019-02-15,2019-02-15,Project payment - Campbell-Willis,REF77836004,0.0,968.01,43516.56
2019-02-15,2019-02-15,Invoice payment - Erickson-Price,REF97783575,0.0,1155.88,44672.44
2019-02-15,2019-02-15,Project payment - Spears-Brown,REF74352426,0.0,460.25,45132.69
2019-02-15,2019-02-15,Business insurance premium,REF57939760,151.66,0.0,44981.03
2019-02-21,2019-02-21,Professional software license,REF81149140,206.4,0.0,44774.63
2019-02-23,2019-02-23,Accounting expense,REF22940290,158.27,0.0,44616.36
2019-02-23,2019-02-23,Marketing expenses,REF24809225,456.76,0.0,44159.6
2019-03-01,2019-03-01,Business travel,REF89246242,266.49,0.0,43893.11
2019-03-03,2019-03-03,Business meal,REF95010807,355.84,0.0,43537.27
2019-03-07,2019-03-07,Business meal,REF23535293,294.05,0.0,43243.22
2019-03-15,2019-03-15,Business insurance premium,REF78571382,132.02,0.0,43111.2
2019-03-15,2019-03-15,Invoice payment - Campbell-Willis,REF65585389,0.0,711.73,43822.93
2019-03-15,2019-03-15,Project payment - Erickson-Price,REF72723974,0.0,933.37,44756.3
2019-03-15,2019-03-15,Service payment - Pugh and Sons,REF89476634,0.0,744.87,45501.17
2019-03-15,2019-03-15,"Invoice payment - Dennis, Henderson and Anderson",REF79332042,0.0,183.14,45684.31
2019-03-15,2019-03-15,"Invoice payment - Miranda, Rodriguez and Myers",REF21120971,0.0,424.15,46108.46
2019-03-15,2019-03-15,Project payment - Spears-Brown,REF38840071,0.0,397.23,46505.69
2019-03-15,2019-03-15,Service payment - White LLC,REF84845019,0.0,826.08,47331.77
2019-03-16,2019-03-16,Business travel,REF23637540,448.48,0.0,46883.29
2019-03-21,2019-03-21,Professional software license,REF91395512,183.05,0.0,46700.24
2019-03-25,2019-03-25,Training/conference,REF92525927,122.65,0.0,46577.59
2019-04-01,2019-04-01,Business travel,REF84666904,346.99,0.0,46230.6
2019-04-03,2019-04-03,Marketing expenses,REF51075221,269.79,0.0,45960.81
2019-04-04,2019-04-04,Accounting expense,REF29327796,240.98,0.0,45719.83
2019-04-12,2019-04-12,Business travel,REF73209409,93.28,0.0,45626.55
2019-04-15,2019-04-15,Payment from Simpson Inc,REF21271090,0.0,1007.77,46634.32
2019-04-15,2019-04-15,Payment from White LLC,REF27450310,0.0,709.22,47343.54
2019-04-15,2019-04-15,Business insurance premium,REF94527809,130.47,0.0,47213.07
2019-04-15,2019-04-15,Project payment - Pugh and Sons,REF71398730,0.0,720.04,47933.11
2019-04-15,2019-04-15,Service payment - Spears-Brown,REF46927742,0.0,554.35,48487.46
2019-04-15,2019-04-15,"Project payment - Miranda, Rodriguez and Myers",REF30152862,0.0,405.18,48892.64
2019-04-15,2019-04-15,Service payment - Erickson-Price,REF26183341,0.0,1125.86,50018.5
2019-04-15,2019-04-15,"Service payment - Dennis, Henderson and Anderson",REF52488909,0.0,201.51,50220.01
2019-04-21,2019-04-21,Professional software license,REF56675849,201.13,0.0,50018.88
2019-04-30,2019-04-30,Accounting expense,REF59143964,392.4,0.0,49626.48
2019-04-30,2019-04-30,Coworking space rental,REF82346125,405.88,0.0,49220.6
2019-05-02,2019-05-02,Business travel,REF57018960,290.99,0.0,48929.61
2019-05-06,2019-05-06,Training/conference,REF54717149,198.87,0.0,48730.74
2019-05-07,2019-05-07,Business travel,REF67688061,335.55,0.0,48395.19
2019-05-08,2019-05-08,Training/conference,REF44502555,176.88,0.0,48218.31
2019-05-13,2019-05-13,Accounting expense,REF74540124,94.26,0.0,48124.05
2019-05-15,2019-05-15,Business insurance premium,REF19956997,132.65,0.0,47991.4
2019-05-15,2019-05-15,Service payment - Simpson Inc,REF37657326,0.0,1062.59,49053.99
2019-05-15,2019-05-15,Payment from White LLC,REF78690279,0.0,869.61,49923.6
2019-05-15,2019-05-15,Invoice payment - Campbell-Willis,REF91584078,0.0,548.94,50472.54
2019-05-15,2019-05-15,Payment from Pugh and Sons,REF38136932,0.0,735.17,51207.71
2019-05-15,2019-05-15,Payment from Spears-Brown,REF41619906,0.0,373.04,51580.75
2019-05-15,2019-05-15,Invoice payment - Erickson-Price,REF63427925,0.0,1020.41,52601.16
2019-05-15,2019-05-15,"Payment from Miranda, Rodriguez and Myers",REF33032181,0.0,379.8,52980.96
2019-05-21,2019-05-21,Professional software license,REF84412016,206.44,0.0,52774.52
2019-05-28,2019-05-28,Marketing expenses,REF26755918,165.69,0.0,52608.83
2019-05-30,2019-05-30,Training/conference,REF40159784,161.4,0.0,52447.43
2019-05-30,2019-05-30,Business travel,REF87894049,377.79,0.0,52069.64
2019-06-10,2019-06-10,Coworking space rental,REF35352101,197.68,0.0,51871.96
2019-06-13,2019-06-13,Training/conference,REF97159957,137.98,0.0,51733.98
2019-06-15,2019-06-15,Service payment - Campbell-Willis,REF44462013,0.0,424.01,52157.99
2019-06-15,2019-06-15,"Project payment - Miranda, Rodriguez and Myers",REF15438848,0.0,309.11,52467.1
2019-06-15,2019-06-15,Business insurance premium,REF20902612,107.9,0.0,52359.2
2019-06-15,2019-06-15,Payment from White LLC,REF55827731,0.0,611.57,52970.77
2019-06-15,2019-06-15,Payment from Erickson-Price,REF30223692,0.0,817.81,53788.58
2019-06-15,2019-06-15,Invoice payment - Spears-Brown,REF27791284,0.0,359.13,54147.71
2019-06-15,2019-06-15,"Payment from Dennis, Henderson and Anderson",REF98137049,0.0,163.28,54310.99
2019-06-15,2019-06-15,Payment from Simpson Inc,REF73139887,0.0,1050.16,55361.15
2019-06-15,2019-06-15,Invoice payment - Pugh and Sons,REF68425109,0.0,735.22,56096.37
2019-06-16,2019-06-16,Coworking space rental,REF92480177,218.62,0.0,55877.75
2019-06-21,2019-06-21,Professional software license,REF49297295,133.45,0.0,55744.3
2019-06-21,2019-06-21,Equipment purchase,REF10188421,146.12,0.0,55598.18
2019-06-22,2019-06-22,Coworking space rental,REF66253317,261.09,0.0,55337.09
2019-06-25,2019-06-25,Marketing expenses,REF91989449,246.91,0.0,55090.18
2019-06-26,2019-06-26,Business travel,REF33888198,281.16,0.0,54809.02
2019-06-28,2019-06-28,Business travel,REF57471926,297.99,0.0,54511.03
2019-06-28,2019-06-28,Accounting expense,REF85272974,213.19,0.0,54297.84
2019-07-06,2019-07-06,Business meal,REF32164491,225.68,0.0,54072.16
2019-07-15,2019-07-15,Invoice payment - Simpson Inc,REF42119305,0.0,727.98,54800.14
2019-07-15,2019-07-15,Project payment - Spears-Brown,REF16295911,0.0,365.21,55165.35
2019-07-15,2019-07-15,Service payment - Campbell-Willis,REF26349464,0.0,497.66,55663.01
2019-07-15,2019-07-15,Service payment - Pugh and Sons,REF91488092,0.0,429.04,56092.05
2019-07-15,2019-07-15,Business insurance premium,REF58344585,106.29,0.0,55985.76
2019-07-15,2019-07-15,Project payment - White LLC,REF88246173,0.0,646.79,56632.55
2019-07-15,2019-07-15,Invoice payment - Erickson-Price,REF35024267,0.0,725.62,57358.17
2019-07-17,2019-07-17,Accounting expense,REF16781210,148.26,0.0,57209.91
2019-07-18,2019-07-18,Marketing expenses,REF95684452,231.11,0.0,56978.8
2019-07-21,2019-07-21,Professional software license,REF52006451,102.66,0.0,56876.14
2019-07-26,2019-07-26,Coworking space rental,REF49257007,233.29,0.0,56642.85
2019-07-28,2019-07-28,Marketing expenses,REF60707063,176.49,0.0,56466.36
2019-07-30,2019-07-30,Accounting expense,REF33187738,89.17,0.0,56377.19
2019-08-02,2019-08-02,Business meal,REF77133575,158.28,0.0,56218.91
2019-08-07,2019-08-07,Marketing expenses,REF30480259,79.6,0.0,56139.31
2019-08-09,2019-08-09,Business meal,REF53364528,255.57,0.0,55883.74
2019-08-10,2019-08-10,Business travel,REF88941036,268.53,0.0,55615.21
2019-08-12,2019-08-12,Training/conference,REF93990656,197.33,0.0,55417.88
2019-08-15,2019-08-15,Project payment - Spears-Brown,REF58064198,0.0,353.36,55771.24
2019-08-15,2019-08-15,Business insurance premium,REF98162796,107.7,0.0,55663.54
2019-08-15,2019-08-15,Invoice payment - Pugh and Sons,REF26580026,0.0,744.09,56407.63
2019-08-15,2019-08-15,Project payment - Simpson Inc,REF73165793,0.0,821.91,57229.54
2019-08-15,2019-08-15,Project payment - White LLC,REF66763287,0.0,577.13,57806.67
2019-08-15,2019-08-15,"Invoice payment - Miranda, Rodriguez and Myers",REF71125757,0.0,392.31,58198.98
2019-08-15,2019-08-15,"Invoice payment - Dennis, Henderson and Anderson",REF68463321,0.0,154.24,58353.22
2019-08-15,2019-08-15,Payment from Campbell-Willis,REF80170744,0.0,560.49,58913.71
2019-08-17,2019-08-17,Business meal,REF71681834,128.03,0.0,58785.68
2019-08-21,2019-08-21,Professional software license,REF36974630,165.41,0.0,58620.27
2019-08-27,2019-08-27,Training/conference,REF41752705,96.12,0.0,58524.15
2019-08-28,2019-08-28,Coworking space rental,REF44736261,296.19,0.0,58227.96
2019-08-30,2019-08-30,Coworking space rental,REF94059849,279.87,0.0,57948.09
2019-09-02,2019-09-02,Marketing expenses,REF48794145,380.29,0.0,57567.8
2019-09-15,2019-09-15,Invoice payment - Pugh and Sons,REF53328348,0.0,635.28,58203.08
2019-09-15,2019-09-15,Invoice payment - White LLC,REF25383217,0.0,726.04,58929.12
2019-09-15,2019-09-15,"Payment from Miranda, Rodriguez and Myers",REF76986400,0.0,524.33,59453.45
2019-09-15,2019-09-15,Service payment - Erickson-Price,REF34384212,0.0,840.97,60294.42
2019-09-15,2019-09-15,Invoice payment - Simpson Inc,REF32909197,0.0,1158.99,61453.41
2019-09-15,2019-09-15,Project payment - Campbell-Willis,REF13447886,0.0,734.37,62187.78
2019-09-15,2019-09-15,Business insurance premium,REF52334251,167.84,0.0,62019.94
2019-09-21,2019-09-21,Professional software license,REF75550677,182.78,0.0,61837.16
2019-09-28,2019-09-28,Equipment purchase,REF81759503,72.84,0.0,61764.32
2019-09-30,2019-09-30,Business meal,REF65179734,252.23,0.0,61512.09
2019-10-02,2019-10-02,Equipment purchase,REF42081819,218.15,0.0,61293.94
2019-10-09,2019-10-09,Equipment purchase,REF60246564,272.77,0.0,61021.17
2019-10-10,2019-10-10,Accounting expense,REF63438154,256.99,0.0,60764.18
2019-10-15,2019-10-15,Business insurance premium,REF56364500,174.03,0.0,60590.15
2019-10-15,2019-10-15,Invoice payment - Campbell-Willis,REF15800578,0.0,862.8,61452.95
2019-10-15,2019-10-15,Payment from Pugh and Sons,REF21509246,0.0,767.44,62220.39
2019-10-15,2019-10-15,Invoice payment - White LLC,REF48371910,0.0,1109.07,63329.46
2019-10-15,2019-10-15,Invoice payment - Spears-Brown,REF42918561,0.0,533.5,63862.96
2019-10-15,2019-10-15,"Project payment - Miranda, Rodriguez and Myers",REF74612152,0.0,557.08,64420.04
2019-10-15,2019-10-15,Invoice payment - Erickson-Price,REF36928466,0.0,1326.39,65746.43
2019-10-15,2019-10-15,Payment from Simpson Inc,REF40033237,0.0,1774.58,67521.01
2019-10-21,2019-10-21,Professional software license,REF76449409,220.46,0.0,67300.55
2019-10-27,2019-10-27,Coworking space rental,REF29276209,355.01,0.0,66945.54
2019-11-02,2019-11-02,Business meal,REF16146163,369.74,0.0,66575.8
2019-11-08,2019-11-08,Coworking space rental,REF44103479,209.45,0.0,66366.35
2019-11-09,2019-11-09,Marketing expenses,REF27108015,353.28,0.0,66013.07
2019-11-12,2019-11-12,Training/conference,REF64830028,357.64,0.0,65655.43
2019-11-15,2019-11-15,Project payment - Spears-Brown,REF94736282,0.0,448.54,66103.97
2019-11-15,2019-11-15,"Service payment - Dennis, Henderson and Anderson",REF38990329,0.0,274.3,66378.27
2019-11-15,2019-11-15,Business insurance premium,REF78985480,155.8,0.0,66222.47
2019-11-15,2019-11-15,"Payment from Miranda, Rodriguez and Myers",REF64010700,0.0,505.98,66728.45
2019-11-15,2019-11-15,Payment from Simpson Inc,REF83929035,0.0,1242.02,67970.47
2019-11-15,2019-11-15,Project payment - Pugh and Sons,REF61262420,0.0,989.21,68959.68
2019-11-15,2019-11-15,Service payment - Erickson-Price,REF40415102,0.0,971.05,69930.73
2019-11-17,2019-11-17,Training/conference,REF10064929,238.91,0.0,69691.82
2019-11-19,2019-11-19,Business travel,REF78815176,454.0,0.0,69237.82
2019-11-21,2019-11-21,Equipment purchase,REF74503614,227.34,0.0,69010.48
2019-11-21,2019-11-21,Professional software license,REF19124043,192.54,0.0,68817.94
2019-11-23,2019-11-23,Marketing expenses,REF96607800,338.43,0.0,68479.51
2019-11-28,2019-11-28,Business travel,REF95975131,539.31,0.0,67940.2
2019-11-29,2019-11-29,Training/conference,REF82473134,257.88,0.0,67682.32
2019-11-30,2019-11-30,Coworking space rental,REF84428118,362.75,0.0,67319.57
2019-12-15,2019-12-15,"Service payment - Dennis, Henderson and Anderson",REF73505145,0.0,174.82,67494.39
2019-12-15,2019-12-15,Payment from Simpson Inc,REF22711710,0.0,991.1,68485.49
2019-12-15,2019-12-15,Service payment - Spears-Brown,REF62514059,0.0,327.73,68813.22
2019-12-15,2019-12-15,Service payment - Campbell-Willis,REF19538413,0.0,492.16,69305.38
2019-12-15,2019-12-15,Service payment - White LLC,REF12197845,0.0,785.33,70090.71
2019-12-15,2019-12-15,"Payment from Miranda, Rodriguez and Myers",REF54681793,0.0,384.04,70474.75
2019-12-15,2019-12-15,Project payment - Erickson-Price,REF69843261,0.0,1074.69,71549.44
2019-12-15,2019-12-15,Business insurance premium,REF82886379,130.05,0.0,71419.39
2019-12-17,2019-12-17,Coworking space rental,REF35009643,343.48,0.0,71075.91
2019-12-18,2019-12-18,Accounting expense,REF69891472,228.44,0.0,70847.47
2019-12-20,2019-12-20,Coworking space rental,REF96991210,335.38,0.0,70512.09
2019-12-21,2019-12-21,Professional software license,REF36206226,175.08,0.0,70337.01
2019-12-28,2019-12-28,Training/conference,REF34250660,181.03,0.0,70155.98
2020-01-01,2020-01-01,Accounting expense,REF61552970,218.8,0.0,69937.18
2020-01-04,2020-01-04,Business meal,REF36182990,385.17,0.0,69552.01
2020-01-09,2020-01-09,Marketing expenses,REF53357773,282.13,0.0,69269.88
2020-01-13,2020-01-13,Equipment purchase,REF79459735,149.04,0.0,69120.84
2020-01-15,2020-01-15,Business insurance premium,REF65359831,166.21,0.0,68954.63
2020-01-15,2020-01-15,Invoice payment - Simpson Inc,REF91485628,0.0,994.48,69949.11
2020-01-15,2020-01-15,Payment from Spears-Brown,REF84764814,0.0,698.52,70647.63
2020-01-15,2020-01-15,Service payment - White LLC,REF50006878,0.0,661.65,71309.28
2020-01-15,2020-01-15,Service payment - Pugh and Sons,REF72811338,0.0,631.92,71941.2
2020-01-15,2020-01-15,Payment from Campbell-Willis,REF33944810,0.0,808.35,72749.55
2020-01-15,2020-01-15,"Invoice payment - Miranda, Rodriguez and Myers",REF80297860,0.0,483.91,73233.46
2020-01-15,2020-01-15,"Payment from Dennis, Henderson and Anderson",REF22721599,0.0,285.87,73519.33
2020-01-21,2020-01-21,Professional software license,REF24160039,206.08,0.0,73313.25
2020-01-23,2020-01-23,Coworking space rental,REF94643935,152.57,0.0,73160.68
2020-01-28,2020-01-28,Business meal,REF27968391,210.72,0.0,72949.96
2020-01-29,2020-01-29,Coworking space rental,REF65516130,345.39,0.0,72604.57
2020-01-30,2020-01-30,Marketing expenses,REF22460171,279.34,0.0,72325.23
2020-01-31,2020-01-31,Training/conference,REF83149412,356.19,0.0,71969.04
2020-02-04,2020-02-04,Marketing expenses,REF68801818,415.27,0.0,71553.77
2020-02-08,2020-02-08,Business meal,REF62747697,276.08,0.0,71277.69
2020-02-15,2020-02-15,Business insurance premium,REF55289153,152.87,0.0,71124.82
2020-02-15,2020-02-15,Service payment - Pugh and Sons,REF69313438,0.0,767.04,71891.86
2020-02-15,2020-02-15,"Payment from Miranda, Rodriguez and Myers",REF43321953,0.0,603.65,72495.51
2020-02-15,2020-02-15,Project payment - White LLC,REF77223321,0.0,1061.51,73557.02
2020-02-15,2020-02-15,"Project payment - Dennis, Henderson and Anderson",REF33552635,0.0,240.01,73797.03
2020-02-15,2020-02-15,Payment from Simpson Inc,REF57383390,0.0,993.53,74790.56
2020-02-15,2020-02-15,Project payment - Spears-Brown,REF64959991,0.0,593.81,75384.37
2020-02-15,2020-02-15,Payment from Erickson-Price,REF97925093,0.0,1309.83,76694.2
2020-02-15,2020-02-15,Payment from Campbell-Willis,REF53375943,0.0,745.12,77439.32
2020-02-21,2020-02-21,Professional software license,REF12622215,227.27,0.0,77212.05
2020-02-21,2020-02-21,Coworking space rental,REF72308156,389.24,0.0,76822.81
2020-02-23,2020-02-23,Coworking space rental,REF46739900,311.85,0.0,76510.96
2020-03-07,2020-03-07,Coworking space rental,REF84106026,234.73,0.0,76276.23
2020-03-09,2020-03-09,Marketing expenses,REF86720437,274.76,0.0,76001.47
2020-03-12,2020-03-12,Business meal,REF29007543,207.52,0.0,75793.95
2020-03-15,2020-03-15,Project payment - Campbell-Willis,REF91113297,0.0,798.62,76592.57
2020-03-15,2020-03-15,Project payment - White LLC,REF73397481,0.0,759.38,77351.95
2020-03-15,2020-03-15,Project payment - Spears-Brown,REF70622220,0.0,520.6,77872.55
2020-03-15,2020-03-15,Payment from Erickson-Price,REF87918567,0.0,1320.78,79193.33
2020-03-15,2020-03-15,Business insurance premium,REF27081943,141.05,0.0,79052.28
2020-03-15,2020-03-15,"Invoice payment - Dennis, Henderson and Anderson",REF58408371,0.0,217.25,79269.53
2020-03-15,2020-03-15,Invoice payment - Simpson Inc,REF95325024,0.0,872.36,80141.89
2020-03-15,2020-03-15,"Invoice payment - Miranda, Rodriguez and Myers",REF42602187,0.0,505.07,80646.96
2020-03-17,2020-03-17,Accounting expense,REF20184886,193.53,0.0,80453.43
2020-03-20,2020-03-20,Business travel,REF62086774,332.42,0.0,80121.01
2020-03-21,2020-03-21,Professional software license,REF66681548,201.22,0.0,79919.79
2020-03-23,2020-03-23,Equipment purchase,REF97934414,76.02,0.0,79843.77
2020-03-25,2020-03-25,Marketing expenses,REF81802419,119.55,0.0,79724.22
2020-03-30,2020-03-30,Equipment purchase,REF90020367,158.19,0.0,79566.03
2020-04-04,2020-04-04,Business meal,REF20356605,293.72,0.0,79272.31
2020-04-06,2020-04-06,Business meal,REF76627912,182.9,0.0,79089.41
2020-04-10,2020-04-10,Equipment purchase,REF96490581,153.99,0.0,78935.42
2020-04-15,2020-04-15,Payment from Simpson Inc,REF66207789,0.0,816.28,79751.7
2020-04-15,2020-04-15,"Project payment - Miranda, Rodriguez and Myers",REF62676979,0.0,552.55,80304.25
2020-04-15,2020-04-15,Payment from White LLC,REF94371104,0.0,797.38,81101.63
2020-04-15,2020-04-15,Service payment - Erickson-Price,REF16837716,0.0,1180.77,82282.4
2020-04-15,2020-04-15,Payment from Campbell-Willis,REF50301707,0.0,713.0,82995.4
2020-04-15,2020-04-15,Business insurance premium,REF44085921,146.58,0.0,82848.82
2020-04-15,2020-04-15,Invoice payment - Spears-Brown,REF84026644,0.0,433.38,83282.2
2020-04-15,2020-04-15,"Invoice payment - Dennis, Henderson and Anderson",REF57229554,0.0,235.15,83517.35
2020-04-17,2020-04-17,Business meal,REF87405647,207.81,0.0,83309.54
2020-04-18,2020-04-18,Coworking space rental,REF78130044,162.93,0.0,83146.61
2020-04-21,2020-04-21,Professional software license,REF81823546,196.27,0.0,82950.34
2020-04-23,2020-04-23,Business travel,REF92626398,531.32,0.0,82419.02
2020-04-23,2020-04-23,Accounting expense,REF63753223,203.12,0.0,82215.9
2020-04-26,2020-04-26,Marketing expenses,REF29874288,243.63,0.0,81972.27
2020-04-28,2020-04-28,Equipment purchase,REF67537101,48.06,0.0,81924.21
2020-05-02,2020-05-02,Business meal,REF45886539,213.12,0.0,81711.09
2020-05-11,2020-05-11,Equipment purchase,REF40167918,154.17,0.0,81556.92
2020-05-13,2020-05-13,Accounting expense,REF70880634,202.54,0.0,81354.38
2020-05-15,2020-05-15,Service payment - Erickson-Price,REF30612483,0.0,1187.33,82541.71
2020-05-15,2020-05-15,"Payment from Dennis, Henderson and Anderson",REF78366471,0.0,189.74,82731.45
2020-05-15,2020-05-15,Payment from Campbell-Willis,REF89145372,0.0,568.61,83300.06
2020-05-15,2020-05-15,Invoice payment - White LLC,REF97293384,0.0,632.78,83932.84
2020-05-15,2020-05-15,Payment from Simpson Inc,REF73539053,0.0,898.51,84831.35
2020-05-15,2020-05-15,Project payment - Pugh and Sons,REF53461224,0.0,524.72,85356.07
2020-05-15,2020-05-15,Business insurance premium,REF74492528,121.2,0.0,85234.87
2020-05-15,2020-05-15,"Service payment - Miranda, Rodriguez and Myers",REF71566283,0.0,366.52,85601.39
2020-05-21,2020-05-21,Professional software license,REF75538743,172.59,0.0,85428.8
2020-05-29,2020-05-29,Business meal,REF25272711,188.04,0.0,85240.76
2020-06-01,2020-06-01,Equipment purchase,REF80708810,147.13,0.0,85093.63
2020-06-01,2020-06-01,Accounting expense,REF62701696,129.78,0.0,84963.85
2020-06-02,2020-06-02,Training/conference,REF34466919,154.05,0.0,84809.8
2020-06-03,2020-06-03,Training/conference,REF42597887,173.44,0.0,84636.36
2020-06-06,2020-06-06,Business meal,REF63097984,296.63,0.0,84339.73
2020-06-07,2020-06-07,Accounting expense,REF30200448,215.67,0.0,84124.06
2020-06-15,2020-06-15,Invoice payment - Spears-Brown,REF91986233,0.0,442.75,84566.81
2020-06-15,2020-06-15,Service payment - Campbell-Willis,REF12322173,0.0,508.24,85075.05
2020-06-15,2020-06-15,Invoice payment - Pugh and Sons,REF43357394,0.0,473.62,85548.67
2020-06-15,2020-06-15,"Invoice payment - Dennis, Henderson and Anderson",REF96138150,0.0,155.97,85704.64
2020-06-15,2020-06-15,Project payment - Erickson-Price,REF21810384,0.0,894.72,86599.36
2020-06-15,2020-06-15,Project payment - Simpson Inc,REF87801492,0.0,611.42,87210.78
2020-06-15,2020-06-15,"Payment from Miranda, Rodriguez and Myers",REF10053898,0.0,353.3,87564.08
2020-06-15,2020-06-15,Coworking space rental,REF39952540,314.83,0.0,87249.25
2020-06-15,2020-06-15,Business insurance premium,REF38324285,121.68,0.0,87127.57
2020-06-16,2020-06-16,Business meal,REF93026073,305.14,0.0,86822.43
2020-06-17,2020-06-17,Business meal,REF37883444,202.56,0.0,86619.87
2020-06-18,2020-06-18,Training/conference,REF53624912,200.1,0.0,86419.77
2020-06-19,2020-06-19,Training/conference,REF56521425,205.65,0.0,86214.12
2020-06-21,2020-06-21,Business meal,REF31021885,154.8,0.0,86059.32
2020-06-21,2020-06-21,Professional software license,REF74732916,145.6,0.0,85913.72
2020-06-26,2020-06-26,Equipment purchase,REF95359640,222.27,0.0,85691.45
2020-06-27,2020-06-27,Accounting expense,REF88218223,142.28,0.0,85549.17
2020-06-29,2020-06-29,Training/conference,REF44773542,144.69,0.0,85404.48
2020-07-05,2020-07-05,Training/conference,REF34188680,164.14,0.0,85240.34
2020-07-07,2020-07-07,Equipment purchase,REF89583025,86.23,0.0,85154.11
2020-07-08,2020-07-08,Equipment purchase,REF52280514,122.15,0.0,85031.96
2020-07-11,2020-07-11,Business meal,REF49957961,171.56,0.0,84860.4
2020-07-15,2020-07-15,Service payment - Pugh and Sons,REF73236997,0.0,492.71,85353.11
2020-07-15,2020-07-15,Business insurance premium,REF11572646,99.1,0.0,85254.01
2020-07-15,2020-07-15,Invoice payment - Erickson-Price,REF65602627,0.0,695.49,85949.5
2020-07-15,2020-07-15,Payment from White LLC,REF24192373,0.0,528.18,86477.68
2020-07-15,2020-07-15,Payment from Spears-Brown,REF84252053,0.0,367.3,86844.98
2020-07-15,2020-07-15,"Payment from Miranda, Rodriguez and Myers",REF23060981,0.0,349.22,87194.2
2020-07-15,2020-07-15,"Payment from Dennis, Henderson and Anderson",REF85727068,0.0,175.75,87369.95
2020-07-15,2020-07-15,Invoice payment - Simpson Inc,REF31188988,0.0,821.57,88191.52
2020-07-19,2020-07-19,Business travel,REF54438918,455.09,0.0,87736.43
2020-07-21,2020-07-21,Professional software license,REF78860346,161.19,0.0,87575.24
2020-07-24,2020-07-24,Equipment purchase,REF81417002,93.25,0.0,87481.99
2020-07-31,2020-07-31,Equipment purchase,REF68284356,114.53,0.0,87367.46
2020-08-01,2020-08-01,Business meal,REF77215976,248.9,0.0,87118.56
2020-08-03,2020-08-03,Marketing expenses,REF20703248,286.35,0.0,86832.21
2020-08-11,2020-08-11,Marketing expenses,REF16656983,245.2,0.0,86587.01
2020-08-15,2020-08-15,Payment from Spears-Brown,REF32991330,0.0,338.82,86925.83
2020-08-15,2020-08-15,Project payment - White LLC,REF52520431,0.0,623.95,87549.78
2020-08-15,2020-08-15,Business insurance premium,REF34814494,109.95,0.0,87439.83
2020-08-15,2020-08-15,"Project payment - Dennis, Henderson and Anderson",REF93559948,0.0,168.25,87608.08
2020-08-15,2020-08-15,Payment from Simpson Inc,REF45583987,0.0,714.84,88322.92
2020-08-15,2020-08-15,Invoice payment - Campbell-Willis,REF23672954,0.0,528.42,88851.34
2020-08-15,2020-08-15,Payment from Pugh and Sons,REF58886284,0.0,462.65,89313.99
2020-08-15,2020-08-15,Service payment - Erickson-Price,REF47229932,0.0,993.72,90307.71
2020-08-15,2020-08-15,"Project payment - Miranda, Rodriguez and Myers",REF52605102,0.0,368.54,90676.25
2020-08-19,2020-08-19,Business travel,REF43246178,355.83,0.0,90320.42
2020-08-19,2020-08-19,Business meal,REF54442087,249.34,0.0,90071.08
2020-08-21,2020-08-21,Marketing expenses,REF38409613,381.38,0.0,89689.7
2020-08-21,2020-08-21,Professional software license,REF36194381,146.07,0.0,89543.63
2020-08-24,2020-08-24,Business meal,REF44295405,138.46,0.0,89405.17
2020-08-27,2020-08-27,Coworking space rental,REF68268192,243.55,0.0,89161.62
2020-08-28,2020-08-28,Coworking space rental,REF50197087,267.12,0.0,88894.5
2020-09-08,2020-09-08,Equipment purchase,REF77489991,148.56,0.0,88745.94
2020-09-08,2020-09-08,Business travel,REF15548443,708.38,0.0,88037.56
2020-09-11,2020-09-11,Equipment purchase,REF35606830,136.38,0.0,87901.18
2020-09-12,2020-09-12,Business meal,REF34501814,411.48,0.0,87489.7
2020-09-15,2020-09-15,Business insurance premium,REF65877088,162.67,0.0,87327.03
2020-09-15,2020-09-15,Project payment - Pugh and Sons,REF47729550,0.0,749.04,88076.07
2020-09-15,2020-09-15,Service payment - Spears-Brown,REF13804516,0.0,503.72,88579.79
2020-09-15,2020-09-15,"Payment from Dennis, Henderson and Anderson",REF14984834,0.0,192.97,88772.76
2020-09-15,2020-09-15,Service payment - Simpson Inc,REF21012357,0.0,1571.75,90344.51
2020-09-15,2020-09-15,Payment from Erickson-Price,REF71071438,0.0,1142.93,91487.44
2020-09-15,2020-09-15,Service payment - White LLC,REF18997725,0.0,965.83,92453.27
2020-09-15,2020-09-15,Service payment - Campbell-Willis,REF56876718,0.0,778.06,93231.33
2020-09-21,2020-09-21,Professional software license,REF19791338,172.87,0.0,93058.46
2020-09-21,2020-09-21,Equipment purchase,REF62475492,258.86,0.0,92799.6
2020-09-26,2020-09-26,Accounting expense,REF31307217,137.21,0.0,92662.39
2020-09-29,2020-09-29,Business travel,REF53122413,284.3,0.0,92378.09
2020-10-06,2020-10-06,Business travel,REF68647800,348.23,0.0,92029.86
2020-10-07,2020-10-07,Equipment purchase,REF79871150,218.51,0.0,91811.35
2020-10-08,2020-10-08,Business meal,REF31607983,326.77,0.0,91484.58
2020-10-12,2020-10-12,Training/conference,REF52374206,286.21,0.0,91198.37
2020-10-15,2020-10-15,Invoice payment - Simpson Inc,REF99675047,0.0,1010.86,92209.23
2020-10-15,2020-10-15,Business insurance premium,REF64135865,172.38,0.0,92036.85
2020-10-15,2020-10-15,Marketing expenses,REF12284754,336.64,0.0,91700.21
2020-10-15,2020-10-15,Payment from White LLC,REF16781664,0.0,903.7,92603.91
2020-10-15,2020-10-15,Project payment - Campbell-Willis,REF57408693,0.0,827.54,93431.45
2020-10-15,2020-10-15,"Project payment - Dennis, Henderson and Anderson",REF59466177,0.0,217.43,93648.88
2020-10-15,2020-10-15,Service payment - Pugh and Sons,REF58416388,0.0,771.72,94420.6
2020-10-15,2020-10-15,"Payment from Miranda, Rodriguez and Myers",REF13404473,0.0,570.63,94991.23
2020-10-15,2020-10-15,Project payment - Spears-Brown,REF86464590,0.0,714.35,95705.58
2020-10-15,2020-10-15,Invoice payment - Erickson-Price,REF61017140,0.0,1284.2,96989.78
2020-10-21,2020-10-21,Professional software license,REF56291090,254.24,0.0,96735.54
2020-10-21,2020-10-21,Business travel,REF80299225,286.74,0.0,96448.8
2020-10-22,2020-10-22,Equipment purchase,REF42327694,282.29,0.0,96166.51
2020-10-23,2020-10-23,Business travel,REF26718560,637.3,0.0,95529.21
2020-10-26,2020-10-26,Equipment purchase,REF67561204,128.47,0.0,95400.74
2020-10-28,2020-10-28,Training/conference,REF24337361,172.0,0.0,95228.74
2020-10-30,2020-10-30,Business travel,REF35216111,552.81,0.0,94675.93
2020-11-02,2020-11-02,Coworking space rental,REF49167647,285.04,0.0,94390.89
2020-11-12,2020-11-12,Equipment purchase,REF20717998,93.15,0.0,94297.74
2020-11-14,2020-11-14,Coworking space rental,REF24812942,179.0,0.0,94118.74
2020-11-15,2020-11-15,Business insurance premium,REF76494972,144.79,0.0,93973.95
2020-11-15,2020-11-15,Project payment - White LLC,REF81846080,0.0,985.55,94959.5
2020-11-15,2020-11-15,Project payment - Campbell-Willis,REF11486052,0.0,662.4,95621.9
2020-11-15,2020-11-15,Project payment - Erickson-Price,REF96465381,0.0,905.07,96526.97
2020-11-15,2020-11-15,"Invoice payment - Dennis, Henderson and Anderson",REF86813568,0.0,127.03,96654.0
2020-11-15,2020-11-15,Service payment - Simpson Inc,REF31276325,0.0,1088.98,97742.98
2020-11-15,2020-11-15,Service payment - Pugh and Sons,REF64343732,0.0,778.71,98521.69
2020-11-15,2020-11-15,Payment from Spears-Brown,REF83349350,0.0,534.45,99056.14
2020-11-15,2020-11-15,"Payment from Miranda, Rodriguez and Myers",REF13817620,0.0,550.18,99606.32
2020-11-17,2020-11-17,Business travel,REF96488263,343.83,0.0,99262.49
2020-11-20,2020-11-20,Business travel,REF18579835,355.96,0.0,98906.53
2020-11-21,2020-11-21,Business travel,REF65757290,552.45,0.0,98354.08
2020-11-21,2020-11-21,Professional software license,REF60624688,181.4,0.0,98172.68
2020-12-02,2020-12-02,Equipment purchase,REF28023712,169.73,0.0,98002.95
2020-12-15,2020-12-15,Service payment - Erickson-Price,REF74572081,0.0,638.41,98641.36
2020-12-15,2020-12-15,Project payment - Spears-Brown,REF51145478,0.0,458.61,99099.97
2020-12-15,2020-12-15,Project payment - Simpson Inc,REF34460895,0.0,1173.31,100273.28
2020-12-15,2020-12-15,Service payment - Pugh and Sons,REF69908663,0.0,645.91,100919.19
2020-12-15,2020-12-15,Service payment - White LLC,REF82230161,0.0,578.62,101497.81
2020-12-15,2020-12-15,"Service payment - Dennis, Henderson and Anderson",REF91628395,0.0,127.54,101625.35
2020-12-15,2020-12-15,Business insurance premium,REF82430445,121.87,0.0,101503.48
2020-12-21,2020-12-21,Professional software license,REF82970085,204.03,0.0,101299.45
2020-12-25,2020-12-25,Business meal,REF41776982,179.76,0.0,101119.69
2020-12-28,2020-12-28,Business travel,REF66352847,243.06,0.0,100876.63
2020-12-28,2020-12-28,Marketing expenses,REF80330815,121.99,0.0,100754.64
2021-01-01,2021-01-01,Marketing expenses,REF12910972,260.32,0.0,100494.32
2021-01-04,2021-01-04,Business meal,REF56429954,454.32,0.0,100040.0
2021-01-04,2021-01-04,Training/conference,REF27542387,249.75,0.0,99790.25
2021-01-13,2021-01-13,Coworking space rental,REF40712585,266.45,0.0,99523.8
2021-01-15,2021-01-15,Business insurance premium,REF49890870,156.36,0.0,99367.44
2021-01-15,2021-01-15,"Invoice payment - Dennis, Henderson and Anderson",REF66511349,0.0,190.7,99558.14
2021-01-15,2021-01-15,Payment from Erickson-Price,REF85110271,0.0,1396.18,100954.32
2021-01-15,2021-01-15,Invoice payment - Spears-Brown,REF36613038,0.0,656.3,101610.62
2021-01-15,2021-01-15,"Service payment - Miranda, Rodriguez and Myers",REF52912002,0.0,680.27,102290.89
2021-01-15,2021-01-15,Payment from Simpson Inc,REF38754030,0.0,1685.93,103976.82
2021-01-15,2021-01-15,Invoice payment - Campbell-Willis,REF42072157,0.0,969.37,104946.19
2021-01-15,2021-01-15,Project payment - Pugh and Sons,REF77375636,0.0,937.41,105883.6
2021-01-15,2021-01-15,Project payment - White LLC,REF61299232,0.0,948.33,106831.93
2021-01-21,2021-01-21,Professional software license,REF16409810,267.42,0.0,106564.51
2021-01-21,2021-01-21,Business travel,REF59396609,348.81,0.0,106215.7
2021-01-23,2021-01-23,Business travel,REF86771996,479.94,0.0,105735.76
2021-01-28,2021-01-28,Marketing expenses,REF65959271,348.88,0.0,105386.88
2021-02-02,2021-02-02,Marketing expenses,REF30780975,406.72,0.0,104980.16
2021-02-06,2021-02-06,Coworking space rental,REF57486663,502.79,0.0,104477.37
2021-02-07,2021-02-07,Accounting expense,REF64699343,121.12,0.0,104356.25
2021-02-08,2021-02-08,Training/conference,REF90289298,108.75,0.0,104247.5
2021-02-10,2021-02-10,Training/conference,REF79481258,298.07,0.0,103949.43
2021-02-13,2021-02-13,Coworking space rental,REF26562849,424.45,0.0,103524.98
2021-02-14,2021-02-14,Training/conference,REF70434231,283.55,0.0,103241.43
2021-02-15,2021-02-15,Business insurance premium,REF49680537,166.81,0.0,103074.62
2021-02-15,2021-02-15,Payment from Pugh and Sons,REF85897128,0.0,833.36,103907.98
2021-02-15,2021-02-15,"Project payment - Miranda, Rodriguez and Myers",REF47609160,0.0,603.12,104511.1
2021-02-15,2021-02-15,Payment from Simpson Inc,REF97079315,0.0,1411.24,105922.34
2021-02-15,2021-02-15,Invoice payment - White LLC,REF28255461,0.0,764.44,106686.78
2021-02-15,2021-02-15,"Service payment - Dennis, Henderson and Anderson",REF99593569,0.0,181.97,106868.75
2021-02-15,2021-02-15,Business travel,REF11017298,299.37,0.0,106569.38
2021-02-15,2021-02-15,Service payment - Erickson-Price,REF99593482,0.0,1081.08,107650.46
2021-02-15,2021-02-15,Payment from Campbell-Willis,REF12761147,0.0,860.13,108510.59
2021-02-18,2021-02-18,Accounting expense,REF87335385,214.15,0.0,108296.44
2021-02-21,2021-02-21,Professional software license,REF65959310,178.58,0.0,108117.86
2021-02-22,2021-02-22,Coworking space rental,REF56368447,100.36,0.0,108017.5
2021-02-24,2021-02-24,Accounting expense,REF21925835,168.72,0.0,107848.78
2021-02-27,2021-02-27,Business meal,REF57310443,101.72,0.0,107747.06
2021-03-04,2021-03-04,Business travel,REF70568468,386.45,0.0,107360.61
2021-03-15,2021-03-15,Invoice payment - Campbell-Willis,REF39141445,0.0,650.33,108010.94
2021-03-15,2021-03-15,Service payment - Spears-Brown,REF64611035,0.0,639.85,108650.79
2021-03-15,2021-03-15,Payment from Pugh and Sons,REF96256857,0.0,538.77,109189.56
2021-03-15,2021-03-15,Business insurance premium,REF79754425,141.3,0.0,109048.26
2021-03-15,2021-03-15,"Payment from Miranda, Rodriguez and Myers",REF84094739,0.0,585.06,109633.32
2021-03-15,2021-03-15,Invoice payment - Simpson Inc,REF97689755,0.0,939.24,110572.56
2021-03-15,2021-03-15,"Payment from Dennis, Henderson and Anderson",REF87245293,0.0,243.17,110815.73
2021-03-17,2021-03-17,Business travel,REF51419938,218.84,0.0,110596.89
2021-03-21,2021-03-21,Coworking space rental,REF12037516,246.39,0.0,110350.5
2021-03-21,2021-03-21,Professional software license,REF68482404,212.88,0.0,110137.62
2021-03-24,2021-03-24,Business travel,REF99029853,341.18,0.0,109796.44
2021-03-25,2021-03-25,Marketing expenses,REF82470342,245.68,0.0,109550.76
2021-03-28,2021-03-28,Coworking space rental,REF63275822,260.79,0.0,109289.97
2021-03-29,2021-03-29,Business meal,REF55529938,86.87,0.0,109203.1
2021-04-01,2021-04-01,Business travel,REF97803267,451.06,0.0,108752.04
2021-04-01,2021-04-01,Business meal,REF94063291,337.87,0.0,108414.17
2021-04-03,2021-04-03,Training/conference,REF29280768,270.15,0.0,108144.02
2021-04-07,2021-04-07,Accounting expense,REF95289067,179.69,0.0,107964.33
2021-04-09,2021-04-09,Training/conference,REF83091655,208.89,0.0,107755.44
2021-04-15,2021-04-15,Business insurance premium,REF69595166,144.04,0.0,107611.4
2021-04-15,2021-04-15,Business meal,REF11889459,278.61,0.0,107332.79
2021-04-15,2021-04-15,Invoice payment - Spears-Brown,REF33723933,0.0,559.31,107892.1
2021-04-15,2021-04-15,Project payment - Campbell-Willis,REF78589075,0.0,657.31,108549.41
2021-04-15,2021-04-15,Invoice payment - Erickson-Price,REF17911591,0.0,1383.08,109932.49
2021-04-15,2021-04-15,Service payment - Simpson Inc,REF36372038,0.0,1181.73,111114.22
2021-04-15,2021-04-15,Project payment - Pugh and Sons,REF65981016,0.0,733.68,111847.9
2021-04-15,2021-04-15,Service payment - White LLC,REF92453497,0.0,535.56,112383.46
2021-04-15,2021-04-15,"Payment from Dennis, Henderson and Anderson",REF22853133,0.0,162.42,112545.88
2021-04-15,2021-04-15,"Payment from Miranda, Rodriguez and Myers",REF98694040,0.0,392.88,112938.76
2021-04-19,2021-04-19,Business travel,REF60348183,68.93,0.0,112869.83
2021-04-21,2021-04-21,Business travel,REF90931864,386.4,0.0,112483.43
2021-04-21,2021-04-21,Accounting expense,REF33683217,208.11,0.0,112275.32
2021-04-21,2021-04-21,Professional software license,REF67129676,165.36,0.0,112109.96
2021-04-25,2021-04-25,Coworking space rental,REF95659723,349.53,0.0,111760.43
2021-04-29,2021-04-29,Business travel,REF26469143,391.28,0.0,111369.15
2021-05-02,2021-05-02,Accounting expense,REF79617682,135.13,0.0,111234.02
2021-05-08,2021-05-08,Business meal,REF62997865,122.41,0.0,111111.61
2021-05-12,2021-05-12,Coworking space rental,REF72644468,264.22,0.0,110847.39
2021-05-15,2021-05-15,Equipment purchase,REF45806576,206.88,0.0,110640.51
2021-05-15,2021-05-15,Business insurance premium,REF64168746,122.17,0.0,110518.34
2021-05-15,2021-05-15,Invoice payment - Pugh and Sons,REF12754663,0.0,567.16,111085.5
2021-05-15,2021-05-15,"Payment from Miranda, Rodriguez and Myers",REF10412574,0.0,390.38,111475.88
2021-05-15,2021-05-15,"Payment from Dennis, Henderson and Anderson",REF35275610,0.0,211.96,111687.84
2021-05-15,2021-05-15,Project payment - Campbell-Willis,REF34449267,0.0,622.07,112309.91
2021-05-15,2021-05-15,Invoice payment - Erickson-Price,REF90435216,0.0,1091.29,113401.2
2021-05-15,2021-05-15,Payment from Simpson Inc,REF88997080,0.0,879.17,114280.37
2021-05-15,2021-05-15,Invoice payment - White LLC,REF99797331,0.0,760.96,115041.33
2021-05-15,2021-05-15,Project payment - Spears-Brown,REF85422046,0.0,367.45,115408.78
2021-05-18,2021-05-18,Accounting expense,REF49242535,299.14,0.0,115109.64
2021-05-19,2021-05-19,Coworking space rental,REF75916437,289.48,0.0,114820.16
2021-05-21,2021-05-21,Professional software license,REF38681074,168.79,0.0,114651.37
2021-05-26,2021-05-26,Business travel,REF11100395,404.66,0.0,114246.71
2021-05-29,2021-05-29,Marketing expenses,REF63319619,327.44,0.0,113919.27
2021-05-29,2021-05-29,Business meal,REF55363989,178.2,0.0,113741.07
2021-05-31,2021-05-31,Coworking space rental,REF70852845,219.58,0.0,113521.49
2021-06-03,2021-06-03,Business meal,REF56169197,253.59,0.0,113267.9
2021-06-04,2021-06-04,Business meal,REF82093418,107.35,0.0,113160.55
2021-06-07,2021-06-07,Accounting expense,REF88434172,224.7,0.0,112935.85
2021-06-09,2021-06-09,Business travel,REF42027605,392.64,0.0,112543.21
2021-06-09,2021-06-09,Marketing expenses,REF81939175,206.77,0.0,112336.44
2021-06-09,2021-06-09,Accounting expense,REF86458216,159.08,0.0,112177.36
2021-06-15,2021-06-15,Business insurance premium,REF25668941,108.06,0.0,112069.3
2021-06-15,2021-06-15,Project payment - Spears-Brown,REF61517228,0.0,419.57,112488.87
2021-06-15,2021-06-15,Invoice payment - White LLC,REF40279430,0.0,576.57,113065.44
2021-06-15,2021-06-15,"Service payment - Dennis, Henderson and Anderson",REF12893007,0.0,127.29,113192.73
2021-06-15,2021-06-15,Service payment - Pugh and Sons,REF83971039,0.0,524.23,113716.96
2021-06-15,2021-06-15,Payment from Simpson Inc,REF33091495,0.0,964.04,114681.0
2021-06-15,2021-06-15,"Invoice payment - Miranda, Rodriguez and Myers",REF91701891,0.0,459.74,115140.74
2021-06-15,2021-06-15,Project payment - Erickson-Price,REF12714501,0.0,970.15,116110.89
2021-06-15,2021-06-15,Invoice payment - Campbell-Willis,REF18275162,0.0,548.53,116659.42
2021-06-19,2021-06-19,Accounting expense,REF68970998,145.81,0.0,116513.61
2021-06-21,2021-06-21,Professional software license,REF12279838,156.02,0.0,116357.59
2021-06-21,2021-06-21,Marketing expenses,REF73830060,304.11,0.0,116053.48
2021-06-25,2021-06-25,Accounting expense,REF19626381,212.84,0.0,115840.64
2021-06-28,2021-06-28,Business meal,REF91272004,219.28,0.0,115621.36
2021-07-05,2021-07-05,Marketing expenses,REF41391702,176.74,0.0,115444.62
2021-07-15,2021-07-15,"Invoice payment - Miranda, Rodriguez and Myers",REF99167409,0.0,469.68,115914.3
2021-07-15,2021-07-15,Invoice payment - Pugh and Sons,REF72538015,0.0,466.31,116380.61
2021-07-15,2021-07-15,Service payment - Campbell-Willis,REF60041901,0.0,412.76,116793.37
2021-07-15,2021-07-15,Business insurance premium,REF18074087,95.35,0.0,116698.02
2021-07-15,2021-07-15,Payment from Spears-Brown,REF13968318,0.0,338.07,117036.09
2021-07-15,2021-07-15,Payment from Simpson Inc,REF20545622,0.0,662.01,117698.1
2021-07-15,2021-07-15,Project payment - White LLC,REF45061030,0.0,512.23,118210.33
2021-07-15,2021-07-15,Invoice payment - Erickson-Price,REF76167431,0.0,811.91,119022.24
2021-07-19,2021-07-19,Business meal,REF29548577,225.68,0.0,118796.56
2021-07-21,2021-07-21,Professional software license,REF55937162,129.07,0.0,118667.49
2021-07-26,2021-07-26,Equipment purchase,REF86944832,121.88,0.0,118545.61
2021-08-02,2021-08-02,Business meal,REF81543531,253.44,0.0,118292.17
2021-08-15,2021-08-15,"Service payment - Dennis, Henderson and Anderson",REF61295770,0.0,190.39,118482.56
2021-08-15,2021-08-15,Payment from White LLC,REF76422373,0.0,538.86,119021.42
2021-08-15,2021-08-15,"Service payment - Miranda, Rodriguez and Myers",REF12412167,0.0,303.52,119324.94
2021-08-15,2021-08-15,Business insurance premium,REF22893982,110.67,0.0,119214.27
2021-08-15,2021-08-15,Invoice payment - Erickson-Price,REF76694308,0.0,880.81,120095.08
2021-08-15,2021-08-15,Invoice payment - Campbell-Willis,REF72773451,0.0,539.47,120634.55
2021-08-15,2021-08-15,Project payment - Simpson Inc,REF45992331,0.0,906.74,121541.29
2021-08-15,2021-08-15,Project payment - Spears-Brown,REF85518672,0.0,304.86,121846.15
2021-08-15,2021-08-15,Project payment - Pugh and Sons,REF39252091,0.0,468.25,122314.4
2021-08-16,2021-08-16,Coworking space rental,REF40079880,273.04,0.0,122041.36
2021-08-21,2021-08-21,Professional software license,REF36834140,161.12,0.0,121880.24
2021-08-24,2021-08-24,Business meal,REF75776138,194.8,0.0,121685.44
2021-08-30,2021-08-30,Training/conference,REF59131909,145.39,0.0,121540.05
2021-08-31,2021-08-31,Marketing expenses,REF27753809,150.35,0.0,121389.7
2021-09-01,2021-09-01,Business meal,REF35321330,277.32,0.0,121112.38
2021-09-02,2021-09-02,Equipment purchase,REF66314724,165.4,0.0,120946.98
2021-09-03,2021-09-03,Business meal,REF55456403,291.8,0.0,120655.18
2021-09-04,2021-09-04,Business travel,REF60198086,456.38,0.0,120198.8
2021-09-05,2021-09-05,Training/conference,REF29572553,128.46,0.0,120070.34
2021-09-06,2021-09-06,Coworking space rental,REF99517670,247.66,0.0,119822.68
2021-09-09,2021-09-09,Business travel,REF84362223,243.72,0.0,119578.96
2021-09-09,2021-09-09,Training/conference,REF23779358,184.38,0.0,119394.58
2021-09-10,2021-09-10,Marketing expenses,REF42472943,221.14,0.0,119173.44
2021-09-14,2021-09-14,Equipment purchase,REF76679599,151.76,0.0,119021.68
2021-09-14,2021-09-14,Training/conference,REF14369759,257.75,0.0,118763.93
2021-09-15,2021-09-15,Project payment - Pugh and Sons,REF73264461,0.0,656.38,119420.31
2021-09-15,2021-09-15,Service payment - Campbell-Willis,REF40923447,0.0,880.83,120301.14
2021-09-15,2021-09-15,"Payment from Dennis, Henderson and Anderson",REF13497741,0.0,220.4,120521.54
2021-09-15,2021-09-15,Invoice payment - Spears-Brown,REF15655212,0.0,614.86,121136.4
2021-09-15,2021-09-15,Business insurance premium,REF13116520,156.47,0.0,120979.93
2021-09-15,2021-09-15,"Payment from Miranda, Rodriguez and Myers",REF73706764,0.0,512.08,121492.01
2021-09-15,2021-09-15,Service payment - Simpson Inc,REF24442833,0.0,1333.73,122825.74
2021-09-15,2021-09-15,Invoice payment - Erickson-Price,REF32038435,0.0,1161.71,123987.45
2021-09-15,2021-09-15,Payment from White LLC,REF94222597,0.0,905.66,124893.11
2021-09-21,2021-09-21,Professional software license,REF58911838,242.35,0.0,124650.76
2021-09-25,2021-09-25,Training/conference,REF86055577,227.67,0.0,124423.09
2021-10-06,2021-10-06,Coworking space rental,REF81017870,522.23,0.0,123900.86
2021-10-12,2021-10-12,Coworking space rental,REF88892460,457.04,0.0,123443.82
2021-10-14,2021-10-14,Coworking space rental,REF58299287,464.27,0.0,122979.55
2021-10-15,2021-10-15,Business insurance premium,REF16439774,181.6,0.0,122797.95
2021-10-15,2021-10-15,"Payment from Dennis, Henderson and Anderson",REF83400174,0.0,216.29,123014.24
2021-10-15,2021-10-15,"Invoice payment - Miranda, Rodriguez and Myers",REF17589173,0.0,387.08,123401.32
2021-10-15,2021-10-15,Service payment - White LLC,REF26725254,0.0,1107.39,124508.71
2021-10-15,2021-10-15,Payment from Spears-Brown,REF60671251,0.0,711.68,125220.39
2021-10-15,2021-10-15,Invoice payment - Erickson-Price,REF36898404,0.0,1039.32,126259.71
2021-10-15,2021-10-15,Invoice payment - Pugh and Sons,REF15002734,0.0,772.86,127032.57
2021-10-15,2021-10-15,Payment from Campbell-Willis,REF52041167,0.0,961.18,127993.75
2021-10-21,2021-10-21,Professional software license,REF49284293,213.35,0.0,127780.4
2021-10-22,2021-10-22,Coworking space rental,REF42120757,486.79,0.0,127293.61
2021-11-03,2021-11-03,Business travel,REF73094459,610.08,0.0,126683.53
2021-11-04,2021-11-04,Coworking space rental,REF68778747,312.56,0.0,126370.97
2021-11-06,2021-11-06,Business meal,REF81178387,366.87,0.0,126004.1
2021-11-11,2021-11-11,Equipment purchase,REF90087773,212.16,0.0,125791.94
2021-11-11,2021-11-11,Coworking space rental,REF65194210,452.3,0.0,125339.64
2021-11-12,2021-11-12,Business meal,REF85225437,375.59,0.0,124964.05
2021-11-15,2021-11-15,Training/conference,REF81404745,184.74,0.0,124779.31
2021-11-15,2021-11-15,"Invoice payment - Dennis, Henderson and Anderson",REF54850417,0.0,194.91,124974.22
2021-11-15,2021-11-15,Invoice payment - Erickson-Price,REF39687924,0.0,1335.19,126309.41
2021-11-15,2021-11-15,"Service payment - Miranda, Rodriguez and Myers",REF82791082,0.0,436.78,126746.19
2021-11-15,2021-11-15,Project payment - White LLC,REF71360499,0.0,964.12,127710.31
2021-11-15,2021-11-15,Project payment - Campbell-Willis,REF64816576,0.0,808.8,128519.11
2021-11-15,2021-11-15,Payment from Pugh and Sons,REF43465985,0.0,943.67,129462.78
2021-11-15,2021-11-15,Business insurance premium,REF79437799,149.25,0.0,129313.53
2021-11-15,2021-11-15,Service payment - Simpson Inc,REF91707286,0.0,1312.97,130626.5
2021-11-19,2021-11-19,Accounting expense,REF62013112,183.7,0.0,130442.8
2021-11-20,2021-11-20,Coworking space rental,REF71758126,314.57,0.0,130128.23
2021-11-21,2021-11-21,Professional software license,REF73567165,231.82,0.0,129896.41
2021-12-02,2021-12-02,Marketing expenses,REF39326259,197.65,0.0,129698.76
2021-12-03,2021-12-03,Business meal,REF63578524,240.63,0.0,129458.13
2021-12-06,2021-12-06,Equipment purchase,REF65403608,102.05,0.0,129356.08
2021-12-11,2021-12-11,Marketing expenses,REF39031385,90.21,0.0,129265.87
2021-12-15,2021-12-15,Project payment - Campbell-Willis,REF16508412,0.0,517.5,129783.37
2021-12-15,2021-12-15,Invoice payment - Pugh and Sons,REF44019619,0.0,612.53,130395.9
2021-12-15,2021-12-15,"Invoice payment - Miranda, Rodriguez and Myers",REF52078089,0.0,438.12,130834.02
2021-12-15,2021-12-15,Payment from Simpson Inc,REF57494117,0.0,955.78,131789.8
2021-12-15,2021-12-15,Business insurance premium,REF23830965,134.24,0.0,131655.56
2021-12-15,2021-12-15,Invoice payment - Spears-Brown,REF40432314,0.0,465.99,132121.55
2021-12-15,2021-12-15,Project payment - Erickson-Price,REF42894634,0.0,1053.81,133175.36
2021-12-17,2021-12-17,Accounting expense,REF58755217,225.68,0.0,132949.68
2021-12-21,2021-12-21,Professional software license,REF87598432,163.9,0.0,132785.78
2021-12-28,2021-12-28,Business meal,REF25471922,253.97,0.0,132531.81
2021-12-29,2021-12-29,Business meal,REF53017101,157.88,0.0,132373.93
2022-01-02,2022-01-02,Business meal,REF49102496,410.45,0.0,131963.48
2022-01-02,2022-01-02,Training/conference,REF74668133,196.08,0.0,131767.4
2022-01-07,2022-01-07,Accounting expense,REF86436903,254.34,0.0,131513.06
2022-01-10,2022-01-10,Accounting expense,REF81333563,261.4,0.0,131251.66
2022-01-11,2022-01-11,Equipment purchase,REF50297179,232.78,0.0,131018.88
2022-01-14,2022-01-14,Business travel,REF96259587,570.47,0.0,130448.41
2022-01-15,2022-01-15,"Service payment - Miranda, Rodriguez and Myers",REF41174403,0.0,504.35,130952.76
2022-01-15,2022-01-15,Service payment - White LLC,REF27060367,0.0,1102.2,132054.96
2022-01-15,2022-01-15,Service payment - Campbell-Willis,REF24219365,0.0,691.22,132746.18
2022-01-15,2022-01-15,Payment from Pugh and Sons,REF47396976,0.0,947.9,133694.08
2022-01-15,2022-01-15,"Project payment - Dennis, Henderson and Anderson",REF65359201,0.0,297.59,133991.67
2022-01-15,2022-01-15,Business insurance premium,REF46238823,164.13,0.0,133827.54
2022-01-15,2022-01-15,Project payment - Simpson Inc,REF45512410,0.0,1329.38,135156.92
2022-01-15,2022-01-15,Payment from Spears-Brown,REF23863496,0.0,567.67,135724.59
2022-01-16,2022-01-16,Coworking space rental,REF80471883,403.66,0.0,135320.93
2022-01-18,2022-01-18,Training/conference,REF10120096,108.13,0.0,135212.8
2022-01-21,2022-01-21,Professional software license,REF10002038,239.03,0.0,134973.77
2022-01-25,2022-01-25,Training/conference,REF37839814,212.73,0.0,134761.04
2022-02-10,2022-02-10,Equipment purchase,REF91401536,141.04,0.0,134620.0
2022-02-11,2022-02-11,Marketing expenses,REF71409142,317.19,0.0,134302.81
2022-02-11,2022-02-11,Equipment purchase,REF79212276,107.97,0.0,134194.84
2022-02-11,2022-02-11,Business travel,REF79615068,580.03,0.0,133614.81
2022-02-15,2022-02-15,Business insurance premium,REF15815280,149.17,0.0,133465.64
2022-02-15,2022-02-15,Invoice payment - Erickson-Price,REF23675190,0.0,968.16,134433.8
2022-02-15,2022-02-15,"Service payment - Miranda, Rodriguez and Myers",REF68445462,0.0,533.77,134967.57
2022-02-15,2022-02-15,Invoice payment - White LLC,REF76814718,0.0,1088.65,136056.22
2022-02-15,2022-02-15,Project payment - Campbell-Willis,REF65554161,0.0,677.2,136733.42
2022-02-15,2022-02-15,Project payment - Spears-Brown,REF30432504,0.0,515.98,137249.4
2022-02-15,2022-02-15,Service payment - Pugh and Sons,REF20058066,0.0,678.05,137927.45
2022-02-15,2022-02-15,Payment from Simpson Inc,REF54455373,0.0,966.43,138893.88
2022-02-17,2022-02-17,Coworking space rental,REF62030241,260.0,0.0,138633.88
2022-02-17,2022-02-17,Marketing expenses,REF79482307,172.49,0.0,138461.39
2022-02-18,2022-02-18,Business travel,REF49919874,371.64,0.0,138089.75
2022-02-21,2022-02-21,Professional software license,REF17531895,198.27,0.0,137891.48
2022-02-24,2022-02-24,Equipment purchase,REF74203671,146.71,0.0,137744.77
2022-03-05,2022-03-05,Marketing expenses,REF14527214,203.86,0.0,137540.91
2022-03-06,2022-03-06,Marketing expenses,REF32238382,397.54,0.0,137143.37
2022-03-09,2022-03-09,Business travel,REF41899874,302.52,0.0,136840.85
2022-03-11,2022-03-11,Training/conference,REF24939380,304.09,0.0,136536.76
2022-03-15,2022-03-15,Payment from Campbell-Willis,REF56358747,0.0,436.31,136973.07
2022-03-15,2022-03-15,Service payment - Simpson Inc,REF90402652,0.0,1159.72,138132.79
2022-03-15,2022-03-15,Invoice payment - Erickson-Price,REF17582384,0.0,1102.06,139234.85
2022-03-15,2022-03-15,Service payment - Pugh and Sons,REF40335160,0.0,810.39,140045.24
2022-03-15,2022-03-15,Service payment - Spears-Brown,REF41394360,0.0,311.49,140356.73
2022-03-15,2022-03-15,"Invoice payment - Miranda, Rodriguez and Myers",REF10609088,0.0,418.32,140775.05
2022-03-15,2022-03-15,Project payment - White LLC,REF75608245,0.0,752.09,141527.14
2022-03-15,2022-03-15,Business insurance premium,REF76515683,131.85,0.0,141395.29
2022-03-21,2022-03-21,Professional software license,REF27413573,187.4,0.0,141207.89
2022-03-22,2022-03-22,Coworking space rental,REF53337245,404.13,0.0,140803.76
2022-03-26,2022-03-26,Business travel,REF38222065,479.16,0.0,140324.6
2022-03-26,2022-03-26,Marketing expenses,REF32227823,270.55,0.0,140054.05
2022-04-15,2022-04-15,"Invoice payment - Dennis, Henderson and Anderson",REF94279549,0.0,220.26,140274.31
2022-04-15,2022-04-15,Business insurance premium,REF19314685,141.66,0.0,140132.65
2022-04-15,2022-04-15,"Project payment - Miranda, Rodriguez and Myers",REF66338808,0.0,421.74,140554.39
2022-04-15,2022-04-15,Payment from Erickson-Price,REF66036205,0.0,1132.48,141686.87
2022-04-15,2022-04-15,Service payment - White LLC,REF89887416,0.0,727.42,142414.29
2022-04-15,2022-04-15,Payment from Pugh and Sons,REF44641077,0.0,842.13,143256.42
2022-04-15,2022-04-15,Invoice payment - Campbell-Willis,REF43199955,0.0,756.85,144013.27
2022-04-15,2022-04-15,Project payment - Simpson Inc,REF84231027,0.0,959.18,144972.45
2022-04-15,2022-04-15,Invoice payment - Spears-Brown,REF89556629,0.0,430.18,145402.63
2022-04-21,2022-04-21,Professional software license,REF94658123,198.7,0.0,145203.93
2022-04-24,2022-04-24,Accounting expense,REF23850281,225.22,0.0,144978.71
2022-04-25,2022-04-25,Equipment purchase,REF93565140,140.69,0.0,144838.02
2022-04-27,2022-04-27,Training/conference,REF66475855,203.45,0.0,144634.57
2022-05-06,2022-05-06,Accounting expense,REF58450334,172.16,0.0,144462.41
2022-05-12,2022-05-12,Marketing expenses,REF91953581,126.91,0.0,144335.5
2022-05-15,2022-05-15,Invoice payment - Erickson-Price,REF34498175,0.0,841.93,145177.43
2022-05-15,2022-05-15,Business insurance premium,REF23405884,131.34,0.0,145046.09
2022-05-15,2022-05-15,Invoice payment - Campbell-Willis,REF22170581,0.0,602.73,145648.82
2022-05-15,2022-05-15,"Service payment - Dennis, Henderson and Anderson",REF58100318,0.0,165.9,145814.72
2022-05-15,2022-05-15,Invoice payment - White LLC,REF11662128,0.0,677.44,146492.16
2022-05-15,2022-05-15,Invoice payment - Simpson Inc,REF36602535,0.0,922.35,147414.51
2022-05-15,2022-05-15,Project payment - Spears-Brown,REF34828866,0.0,456.81,147871.32
2022-05-15,2022-05-15,"Payment from Miranda, Rodriguez and Myers",REF53707965,0.0,501.7,148373.02
2022-05-15,2022-05-15,Invoice payment - Pugh and Sons,REF40607615,0.0,632.16,149005.18
2022-05-19,2022-05-19,Business travel,REF25606139,501.52,0.0,148503.66
2022-05-20,2022-05-20,Training/conference,REF60558919,304.94,0.0,148198.72
2022-05-21,2022-05-21,Professional software license,REF56857539,186.49,0.0,148012.23
2022-05-26,2022-05-26,Business meal,REF68550434,113.49,0.0,147898.74
2022-05-28,2022-05-28,Coworking space rental,REF36621657,346.82,0.0,147551.92
2022-06-11,2022-06-11,Accounting expense,REF16191943,103.01,0.0,147448.91
2022-06-11,2022-06-11,Coworking space rental,REF30140900,171.82,0.0,147277.09
2022-06-15,2022-06-15,Business insurance premium,REF93385513,111.95,0.0,147165.14
2022-06-15,2022-06-15,Project payment - Simpson Inc,REF27463068,0.0,842.25,148007.39
2022-06-15,2022-06-15,Service payment - Erickson-Price,REF33691145,0.0,840.72,148848.11
2022-06-15,2022-06-15,Payment from Spears-Brown,REF61782146,0.0,353.31,149201.42
2022-06-15,2022-06-15,Invoice payment - Pugh and Sons,REF84145422,0.0,659.59,149861.01
2022-06-15,2022-06-15,"Invoice payment - Dennis, Henderson and Anderson",REF74161186,0.0,116.17,149977.18
2022-06-15,2022-06-15,Service payment - Campbell-Willis,REF12551989,0.0,604.77,150581.95
2022-06-15,2022-06-15,"Service payment - Miranda, Rodriguez and Myers",REF70318562,0.0,401.94,150983.89
2022-06-16,2022-06-16,Coworking space rental,REF81572736,89.84,0.0,150894.05
2022-06-21,2022-06-21,Business meal,REF19533637,186.36,0.0,150707.69
2022-06-21,2022-06-21,Training/conference,REF64480859,213.33,0.0,150494.36
2022-06-21,2022-06-21,Professional software license,REF25063071,157.61,0.0,150336.75
2022-06-23,2022-06-23,Accounting expense,REF32569979,95.46,0.0,150241.29
2022-06-25,2022-06-25,Training/conference,REF71180543,199.57,0.0,150041.72
2022-06-26,2022-06-26,Equipment purchase,REF45365918,174.69,0.0,149867.03
2022-07-01,2022-07-01,Accounting expense,REF62616777,149.28,0.0,149717.75
2022-07-02,2022-07-02,Accounting expense,REF63731430,134.04,0.0,149583.71
2022-07-09,2022-07-09,Equipment purchase,REF21647647,140.81,0.0,149442.9
2022-07-13,2022-07-13,Equipment purchase,REF21006918,122.52,0.0,149320.38
2022-07-15,2022-07-15,Project payment - Spears-Brown,REF40497304,0.0,398.1,149718.48
2022-07-15,2022-07-15,Service payment - Simpson Inc,REF37337736,0.0,898.11,150616.59
2022-07-15,2022-07-15,"Payment from Dennis, Henderson and Anderson",REF88853716,0.0,122.1,150738.69
2022-07-15,2022-07-15,Service payment - White LLC,REF48114714,0.0,538.06,151276.75
2022-07-15,2022-07-15,Service payment - Campbell-Willis,REF67636482,0.0,524.99,151801.74
2022-07-15,2022-07-15,"Project payment - Miranda, Rodriguez and Myers",REF85659915,0.0,359.78,152161.52
2022-07-15,2022-07-15,Project payment - Pugh and Sons,REF32596503,0.0,415.72,152577.24
2022-07-15,2022-07-15,Business insurance premium,REF27605170,107.78,0.0,152469.46
2022-07-19,2022-07-19,Training/conference,REF92821573,170.25,0.0,152299.21
2022-07-21,2022-07-21,Professional software license,REF35933368,110.29,0.0,152188.92
2022-07-21,2022-07-21,Equipment purchase,REF13636968,122.81,0.0,152066.11
2022-07-21,2022-07-21,Business travel,REF59381260,219.36,0.0,151846.75
2022-07-22,2022-07-22,Training/conference,REF20120041,153.27,0.0,151693.48
2022-07-22,2022-07-22,Business travel,REF62898142,200.97,0.0,151492.51
2022-07-23,2022-07-23,Coworking space rental,REF51879474,145.05,0.0,151347.46
2022-07-23,2022-07-23,Marketing expenses,REF46125686,178.05,0.0,151169.41
2022-08-07,2022-08-07,Business travel,REF22451351,302.7,0.0,150866.71
2022-08-08,2022-08-08,Business meal,REF77244501,172.17,0.0,150694.54
2022-08-08,2022-08-08,Accounting expense,REF52935794,224.66,0.0,150469.88
2022-08-15,2022-08-15,Payment from Simpson Inc,REF92742563,0.0,813.86,151283.74
2022-08-15,2022-08-15,Payment from Campbell-Willis,REF95435290,0.0,511.14,151794.88
2022-08-15,2022-08-15,Service payment - Erickson-Price,REF97660594,0.0,819.71,152614.59
2022-08-15,2022-08-15,Project payment - Pugh and Sons,REF71044140,0.0,824.08,153438.67
2022-08-15,2022-08-15,Service payment - Spears-Brown,REF11573331,0.0,318.46,153757.13
2022-08-15,2022-08-15,"Project payment - Dennis, Henderson and Anderson",REF95567149,0.0,164.69,153921.82
2022-08-15,2022-08-15,Business insurance premium,REF39267574,113.53,0.0,153808.29
2022-08-15,2022-08-15,"Service payment - Miranda, Rodriguez and Myers",REF76093861,0.0,404.95,154213.24
2022-08-15,2022-08-15,Service payment - White LLC,REF94039401,0.0,611.11,154824.35
2022-08-18,2022-08-18,Business travel,REF44356246,263.93,0.0,154560.42
2022-08-21,2022-08-21,Professional software license,REF19693009,167.9,0.0,154392.52
2022-08-22,2022-08-22,Business travel,REF80748655,279.16,0.0,154113.36
2022-08-27,2022-08-27,Business meal,REF31733411,143.09,0.0,153970.27
2022-08-27,2022-08-27,Business travel,REF76615382,412.08,0.0,153558.19
2022-08-31,2022-08-31,Marketing expenses,REF45324841,148.57,0.0,153409.62
2022-09-04,2022-09-04,Marketing expenses,REF44387651,302.01,0.0,153107.61
2022-09-13,2022-09-13,Training/conference,REF14831506,256.27,0.0,152851.34
2022-09-15,2022-09-15,Service payment - Pugh and Sons,REF20236926,0.0,853.85,153705.19
2022-09-15,2022-09-15,"Project payment - Miranda, Rodriguez and Myers",REF57831879,0.0,582.06,154287.25
2022-09-15,2022-09-15,Service payment - Simpson Inc,REF71620364,0.0,1192.55,155479.8
2022-09-15,2022-09-15,Invoice payment - White LLC,REF41932308,0.0,681.02,156160.82
2022-09-15,2022-09-15,Service payment - Campbell-Willis,REF69481318,0.0,750.73,156911.55
2022-09-15,2022-09-15,Business insurance premium,REF21045189,150.27,0.0,156761.28
2022-09-15,2022-09-15,"Service payment - Dennis, Henderson and Anderson",REF91018067,0.0,143.83,156905.11
2022-09-15,2022-09-15,Invoice payment - Spears-Brown,REF15508838,0.0,523.2,157428.31
2022-09-15,2022-09-15,Service payment - Erickson-Price,REF20321142,0.0,1232.93,158661.24
2022-09-20,2022-09-20,Business meal,REF22859986,299.45,0.0,158361.79
2022-09-21,2022-09-21,Professional software license,REF61469342,249.95,0.0,158111.84
2022-09-22,2022-09-22,Business meal,REF91229961,315.08,0.0,157796.76
2022-09-25,2022-09-25,Marketing expenses,REF77251136,454.0,0.0,157342.76
2022-09-28,2022-09-28,Business travel,REF29898931,503.31,0.0,156839.45
2022-09-29,2022-09-29,Coworking space rental,REF59229631,154.79,0.0,156684.66
2022-10-02,2022-10-02,Marketing expenses,REF87921249,416.15,0.0,156268.51
2022-10-03,2022-10-03,Coworking space rental,REF41566887,561.81,0.0,155706.7
2022-10-15,2022-10-15,Business insurance premium,REF10391233,160.12,0.0,155546.58
2022-10-15,2022-10-15,Invoice payment - White LLC,REF94644311,0.0,785.6,156332.18
2022-10-15,2022-10-15,Service payment - Simpson Inc,REF92796572,0.0,1016.39,157348.57
2022-10-15,2022-10-15,Service payment - Spears-Brown,REF21481176,0.0,414.26,157762.83
2022-10-15,2022-10-15,Project payment - Erickson-Price,REF49150285,0.0,1337.43,159100.26
2022-10-15,2022-10-15,"Service payment - Dennis, Henderson and Anderson",REF10163251,0.0,380.76,159481.02
2022-10-15,2022-10-15,Invoice payment - Pugh and Sons,REF87608217,0.0,1099.39,160580.41
2022-10-21,2022-10-21,Professional software license,REF35179005,257.41,0.0,160323.0
2022-10-22,2022-10-22,Business meal,REF21592404,331.88,0.0,159991.12
2022-10-26,2022-10-26,Equipment purchase,REF73028352,205.64,0.0,159785.48
2022-10-27,2022-10-27,Accounting expense,REF65759242,258.15,0.0,159527.33
2022-10-27,2022-10-27,Marketing expenses,REF89461642,297.16,0.0,159230.17
2022-10-27,2022-10-27,Business travel,REF38602993,578.58,0.0,158651.59
2022-10-31,2022-10-31,Business travel,REF34765259,183.52,0.0,158468.07
2022-11-07,2022-11-07,Accounting expense,REF84718394,215.75,0.0,158252.32
2022-11-10,2022-11-10,Business meal,REF78285861,184.82,0.0,158067.5
2022-11-15,2022-11-15,"Project payment - Dennis, Henderson and Anderson",REF49664465,0.0,165.61,158233.11
2022-11-15,2022-11-15,"Service payment - Miranda, Rodriguez and Myers",REF21792522,0.0,586.9,158820.01
2022-11-15,2022-11-15,Project payment - Erickson-Price,REF79959956,0.0,1524.51,160344.52
2022-11-15,2022-11-15,Business insurance premium,REF40175739,177.06,0.0,160167.46
2022-11-15,2022-11-15,Project payment - Pugh and Sons,REF37015422,0.0,772.12,160939.58
2022-11-15,2022-11-15,Payment from Campbell-Willis,REF99183397,0.0,816.89,161756.47
2022-11-15,2022-11-15,Service payment - Spears-Brown,REF63613545,0.0,510.65,162267.12
2022-11-15,2022-11-15,Equipment purchase,REF23292193,146.08,0.0,162121.04
2022-11-15,2022-11-15,Marketing expenses,REF35281394,153.47,0.0,161967.57
2022-11-15,2022-11-15,Invoice payment - White LLC,REF85433999,0.0,729.92,162697.49
2022-11-21,2022-11-21,Professional software license,REF26564238,207.09,0.0,162490.4
2022-11-28,2022-11-28,Business travel,REF46671023,388.64,0.0,162101.76
2022-12-06,2022-12-06,Business travel,REF38978627,290.99,0.0,161810.77
2022-12-13,2022-12-13,Marketing expenses,REF48012331,262.99,0.0,161547.78
2022-12-15,2022-12-15,"Invoice payment - Dennis, Henderson and Anderson",REF14219628,0.0,207.07,161754.85
2022-12-15,2022-12-15,Business insurance premium,REF23091460,122.59,0.0,161632.26
2022-12-15,2022-12-15,Service payment - Spears-Brown,REF90240202,0.0,485.14,162117.4
2022-12-15,2022-12-15,"Invoice payment - Miranda, Rodriguez and Myers",REF19588199,0.0,413.55,162530.95
2022-12-15,2022-12-15,Payment from Erickson-Price,REF76749252,0.0,981.46,163512.41
2022-12-15,2022-12-15,Payment from White LLC,REF82271486,0.0,747.89,164260.3
2022-12-15,2022-12-15,Invoice payment - Campbell-Willis,REF58082147,0.0,593.54,164853.84
2022-12-15,2022-12-15,Service payment - Pugh and Sons,REF73338136,0.0,594.31,165448.15
2022-12-15,2022-12-15,Invoice payment - Simpson Inc,REF41785045,0.0,1177.23,166625.38
2022-12-21,2022-12-21,Professional software license,REF82988280,190.86,0.0,166434.52
2022-12-24,2022-12-24,Equipment purchase,REF88672847,104.12,0.0,166330.4
2022-12-24,2022-12-24,Coworking space rental,REF99948555,262.97,0.0,166067.43
2022-12-25,2022-12-25,Business meal,REF11229470,222.6,0.0,165844.83
2022-12-31,2022-12-31,Coworking space rental,REF89191033,272.08,0.0,165572.75
2023-01-01,2023-01-01,Training/conference,REF14432409,339.21,0.0,165233.54
2023-01-06,2023-01-06,Training/conference,REF74805080,87.01,0.0,165146.53
2023-01-09,2023-01-09,Coworking space rental,REF31190235,231.01,0.0,164915.52
2023-01-09,2023-01-09,Equipment purchase,REF54686155,161.09,0.0,164754.43
2023-01-13,2023-01-13,Accounting expense,REF53208838,359.25,0.0,164395.18
2023-01-14,2023-01-14,Business meal,REF98417472,259.5,0.0,164135.68
2023-01-15,2023-01-15,Business insurance premium,REF93752957,177.97,0.0,163957.71
2023-01-15,2023-01-15,"Invoice payment - Miranda, Rodriguez and Myers",REF85273455,0.0,552.77,164510.48
2023-01-15,2023-01-15,Payment from Simpson Inc,REF37781412,0.0,1071.04,165581.52
2023-01-15,2023-01-15,Invoice payment - Pugh and Sons,REF47373490,0.0,868.22,166449.74
2023-01-15,2023-01-15,Project payment - Campbell-Willis,REF12734400,0.0,875.57,167325.31
2023-01-15,2023-01-15,Payment from White LLC,REF57708840,0.0,1015.62,168340.93
2023-01-15,2023-01-15,"Project payment - Dennis, Henderson and Anderson",REF19305973,0.0,230.92,168571.85
2023-01-17,2023-01-17,Equipment purchase,REF52939807,282.65,0.0,168289.2
2023-01-21,2023-01-21,Professional software license,REF80556787,212.57,0.0,168076.63
2023-01-25,2023-01-25,Business meal,REF49431671,277.02,0.0,167799.61
2023-01-26,2023-01-26,Marketing expenses,REF20010138,219.43,0.0,167580.18
2023-01-26,2023-01-26,Accounting expense,REF19819958,142.13,0.0,167438.05
2023-01-31,2023-01-31,Business travel,REF96141949,449.5,0.0,166988.55
2023-02-08,2023-02-08,Business travel,REF49397352,413.2,0.0,166575.35
2023-02-12,2023-02-12,Coworking space rental,REF83816844,307.26,0.0,166268.09
2023-02-13,2023-02-13,Accounting expense,REF89948600,215.09,0.0,166053.0
2023-02-13,2023-02-13,Business meal,REF87328115,290.36,0.0,165762.64
2023-02-15,2023-02-15,Service payment - Campbell-Willis,REF47822698,0.0,820.69,166583.33
2023-02-15,2023-02-15,Invoice payment - Erickson-Price,REF17933979,0.0,1013.86,167597.19
2023-02-15,2023-02-15,"Service payment - Dennis, Henderson and Anderson",REF53050277,0.0,245.23,167842.42
2023-02-15,2023-02-15,Invoice payment - White LLC,REF65391012,0.0,895.62,168738.04
2023-02-15,2023-02-15,Invoice payment - Simpson Inc,REF39234629,0.0,1150.44,169888.48
2023-02-15,2023-02-15,"Service payment - Miranda, Rodriguez and Myers",REF57870030,0.0,567.45,170455.93
2023-02-15,2023-02-15,Project payment - Pugh and Sons,REF18309522,0.0,857.88,171313.81
2023-02-15,2023-02-15,Invoice payment - Spears-Brown,REF45834653,0.0,552.58,171866.39
2023-02-15,2023-02-15,Business insurance premium,REF25600411,149.54,0.0,171716.85
2023-02-21,2023-02-21,Professional software license,REF63323183,214.28,0.0,171502.57
2023-02-22,2023-02-22,Marketing expenses,REF58017108,205.59,0.0,171296.98
2023-02-24,2023-02-24,Coworking space rental,REF79902168,274.91,0.0,171022.07
2023-02-28,2023-02-28,Equipment purchase,REF46426551,190.25,0.0,170831.82
2023-03-04,2023-03-04,Business meal,REF47045641,212.49,0.0,170619.33
2023-03-08,2023-03-08,Equipment purchase,REF44538487,157.69,0.0,170461.64
2023-03-09,2023-03-09,Business meal,REF97087125,231.62,0.0,170230.02
2023-03-10,2023-03-10,Marketing expenses,REF45777652,261.24,0.0,169968.78
2023-03-15,2023-03-15,Payment from Erickson-Price,REF67633922,0.0,1130.96,171099.74
2023-03-15,2023-03-15,"Project payment - Miranda, Rodriguez and Myers",REF88955990,0.0,358.34,171458.08
2023-03-15,2023-03-15,Project payment - White LLC,REF24558278,0.0,824.55,172282.63
2023-03-15,2023-03-15,Project payment - Pugh and Sons,REF62770097,0.0,556.51,172839.14
2023-03-15,2023-03-15,Payment from Campbell-Willis,REF84998882,0.0,720.29,173559.43
2023-03-15,2023-03-15,Business insurance premium,REF28411935,143.35,0.0,173416.08
2023-03-15,2023-03-15,"Payment from Dennis, Henderson and Anderson",REF99455838,0.0,210.26,173626.34
2023-03-18,2023-03-18,Business meal,REF96274951,210.35,0.0,173415.99
2023-03-21,2023-03-21,Professional software license,REF14922719,192.56,0.0,173223.43
2023-03-23,2023-03-23,Business meal,REF31589410,296.87,0.0,172926.56
2023-04-02,2023-04-02,Coworking space rental,REF53219143,245.8,0.0,172680.76
2023-04-02,2023-04-02,Business meal,REF66083150,292.21,0.0,172388.55
2023-04-03,2023-04-03,Business meal,REF53276694,200.71,0.0,172187.84
2023-04-03,2023-04-03,Coworking space rental,REF91507179,425.81,0.0,171762.03
2023-04-09,2023-04-09,Training/conference,REF48427616,302.99,0.0,171459.04
2023-04-09,2023-04-09,Marketing expenses,REF58649735,375.13,0.0,171083.91
2023-04-15,2023-04-15,"Service payment - Dennis, Henderson and Anderson",REF42150479,0.0,178.27,171262.18
2023-04-15,2023-04-15,Service payment - Simpson Inc,REF63222408,0.0,958.67,172220.85
2023-04-15,2023-04-15,Project payment - Spears-Brown,REF33090795,0.0,405.79,172626.64
2023-04-15,2023-04-15,"Project payment - Miranda, Rodriguez and Myers",REF48237236,0.0,510.5,173137.14
2023-04-15,2023-04-15,Project payment - Erickson-Price,REF46429539,0.0,984.94,174122.08
2023-04-15,2023-04-15,Invoice payment - Campbell-Willis,REF73346211,0.0,562.34,174684.42
2023-04-15,2023-04-15,Invoice payment - Pugh and Sons,REF60559529,0.0,557.3,175241.72
2023-04-15,2023-04-15,Business insurance premium,REF32444956,133.92,0.0,175107.8
2023-04-15,2023-04-15,Project payment - White LLC,REF92287683,0.0,657.55,175765.35
2023-04-18,2023-04-18,Business travel,REF77614810,248.04,0.0,175517.31
2023-04-20,2023-04-20,Business travel,REF47808762,288.64,0.0,175228.67
2023-04-21,2023-04-21,Professional software license,REF44883027,213.73,0.0,175014.94
2023-04-24,2023-04-24,Equipment purchase,REF16038002,161.93,0.0,174853.01
2023-04-29,2023-04-29,Training/conference,REF32920200,328.8,0.0,174524.21
2023-04-29,2023-04-29,Marketing expenses,REF42405219,286.87,0.0,174237.34
2023-05-08,2023-05-08,Equipment purchase,REF58209148,125.36,0.0,174111.98
2023-05-10,2023-05-10,Business travel,REF14094452,331.24,0.0,173780.74
2023-05-12,2023-05-12,Accounting expense,REF66623636,190.43,0.0,173590.31
2023-05-13,2023-05-13,Marketing expenses,REF51339161,327.6,0.0,173262.71
2023-05-15,2023-05-15,Service payment - Simpson Inc,REF83547942,0.0,921.48,174184.19
2023-05-15,2023-05-15,Project payment - White LLC,REF95136632,0.0,801.9,174986.09
2023-05-15,2023-05-15,Business insurance premium,REF11705602,114.8,0.0,174871.29
2023-05-15,2023-05-15,Service payment - Spears-Brown,REF16149801,0.0,375.23,175246.52
2023-05-15,2023-05-15,Project payment - Campbell-Willis,REF22984240,0.0,711.8,175958.32
2023-05-15,2023-05-15,Payment from Erickson-Price,REF10557769,0.0,805.29,176763.61
2023-05-15,2023-05-15,Business meal,REF86024590,118.55,0.0,176645.06
2023-05-21,2023-05-21,Coworking space rental,REF59388038,218.21,0.0,176426.85
2023-05-21,2023-05-21,Professional software license,REF43297686,149.45,0.0,176277.4
2023-05-23,2023-05-23,Training/conference,REF35888006,145.25,0.0,176132.15
2023-05-23,2023-05-23,Accounting expense,REF92015015,214.48,0.0,175917.67
2023-05-31,2023-05-31,Business travel,REF43597170,351.07,0.0,175566.6
2023-06-01,2023-06-01,Accounting expense,REF46484602,211.84,0.0,175354.76
2023-06-01,2023-06-01,Business travel,REF22861143,248.47,0.0,175106.29
2023-06-09,2023-06-09,Accounting expense,REF56661738,169.79,0.0,174936.5
2023-06-15,2023-06-15,Business insurance premium,REF85157134,117.32,0.0,174819.18
2023-06-15,2023-06-15,Payment from White LLC,REF45521464,0.0,654.52,175473.7
2023-06-15,2023-06-15,Invoice payment - Campbell-Willis,REF29560618,0.0,453.48,175927.18
2023-06-15,2023-06-15,Invoice payment - Spears-Brown,REF35482173,0.0,307.85,176235.03
2023-06-15,2023-06-15,Payment from Simpson Inc,REF26786314,0.0,1071.5,177306.53
2023-06-15,2023-06-15,"Project payment - Dennis, Henderson and Anderson",REF69151063,0.0,161.31,177467.84
2023-06-15,2023-06-15,"Payment from Miranda, Rodriguez and Myers",REF88039051,0.0,439.96,177907.8
2023-06-15,2023-06-15,Invoice payment - Erickson-Price,REF17027489,0.0,966.01,178873.81
2023-06-17,2023-06-17,Business travel,REF72972245,249.04,0.0,178624.77
2023-06-21,2023-06-21,Professional software license,REF69044718,158.17,0.0,178466.6
2023-06-22,2023-06-22,Business meal,REF42879561,269.02,0.0,178197.58
2023-06-30,2023-06-30,Equipment purchase,REF12356006,186.51,0.0,178011.07
2023-07-01,2023-07-01,Business travel,REF50748181,267.32,0.0,177743.75
2023-07-07,2023-07-07,Coworking space rental,REF89380812,286.2,0.0,177457.55
2023-07-11,2023-07-11,Training/conference,REF38878990,72.14,0.0,177385.41
2023-07-12,2023-07-12,Equipment purchase,REF58895979,50.12,0.0,177335.29
2023-07-14,2023-07-14,Marketing expenses,REF70843761,234.47,0.0,177100.82
2023-07-15,2023-07-15,Invoice payment - Simpson Inc,REF56659432,0.0,774.67,177875.49
2023-07-15,2023-07-15,Invoice payment - Spears-Brown,REF36364479,0.0,374.91,178250.4
2023-07-15,2023-07-15,Business insurance premium,REF12446306,109.71,0.0,178140.69
2023-07-15,2023-07-15,"Payment from Dennis, Henderson and Anderson",REF64732793,0.0,135.29,178275.98
2023-07-15,2023-07-15,Service payment - Erickson-Price,REF23827510,0.0,705.71,178981.69
2023-07-15,2023-07-15,Payment from Pugh and Sons,REF97026338,0.0,525.81,179507.5
2023-07-15,2023-07-15,"Payment from Miranda, Rodriguez and Myers",REF32541973,0.0,382.43,179889.93
2023-07-21,2023-07-21,Professional software license,REF15179645,147.26,0.0,179742.67
2023-07-27,2023-07-27,Training/conference,REF69886085,170.75,0.0,179571.92
2023-07-29,2023-07-29,Marketing expenses,REF55836092,257.59,0.0,179314.33
2023-07-30,2023-07-30,Equipment purchase,REF63926159,112.92,0.0,179201.41
2023-08-10,2023-08-10,Business meal,REF20700926,238.26,0.0,178963.15
2023-08-11,2023-08-11,Accounting expense,REF40888090,147.22,0.0,178815.93
2023-08-13,2023-08-13,Business travel,REF55297603,107.94,0.0,178707.99
2023-08-15,2023-08-15,Service payment - Campbell-Willis,REF83294981,0.0,442.45,179150.44
2023-08-15,2023-08-15,Business insurance premium,REF73328202,110.85,0.0,179039.59
2023-08-15,2023-08-15,Invoice payment - Pugh and Sons,REF97777613,0.0,596.99,179636.58
2023-08-15,2023-08-15,Payment from Erickson-Price,REF43569014,0.0,1060.58,180697.16
2023-08-15,2023-08-15,Invoice payment - Spears-Brown,REF13399716,0.0,339.45,181036.61
2023-08-15,2023-08-15,Project payment - Simpson Inc,REF59566795,0.0,753.91,181790.52
2023-08-15,2023-08-15,"Payment from Miranda, Rodriguez and Myers",REF69056654,0.0,372.56,182163.08
2023-08-15,2023-08-15,"Project payment - Dennis, Henderson and Anderson",REF46240080,0.0,162.97,182326.05
2023-08-18,2023-08-18,Training/conference,REF52507141,182.4,0.0,182143.65
2023-08-19,2023-08-19,Business travel,REF91236565,296.26,0.0,181847.39
2023-08-21,2023-08-21,Professional software license,REF26166171,130.63,0.0,181716.76
2023-08-22,2023-08-22,Business meal,REF67338069,195.03,0.0,181521.73
2023-08-22,2023-08-22,Business travel,REF15965815,380.13,0.0,181141.6
2023-08-23,2023-08-23,Business travel,REF60349792,346.1,0.0,180795.5
2023-08-28,2023-08-28,Business meal,REF32976078,83.12,0.0,180712.38
2023-08-31,2023-08-31,Business travel,REF18985230,221.14,0.0,180491.24
2023-09-01,2023-09-01,Training/conference,REF68233943,163.25,0.0,180327.99
2023-09-05,2023-09-05,Business travel,REF82092505,318.84,0.0,180009.15
2023-09-09,2023-09-09,Coworking space rental,REF49916706,346.02,0.0,179663.13
2023-09-11,2023-09-11,Business travel,REF68297029,341.27,0.0,179321.86
2023-09-15,2023-09-15,Business insurance premium,REF57814960,135.76,0.0,179186.1
2023-09-15,2023-09-15,Invoice payment - Simpson Inc,REF83244100,0.0,1251.54,180437.64
2023-09-15,2023-09-15,Invoice payment - White LLC,REF53994189,0.0,968.24,181405.88
2023-09-15,2023-09-15,"Invoice payment - Dennis, Henderson and Anderson",REF35677409,0.0,191.71,181597.59
2023-09-15,2023-09-15,Invoice payment - Spears-Brown,REF12250644,0.0,580.62,182178.21
2023-09-15,2023-09-15,Service payment - Pugh and Sons,REF61886948,0.0,663.75,182841.96
2023-09-15,2023-09-15,Service payment - Campbell-Willis,REF34659690,0.0,573.13,183415.09
2023-09-15,2023-09-15,Payment from Erickson-Price,REF22161805,0.0,1187.68,184602.77
2023-09-16,2023-09-16,Business meal,REF38187132,291.4,0.0,184311.37
2023-09-21,2023-09-21,Professional software license,REF31249449,242.94,0.0,184068.43
2023-09-27,2023-09-27,Business travel,REF74108782,414.75,0.0,183653.68
2023-09-30,2023-09-30,Business travel,REF38092743,190.82,0.0,183462.86
2023-10-15,2023-10-15,Service payment - Pugh and Sons,REF75558268,0.0,907.41,184370.27
2023-10-15,2023-10-15,Business insurance premium,REF44764627,159.76,0.0,184210.51
2023-10-15,2023-10-15,Project payment - Campbell-Willis,REF87202187,0.0,854.83,185065.34
2023-10-15,2023-10-15,"Invoice payment - Miranda, Rodriguez and Myers",REF31549684,0.0,596.64,185661.98
2023-10-15,2023-10-15,"Project payment - Dennis, Henderson and Anderson",REF83781427,0.0,324.15,185986.13
2023-10-15,2023-10-15,Project payment - White LLC,REF73464222,0.0,809.18,186795.31
2023-10-15,2023-10-15,Project payment - Simpson Inc,REF39837231,0.0,1341.45,188136.76
2023-10-15,2023-10-15,Payment from Spears-Brown,REF22712213,0.0,576.37,188713.13
2023-10-15,2023-10-15,Business meal,REF16852722,292.07,0.0,188421.06
2023-10-15,2023-10-15,Payment from Erickson-Price,REF38882819,0.0,1002.78,189423.84
2023-10-16,2023-10-16,Equipment purchase,REF31064721,281.47,0.0,189142.37
2023-10-17,2023-10-17,Coworking space rental,REF24811599,322.55,0.0,188819.82
2023-10-18,2023-10-18,Business meal,REF38955945,140.25,0.0,188679.57
2023-10-21,2023-10-21,Professional software license,REF96693198,264.41,0.0,188415.16
2023-10-22,2023-10-22,Training/conference,REF93671111,235.04,0.0,188180.12
2023-10-24,2023-10-24,Business travel,REF94843487,484.88,0.0,187695.24
2023-10-26,2023-10-26,Marketing expenses,REF75458184,329.64,0.0,187365.6
2023-10-31,2023-10-31,Training/conference,REF44026596,106.15,0.0,187259.45
2023-11-02,2023-11-02,Accounting expense,REF68251419,233.99,0.0,187025.46
2023-11-05,2023-11-05,Business meal,REF29441785,238.97,0.0,186786.49
2023-11-06,2023-11-06,Business meal,REF36072513,356.64,0.0,186429.85
2023-11-11,2023-11-11,Training/conference,REF24335246,186.59,0.0,186243.26
2023-11-15,2023-11-15,Payment from Spears-Brown,REF75279157,0.0,493.05,186736.31
2023-11-15,2023-11-15,"Service payment - Dennis, Henderson and Anderson",REF84979429,0.0,228.9,186965.21
2023-11-15,2023-11-15,Payment from White LLC,REF42335906,0.0,999.13,187964.34
2023-11-15,2023-11-15,Marketing expenses,REF90163183,382.34,0.0,187582.0
2023-11-15,2023-11-15,"Payment from Miranda, Rodriguez and Myers",REF85987314,0.0,368.63,187950.63
2023-11-15,2023-11-15,Service payment - Pugh and Sons,REF92635909,0.0,716.75,188667.38
2023-11-15,2023-11-15,Payment from Simpson Inc,REF43840813,0.0,1168.31,189835.69
2023-11-15,2023-11-15,Invoice payment - Erickson-Price,REF64306931,0.0,1157.2,190992.89
2023-11-15,2023-11-15,Project payment - Campbell-Willis,REF96115247,0.0,681.37,191674.26
2023-11-15,2023-11-15,Business insurance premium,REF20963657,171.74,0.0,191502.52
2023-11-18,2023-11-18,Business travel,REF92682662,327.77,0.0,191174.75
2023-11-21,2023-11-21,Professional software license,REF45868593,230.09,0.0,190944.66
2023-11-21,2023-11-21,Business meal,REF24095273,93.69,0.0,190850.97
2023-11-27,2023-11-27,Business travel,REF63166402,551.08,0.0,190299.89
2023-12-04,2023-12-04,Training/conference,REF37328530,221.71,0.0,190078.18
2023-12-05,2023-12-05,Equipment purchase,REF32322763,134.75,0.0,189943.43
2023-12-15,2023-12-15,"Invoice payment - Miranda, Rodriguez and Myers",REF96575678,0.0,501.24,190444.67
2023-12-15,2023-12-15,Business insurance premium,REF15138606,132.89,0.0,190311.78
2023-12-15,2023-12-15,Payment from Pugh and Sons,REF96386487,0.0,508.18,190819.96
2023-12-15,2023-12-15,Invoice payment - Spears-Brown,REF68106738,0.0,483.59,191303.55
2023-12-15,2023-12-15,Payment from Simpson Inc,REF82450514,0.0,925.67,192229.22
2023-12-15,2023-12-15,Service payment - White LLC,REF65502137,0.0,706.0,192935.22
2023-12-15,2023-12-15,"Invoice payment - Dennis, Henderson and Anderson",REF56380415,0.0,185.71,193120.93
2023-12-15,2023-12-15,Project payment - Erickson-Price,REF36434623,0.0,1069.9,194190.83
2023-12-15,2023-12-15,Coworking space rental,REF24802093,315.17,0.0,193875.66
2023-12-15,2023-12-15,Invoice payment - Campbell-Willis,REF76003267,0.0,496.4,194372.06
2023-12-21,2023-12-21,Professional software license,REF90832796,191.87,0.0,194180.19
2023-12-23,2023-12-23,Marketing expenses,REF36970901,227.37,0.0,193952.82
2023-12-24,2023-12-24,Accounting expense,REF71430471,181.98,0.0,193770.84
2023-12-29,2023-12-29,Business meal,REF77489698,110.89,0.0,193659.95
2024-01-01,2024-01-01,Business meal,REF18738106,237.98,0.0,193421.97
2024-01-04,2024-01-04,Business meal,REF69784039,295.17,0.0,193126.8
2024-01-05,2024-01-05,Coworking space rental,REF19899917,427.88,0.0,192698.92
2024-01-13,2024-01-13,Business meal,REF14701582,75.28,0.0,192623.64
2024-01-15,2024-01-15,"Payment from Dennis, Henderson and Anderson",REF43248221,0.0,222.01,192845.65
2024-01-15,2024-01-15,Payment from Spears-Brown,REF37262943,0.0,514.17,193359.82
2024-01-15,2024-01-15,Payment from White LLC,REF39915178,0.0,810.42,194170.24
2024-01-15,2024-01-15,Business insurance premium,REF77938853,165.5,0.0,194004.74
2024-01-15,2024-01-15,Invoice payment - Erickson-Price,REF17892787,0.0,1197.1,195201.84
2024-01-15,2024-01-15,Invoice payment - Simpson Inc,REF77208864,0.0,1089.41,196291.25
2024-01-15,2024-01-15,Payment from Campbell-Willis,REF73155631,0.0,793.28,197084.53
2024-01-15,2024-01-15,"Service payment - Miranda, Rodriguez and Myers",REF10181605,0.0,465.6,197550.13
2024-01-21,2024-01-21,Professional software license,REF18408205,230.94,0.0,197319.19
2024-01-28,2024-01-28,Business travel,REF51714255,247.59,0.0,197071.6
2024-02-03,2024-02-03,Accounting expense,REF45698317,178.71,0.0,196892.89
2024-02-03,2024-02-03,Training/conference,REF19762406,286.75,0.0,196606.14
2024-02-04,2024-02-04,Coworking space rental,REF65259934,252.35,0.0,196353.79
2024-02-05,2024-02-05,Business meal,REF37035773,236.69,0.0,196117.1
2024-02-10,2024-02-10,Business meal,REF59266269,231.22,0.0,195885.88
2024-02-11,2024-02-11,Coworking space rental,REF61009727,285.72,0.0,195600.16
2024-02-11,2024-02-11,Business travel,REF28889033,471.4,0.0,195128.76
2024-02-15,2024-02-15,Business insurance premium,REF62587945,149.65,0.0,194979.11
2024-02-15,2024-02-15,Payment from Spears-Brown,REF65054044,0.0,536.31,195515.42
2024-02-15,2024-02-15,Service payment - Erickson-Price,REF51759767,0.0,1130.5,196645.92
2024-02-15,2024-02-15,Service payment - Simpson Inc,REF35859728,0.0,1506.43,198152.35
2024-02-15,2024-02-15,"Payment from Dennis, Henderson and Anderson",REF72765784,0.0,212.02,198364.37
2024-02-15,2024-02-15,Payment from White LLC,REF61137077,0.0,978.23,199342.6
2024-02-15,2024-02-15,"Service payment - Miranda, Rodriguez and Myers",REF38767274,0.0,522.92,199865.52
2024-02-15,2024-02-15,Project payment - Pugh and Sons,REF35459591,0.0,779.6,200645.12
2024-02-15,2024-02-15,Project payment - Campbell-Willis,REF98632249,0.0,876.69,201521.81
2024-02-16,2024-02-16,Equipment purchase,REF93169298,219.28,0.0,201302.53
2024-02-16,2024-02-16,Business travel,REF85583164,212.23,0.0,201090.3
2024-02-17,2024-02-17,Training/conference,REF81403682,210.58,0.0,200879.72
2024-02-18,2024-02-18,Marketing expenses,REF28113674,168.12,0.0,200711.6
2024-02-21,2024-02-21,Marketing expenses,REF20076286,471.78,0.0,200239.82
2024-02-21,2024-02-21,Professional software license,REF25961744,235.03,0.0,200004.79
2024-02-22,2024-02-22,Training/conference,REF15800272,207.81,0.0,199796.98
2024-02-23,2024-02-23,Coworking space rental,REF69305103,502.62,0.0,199294.36
2024-03-01,2024-03-01,Business meal,REF56325855,372.95,0.0,198921.41
2024-03-01,2024-03-01,Accounting expense,REF49253572,300.51,0.0,198620.9
2024-03-05,2024-03-05,Equipment purchase,REF61890473,165.56,0.0,198455.34
2024-03-11,2024-03-11,Business meal,REF80156249,288.57,0.0,198166.77
2024-03-15,2024-03-15,Service payment - Pugh and Sons,REF31762796,0.0,835.62,199002.39
2024-03-15,2024-03-15,Marketing expenses,REF88628565,488.48,0.0,198513.91
2024-03-15,2024-03-15,Project payment - Erickson-Price,REF28980878,0.0,1059.62,199573.53
2024-03-15,2024-03-15,Service payment - White LLC,REF34367058,0.0,825.78,200399.31
2024-03-15,2024-03-15,Service payment - Simpson Inc,REF23564994,0.0,1124.62,201523.93
2024-03-15,2024-03-15,Project payment - Campbell-Willis,REF65660480,0.0,656.95,202180.88
2024-03-15,2024-03-15,Payment from Spears-Brown,REF86731807,0.0,528.05,202708.93
2024-03-15,2024-03-15,"Invoice payment - Miranda, Rodriguez and Myers",REF31616843,0.0,538.12,203247.05
2024-03-15,2024-03-15,"Service payment - Dennis, Henderson and Anderson",REF22246361,0.0,255.34,203502.39
2024-03-15,2024-03-15,Business insurance premium,REF53462304,145.79,0.0,203356.6
2024-03-21,2024-03-21,Professional software license,REF92863906,221.11,0.0,203135.49
2024-03-23,2024-03-23,Business meal,REF75785271,294.56,0.0,202840.93
2024-03-25,2024-03-25,Business travel,REF32543020,387.3,0.0,202453.63
2024-04-01,2024-04-01,Business meal,REF77219157,244.99,0.0,202208.64
2024-04-03,2024-04-03,Business meal,REF21882064,214.33,0.0,201994.31
2024-04-05,2024-04-05,Equipment purchase,REF87932385,112.84,0.0,201881.47
2024-04-06,2024-04-06,Marketing expenses,REF80376356,338.44,0.0,201543.03
2024-04-14,2024-04-14,Business travel,REF93632641,512.74,0.0,201030.29
2024-04-15,2024-04-15,Invoice payment - White LLC,REF31437284,0.0,855.6,201885.89
2024-04-15,2024-04-15,Business insurance premium,REF51111309,158.2,0.0,201727.69
2024-04-15,2024-04-15,"Service payment - Dennis, Henderson and Anderson",REF95716141,0.0,188.15,201915.84
2024-04-15,2024-04-15,"Project payment - Miranda, Rodriguez and Myers",REF63191476,0.0,355.74,202271.58
2024-04-15,2024-04-15,Project payment - Pugh and Sons,REF15031987,0.0,899.19,203170.77
2024-04-15,2024-04-15,Payment from Campbell-Willis,REF54194365,0.0,636.77,203807.54
2024-04-15,2024-04-15,Invoice payment - Spears-Brown,REF89180504,0.0,459.93,204267.47
2024-04-15,2024-04-15,Payment from Erickson-Price,REF98066428,0.0,895.21,205162.68
2024-04-19,2024-04-19,Coworking space rental,REF26396845,336.67,0.0,204826.01
2024-04-19,2024-04-19,Business travel,REF52127313,500.86,0.0,204325.15
2024-04-21,2024-04-21,Professional software license,REF56545326,194.7,0.0,204130.45
2024-05-05,2024-05-05,Business travel,REF80553886,392.38,0.0,203738.07
2024-05-13,2024-05-13,Accounting expense,REF82144044,244.38,0.0,203493.69
2024-05-14,2024-05-14,Business travel,REF25043099,236.45,0.0,203257.24
2024-05-15,2024-05-15,Service payment - Pugh and Sons,REF19646743,0.0,674.09,203931.33
2024-05-15,2024-05-15,Project payment - Simpson Inc,REF29549461,0.0,948.41,204879.74
2024-05-15,2024-05-15,Business insurance premium,REF70270245,125.86,0.0,204753.88
2024-05-15,2024-05-15,Project payment - White LLC,REF59719752,0.0,695.84,205449.72
2024-05-15,2024-05-15,"Project payment - Dennis, Henderson and Anderson",REF73934424,0.0,194.29,205644.01
2024-05-15,2024-05-15,"Invoice payment - Miranda, Rodriguez and Myers",REF66617849,0.0,541.21,206185.22
2024-05-21,2024-05-21,Professional software license,REF62851877,152.13,0.0,206033.09
2024-05-27,2024-05-27,Training/conference,REF26345074,179.07,0.0,205854.02
2024-05-30,2024-05-30,Marketing expenses,REF72341527,300.45,0.0,205553.57
2024-06-15,2024-06-15,Payment from Campbell-Willis,REF20433975,0.0,638.31,206191.88
2024-06-15,2024-06-15,Payment from Simpson Inc,REF58449344,0.0,826.2,207018.08
2024-06-15,2024-06-15,"Project payment - Miranda, Rodriguez and Myers",REF35428021,0.0,414.94,207433.02
2024-06-15,2024-06-15,Business insurance premium,REF98320381,107.45,0.0,207325.57
2024-06-15,2024-06-15,"Service payment - Dennis, Henderson and Anderson",REF38379072,0.0,154.78,207480.35
2024-06-15,2024-06-15,Invoice payment - Erickson-Price,REF95985523,0.0,840.18,208320.53
2024-06-15,2024-06-15,Service payment - Spears-Brown,REF67500797,0.0,327.64,208648.17
2024-06-15,2024-06-15,Payment from White LLC,REF84188726,0.0,660.85,209309.02
2024-06-15,2024-06-15,Service payment - Pugh and Sons,REF38332002,0.0,613.56,209922.58
2024-06-17,2024-06-17,Business meal,REF50732337,170.62,0.0,209751.96
2024-06-19,2024-06-19,Marketing expenses,REF96418592,169.05,0.0,209582.91
2024-06-21,2024-06-21,Professional software license,REF65040497,163.6,0.0,209419.31
2024-06-24,2024-06-24,Equipment purchase,REF92162789,79.53,0.0,209339.78
2024-06-25,2024-06-25,Accounting expense,REF61076473,127.57,0.0,209212.21
2024-07-01,2024-07-01,Equipment purchase,REF56455050,95.57,0.0,209116.64
2024-07-06,2024-07-06,Business travel,REF51450919,307.75,0.0,208808.89
2024-07-12,2024-07-12,Business meal,REF30726618,232.11,0.0,208576.78
2024-07-15,2024-07-15,Invoice payment - White LLC,REF30233442,0.0,398.55,208975.33
2024-07-15,2024-07-15,"Payment from Dennis, Henderson and Anderson",REF35424402,0.0,149.42,209124.75
2024-07-15,2024-07-15,Invoice payment - Erickson-Price,REF93122574,0.0,868.69,209993.44
2024-07-15,2024-07-15,Payment from Campbell-Willis,REF30057351,0.0,379.63,210373.07
2024-07-15,2024-07-15,Service payment - Spears-Brown,REF68361557,0.0,340.37,210713.44
2024-07-15,2024-07-15,"Project payment - Miranda, Rodriguez and Myers",REF71134992,0.0,375.81,211089.25
2024-07-15,2024-07-15,Project payment - Simpson Inc,REF73091526,0.0,658.78,211748.03
2024-07-15,2024-07-15,Business insurance premium,REF59883661,97.33,0.0,211650.7
2024-07-16,2024-07-16,Accounting expense,REF34827360,102.52,0.0,211548.18
2024-07-21,2024-07-21,Professional software license,REF30913563,151.56,0.0,211396.62
2024-07-23,2024-07-23,Business travel,REF25734086,220.47,0.0,211176.15
2024-07-23,2024-07-23,Business meal,REF63825869,167.19,0.0,211008.96
2024-07-28,2024-07-28,Coworking space rental,REF81589770,153.15,0.0,210855.81
2024-07-30,2024-07-30,Accounting expense,REF67549607,78.7,0.0,210777.11
2024-07-31,2024-07-31,Business travel,REF26975337,306.37,0.0,210470.74
2024-08-02,2024-08-02,Business meal,REF29549493,297.9,0.0,210172.84
2024-08-05,2024-08-05,Business meal,REF43815682,297.47,0.0,209875.37
2024-08-15,2024-08-15,"Invoice payment - Miranda, Rodriguez and Myers",REF58703843,0.0,405.62,210280.99
2024-08-15,2024-08-15,Payment from Simpson Inc,REF77388512,0.0,931.33,211212.32
2024-08-15,2024-08-15,Business insurance premium,REF95157396,110.98,0.0,211101.34
2024-08-15,2024-08-15,Payment from Campbell-Willis,REF99321932,0.0,399.67,211501.01
2024-08-15,2024-08-15,"Service payment - Dennis, Henderson and Anderson",REF63298833,0.0,141.21,211642.22
2024-08-15,2024-08-15,Invoice payment - Spears-Brown,REF52864535,0.0,383.83,212026.05
2024-08-15,2024-08-15,Project payment - White LLC,REF21012360,0.0,503.89,212529.94
2024-08-15,2024-08-15,Project payment - Pugh and Sons,REF57768577,0.0,669.5,213199.44
2024-08-15,2024-08-15,Payment from Erickson-Price,REF30057813,0.0,840.36,214039.8
2018-08-21,2018-08-21,Professional software license,REF99531117,160.7,0.0,4557.92
2018-08-23,2018-08-23,Business meal,REF23691062,194.64,0.0,4363.28
2018-08-24,2018-08-24,Equipment purchase,REF43822842,48.83,0.0,4314.45
2018-08-29,2018-08-29,Marketing expenses,REF76151745,277.64,0.0,4036.81
2018-09-01,2018-09-01,Equipment purchase,REF79215670,171.24,0.0,3865.57
2018-09-02,2018-09-02,Equipment purchase,REF66413990,214.13,0.0,3651.44
2018-09-15,2018-09-15,Project payment - Kennedy-Lewis,REF33332433,0.0,1031.96,4683.4
2018-09-15,2018-09-15,Business insurance premium,REF29380415,157.39,0.0,4526.01
2018-09-15,2018-09-15,"Project payment - Burke, Hernandez and Alexander",REF93152052,0.0,791.48,5317.49
2018-09-15,2018-09-15,Project payment - Walker Inc,REF35431611,0.0,1003.55,6321.04
2018-09-15,2018-09-15,"Service payment - Sanchez, Terry and Cox",REF38342779,0.0,544.53,6865.57
2018-09-15,2018-09-15,Business travel,REF31997902,122.09,0.0,6743.48
2018-09-15,2018-09-15,"Invoice payment - Jones, Anderson and Hancock",REF83981414,0.0,489.58,7233.06
2018-09-15,2018-09-15,Project payment - Gordon-Snow,REF28560780,0.0,941.8,8174.86
2018-09-15,2018-09-15,"Invoice payment - Bond, Ryan and Austin",REF50382889,0.0,834.82,9009.68
2018-09-21,2018-09-21,Professional software license,REF59687513,221.6,0.0,8788.08
2018-09-22,2018-09-22,Coworking space rental,REF92043732,431.8,0.0,8356.28
2018-09-29,2018-09-29,Coworking space rental,REF41393349,432.77,0.0,7923.51
2018-09-29,2018-09-29,Accounting expense,REF99705194,240.69,0.0,7682.82
2018-09-29,2018-09-29,Business meal,REF21101204,299.56,0.0,7383.26
2018-10-13,2018-10-13,Business meal,REF65299959,351.1,0.0,7032.16
2018-10-15,2018-10-15,"Project payment - Sanchez, Terry and Cox",REF30118404,0.0,564.11,7596.27
2018-10-15,2018-10-15,Project payment - Contreras-Miller,REF56504049,0.0,1202.42,8798.69
2018-10-15,2018-10-15,Business insurance premium,REF66300179,162.86,0.0,8635.83
2018-10-15,2018-10-15,"Invoice payment - Bond, Ryan and Austin",REF76288154,0.0,901.45,9537.28
2018-10-15,2018-10-15,Training/conference,REF66481256,315.73,0.0,9221.55
2018-10-15,2018-10-15,Project payment - Gordon-Snow,REF95893664,0.0,986.43,10207.98
2018-10-15,2018-10-15,"Service payment - Jones, Anderson and Hancock",REF76521621,0.0,712.68,10920.66
2018-10-15,2018-10-15,Project payment - Walker Inc,REF59766487,0.0,967.87,11888.53
2018-10-15,2018-10-15,"Project payment - Burke, Hernandez and Alexander",REF49912393,0.0,806.62,12695.15
2018-10-15,2018-10-15,Service payment - Kennedy-Lewis,REF83169580,0.0,689.45,13384.6
2018-10-17,2018-10-17,Equipment purchase,REF43085093,178.24,0.0,13206.36
2018-10-20,2018-10-20,Accounting expense,REF93518924,61.5,0.0,13144.86
2018-10-21,2018-10-21,Professional software license,REF15699652,239.29,0.0,12905.57
2018-10-25,2018-10-25,Business travel,REF86970438,494.89,0.0,12410.68
2018-10-25,2018-10-25,Training/conference,REF72245220,194.02,0.0,12216.66
2018-10-28,2018-10-28,Marketing expenses,REF91963904,266.25,0.0,11950.41
2018-11-06,2018-11-06,Equipment purchase,REF42450788,252.86,0.0,11697.55
2018-11-06,2018-11-06,Marketing expenses,REF64426543,535.5,0.0,11162.05
2018-11-10,2018-11-10,Business travel,REF81049063,488.74,0.0,10673.31
2018-11-15,2018-11-15,"Project payment - Sanchez, Terry and Cox",REF41772560,0.0,595.02,11268.33
2018-11-15,2018-11-15,Invoice payment - Gordon-Snow,REF46741794,0.0,799.6,12067.93
2018-11-15,2018-11-15,Payment from Contreras-Miller,REF72943720,0.0,770.06,12837.99
2018-11-15,2018-11-15,Business insurance premium,REF10214159,154.05,0.0,12683.94
2018-11-15,2018-11-15,Payment from Walker Inc,REF30405621,0.0,1163.18,13847.12
2018-11-15,2018-11-15,Payment from Kennedy-Lewis,REF92910297,0.0,785.97,14633.09
2018-11-15,2018-11-15,"Service payment - Jones, Anderson and Hancock",REF41895003,0.0,565.8,15198.89
2018-11-15,2018-11-15,"Project payment - Burke, Hernandez and Alexander",REF26227478,0.0,532.97,15731.86
2018-11-18,2018-11-18,Coworking space rental,REF85365394,404.84,0.0,15327.02
2018-11-21,2018-11-21,Professional software license,REF35259300,215.37,0.0,15111.65
2018-11-23,2018-11-23,Equipment purchase,REF35160951,219.53,0.0,14892.12
2018-11-27,2018-11-27,Coworking space rental,REF72099084,406.51,0.0,14485.61
2018-11-30,2018-11-30,Accounting expense,REF53886504,204.79,0.0,14280.82
2018-12-13,2018-12-13,Business meal,REF33553889,240.03,0.0,14040.79
2018-12-15,2018-12-15,Business insurance premium,REF90630646,126.95,0.0,13913.84
2018-12-15,2018-12-15,"Invoice payment - Bond, Ryan and Austin",REF38238075,0.0,630.63,14544.47
2018-12-15,2018-12-15,Invoice payment - Walker Inc,REF57536696,0.0,619.62,15164.09
2018-12-15,2018-12-15,Service payment - Kennedy-Lewis,REF87184624,0.0,766.05,15930.14
2018-12-15,2018-12-15,"Payment from Sanchez, Terry and Cox",REF49986310,0.0,445.88,16376.02
2018-12-15,2018-12-15,"Payment from Jones, Anderson and Hancock",REF25234442,0.0,596.82,16972.84
2018-12-15,2018-12-15,Invoice payment - Gordon-Snow,REF25244936,0.0,699.05,17671.89
2018-12-15,2018-12-15,Payment from Contreras-Miller,REF31583109,0.0,610.89,18282.78
2018-12-15,2018-12-15,"Project payment - Burke, Hernandez and Alexander",REF55124329,0.0,553.78,18836.56
2018-12-21,2018-12-21,Professional software license,REF36024493,189.29,0.0,18647.27
2018-12-25,2018-12-25,Business meal,REF92012195,293.47,0.0,18353.8
2018-12-28,2018-12-28,Business meal,REF76513524,94.37,0.0,18259.43
2018-12-30,2018-12-30,Marketing expenses,REF64275292,195.97,0.0,18063.46
2019-01-01,2019-01-01,Accounting expense,REF24031824,215.17,0.0,17848.29
2019-01-03,2019-01-03,Business meal,REF79934129,228.61,0.0,17619.68
2019-01-05,2019-01-05,Business meal,REF11765317,425.39,0.0,17194.29
2019-01-07,2019-01-07,Equipment purchase,REF80484301,197.22,0.0,16997.07
2019-01-12,2019-01-12,Equipment purchase,REF56840197,164.36,0.0,16832.71
2019-01-15,2019-01-15,Business insurance premium,REF81526409,176.98,0.0,16655.73
2019-01-15,2019-01-15,Invoice payment - Gordon-Snow,REF62027253,0.0,592.23,17247.96
2019-01-15,2019-01-15,"Service payment - Sanchez, Terry and Cox",REF53941069,0.0,532.99,17780.95
2019-01-15,2019-01-15,"Invoice payment - Burke, Hernandez and Alexander",REF92702300,0.0,905.78,18686.73
2019-01-15,2019-01-15,Invoice payment - Contreras-Miller,REF78083312,0.0,1156.85,19843.58
2019-01-15,2019-01-15,Project payment - Walker Inc,REF32668322,0.0,1065.69,20909.27
2019-01-15,2019-01-15,"Invoice payment - Jones, Anderson and Hancock",REF95251410,0.0,789.62,21698.89
2019-01-15,2019-01-15,Payment from Kennedy-Lewis,REF96559806,0.0,1141.6,22840.49
2019-01-21,2019-01-21,Professional software license,REF97673997,209.38,0.0,22631.11
2019-01-25,2019-01-25,Marketing expenses,REF53742803,540.09,0.0,22091.02
2019-01-29,2019-01-29,Marketing expenses,REF58430979,279.86,0.0,21811.16
2019-01-30,2019-01-30,Marketing expenses,REF31626485,335.07,0.0,21476.09
2019-02-04,2019-02-04,Accounting expense,REF51267660,362.0,0.0,21114.09
2019-02-05,2019-02-05,Equipment purchase,REF57553138,165.83,0.0,20948.26
2019-02-15,2019-02-15,Service payment - Gordon-Snow,REF51284050,0.0,1066.58,22014.84
2019-02-15,2019-02-15,"Service payment - Burke, Hernandez and Alexander",REF50641535,0.0,536.01,22550.85
2019-02-15,2019-02-15,Invoice payment - Kennedy-Lewis,REF52634363,0.0,929.22,23480.07
2019-02-15,2019-02-15,"Project payment - Bond, Ryan and Austin",REF24564310,0.0,895.2,24375.27
2019-02-15,2019-02-15,"Payment from Sanchez, Terry and Cox",REF93114295,0.0,506.74,24882.01
2019-02-15,2019-02-15,Project payment - Walker Inc,REF75455362,0.0,1038.74,25920.75
2019-02-15,2019-02-15,Invoice payment - Contreras-Miller,REF13915944,0.0,933.72,26854.47
2019-02-15,2019-02-15,Business insurance premium,REF10460330,160.38,0.0,26694.09
2019-02-16,2019-02-16,Accounting expense,REF49109185,221.76,0.0,26472.33
2019-02-16,2019-02-16,Equipment purchase,REF85195747,156.17,0.0,26316.16
2019-02-18,2019-02-18,Training/conference,REF48620085,289.71,0.0,26026.45
2019-02-21,2019-02-21,Professional software license,REF63552671,210.92,0.0,25815.53
2019-02-28,2019-02-28,Training/conference,REF10808717,209.02,0.0,25606.51
2019-03-06,2019-03-06,Business meal,REF97070031,375.7,0.0,25230.81
2019-03-06,2019-03-06,Business travel,REF70297184,424.87,0.0,24805.94
2019-03-08,2019-03-08,Business meal,REF70573369,213.21,0.0,24592.73
2019-03-09,2019-03-09,Training/conference,REF34453798,294.77,0.0,24297.96
2019-03-12,2019-03-12,Marketing expenses,REF81425911,334.93,0.0,23963.03
2019-03-15,2019-03-15,Invoice payment - Contreras-Miller,REF61971834,0.0,796.14,24759.17
2019-03-15,2019-03-15,Payment from Kennedy-Lewis,REF59632323,0.0,658.2,25417.37
2019-03-15,2019-03-15,"Payment from Jones, Anderson and Hancock",REF29626271,0.0,735.95,26153.32
2019-03-15,2019-03-15,"Project payment - Sanchez, Terry and Cox",REF63762307,0.0,515.76,26669.08
2019-03-15,2019-03-15,Business insurance premium,REF75647771,143.28,0.0,26525.8
2019-03-15,2019-03-15,"Project payment - Bond, Ryan and Austin",REF53143329,0.0,645.58,27171.38
2019-03-15,2019-03-15,Service payment - Gordon-Snow,REF35720964,0.0,819.32,27990.7
2019-03-15,2019-03-15,Service payment - Walker Inc,REF40060941,0.0,903.09,28893.79
2019-03-15,2019-03-15,"Service payment - Burke, Hernandez and Alexander",REF82092475,0.0,685.11,29578.9
2019-03-21,2019-03-21,Professional software license,REF88822688,193.57,0.0,29385.33
2019-03-22,2019-03-22,Accounting expense,REF50867608,149.84,0.0,29235.49
2019-03-24,2019-03-24,Marketing expenses,REF80587599,372.44,0.0,28863.05
2019-03-26,2019-03-26,Marketing expenses,REF55070814,340.26,0.0,28522.79
2019-03-28,2019-03-28,Business meal,REF53416577,321.73,0.0,28201.06
2019-04-09,2019-04-09,Accounting expense,REF15015530,248.44,0.0,27952.62
2019-04-09,2019-04-09,Equipment purchase,REF47582532,142.47,0.0,27810.15
2019-04-13,2019-04-13,Business travel,REF34795248,400.27,0.0,27409.88
2019-04-15,2019-04-15,"Invoice payment - Jones, Anderson and Hancock",REF74327393,0.0,640.27,28050.15
2019-04-15,2019-04-15,"Project payment - Sanchez, Terry and Cox",REF71983503,0.0,403.48,28453.63
2019-04-15,2019-04-15,"Payment from Bond, Ryan and Austin",REF44619071,0.0,748.13,29201.76
2019-04-15,2019-04-15,Invoice payment - Contreras-Miller,REF96439760,0.0,939.9,30141.66
2019-04-15,2019-04-15,Payment from Kennedy-Lewis,REF75350248,0.0,781.32,30922.98
2019-04-15,2019-04-15,Payment from Gordon-Snow,REF83079956,0.0,885.91,31808.89
2019-04-15,2019-04-15,"Payment from Burke, Hernandez and Alexander",REF75380039,0.0,700.93,32509.82
2019-04-15,2019-04-15,Business insurance premium,REF17842111,141.41,0.0,32368.41
2019-04-16,2019-04-16,Business meal,REF76705698,198.97,0.0,32169.44
2019-04-19,2019-04-19,Marketing expenses,REF97732690,318.67,0.0,31850.77
2019-04-21,2019-04-21,Professional software license,REF92740815,185.65,0.0,31665.12
2019-04-25,2019-04-25,Business meal,REF57935984,194.69,0.0,31470.43
2019-05-01,2019-05-01,Training/conference,REF38358010,189.11,0.0,31281.32
2019-05-03,2019-05-03,Business travel,REF23093163,289.29,0.0,30992.03
2019-05-09,2019-05-09,Business travel,REF95290720,275.32,0.0,30716.71
2019-05-12,2019-05-12,Business meal,REF60944188,174.92,0.0,30541.79
2019-05-13,2019-05-13,Accounting expense,REF91052826,170.02,0.0,30371.77
2019-05-14,2019-05-14,Accounting expense,REF78661396,139.6,0.0,30232.17
2019-05-15,2019-05-15,Payment from Walker Inc,REF93925631,0.0,836.0,31068.17
2019-05-15,2019-05-15,Service payment - Contreras-Miller,REF37067635,0.0,658.39,31726.56
2019-05-15,2019-05-15,"Payment from Burke, Hernandez and Alexander",REF45095506,0.0,575.06,32301.62
2019-05-15,2019-05-15,"Service payment - Bond, Ryan and Austin",REF38713248,0.0,729.19,33030.81
2019-05-15,2019-05-15,Service payment - Kennedy-Lewis,REF22264288,0.0,695.74,33726.55
2019-05-15,2019-05-15,Payment from Gordon-Snow,REF20621285,0.0,848.32,34574.87
2019-05-15,2019-05-15,"Invoice payment - Jones, Anderson and Hancock",REF61443009,0.0,438.59,35013.46
2019-05-15,2019-05-15,"Service payment - Sanchez, Terry and Cox",REF58363289,0.0,444.37,35457.83
2019-05-15,2019-05-15,Business insurance premium,REF87992648,122.28,0.0,35335.55
2019-05-21,2019-05-21,Professional software license,REF18562581,198.75,0.0,35136.8
2019-06-10,2019-06-10,Accounting expense,REF98507294,128.2,0.0,35008.6
2019-06-13,2019-06-13,Business meal,REF30531490,224.64,0.0,34783.96
2019-06-15,2019-06-15,"Payment from Jones, Anderson and Hancock",REF10893925,0.0,484.69,35268.65
2019-06-15,2019-06-15,Project payment - Walker Inc,REF73346915,0.0,696.42,35965.07
2019-06-15,2019-06-15,"Service payment - Sanchez, Terry and Cox",REF76891320,0.0,357.07,36322.14
2019-06-15,2019-06-15,Invoice payment - Contreras-Miller,REF80826842,0.0,823.97,37146.11
2019-06-15,2019-06-15,"Service payment - Burke, Hernandez and Alexander",REF13777326,0.0,520.76,37666.87
2019-06-15,2019-06-15,Payment from Kennedy-Lewis,REF56880648,0.0,577.68,38244.55
2019-06-15,2019-06-15,Payment from Gordon-Snow,REF19782283,0.0,549.73,38794.28
2019-06-15,2019-06-15,"Invoice payment - Bond, Ryan and Austin",REF33233885,0.0,579.12,39373.4
2019-06-15,2019-06-15,Business insurance premium,REF50998493,113.23,0.0,39260.17
2019-06-17,2019-06-17,Accounting expense,REF99784175,102.58,0.0,39157.59
2019-06-18,2019-06-18,Training/conference,REF77098780,183.44,0.0,38974.15
2019-06-21,2019-06-21,Professional software license,REF10608557,166.76,0.0,38807.39
2019-07-03,2019-07-03,Marketing expenses,REF81297956,243.4,0.0,38563.99
2019-07-04,2019-07-04,Business travel,REF70726356,294.14,0.0,38269.85
2019-07-07,2019-07-07,Training/conference,REF58160175,112.16,0.0,38157.69
2019-07-07,2019-07-07,Accounting expense,REF28560976,177.47,0.0,37980.22
2019-07-12,2019-07-12,Marketing expenses,REF98954013,279.58,0.0,37700.64
2019-07-13,2019-07-13,Equipment purchase,REF59781748,115.57,0.0,37585.07
2019-07-15,2019-07-15,Payment from Gordon-Snow,REF43758401,0.0,520.2,38105.27
2019-07-15,2019-07-15,Invoice payment - Contreras-Miller,REF80316886,0.0,654.83,38760.1
2019-07-15,2019-07-15,Business insurance premium,REF39507723,98.32,0.0,38661.78
2019-07-15,2019-07-15,Business travel,REF75497976,247.1,0.0,38414.68
2019-07-15,2019-07-15,"Project payment - Bond, Ryan and Austin",REF28774928,0.0,384.59,38799.27
2019-07-15,2019-07-15,"Invoice payment - Jones, Anderson and Hancock",REF92105860,0.0,470.47,39269.74
2019-07-15,2019-07-15,"Project payment - Burke, Hernandez and Alexander",REF24198544,0.0,365.41,39635.15
2019-07-15,2019-07-15,Project payment - Walker Inc,REF56432335,0.0,724.39,40359.54
2019-07-15,2019-07-15,"Service payment - Sanchez, Terry and Cox",REF37657441,0.0,317.37,40676.91
2019-07-17,2019-07-17,Business travel,REF10816915,469.27,0.0,40207.64
2019-07-20,2019-07-20,Business travel,REF46118011,315.12,0.0,39892.52
2019-07-21,2019-07-21,Professional software license,REF46338812,144.97,0.0,39747.55
2019-07-24,2019-07-24,Business meal,REF65821283,117.07,0.0,39630.48
2019-07-26,2019-07-26,Coworking space rental,REF89986448,159.92,0.0,39470.56
2019-07-26,2019-07-26,Marketing expenses,REF71650538,171.97,0.0,39298.59
2019-07-26,2019-07-26,Accounting expense,REF11180983,101.9,0.0,39196.69
2019-07-27,2019-07-27,Business travel,REF58349397,404.03,0.0,38792.66
2019-07-28,2019-07-28,Marketing expenses,REF16283245,247.66,0.0,38545.0
2019-07-29,2019-07-29,Training/conference,REF34338330,96.61,0.0,38448.39
2019-07-30,2019-07-30,Business meal,REF83508477,145.12,0.0,38303.27
2019-08-07,2019-08-07,Training/conference,REF10121222,208.84,0.0,38094.43
2019-08-14,2019-08-14,Accounting expense,REF93155010,135.09,0.0,37959.34
2019-08-15,2019-08-15,"Invoice payment - Burke, Hernandez and Alexander",REF44845637,0.0,539.77,38499.11
2019-08-15,2019-08-15,"Payment from Bond, Ryan and Austin",REF23063029,0.0,615.97,39115.08
2019-08-15,2019-08-15,Invoice payment - Gordon-Snow,REF27219243,0.0,796.71,39911.79
2019-08-15,2019-08-15,Service payment - Walker Inc,REF63281208,0.0,603.64,40515.43
2019-08-15,2019-08-15,Business insurance premium,REF75042362,106.62,0.0,40408.81
2019-08-15,2019-08-15,"Invoice payment - Sanchez, Terry and Cox",REF12545312,0.0,451.08,40859.89
2019-08-21,2019-08-21,Professional software license,REF63754697,161.55,0.0,40698.34
2019-08-24,2019-08-24,Coworking space rental,REF59564392,153.32,0.0,40545.02
2019-08-27,2019-08-27,Coworking space rental,REF78027345,185.98,0.0,40359.04
2019-09-01,2019-09-01,Business travel,REF93053102,539.08,0.0,39819.96
2019-09-01,2019-09-01,Training/conference,REF94315927,216.98,0.0,39602.98
2019-09-06,2019-09-06,Coworking space rental,REF70203445,349.85,0.0,39253.13
2019-09-15,2019-09-15,Business insurance premium,REF62643199,156.17,0.0,39096.96
2019-09-15,2019-09-15,"Payment from Burke, Hernandez and Alexander",REF93813951,0.0,702.43,39799.39
2019-09-15,2019-09-15,Invoice payment - Walker Inc,REF85506087,0.0,1020.41,40819.8
2019-09-15,2019-09-15,"Payment from Jones, Anderson and Hancock",REF82295123,0.0,608.77,41428.57
2019-09-15,2019-09-15,"Project payment - Bond, Ryan and Austin",REF82824659,0.0,887.72,42316.29
2019-09-15,2019-09-15,Project payment - Kennedy-Lewis,REF85753438,0.0,882.34,43198.63
2019-09-15,2019-09-15,"Service payment - Sanchez, Terry and Cox",REF18217518,0.0,536.28,43734.91
2019-09-15,2019-09-15,Service payment - Contreras-Miller,REF82724091,0.0,1132.82,44867.73
2019-09-16,2019-09-16,Business travel,REF14125058,366.88,0.0,44500.85
2019-09-19,2019-09-19,Coworking space rental,REF57814609,401.77,0.0,44099.08
2019-09-20,2019-09-20,Marketing expenses,REF93565492,549.01,0.0,43550.07
2019-09-21,2019-09-21,Professional software license,REF28294820,220.94,0.0,43329.13
2019-09-22,2019-09-22,Business travel,REF36464842,355.12,0.0,42974.01
2019-09-22,2019-09-22,Training/conference,REF58746267,285.55,0.0,42688.46
2019-09-23,2019-09-23,Business meal,REF99968895,120.04,0.0,42568.42
2019-09-27,2019-09-27,Marketing expenses,REF87049147,125.12,0.0,42443.3
2019-10-02,2019-10-02,Business travel,REF48574061,636.66,0.0,41806.64
2019-10-04,2019-10-04,Business travel,REF61696697,414.01,0.0,41392.63
2019-10-04,2019-10-04,Coworking space rental,REF18896022,529.5,0.0,40863.13
2019-10-07,2019-10-07,Marketing expenses,REF29930809,334.4,0.0,40528.73
2019-10-11,2019-10-11,Marketing expenses,REF15322052,240.76,0.0,40287.97
2019-10-14,2019-10-14,Marketing expenses,REF77607903,320.43,0.0,39967.54
2019-10-15,2019-10-15,Service payment - Walker Inc,REF59831847,0.0,1083.93,41051.47
2019-10-15,2019-10-15,Project payment - Kennedy-Lewis,REF93630016,0.0,1093.12,42144.59
2019-10-15,2019-10-15,"Project payment - Bond, Ryan and Austin",REF75502387,0.0,798.0,42942.59
2019-10-15,2019-10-15,Business insurance premium,REF26680957,169.84,0.0,42772.75
2019-10-15,2019-10-15,Invoice payment - Contreras-Miller,REF87142315,0.0,1097.48,43870.23
2019-10-15,2019-10-15,Equipment purchase,REF28595793,223.76,0.0,43646.47
2019-10-15,2019-10-15,"Service payment - Sanchez, Terry and Cox",REF87252225,0.0,680.13,44326.6
2019-10-15,2019-10-15,Payment from Gordon-Snow,REF93219459,0.0,1043.07,45369.67
2019-10-15,2019-10-15,"Invoice payment - Burke, Hernandez and Alexander",REF70212206,0.0,605.75,45975.42
2019-10-15,2019-10-15,Business travel,REF87397548,544.05,0.0,45431.37
2019-10-19,2019-10-19,Business meal,REF60082600,344.98,0.0,45086.39
2019-10-21,2019-10-21,Professional software license,REF69675191,229.2,0.0,44857.19
2019-10-24,2019-10-24,Accounting expense,REF24172011,251.88,0.0,44605.31
2019-11-06,2019-11-06,Accounting expense,REF76533827,169.72,0.0,44435.59
2019-11-07,2019-11-07,Marketing expenses,REF14081741,457.48,0.0,43978.11
2019-11-07,2019-11-07,Business travel,REF38570173,705.77,0.0,43272.34
2019-11-08,2019-11-08,Training/conference,REF37771185,194.45,0.0,43077.89
2019-11-08,2019-11-08,Business travel,REF99826484,382.18,0.0,42695.71
2019-11-09,2019-11-09,Business travel,REF87344968,205.78,0.0,42489.93
2019-11-11,2019-11-11,Equipment purchase,REF14985450,148.01,0.0,42341.92
2019-11-14,2019-11-14,Business travel,REF46047035,270.21,0.0,42071.71
2019-11-15,2019-11-15,Payment from Contreras-Miller,REF31628467,0.0,1145.67,43217.38
2019-11-15,2019-11-15,"Project payment - Jones, Anderson and Hancock",REF73610258,0.0,593.22,43810.6
2019-11-15,2019-11-15,Service payment - Walker Inc,REF39825146,0.0,1074.91,44885.51
2019-11-15,2019-11-15,Business insurance premium,REF21382950,159.31,0.0,44726.2
2019-11-15,2019-11-15,"Payment from Sanchez, Terry and Cox",REF89792125,0.0,508.98,45235.18
2019-11-15,2019-11-15,Payment from Gordon-Snow,REF87891721,0.0,679.21,45914.39
2019-11-15,2019-11-15,Project payment - Kennedy-Lewis,REF31038708,0.0,910.14,46824.53
2019-11-20,2019-11-20,Accounting expense,REF77627457,247.55,0.0,46576.98
2019-11-21,2019-11-21,Professional software license,REF52208181,227.74,0.0,46349.24
2019-11-23,2019-11-23,Equipment purchase,REF88756129,259.45,0.0,46089.79
2019-11-24,2019-11-24,Business meal,REF13414679,317.96,0.0,45771.83
2019-11-29,2019-11-29,Coworking space rental,REF47462934,554.47,0.0,45217.36
2019-12-01,2019-12-01,Accounting expense,REF84874464,159.44,0.0,45057.92
2019-12-04,2019-12-04,Marketing expenses,REF76120714,323.73,0.0,44734.19
2019-12-09,2019-12-09,Training/conference,REF24372371,166.88,0.0,44567.31
2019-12-15,2019-12-15,Business insurance premium,REF72265362,124.19,0.0,44443.12
2019-12-15,2019-12-15,"Invoice payment - Sanchez, Terry and Cox",REF92249841,0.0,447.49,44890.61
2019-12-15,2019-12-15,"Service payment - Bond, Ryan and Austin",REF86106800,0.0,571.18,45461.79
2019-12-15,2019-12-15,Service payment - Contreras-Miller,REF52735629,0.0,800.9,46262.69
2019-12-15,2019-12-15,"Invoice payment - Burke, Hernandez and Alexander",REF35227497,0.0,484.47,46747.16
2019-12-15,2019-12-15,Invoice payment - Kennedy-Lewis,REF19165007,0.0,831.49,47578.65
2019-12-15,2019-12-15,Service payment - Walker Inc,REF42697298,0.0,938.35,48517.0
2019-12-15,2019-12-15,"Invoice payment - Jones, Anderson and Hancock",REF14799348,0.0,572.93,49089.93
2019-12-15,2019-12-15,Invoice payment - Gordon-Snow,REF16102977,0.0,870.03,49959.96
2019-12-16,2019-12-16,Training/conference,REF29684605,239.51,0.0,49720.45
2019-12-18,2019-12-18,Marketing expenses,REF32735588,246.3,0.0,49474.15
2019-12-18,2019-12-18,Business meal,REF52136710,290.07,0.0,49184.08
2019-12-19,2019-12-19,Accounting expense,REF93923146,107.34,0.0,49076.74
2019-12-20,2019-12-20,Business travel,REF17265848,463.29,0.0,48613.45
2019-12-21,2019-12-21,Professional software license,REF93381005,185.21,0.0,48428.24
2019-12-22,2019-12-22,Business meal,REF63775638,319.56,0.0,48108.68
2019-12-23,2019-12-23,Training/conference,REF74944593,224.48,0.0,47884.2
2020-01-15,2020-01-15,Invoice payment - Contreras-Miller,REF31899444,0.0,1013.18,48897.38
2020-01-15,2020-01-15,"Payment from Sanchez, Terry and Cox",REF41961708,0.0,532.62,49430.0
2020-01-15,2020-01-15,Business insurance premium,REF36906950,177.48,0.0,49252.52
2020-01-15,2020-01-15,"Service payment - Jones, Anderson and Hancock",REF28558644,0.0,741.34,49993.86
2020-01-15,2020-01-15,Service payment - Gordon-Snow,REF23203819,0.0,918.32,50912.18
2020-01-15,2020-01-15,"Payment from Burke, Hernandez and Alexander",REF10479639,0.0,817.25,51729.43
2020-01-15,2020-01-15,Project payment - Walker Inc,REF83342431,0.0,854.31,52583.74
2020-01-15,2020-01-15,Invoice payment - Kennedy-Lewis,REF15727430,0.0,1269.43,53853.17
2020-01-15,2020-01-15,"Service payment - Bond, Ryan and Austin",REF10388751,0.0,951.39,54804.56
2020-01-17,2020-01-17,Equipment purchase,REF94606989,158.27,0.0,54646.29
2020-01-21,2020-01-21,Professional software license,REF64331449,238.65,0.0,54407.64
2020-01-23,2020-01-23,Business travel,REF69687185,530.19,0.0,53877.45
2020-01-23,2020-01-23,Business meal,REF45013929,206.51,0.0,53670.94
2020-01-27,2020-01-27,Coworking space rental,REF65760902,269.02,0.0,53401.92
2020-01-27,2020-01-27,Training/conference,REF65965358,298.55,0.0,53103.37
2020-01-29,2020-01-29,Training/conference,REF28194579,213.37,0.0,52890.0
2020-01-31,2020-01-31,Business travel,REF27363185,580.81,0.0,52309.19
2020-02-06,2020-02-06,Coworking space rental,REF27179296,390.78,0.0,51918.41
2020-02-15,2020-02-15,Business travel,REF83418517,427.18,0.0,51491.23
2020-02-15,2020-02-15,Payment from Gordon-Snow,REF97649086,0.0,936.36,52427.59
2020-02-15,2020-02-15,"Project payment - Sanchez, Terry and Cox",REF62747894,0.0,416.56,52844.15
2020-02-15,2020-02-15,Invoice payment - Walker Inc,REF85770524,0.0,842.43,53686.58
2020-02-15,2020-02-15,Project payment - Kennedy-Lewis,REF29916755,0.0,859.01,54545.59
2020-02-15,2020-02-15,"Payment from Bond, Ryan and Austin",REF70435178,0.0,648.95,55194.54
2020-02-15,2020-02-15,"Invoice payment - Burke, Hernandez and Alexander",REF81724420,0.0,619.27,55813.81
2020-02-15,2020-02-15,Service payment - Contreras-Miller,REF47252246,0.0,861.46,56675.27
2020-02-15,2020-02-15,"Service payment - Jones, Anderson and Hancock",REF95385186,0.0,600.89,57276.16
2020-02-15,2020-02-15,Business insurance premium,REF48831708,153.26,0.0,57122.9
2020-02-18,2020-02-18,Training/conference,REF37013999,244.71,0.0,56878.19
2020-02-21,2020-02-21,Professional software license,REF92496332,218.35,0.0,56659.84
2020-02-28,2020-02-28,Marketing expenses,REF24517574,520.96,0.0,56138.88
2020-03-06,2020-03-06,Coworking space rental,REF63356540,294.49,0.0,55844.39
2020-03-08,2020-03-08,Accounting expense,REF26980729,100.19,0.0,55744.2
2020-03-15,2020-03-15,Business insurance premium,REF89110456,129.36,0.0,55614.84
2020-03-15,2020-03-15,"Project payment - Sanchez, Terry and Cox",REF32392921,0.0,540.85,56155.69
2020-03-15,2020-03-15,Project payment - Walker Inc,REF31324516,0.0,932.71,57088.4
2020-03-15,2020-03-15,Payment from Contreras-Miller,REF62606583,0.0,840.81,57929.21
2020-03-15,2020-03-15,Payment from Kennedy-Lewis,REF97967363,0.0,936.98,58866.19
2020-03-15,2020-03-15,Payment from Gordon-Snow,REF26041926,0.0,587.68,59453.87
2020-03-15,2020-03-15,"Invoice payment - Burke, Hernandez and Alexander",REF12634692,0.0,706.23,60160.1
2020-03-15,2020-03-15,"Project payment - Jones, Anderson and Hancock",REF28985651,0.0,628.59,60788.69
2020-03-15,2020-03-15,"Service payment - Bond, Ryan and Austin",REF33404469,0.0,646.36,61435.05
2020-03-20,2020-03-20,Business travel,REF68034896,402.74,0.0,61032.31
2020-03-20,2020-03-20,Coworking space rental,REF47921263,408.94,0.0,60623.37
2020-03-21,2020-03-21,Business travel,REF17823748,395.19,0.0,60228.18
2020-03-21,2020-03-21,Professional software license,REF31147598,196.41,0.0,60031.77
2020-03-27,2020-03-27,Business travel,REF42015627,365.04,0.0,59666.73
2020-04-03,2020-04-03,Business meal,REF46119488,296.01,0.0,59370.72
2020-04-10,2020-04-10,Training/conference,REF62258099,290.01,0.0,59080.71
2020-04-15,2020-04-15,"Payment from Bond, Ryan and Austin",REF43423293,0.0,842.24,59922.95
2020-04-15,2020-04-15,"Payment from Burke, Hernandez and Alexander",REF85335518,0.0,556.86,60479.81
2020-04-15,2020-04-15,Project payment - Walker Inc,REF68662130,0.0,1122.39,61602.2
2020-04-15,2020-04-15,Payment from Contreras-Miller,REF69393096,0.0,729.77,62331.97
2020-04-15,2020-04-15,"Invoice payment - Jones, Anderson and Hancock",REF61284789,0.0,773.84,63105.81
2020-04-15,2020-04-15,"Invoice payment - Sanchez, Terry and Cox",REF85255069,0.0,508.07,63613.88
2020-04-15,2020-04-15,Service payment - Gordon-Snow,REF95770978,0.0,573.42,64187.3
2020-04-15,2020-04-15,Invoice payment - Kennedy-Lewis,REF84752980,0.0,851.83,65039.13
2020-04-15,2020-04-15,Business insurance premium,REF87765237,145.02,0.0,64894.11
2020-04-18,2020-04-18,Equipment purchase,REF76617309,181.92,0.0,64712.19
2020-04-19,2020-04-19,Marketing expenses,REF68287457,336.29,0.0,64375.9
2020-04-21,2020-04-21,Professional software license,REF19388402,204.71,0.0,64171.19
2020-04-22,2020-04-22,Business meal,REF87491462,306.55,0.0,63864.64
2020-04-24,2020-04-24,Business travel,REF80324021,367.19,0.0,63497.45
2020-05-06,2020-05-06,Equipment purchase,REF50223006,138.27,0.0,63359.18
2020-05-10,2020-05-10,Coworking space rental,REF49292941,167.47,0.0,63191.71
2020-05-12,2020-05-12,Business travel,REF14906064,370.04,0.0,62821.67
2020-05-14,2020-05-14,Business meal,REF30494062,272.15,0.0,62549.52
2020-05-15,2020-05-15,Business insurance premium,REF75038132,118.22,0.0,62431.3
2020-05-15,2020-05-15,"Project payment - Bond, Ryan and Austin",REF93135694,0.0,697.76,63129.06
2020-05-15,2020-05-15,"Payment from Burke, Hernandez and Alexander",REF32362158,0.0,500.04,63629.1
2020-05-15,2020-05-15,"Project payment - Sanchez, Terry and Cox",REF62567340,0.0,432.16,64061.26
2020-05-15,2020-05-15,Payment from Kennedy-Lewis,REF41412727,0.0,619.91,64681.17
2020-05-15,2020-05-15,Invoice payment - Gordon-Snow,REF50478092,0.0,534.0,65215.17
2020-05-15,2020-05-15,Service payment - Contreras-Miller,REF95148191,0.0,757.75,65972.92
2020-05-15,2020-05-15,Payment from Walker Inc,REF44295674,0.0,665.83,66638.75
2020-05-15,2020-05-15,Marketing expenses,REF85342207,243.3,0.0,66395.45
2020-05-21,2020-05-21,Accounting expense,REF47413905,150.76,0.0,66244.69
2020-05-21,2020-05-21,Professional software license,REF62694401,178.97,0.0,66065.72
2020-05-21,2020-05-21,Marketing expenses,REF78559058,254.18,0.0,65811.54
2020-05-24,2020-05-24,Coworking space rental,REF14211879,277.12,0.0,65534.42
2020-05-26,2020-05-26,Business meal,REF98086587,331.64,0.0,65202.78
2020-06-10,2020-06-10,Business meal,REF75277869,192.82,0.0,65009.96
2020-06-12,2020-06-12,Equipment purchase,REF52243669,91.18,0.0,64918.78
2020-06-13,2020-06-13,Coworking space rental,REF97679746,228.4,0.0,64690.38
2020-06-14,2020-06-14,Marketing expenses,REF50437551,217.61,0.0,64472.77
2020-06-14,2020-06-14,Business travel,REF93047168,447.19,0.0,64025.58
2020-06-15,2020-06-15,Payment from Contreras-Miller,REF98001573,0.0,660.08,64685.66
2020-06-15,2020-06-15,"Payment from Jones, Anderson and Hancock",REF14983892,0.0,485.83,65171.49
2020-06-15,2020-06-15,Invoice payment - Gordon-Snow,REF56236331,0.0,670.32,65841.81
2020-06-15,2020-06-15,"Service payment - Bond, Ryan and Austin",REF71485449,0.0,447.64,66289.45
2020-06-15,2020-06-15,Service payment - Kennedy-Lewis,REF48241773,0.0,785.79,67075.24
2020-06-15,2020-06-15,"Payment from Burke, Hernandez and Alexander",REF98600285,0.0,421.46,67496.7
2020-06-15,2020-06-15,"Service payment - Sanchez, Terry and Cox",REF22254501,0.0,391.86,67888.56
2020-06-15,2020-06-15,Business insurance premium,REF54844544,109.6,0.0,67778.96
2020-06-21,2020-06-21,Professional software license,REF25685539,163.89,0.0,67615.07
2020-06-25,2020-06-25,Business meal,REF51023199,178.62,0.0,67436.45
